/jdk1.3.1_20/com/sun/image/codec/jpeg/ImageFormatException.java,Java,,10,4,38,52
/jdk1.3.1_20/com/sun/image/codec/jpeg/JPEGCodec.java,Java,,49,13,88,150
/jdk1.3.1_20/com/sun/image/codec/jpeg/JPEGDecodeParam.java,Java,,62,45,262,369
/jdk1.3.1_20/com/sun/image/codec/jpeg/JPEGEncodeParam.java,Java,,27,20,209,256
/jdk1.3.1_20/com/sun/image/codec/jpeg/JPEGHuffmanTable.java,Java,,139,31,71,241
/jdk1.3.1_20/com/sun/image/codec/jpeg/JPEGImageDecoder.java,Java,,23,14,103,140
/jdk1.3.1_20/com/sun/image/codec/jpeg/JPEGImageEncoder.java,Java,,29,23,178,230
/jdk1.3.1_20/com/sun/image/codec/jpeg/JPEGQTable.java,Java,,62,20,68,150
/jdk1.3.1_20/com/sun/image/codec/jpeg/TruncatedFileException.java,Java,,19,8,55,82
/jdk1.3.1_20/com/sun/java/swing/plaf/motif/MotifBorders.java,Java,,498,125,93,716
/jdk1.3.1_20/com/sun/java/swing/plaf/motif/MotifButtonListener.java,Java,,14,8,24,46
/jdk1.3.1_20/com/sun/java/swing/plaf/motif/MotifButtonUI.java,Java,,54,21,33,108
/jdk1.3.1_20/com/sun/java/swing/plaf/motif/MotifCheckBoxMenuItemUI.java,Java,,72,25,12,109
/jdk1.3.1_20/com/sun/java/swing/plaf/motif/MotifCheckBoxUI.java,Java,,26,13,23,62
/jdk1.3.1_20/com/sun/java/swing/plaf/motif/MotifComboBoxRenderer.java,Java,,44,17,33,94
/jdk1.3.1_20/com/sun/java/swing/plaf/motif/MotifComboBoxUI.java,Java,,269,44,38,351
/jdk1.3.1_20/com/sun/java/swing/plaf/motif/MotifDesktopIconUI.java,Java,,248,52,28,328
/jdk1.3.1_20/com/sun/java/swing/plaf/motif/MotifDesktopPaneUI.java,Java,,103,19,24,146
/jdk1.3.1_20/com/sun/java/swing/plaf/motif/MotifEditorPaneUI.java,Java,,13,7,31,51
/jdk1.3.1_20/com/sun/java/swing/plaf/motif/MotifFileChooserUI.java,Java,,485,116,58,659
/jdk1.3.1_20/com/sun/java/swing/plaf/motif/MotifGraphicsUtils.java,Java,,306,61,73,440
/jdk1.3.1_20/com/sun/java/swing/plaf/motif/MotifIconFactory.java,Java,,355,58,36,449
/jdk1.3.1_20/com/sun/java/swing/plaf/motif/MotifInternalFrameTitlePane.java,Java,,324,52,18,394
/jdk1.3.1_20/com/sun/java/swing/plaf/motif/MotifInternalFrameUI.java,Java,,133,29,40,202
/jdk1.3.1_20/com/sun/java/swing/plaf/motif/MotifLabelUI.java,Java,,11,4,18,33
/jdk1.3.1_20/com/sun/java/swing/plaf/motif/MotifLookAndFeel.java,Java,,881,124,52,1057
/jdk1.3.1_20/com/sun/java/swing/plaf/motif/MotifMenuBarUI.java,Java,,23,8,20,51
/jdk1.3.1_20/com/sun/java/swing/plaf/motif/MotifMenuItemUI.java,Java,,71,23,11,105
/jdk1.3.1_20/com/sun/java/swing/plaf/motif/MotifMenuMouseListener.java,Java,,17,2,10,29
/jdk1.3.1_20/com/sun/java/swing/plaf/motif/MotifMenuMouseMotionListener.java,Java,,11,3,10,24
/jdk1.3.1_20/com/sun/java/swing/plaf/motif/MotifMenuUI.java,Java,,93,25,25,143
/jdk1.3.1_20/com/sun/java/swing/plaf/motif/MotifOptionPaneUI.java,Java,,49,13,33,95
/jdk1.3.1_20/com/sun/java/swing/plaf/motif/MotifPasswordFieldUI.java,Java,,13,10,31,54
/jdk1.3.1_20/com/sun/java/swing/plaf/motif/MotifPopupMenuSeparatorUI.java,Java,,27,9,11,47
/jdk1.3.1_20/com/sun/java/swing/plaf/motif/MotifPopupMenuUI.java,Java,,62,15,21,98
/jdk1.3.1_20/com/sun/java/swing/plaf/motif/MotifProgressBarUI.java,Java,,13,6,20,39
/jdk1.3.1_20/com/sun/java/swing/plaf/motif/MotifRadioButtonMenuItemUI.java,Java,,75,23,18,116
/jdk1.3.1_20/com/sun/java/swing/plaf/motif/MotifRadioButtonUI.java,Java,,33,15,29,77
/jdk1.3.1_20/com/sun/java/swing/plaf/motif/MotifScrollBarButton.java,Java,,154,25,14,193
/jdk1.3.1_20/com/sun/java/swing/plaf/motif/MotifScrollBarUI.java,Java,,54,18,18,90
/jdk1.3.1_20/com/sun/java/swing/plaf/motif/MotifScrollPaneUI.java,Java,,53,16,17,86
/jdk1.3.1_20/com/sun/java/swing/plaf/motif/MotifSeparatorUI.java,Java,,16,9,19,44
/jdk1.3.1_20/com/sun/java/swing/plaf/motif/MotifSliderUI.java,Java,,82,29,30,141
/jdk1.3.1_20/com/sun/java/swing/plaf/motif/MotifSplitPaneDivider.java,Java,,181,36,59,276
/jdk1.3.1_20/com/sun/java/swing/plaf/motif/MotifSplitPaneUI.java,Java,,18,6,23,47
/jdk1.3.1_20/com/sun/java/swing/plaf/motif/MotifTabbedPaneUI.java,Java,,194,34,22,250
/jdk1.3.1_20/com/sun/java/swing/plaf/motif/MotifTextAreaUI.java,Java,,13,5,33,51
/jdk1.3.1_20/com/sun/java/swing/plaf/motif/MotifTextFieldUI.java,Java,,13,5,31,49
/jdk1.3.1_20/com/sun/java/swing/plaf/motif/MotifTextPaneUI.java,Java,,13,7,31,51
/jdk1.3.1_20/com/sun/java/swing/plaf/motif/MotifTextUI.java,Java,,73,15,76,164
/jdk1.3.1_20/com/sun/java/swing/plaf/motif/MotifToggleButtonUI.java,Java,,52,18,29,99
/jdk1.3.1_20/com/sun/java/swing/plaf/motif/MotifTreeCellRenderer.java,Java,,51,16,27,94
/jdk1.3.1_20/com/sun/java/swing/plaf/motif/MotifTreeUI.java,Java,,74,24,45,143
/jdk1.3.1_20/com/sun/java/swing/plaf/windows/WindowsBorders.java,Java,,56,18,9,83
/jdk1.3.1_20/com/sun/java/swing/plaf/windows/WindowsButtonListener.java,Java,,12,8,30,50
/jdk1.3.1_20/com/sun/java/swing/plaf/windows/WindowsButtonUI.java,Java,,51,16,31,98
/jdk1.3.1_20/com/sun/java/swing/plaf/windows/WindowsCheckBoxMenuItemUI.java,Java,,5,6,14,25
/jdk1.3.1_20/com/sun/java/swing/plaf/windows/WindowsCheckBoxUI.java,Java,,28,14,26,68
/jdk1.3.1_20/com/sun/java/swing/plaf/windows/WindowsComboBoxUI.java,Java,,123,26,22,171
/jdk1.3.1_20/com/sun/java/swing/plaf/windows/WindowsDesktopIconUI.java,Java,,5,6,14,25
/jdk1.3.1_20/com/sun/java/swing/plaf/windows/WindowsDesktopManager.java,Java,,81,18,50,149
/jdk1.3.1_20/com/sun/java/swing/plaf/windows/WindowsDesktopPaneUI.java,Java,,49,12,18,79
/jdk1.3.1_20/com/sun/java/swing/plaf/windows/WindowsEditorPaneUI.java,Java,,14,7,28,49
/jdk1.3.1_20/com/sun/java/swing/plaf/windows/WindowsFileChooserUI.java,Java,,770,183,111,1064
/jdk1.3.1_20/com/sun/java/swing/plaf/windows/WindowsIconFactory.java,Java,,324,63,41,428
/jdk1.3.1_20/com/sun/java/swing/plaf/windows/WindowsInternalFrameUI.java,Java,,16,8,14,38
/jdk1.3.1_20/com/sun/java/swing/plaf/windows/WindowsLabelUI.java,Java,,5,6,14,25
/jdk1.3.1_20/com/sun/java/swing/plaf/windows/WindowsListUI.java,Java,,5,6,4,15
/jdk1.3.1_20/com/sun/java/swing/plaf/windows/WindowsLookAndFeel.java,Java,,623,78,69,770
/jdk1.3.1_20/com/sun/java/swing/plaf/windows/WindowsMenuBarUI.java,Java,,5,6,14,25
/jdk1.3.1_20/com/sun/java/swing/plaf/windows/WindowsMenuItemUI.java,Java,,5,6,14,25
/jdk1.3.1_20/com/sun/java/swing/plaf/windows/WindowsMenuUI.java,Java,,5,6,14,25
/jdk1.3.1_20/com/sun/java/swing/plaf/windows/WindowsOptionPaneUI.java,Java,,5,6,14,25
/jdk1.3.1_20/com/sun/java/swing/plaf/windows/WindowsPasswordFieldUI.java,Java,,13,9,28,50
/jdk1.3.1_20/com/sun/java/swing/plaf/windows/WindowsPopupMenuUI.java,Java,,5,6,14,25
/jdk1.3.1_20/com/sun/java/swing/plaf/windows/WindowsProgressBarUI.java,Java,,11,6,17,34
/jdk1.3.1_20/com/sun/java/swing/plaf/windows/WindowsRadioButtonMenuItemUI.java,Java,,5,6,14,25
/jdk1.3.1_20/com/sun/java/swing/plaf/windows/WindowsRadioButtonUI.java,Java,,36,14,23,73
/jdk1.3.1_20/com/sun/java/swing/plaf/windows/WindowsScrollBarUI.java,Java,,5,6,14,25
/jdk1.3.1_20/com/sun/java/swing/plaf/windows/WindowsScrollPaneUI.java,Java,,5,6,14,25
/jdk1.3.1_20/com/sun/java/swing/plaf/windows/WindowsSeparatorUI.java,Java,,5,6,4,15
/jdk1.3.1_20/com/sun/java/swing/plaf/windows/WindowsSliderUI.java,Java,,9,7,14,30
/jdk1.3.1_20/com/sun/java/swing/plaf/windows/WindowsSpinnerUI.java,Java,,5,6,4,15
/jdk1.3.1_20/com/sun/java/swing/plaf/windows/WindowsSplitPaneDivider.java,Java,,23,7,23,53
/jdk1.3.1_20/com/sun/java/swing/plaf/windows/WindowsSplitPaneUI.java,Java,,18,10,20,48
/jdk1.3.1_20/com/sun/java/swing/plaf/windows/WindowsStandardDialogUI.java,Java,,5,6,4,15
/jdk1.3.1_20/com/sun/java/swing/plaf/windows/WindowsTabbedPaneUI.java,Java,,5,6,14,25
/jdk1.3.1_20/com/sun/java/swing/plaf/windows/WindowsTableHeaderUI.java,Java,,5,6,4,15
/jdk1.3.1_20/com/sun/java/swing/plaf/windows/WindowsTableUI.java,Java,,5,6,4,15
/jdk1.3.1_20/com/sun/java/swing/plaf/windows/WindowsTextAreaUI.java,Java,,13,8,28,49
/jdk1.3.1_20/com/sun/java/swing/plaf/windows/WindowsTextFieldUI.java,Java,,36,12,57,105
/jdk1.3.1_20/com/sun/java/swing/plaf/windows/WindowsTextPaneUI.java,Java,,14,6,28,48
/jdk1.3.1_20/com/sun/java/swing/plaf/windows/WindowsTextUI.java,Java,,139,15,63,217
/jdk1.3.1_20/com/sun/java/swing/plaf/windows/WindowsToggleButtonUI.java,Java,,44,18,23,85
/jdk1.3.1_20/com/sun/java/swing/plaf/windows/WindowsToolBarUI.java,Java,,5,6,4,15
/jdk1.3.1_20/com/sun/java/swing/plaf/windows/WindowsTreeUI.java,Java,,52,17,37,106
/jdk1.3.1_20/com/sun/java/swing/plaf/windows/WindowsUtils.java,Java,,9,4,14,27
/jdk1.3.1_20/com/sun/naming/internal/FactoryEnumeration.java,Java,,49,11,30,90
/jdk1.3.1_20/com/sun/naming/internal/NamedWeakReference.java,Java,,11,8,10,29
/jdk1.3.1_20/com/sun/naming/internal/ResourceManager.java,Java,,261,53,226,540
/jdk1.3.1_20/com/sun/naming/internal/VersionHelper.java,Java,,80,22,49,151
/jdk1.3.1_20/com/sun/naming/internal/VersionHelper12.java,Java,,174,29,30,233
/jdk1.3.1_20/java/applet/Applet.java,Java,,128,34,345,507
/jdk1.3.1_20/java/applet/AppletContext.java,Java,,15,9,97,121
/jdk1.3.1_20/java/applet/AppletStub.java,Java,,10,7,72,89
/jdk1.3.1_20/java/applet/AudioClip.java,Java,,6,4,24,34
/jdk1.3.1_20/java/awt/ActiveEvent.java,Java,,4,3,33,40
/jdk1.3.1_20/java/awt/Adjustable.java,Java,,21,22,77,120
/jdk1.3.1_20/java/awt/AlphaComposite.java,Java,,93,36,231,360
/jdk1.3.1_20/java/awt/AlphaCompositeContext.java,Java,,88,24,31,143
/jdk1.3.1_20/java/awt/AttributeValue.java,Java,,21,5,6,32
/jdk1.3.1_20/java/awt/AWTError.java,Java,,7,4,19,30
/jdk1.3.1_20/java/awt/AWTEvent.java,Java,,196,51,178,425
/jdk1.3.1_20/java/awt/AWTEventMulticaster.java,Java,,320,76,399,795
/jdk1.3.1_20/java/awt/AWTException.java,Java,,7,4,21,32
/jdk1.3.1_20/java/awt/AWTPermission.java,Java,,13,9,118,140
/jdk1.3.1_20/java/awt/BasicStroke.java,Java,,255,55,254,564
/jdk1.3.1_20/java/awt/BorderLayout.java,Java,,258,46,377,681
/jdk1.3.1_20/java/awt/Button.java,Java,[PENDING:  WDW -- need to provide a localized string,195,52,318,565
/jdk1.3.1_20/java/awt/Canvas.java,Java,,44,15,79,138
/jdk1.3.1_20/java/awt/CardLayout.java,Java,,220,31,211,462
/jdk1.3.1_20/java/awt/Checkbox.java,Java,,256,65,378,699
/jdk1.3.1_20/java/awt/CheckboxGroup.java,Java,,32,9,87,128
/jdk1.3.1_20/java/awt/CheckboxMenuItem.java,Java,,175,49,295,519
/jdk1.3.1_20/java/awt/Choice.java,Java,,264,67,346,677
/jdk1.3.1_20/java/awt/color/CMMException.java,Java,,6,7,26,39
/jdk1.3.1_20/java/awt/color/ColorSpace.java,Java,,107,71,270,448
/jdk1.3.1_20/java/awt/color/ICC_ColorSpace.java,Java,,127,54,344,525
/jdk1.3.1_20/java/awt/color/ICC_Profile.java,Java,,799,343,710,1852
/jdk1.3.1_20/java/awt/color/ICC_ProfileGray.java,Java,,25,18,84,127
/jdk1.3.1_20/java/awt/color/ICC_ProfileRGB.java,Java,,73,34,120,227
/jdk1.3.1_20/java/awt/color/ProfileDataException.java,Java,,6,4,11,21
/jdk1.3.1_20/java/awt/Color.java,Java,,452,68,607,1127
/jdk1.3.1_20/java/awt/ColorPaintContext.java,Java,,35,12,4,51
/jdk1.3.1_20/java/awt/Component.java,Java,,2495,424,2561,5480
/jdk1.3.1_20/java/awt/ComponentOrientation.java,Java,,53,16,104,173
/jdk1.3.1_20/java/awt/Composite.java,Java,,7,5,55,67
/jdk1.3.1_20/java/awt/CompositeContext.java,Java,,9,8,33,50
/jdk1.3.1_20/java/awt/Conditional.java,Java,,4,2,12,18
/jdk1.3.1_20/java/awt/Container.java,Java,,1390,207,941,2538
/jdk1.3.1_20/java/awt/Cursor.java,Java,,189,64,127,380
/jdk1.3.1_20/java/awt/datatransfer/Clipboard.java,Java,,22,13,33,68
/jdk1.3.1_20/java/awt/datatransfer/ClipboardOwner.java,Java,,4,5,17,26
/jdk1.3.1_20/java/awt/datatransfer/DataFlavor.java,Java,,430,133,394,957
/jdk1.3.1_20/java/awt/datatransfer/FlavorMap.java,Java,,6,8,57,71
/jdk1.3.1_20/java/awt/datatransfer/MimeType.java,Java,,168,42,124,334
/jdk1.3.1_20/java/awt/datatransfer/MimeTypeParameterList.java,Java,,238,55,87,380
/jdk1.3.1_20/java/awt/datatransfer/MimeTypeParseException.java,Java,,10,6,18,34
/jdk1.3.1_20/java/awt/datatransfer/StringSelection.java,Java,,38,11,63,112
/jdk1.3.1_20/java/awt/datatransfer/SystemFlavorMap.java,Java,,166,74,59,299
/jdk1.3.1_20/java/awt/datatransfer/Transferable.java,Java,,7,8,34,49
/jdk1.3.1_20/java/awt/datatransfer/UnsupportedFlavorException.java,Java,,7,5,21,33
/jdk1.3.1_20/java/awt/Dialog.java,Java,,217,49,291,557
/jdk1.3.1_20/java/awt/Dimension.java,Java,,56,20,127,203
/jdk1.3.1_20/java/awt/dnd/Autoscroll.java,Java,,7,9,45,61
/jdk1.3.1_20/java/awt/dnd/DnDConstants.java,Java,,10,14,42,66
/jdk1.3.1_20/java/awt/dnd/DragGestureEvent.java,Java,,55,49,123,227
/jdk1.3.1_20/java/awt/dnd/DragGestureListener.java,Java,,5,8,26,39
/jdk1.3.1_20/java/awt/dnd/DragGestureRecognizer.java,Java,,75,58,266,399
/jdk1.3.1_20/java/awt/dnd/DragSource.java,Java,,106,76,284,466
/jdk1.3.1_20/java/awt/dnd/DragSourceContext.java,Java,,148,86,203,437
/jdk1.3.1_20/java/awt/dnd/DragSourceDragEvent.java,Java,,23,25,69,117
/jdk1.3.1_20/java/awt/dnd/DragSourceDropEvent.java,Java,,18,23,51,92
/jdk1.3.1_20/java/awt/dnd/DragSourceEvent.java,Java,,9,10,23,42
/jdk1.3.1_20/java/awt/dnd/DragSourceListener.java,Java,,11,21,102,134
/jdk1.3.1_20/java/awt/dnd/DropTarget.java,Java,,261,167,308,736
/jdk1.3.1_20/java/awt/dnd/DropTargetContext.java,Java,,131,85,187,403
/jdk1.3.1_20/java/awt/dnd/DropTargetDragEvent.java,Java,,44,37,88,169
/jdk1.3.1_20/java/awt/dnd/DropTargetDropEvent.java,Java,,60,49,126,235
/jdk1.3.1_20/java/awt/dnd/DropTargetEvent.java,Java,,17,13,32,62
/jdk1.3.1_20/java/awt/dnd/DropTargetListener.java,Java,,12,22,73,107
/jdk1.3.1_20/java/awt/dnd/InvalidDnDOperationException.java,Java,,6,12,21,39
/jdk1.3.1_20/java/awt/dnd/MouseDragGestureRecognizer.java,Java,,34,34,108,176
/jdk1.3.1_20/java/awt/dnd/peer/DragSourceContextPeer.java,Java,,19,15,27,61
/jdk1.3.1_20/java/awt/dnd/peer/DropTargetContextPeer.java,Java,,23,30,47,100
/jdk1.3.1_20/java/awt/dnd/peer/DropTargetPeer.java,Java,,6,8,26,40
/jdk1.3.1_20/java/awt/event/ActionEvent.java,Java,,40,19,110,169
/jdk1.3.1_20/java/awt/event/ActionListener.java,Java,,5,5,24,34
/jdk1.3.1_20/java/awt/event/AdjustmentEvent.java,Java,,64,20,88,172
/jdk1.3.1_20/java/awt/event/AdjustmentListener.java,Java,,5,5,14,24
/jdk1.3.1_20/java/awt/event/AWTEventListener.java,Java,,6,5,32,43
/jdk1.3.1_20/java/awt/event/ComponentAdapter.java,Java,,7,5,42,54
/jdk1.3.1_20/java/awt/event/ComponentEvent.java,Java,,45,14,76,135
/jdk1.3.1_20/java/awt/event/ComponentListener.java,Java,,8,6,42,56
/jdk1.3.1_20/java/awt/event/ContainerAdapter.java,Java,,5,3,36,44
/jdk1.3.1_20/java/awt/event/ContainerEvent.java,Java,,36,13,77,126
/jdk1.3.1_20/java/awt/event/ContainerListener.java,Java,,6,5,37,48
/jdk1.3.1_20/java/awt/event/FocusAdapter.java,Java,,5,3,36,44
/jdk1.3.1_20/java/awt/event/FocusEvent.java,Java,,35,14,90,139
/jdk1.3.1_20/java/awt/event/FocusListener.java,Java,,6,5,32,43
/jdk1.3.1_20/java/awt/event/HierarchyBoundsAdapter.java,Java,,6,3,33,42
/jdk1.3.1_20/java/awt/event/HierarchyBoundsListener.java,Java,,6,4,33,43
/jdk1.3.1_20/java/awt/event/HierarchyEvent.java,Java,,85,19,163,267
/jdk1.3.1_20/java/awt/event/HierarchyListener.java,Java,,5,3,30,38
/jdk1.3.1_20/java/awt/event/InputEvent.java,Java,,53,26,109,188
/jdk1.3.1_20/java/awt/event/InputMethodEvent.java,Java,,107,27,141,275
/jdk1.3.1_20/java/awt/event/InputMethodListener.java,Java,,6,7,24,37
/jdk1.3.1_20/java/awt/event/InvocationEvent.java,Java,,59,17,113,189
/jdk1.3.1_20/java/awt/event/ItemEvent.java,Java,,51,18,93,162
/jdk1.3.1_20/java/awt/event/ItemListener.java,Java,,5,5,28,38
/jdk1.3.1_20/java/awt/event/KeyAdapter.java,Java,,6,4,41,51
/jdk1.3.1_20/java/awt/event/KeyEvent.java,Java,,525,128,504,1157
/jdk1.3.1_20/java/awt/event/KeyListener.java,Java,,7,6,37,50
/jdk1.3.1_20/java/awt/event/MouseAdapter.java,Java,,8,6,51,65
/jdk1.3.1_20/java/awt/event/MouseEvent.java,Java,,88,25,226,339
/jdk1.3.1_20/java/awt/event/MouseListener.java,Java,,9,8,47,64
/jdk1.3.1_20/java/awt/event/MouseMotionAdapter.java,Java,,5,3,45,53
/jdk1.3.1_20/java/awt/event/MouseMotionListener.java,Java,,6,6,41,53
/jdk1.3.1_20/java/awt/event/NativeLibLoader.java,Java,,7,3,29,39
/jdk1.3.1_20/java/awt/event/PaintEvent.java,Java,,36,13,58,107
/jdk1.3.1_20/java/awt/event/TextEvent.java,Java,,23,13,50,86
/jdk1.3.1_20/java/awt/event/TextListener.java,Java,,5,5,28,38
/jdk1.3.1_20/java/awt/event/WindowAdapter.java,Java,,10,8,54,72
/jdk1.3.1_20/java/awt/event/WindowEvent.java,Java,,50,17,90,157
/jdk1.3.1_20/java/awt/event/WindowListener.java,Java,,11,9,61,81
/jdk1.3.1_20/java/awt/Event.java,Java,,228,106,461,795
/jdk1.3.1_20/java/awt/EventDispatchThread.java,Java,,116,29,86,231
/jdk1.3.1_20/java/awt/EventQueue.java,Java,,308,54,210,572
/jdk1.3.1_20/java/awt/FileDialog.java,Java,,110,27,190,327
/jdk1.3.1_20/java/awt/FlowLayout.java,Java,,189,37,263,489
/jdk1.3.1_20/java/awt/font/FontRenderContext.java,Java,,33,11,76,120
/jdk1.3.1_20/java/awt/font/GlyphJustificationInfo.java,Java,,60,23,109,192
/jdk1.3.1_20/java/awt/font/GlyphMetrics.java,Java,,48,25,171,244
/jdk1.3.1_20/java/awt/font/GlyphVector.java,Java,,35,27,351,413
/jdk1.3.1_20/java/awt/font/GraphicAttribute.java,Java,,43,21,107,171
/jdk1.3.1_20/java/awt/font/ImageGraphicAttribute.java,Java,,68,36,105,209
/jdk1.3.1_20/java/awt/font/LineBreakMeasurer.java,Java,,106,32,345,483
/jdk1.3.1_20/java/awt/font/LineMetrics.java,Java,,14,16,96,126
/jdk1.3.1_20/java/awt/font/MultipleMaster.java,Java,,15,10,62,87
/jdk1.3.1_20/java/awt/font/OpenType.java,Java,,61,64,289,414
/jdk1.3.1_20/java/awt/font/ShapeGraphicAttribute.java,Java,,82,35,106,223
/jdk1.3.1_20/java/awt/font/TextAttribute.java,Java,,78,72,722,872
/jdk1.3.1_20/java/awt/font/TextHitInfo.java,Java,,54,18,155,227
/jdk1.3.1_20/java/awt/font/TextJustifier.java,Java,,146,26,48,220
/jdk1.3.1_20/java/awt/font/TextLayout.java,Java,,1182,348,1032,2562
/jdk1.3.1_20/java/awt/font/TextLine.java,Java,,898,276,138,1312
/jdk1.3.1_20/java/awt/font/TextMeasurer.java,Java,,256,87,144,487
/jdk1.3.1_20/java/awt/font/TransformAttribute.java,Java,,15,12,32,59
/jdk1.3.1_20/java/awt/Font.java,Java,,745,152,832,1729
/jdk1.3.1_20/java/awt/FontFormatException.java,Java,,7,2,16,25
/jdk1.3.1_20/java/awt/FontMetrics.java,Java,,133,36,392,561
/jdk1.3.1_20/java/awt/Frame.java,Java,,309,73,427,809
/jdk1.3.1_20/java/awt/geom/AffineTransform.java,Java,,1678,133,1165,2976
/jdk1.3.1_20/java/awt/geom/Arc2D.java,Java,,582,111,673,1366
/jdk1.3.1_20/java/awt/geom/ArcIterator.java,Java,,151,10,62,223
/jdk1.3.1_20/java/awt/geom/Area.java,Java,,307,37,247,591
/jdk1.3.1_20/java/awt/geom/CubicCurve2D.java,Java,,674,112,849,1635
/jdk1.3.1_20/java/awt/geom/CubicIterator.java,Java,,66,9,62,137
/jdk1.3.1_20/java/awt/geom/Dimension2D.java,Java,,18,7,63,88
/jdk1.3.1_20/java/awt/geom/Ellipse2D.java,Java,,136,33,236,405
/jdk1.3.1_20/java/awt/geom/EllipseIterator.java,Java,,100,12,62,174
/jdk1.3.1_20/java/awt/geom/FlatteningPathIterator.java,Java,,184,36,156,376
/jdk1.3.1_20/java/awt/geom/GeneralPath.java,Java,,274,37,307,618
/jdk1.3.1_20/java/awt/geom/GeneralPathIterator.java,Java,,51,10,78,139
/jdk1.3.1_20/java/awt/geom/IllegalPathStateException.java,Java,,8,4,25,37
/jdk1.3.1_20/java/awt/geom/Line2D.java,Java,,289,72,633,994
/jdk1.3.1_20/java/awt/geom/LineIterator.java,Java,,58,9,62,129
/jdk1.3.1_20/java/awt/geom/NoninvertibleTransformException.java,Java,,6,3,18,27
/jdk1.3.1_20/java/awt/geom/PathIterator.java,Java,,15,13,167,195
/jdk1.3.1_20/java/awt/geom/Point2D.java,Java,,112,32,224,368
/jdk1.3.1_20/java/awt/geom/QuadCurve2D.java,Java,,499,98,679,1276
/jdk1.3.1_20/java/awt/geom/QuadIterator.java,Java,,62,9,62,133
/jdk1.3.1_20/java/awt/geom/Rectangle2D.java,Java,,326,65,607,998
/jdk1.3.1_20/java/awt/geom/RectangularShape.java,Java,,101,28,222,351
/jdk1.3.1_20/java/awt/geom/RectIterator.java,Java,,66,9,62,137
/jdk1.3.1_20/java/awt/geom/RoundRectangle2D.java,Java,,213,49,351,613
/jdk1.3.1_20/java/awt/geom/RoundRectIterator.java,Java,,92,11,67,170
/jdk1.3.1_20/java/awt/GradientPaint.java,Java,,77,17,126,220
/jdk1.3.1_20/java/awt/GradientPaintContext.java,Java,,153,20,42,215
/jdk1.3.1_20/java/awt/Graphics.java,Java,,163,57,952,1172
/jdk1.3.1_20/java/awt/Graphics2D.java,Java,,98,47,1023,1168
/jdk1.3.1_20/java/awt/GraphicsCallback.java,Java,,108,13,4,125
/jdk1.3.1_20/java/awt/GraphicsConfigTemplate.java,Java,,14,11,65,90
/jdk1.3.1_20/java/awt/GraphicsConfiguration.java,Java,,17,16,188,221
/jdk1.3.1_20/java/awt/GraphicsDevice.java,Java,,17,12,112,141
/jdk1.3.1_20/java/awt/GraphicsEnvironment.java,Java,,37,16,114,167
/jdk1.3.1_20/java/awt/GridBagConstraints.java,Java,,75,34,302,411
/jdk1.3.1_20/java/awt/GridBagLayout.java,Java,,561,127,643,1331
/jdk1.3.1_20/java/awt/GridLayout.java,Java,,142,23,249,414
/jdk1.3.1_20/java/awt/IllegalComponentStateException.java,Java,,10,4,24,38
/jdk1.3.1_20/java/awt/im/InputContext.java,Java,,39,18,210,267
/jdk1.3.1_20/java/awt/im/InputMethodHighlight.java,Java,,45,21,107,173
/jdk1.3.1_20/java/awt/im/InputMethodRequests.java,Java,,15,11,163,189
/jdk1.3.1_20/java/awt/im/InputSubset.java,Java,,24,15,56,95
/jdk1.3.1_20/java/awt/im/spi/InputMethod.java,Java,,23,22,311,356
/jdk1.3.1_20/java/awt/im/spi/InputMethodContext.java,Java,,12,7,57,76
/jdk1.3.1_20/java/awt/im/spi/InputMethodDescriptor.java,Java,,11,10,83,104
/jdk1.3.1_20/java/awt/image/AffineTransformOp.java,Java,,265,36,218,519
/jdk1.3.1_20/java/awt/image/AreaAveragingScaleFilter.java,Java,,151,11,80,242
/jdk1.3.1_20/java/awt/image/BandCombineOp.java,Java,,124,15,118,257
/jdk1.3.1_20/java/awt/image/BandedSampleModel.java,Java,,279,76,310,665
/jdk1.3.1_20/java/awt/image/BufferedImage.java,Java,,688,130,629,1447
/jdk1.3.1_20/java/awt/image/BufferedImageFilter.java,Java,,260,15,119,394
/jdk1.3.1_20/java/awt/image/BufferedImageOp.java,Java,,12,7,63,82
/jdk1.3.1_20/java/awt/image/ByteLookupTable.java,Java,,79,13,99,191
/jdk1.3.1_20/java/awt/image/ColorConvertOp.java,Java,,685,84,265,1034
/jdk1.3.1_20/java/awt/image/ColorModel.java,Java,,668,83,939,1690
/jdk1.3.1_20/java/awt/image/ComponentColorModel.java,Java,,771,74,580,1425
/jdk1.3.1_20/java/awt/image/ComponentSampleModel.java,Java,,458,99,372,929
/jdk1.3.1_20/java/awt/image/ConvolveOp.java,Java,,134,31,139,304
/jdk1.3.1_20/java/awt/image/CropImageFilter.java,Java,,77,8,74,159
/jdk1.3.1_20/java/awt/image/DataBuffer.java,Java,,127,40,160,327
/jdk1.3.1_20/java/awt/image/DataBufferByte.java,Java,,63,18,120,201
/jdk1.3.1_20/java/awt/image/DataBufferInt.java,Java,,63,19,118,200
/jdk1.3.1_20/java/awt/image/DataBufferShort.java,Java,,63,19,117,199
/jdk1.3.1_20/java/awt/image/DataBufferUShort.java,Java,,94,21,119,234
/jdk1.3.1_20/java/awt/image/DirectColorModel.java,Java,,599,53,605,1257
/jdk1.3.1_20/java/awt/image/FilteredImageSource.java,Java,,60,10,59,129
/jdk1.3.1_20/java/awt/image/ImageConsumer.java,Java,,22,18,134,174
/jdk1.3.1_20/java/awt/image/ImageFilter.java,Java,,52,13,143,208
/jdk1.3.1_20/java/awt/image/ImageObserver.java,Java,,14,11,126,151
/jdk1.3.1_20/java/awt/image/ImageProducer.java,Java,,8,6,67,81
/jdk1.3.1_20/java/awt/image/ImagingOpException.java,Java,,6,4,16,26
/jdk1.3.1_20/java/awt/image/IndexColorModel.java,Java,,645,77,600,1322
/jdk1.3.1_20/java/awt/image/Kernel.java,Java,,59,19,62,140
/jdk1.3.1_20/java/awt/image/LookupOp.java,Java,,331,52,122,505
/jdk1.3.1_20/java/awt/image/LookupTable.java,Java,,25,10,46,81
/jdk1.3.1_20/java/awt/image/MemoryImageSource.java,Java,,215,24,231,470
/jdk1.3.1_20/java/awt/image/MultiPixelPackedSampleModel.java,Java,,226,61,312,599
/jdk1.3.1_20/java/awt/image/PackedColorModel.java,Java,,222,33,219,474
/jdk1.3.1_20/java/awt/image/PixelGrabber.java,Java,,308,28,282,618
/jdk1.3.1_20/java/awt/image/PixelInterleavedSampleModel.java,Java,,64,6,75,145
/jdk1.3.1_20/java/awt/image/Raster.java,Java,,604,140,674,1418
/jdk1.3.1_20/java/awt/image/RasterFormatException.java,Java,,6,4,15,25
/jdk1.3.1_20/java/awt/image/RasterOp.java,Java,,11,7,54,72
/jdk1.3.1_20/java/awt/image/renderable/ContextualRenderedImageFactory.java,Java,,15,9,89,113
/jdk1.3.1_20/java/awt/image/renderable/ParameterBlock.java,Java,,189,50,303,542
/jdk1.3.1_20/java/awt/image/renderable/RenderableImage.java,Java,,18,15,135,168
/jdk1.3.1_20/java/awt/image/renderable/RenderableImageOp.java,Java,,121,29,170,320
/jdk1.3.1_20/java/awt/image/renderable/RenderableImageProducer.java,Java,,93,19,87,199
/jdk1.3.1_20/java/awt/image/renderable/RenderContext.java,Java,,61,22,159,242
/jdk1.3.1_20/java/awt/image/renderable/RenderedImageFactory.java,Java,,7,4,47,58
/jdk1.3.1_20/java/awt/image/RenderedImage.java,Java,,27,25,116,168
/jdk1.3.1_20/java/awt/image/ReplicateScaleFilter.java,Java,,115,16,101,232
/jdk1.3.1_20/java/awt/image/RescaleOp.java,Java,,348,63,193,604
/jdk1.3.1_20/java/awt/image/RGBImageFilter.java,Java,,101,13,142,256
/jdk1.3.1_20/java/awt/image/SampleModel.java,Java,,402,134,549,1085
/jdk1.3.1_20/java/awt/image/ShortLookupTable.java,Java,,79,13,86,178
/jdk1.3.1_20/java/awt/image/SinglePixelPackedSampleModel.java,Java,,294,78,295,667
/jdk1.3.1_20/java/awt/image/TileObserver.java,Java,,6,4,25,35
/jdk1.3.1_20/java/awt/image/WritableRaster.java,Java,,204,36,341,581
/jdk1.3.1_20/java/awt/image/WritableRenderedImage.java,Java,,13,13,95,121
/jdk1.3.1_20/java/awt/Image.java,Java,,32,14,142,188
/jdk1.3.1_20/java/awt/Insets.java,Java,,45,14,92,151
/jdk1.3.1_20/java/awt/ItemSelectable.java,Java,,7,7,29,43
/jdk1.3.1_20/java/awt/JobAttributes.java,Java,,443,68,510,1021
/jdk1.3.1_20/java/awt/Label.java,Java,,111,33,158,302
/jdk1.3.1_20/java/awt/LayoutManager.java,Java,,8,5,40,53
/jdk1.3.1_20/java/awt/LayoutManager2.java,Java,,8,7,53,68
/jdk1.3.1_20/java/awt/List.java,Java,[FIXME,597,153,981,1731
/jdk1.3.1_20/java/awt/MediaTracker.java,Java,,390,56,463,909
/jdk1.3.1_20/java/awt/Menu.java,Java,,236,58,277,571
/jdk1.3.1_20/java/awt/MenuBar.java,Java,,197,41,221,459
/jdk1.3.1_20/java/awt/MenuComponent.java,Java,,298,91,521,910
/jdk1.3.1_20/java/awt/MenuContainer.java,Java,,6,3,14,23
/jdk1.3.1_20/java/awt/MenuItem.java,Java,[PENDING:  WDW -- need to provide a localized string,271,69,439,779
/jdk1.3.1_20/java/awt/MenuShortcut.java,Java,,52,12,74,138
/jdk1.3.1_20/java/awt/PageAttributes.java,Java,,521,52,780,1353
/jdk1.3.1_20/java/awt/Paint.java,Java,,12,6,40,58
/jdk1.3.1_20/java/awt/PaintContext.java,Java,,12,7,42,61
/jdk1.3.1_20/java/awt/Panel.java,Java,,37,13,61,111
/jdk1.3.1_20/java/awt/peer/ButtonPeer.java,Java,,5,3,11,19
/jdk1.3.1_20/java/awt/peer/CanvasPeer.java,Java,,4,2,11,17
/jdk1.3.1_20/java/awt/peer/CheckboxMenuItemPeer.java,Java,,4,1,11,16
/jdk1.3.1_20/java/awt/peer/CheckboxPeer.java,Java,,7,2,11,20
/jdk1.3.1_20/java/awt/peer/ChoicePeer.java,Java,,9,3,14,26
/jdk1.3.1_20/java/awt/peer/ComponentPeer.java,Java,,44,13,32,89
/jdk1.3.1_20/java/awt/peer/ContainerPeer.java,Java,,8,3,14,25
/jdk1.3.1_20/java/awt/peer/DialogPeer.java,Java,,6,5,11,22
/jdk1.3.1_20/java/awt/peer/FileDialogPeer.java,Java,,8,3,11,22
/jdk1.3.1_20/java/awt/peer/FontPeer.java,Java,,3,2,11,16
/jdk1.3.1_20/java/awt/peer/FramePeer.java,Java,,10,5,11,26
/jdk1.3.1_20/java/awt/peer/LabelPeer.java,Java,,7,2,11,20
/jdk1.3.1_20/java/awt/peer/LightweightPeer.java,Java,,3,3,19,25
/jdk1.3.1_20/java/awt/peer/ListPeer.java,Java,,19,7,26,52
/jdk1.3.1_20/java/awt/peer/MenuBarPeer.java,Java,,7,2,11,20
/jdk1.3.1_20/java/awt/peer/MenuComponentPeer.java,Java,,4,1,11,16
/jdk1.3.1_20/java/awt/peer/MenuItemPeer.java,Java,,7,4,17,28
/jdk1.3.1_20/java/awt/peer/MenuPeer.java,Java,,7,2,11,20
/jdk1.3.1_20/java/awt/peer/PanelPeer.java,Java,,4,2,11,17
/jdk1.3.1_20/java/awt/peer/PopupMenuPeer.java,Java,,5,2,11,18
/jdk1.3.1_20/java/awt/peer/RobotPeer.java,Java,,12,5,15,32
/jdk1.3.1_20/java/awt/peer/ScrollbarPeer.java,Java,,6,1,11,18
/jdk1.3.1_20/java/awt/peer/ScrollPanePeer.java,Java,,11,2,11,24
/jdk1.3.1_20/java/awt/peer/TextAreaPeer.java,Java,,12,6,23,41
/jdk1.3.1_20/java/awt/peer/TextComponentPeer.java,Java,,16,2,11,29
/jdk1.3.1_20/java/awt/peer/TextFieldPeer.java,Java,,10,5,20,35
/jdk1.3.1_20/java/awt/peer/WindowPeer.java,Java,,12,5,11,28
/jdk1.3.1_20/java/awt/Point.java,Java,,54,18,128,200
/jdk1.3.1_20/java/awt/Polygon.java,Java,,244,51,306,601
/jdk1.3.1_20/java/awt/PopupMenu.java,Java,,76,18,80,174
/jdk1.3.1_20/java/awt/print/Book.java,Java,,66,27,111,204
/jdk1.3.1_20/java/awt/print/Pageable.java,Java,,9,7,48,64
/jdk1.3.1_20/java/awt/print/PageFormat.java,Java,,141,58,140,339
/jdk1.3.1_20/java/awt/print/Paper.java,Java,,53,25,109,187
/jdk1.3.1_20/java/awt/print/Printable.java,Java,,8,7,51,66
/jdk1.3.1_20/java/awt/print/PrinterAbortException.java,Java,,9,6,20,35
/jdk1.3.1_20/java/awt/print/PrinterException.java,Java,,8,6,19,33
/jdk1.3.1_20/java/awt/print/PrinterGraphics.java,Java,,4,5,18,27
/jdk1.3.1_20/java/awt/print/PrinterIOException.java,Java,,12,8,26,46
/jdk1.3.1_20/java/awt/print/PrinterJob.java,Java,,48,26,149,223
/jdk1.3.1_20/java/awt/PrintGraphics.java,Java,,4,4,14,22
/jdk1.3.1_20/java/awt/PrintJob.java,Java,,11,9,41,61
/jdk1.3.1_20/java/awt/Rectangle.java,Java,,243,54,475,772
/jdk1.3.1_20/java/awt/RenderingHints.java,Java,,203,71,390,664
/jdk1.3.1_20/java/awt/Robot.java,Java,,189,42,171,402
/jdk1.3.1_20/java/awt/Scrollbar.java,Java,,296,72,667,1035
/jdk1.3.1_20/java/awt/ScrollPane.java,Java,,398,92,312,802
/jdk1.3.1_20/java/awt/Shape.java,Java,,17,12,276,305
/jdk1.3.1_20/java/awt/Stroke.java,Java,,4,6,43,53
/jdk1.3.1_20/java/awt/SystemColor.java,Java,,109,64,211,384
/jdk1.3.1_20/java/awt/TextArea.java,Java,,211,59,327,597
/jdk1.3.1_20/java/awt/TextComponent.java,Java,,439,88,525,1052
/jdk1.3.1_20/java/awt/TextField.java,Java,,212,54,370,636
/jdk1.3.1_20/java/awt/TexturePaint.java,Java,,47,13,61,121
/jdk1.3.1_20/java/awt/TexturePaintContext.java,Java,,622,39,51,712
/jdk1.3.1_20/java/awt/Toolkit.java,Java,,595,151,931,1677
/jdk1.3.1_20/java/awt/Transparency.java,Java,,7,6,27,40
/jdk1.3.1_20/java/awt/Window.java,Java,,706,119,544,1369
/jdk1.3.1_20/java/beans/AppletInitializer.java,Java,,7,10,54,71
/jdk1.3.1_20/java/beans/beancontext/BeanContext.java,Java,,16,13,85,114
/jdk1.3.1_20/java/beans/beancontext/BeanContextChild.java,Java,,13,12,94,119
/jdk1.3.1_20/java/beans/beancontext/BeanContextChildComponentProxy.java,Java,,5,6,24,35
/jdk1.3.1_20/java/beans/beancontext/BeanContextChildSupport.java,Java,,100,57,169,326
/jdk1.3.1_20/java/beans/beancontext/BeanContextContainerProxy.java,Java,,5,5,23,33
/jdk1.3.1_20/java/beans/beancontext/BeanContextEvent.java,Java,,19,19,55,93
/jdk1.3.1_20/java/beans/beancontext/BeanContextMembershipEvent.java,Java,,28,24,63,115
/jdk1.3.1_20/java/beans/beancontext/BeanContextMembershipListener.java,Java,,7,7,28,42
/jdk1.3.1_20/java/beans/beancontext/BeanContextProxy.java,Java,,4,4,58,66
/jdk1.3.1_20/java/beans/beancontext/BeanContextServiceAvailableEvent.java,Java,,19,17,33,69
/jdk1.3.1_20/java/beans/beancontext/BeanContextServiceProvider.java,Java,,7,9,69,85
/jdk1.3.1_20/java/beans/beancontext/BeanContextServiceProviderBeanInfo.java,Java,,5,5,17,27
/jdk1.3.1_20/java/beans/beancontext/BeanContextServiceRevokedEvent.java,Java,,20,18,46,84
/jdk1.3.1_20/java/beans/beancontext/BeanContextServiceRevokedListener.java,Java,,6,7,16,29
/jdk1.3.1_20/java/beans/beancontext/BeanContextServices.java,Java,,17,17,105,139
/jdk1.3.1_20/java/beans/beancontext/BeanContextServicesListener.java,Java,,7,4,15,26
/jdk1.3.1_20/java/beans/beancontext/BeanContextServicesSupport.java,Java,,615,313,280,1208
/jdk1.3.1_20/java/beans/beancontext/BeanContextSupport.java,Java,,597,260,519,1376
/jdk1.3.1_20/java/beans/BeanDescriptor.java,Java,,28,10,40,78
/jdk1.3.1_20/java/beans/BeanInfo.java,Java,,15,15,121,151
/jdk1.3.1_20/java/beans/Beans.java,Java,,299,89,243,631
/jdk1.3.1_20/java/beans/Customizer.java,Java,,6,8,32,46
/jdk1.3.1_20/java/beans/DesignMode.java,Java,,6,9,55,70
/jdk1.3.1_20/java/beans/EventSetDescriptor.java,Java,,154,37,147,338
/jdk1.3.1_20/java/beans/FeatureDescriptor.java,Java,,144,33,136,313
/jdk1.3.1_20/java/beans/IndexedPropertyDescriptor.java,Java,,246,45,126,417
/jdk1.3.1_20/java/beans/IntrospectionException.java,Java,,7,4,18,29
/jdk1.3.1_20/java/beans/Introspector.java,Java,,959,156,351,1466
/jdk1.3.1_20/java/beans/MethodDescriptor.java,Java,,41,14,46,101
/jdk1.3.1_20/java/beans/ParameterDescriptor.java,Java,,8,6,19,33
/jdk1.3.1_20/java/beans/PropertyChangeEvent.java,Java,,29,13,80,122
/jdk1.3.1_20/java/beans/PropertyChangeListener.java,Java,,4,6,14,24
/jdk1.3.1_20/java/beans/PropertyChangeSupport.java,Java,,162,39,122,323
/jdk1.3.1_20/java/beans/PropertyDescriptor.java,Java,,343,61,180,584
/jdk1.3.1_20/java/beans/PropertyEditor.java,Java,,15,25,144,184
/jdk1.3.1_20/java/beans/PropertyEditorManager.java,Java,,90,19,78,187
/jdk1.3.1_20/java/beans/PropertyEditorSupport.java,Java,,81,33,129,243
/jdk1.3.1_20/java/beans/PropertyVetoException.java,Java,,12,8,24,44
/jdk1.3.1_20/java/beans/SimpleBeanInfo.java,Java,,54,14,58,126
/jdk1.3.1_20/java/beans/VetoableChangeListener.java,Java,,5,2,17,24
/jdk1.3.1_20/java/beans/VetoableChangeSupport.java,Java,,162,40,133,335
/jdk1.3.1_20/java/beans/Visibility.java,Java,,7,8,32,47
/jdk1.3.1_20/java/io/BufferedInputStream.java,Java,,133,25,242,400
/jdk1.3.1_20/java/io/BufferedOutputStream.java,Java,,44,9,75,128
/jdk1.3.1_20/java/io/BufferedReader.java,Java,,263,37,203,503
/jdk1.3.1_20/java/io/BufferedWriter.java,Java,,105,24,119,248
/jdk1.3.1_20/java/io/ByteArrayInputStream.java,Java,,76,19,173,268
/jdk1.3.1_20/java/io/ByteArrayOutputStream.java,Java,,73,21,130,224
/jdk1.3.1_20/java/io/CharArrayReader.java,Java,,96,17,79,192
/jdk1.3.1_20/java/io/CharArrayWriter.java,Java,,83,16,74,173
/jdk1.3.1_20/java/io/CharConversionException.java,Java,,10,1,19,30
/jdk1.3.1_20/java/io/DataInput.java,Java,,19,16,452,487
/jdk1.3.1_20/java/io/DataInputStream.java,Java,,184,30,348,562
/jdk1.3.1_20/java/io/DataOutput.java,Java,,18,15,298,331
/jdk1.3.1_20/java/io/DataOutputStream.java,Java,,135,25,217,377
/jdk1.3.1_20/java/io/EOFException.java,Java,,10,3,35,48
/jdk1.3.1_20/java/io/Externalizable.java,Java,,7,4,67,78
/jdk1.3.1_20/java/io/File.java,Java,,380,82,949,1411
/jdk1.3.1_20/java/io/FileDescriptor.java,Java,,21,12,80,113
/jdk1.3.1_20/java/io/FileFilter.java,Java,,4,5,21,30
/jdk1.3.1_20/java/io/FileInputStream.java,Java,,55,18,174,247
/jdk1.3.1_20/java/io/FilenameFilter.java,Java,,5,2,27,34
/jdk1.3.1_20/java/io/FileNotFoundException.java,Java,,14,8,40,62
/jdk1.3.1_20/java/io/FileOutputStream.java,Java,,68,21,178,267
/jdk1.3.1_20/java/io/FilePermission.java,Java,,295,89,343,727
/jdk1.3.1_20/java/io/FileReader.java,Java,,12,8,39,59
/jdk1.3.1_20/java/io/FileSystem.java,Java,,33,43,120,196
/jdk1.3.1_20/java/io/FileWriter.java,Java,,15,9,46,70
/jdk1.3.1_20/java/io/FilterInputStream.java,Java,,35,12,174,221
/jdk1.3.1_20/java/io/FilterOutputStream.java,Java,,31,9,103,143
/jdk1.3.1_20/java/io/FilterReader.java,Java,,32,15,58,105
/jdk1.3.1_20/java/io/FilterWriter.java,Java,,23,12,52,87
/jdk1.3.1_20/java/io/InputStream.java,Java,,68,20,256,344
/jdk1.3.1_20/java/io/InputStreamReader.java,Java,,139,30,109,278
/jdk1.3.1_20/java/io/InterruptedIOException.java,Java,,11,4,38,53
/jdk1.3.1_20/java/io/InvalidClassException.java,Java,,17,5,37,59
/jdk1.3.1_20/java/io/InvalidObjectException.java,Java,,6,2,21,29
/jdk1.3.1_20/java/io/IOException.java,Java,,10,3,27,40
/jdk1.3.1_20/java/io/LineNumberInputStream.java,Java,,96,19,157,272
/jdk1.3.1_20/java/io/LineNumberReader.java,Java,,100,23,103,226
/jdk1.3.1_20/java/io/NotActiveException.java,Java,,9,3,19,31
/jdk1.3.1_20/java/io/NotSerializableException.java,Java,,9,3,21,33
/jdk1.3.1_20/java/io/ObjectInput.java,Java,,11,8,69,88
/jdk1.3.1_20/java/io/ObjectInputStream.java,Java,,1350,254,1307,2911
/jdk1.3.1_20/java/io/ObjectInputValidation.java,Java,,4,2,20,26
/jdk1.3.1_20/java/io/ObjectOutput.java,Java,,10,7,54,71
/jdk1.3.1_20/java/io/ObjectOutputStream.java,Java,,1139,226,1125,2490
/jdk1.3.1_20/java/io/ObjectStreamClass.java,Java,,916,181,617,1714
/jdk1.3.1_20/java/io/ObjectStreamConstants.java,Java,,32,34,138,204
/jdk1.3.1_20/java/io/ObjectStreamException.java,Java,,9,3,19,31
/jdk1.3.1_20/java/io/ObjectStreamField.java,Java,,141,30,120,291
/jdk1.3.1_20/java/io/OptionalDataException.java,Java,,13,4,35,52
/jdk1.3.1_20/java/io/OutputStream.java,Java,,24,7,98,129
/jdk1.3.1_20/java/io/OutputStreamWriter.java,Java,,124,21,116,261
/jdk1.3.1_20/java/io/PipedInputStream.java,Java,,134,20,169,323
/jdk1.3.1_20/java/io/PipedOutputStream.java,Java,,53,11,93,157
/jdk1.3.1_20/java/io/PipedReader.java,Java,,144,23,136,303
/jdk1.3.1_20/java/io/PipedWriter.java,Java,,53,14,90,157
/jdk1.3.1_20/java/io/PrintStream.java,Java,,236,46,281,563
/jdk1.3.1_20/java/io/PrintWriter.java,Java,,211,48,252,511
/jdk1.3.1_20/java/io/PushbackInputStream.java,Java,,106,19,181,306
/jdk1.3.1_20/java/io/PushbackReader.java,Java,,102,20,106,228
/jdk1.3.1_20/java/io/RandomAccessFile.java,Java,,229,59,660,948
/jdk1.3.1_20/java/io/Reader.java,Java,,56,19,143,218
/jdk1.3.1_20/java/io/SequenceInputStream.java,Java,,79,14,106,199
/jdk1.3.1_20/java/io/Serializable.java,Java,,3,2,97,102
/jdk1.3.1_20/java/io/SerializablePermission.java,Java,,16,11,82,109
/jdk1.3.1_20/java/io/StreamCorruptedException.java,Java,,9,3,20,32
/jdk1.3.1_20/java/io/StreamTokenizer.java,Java,,367,52,382,801
/jdk1.3.1_20/java/io/StringBufferInputStream.java,Java,,53,11,88,152
/jdk1.3.1_20/java/io/StringReader.java,Java,,77,16,74,167
/jdk1.3.1_20/java/io/StringWriter.java,Java,,52,18,65,135
/jdk1.3.1_20/java/io/SyncFailedException.java,Java,,6,2,19,27
/jdk1.3.1_20/java/io/UnsupportedEncodingException.java,Java,,11,2,18,31
/jdk1.3.1_20/java/io/UTFDataFormatException.java,Java,,10,3,30,43
/jdk1.3.1_20/java/io/WriteAbortedException.java,Java,,14,4,30,48
/jdk1.3.1_20/java/io/Writer.java,Java,,48,17,107,172
/jdk1.3.1_20/java/lang/AbstractMethodError.java,Java,,10,3,24,37
/jdk1.3.1_20/java/lang/ArithmeticException.java,Java,,10,3,23,36
/jdk1.3.1_20/java/lang/ArrayIndexOutOfBoundsException.java,Java,,13,4,29,46
/jdk1.3.1_20/java/lang/ArrayStoreException.java,Java,,10,4,26,40
/jdk1.3.1_20/java/lang/Boolean.java,Java,,45,15,116,176
/jdk1.3.1_20/java/lang/Byte.java,Java,,101,31,180,312
/jdk1.3.1_20/java/lang/Character.java,Java,,971,70,867,1908
/jdk1.3.1_20/java/lang/Class.java,Java,,250,105,1049,1404
/jdk1.3.1_20/java/lang/ClassCastException.java,Java,,10,3,26,39
/jdk1.3.1_20/java/lang/ClassCircularityError.java,Java,,9,3,20,32
/jdk1.3.1_20/java/lang/ClassFormatError.java,Java,,10,3,22,35
/jdk1.3.1_20/java/lang/ClassLoader.java,Java,,662,87,694,1443
/jdk1.3.1_20/java/lang/ClassNotFoundException.java,Java,,44,12,81,137
/jdk1.3.1_20/java/lang/Cloneable.java,Java,,3,3,21,27
/jdk1.3.1_20/java/lang/CloneNotSupportedException.java,Java,,10,4,30,44
/jdk1.3.1_20/java/lang/Comparable.java,Java,,4,3,100,107
/jdk1.3.1_20/java/lang/Compiler.java,Java,,40,10,59,109
/jdk1.3.1_20/java/lang/Double.java,Java,,87,35,454,576
/jdk1.3.1_20/java/lang/Error.java,Java,,10,3,30,43
/jdk1.3.1_20/java/lang/Exception.java,Java,,10,3,22,35
/jdk1.3.1_20/java/lang/ExceptionInInitializerError.java,Java,,43,13,72,128
/jdk1.3.1_20/java/lang/Float.java,Java,,88,36,437,561
/jdk1.3.1_20/java/lang/FloatingDecimal.java,Java,,1428,100,718,2246
/jdk1.3.1_20/java/lang/IllegalAccessError.java,Java,,9,3,25,37
/jdk1.3.1_20/java/lang/IllegalAccessException.java,Java,,9,3,33,45
/jdk1.3.1_20/java/lang/IllegalArgumentException.java,Java,,10,3,23,36
/jdk1.3.1_20/java/lang/IllegalMonitorStateException.java,Java,,10,3,28,41
/jdk1.3.1_20/java/lang/IllegalStateException.java,Java,,10,3,25,38
/jdk1.3.1_20/java/lang/IllegalThreadStateException.java,Java,,9,3,26,38
/jdk1.3.1_20/java/lang/IncompatibleClassChangeError.java,Java,,10,3,23,36
/jdk1.3.1_20/java/lang/IndexOutOfBoundsException.java,Java,,10,3,24,37
/jdk1.3.1_20/java/lang/InheritableThreadLocal.java,Java,,19,7,60,86
/jdk1.3.1_20/java/lang/InstantiationError.java,Java,,10,5,25,40
/jdk1.3.1_20/java/lang/InstantiationException.java,Java,,10,3,24,37
/jdk1.3.1_20/java/lang/Integer.java,Java,,286,63,528,877
/jdk1.3.1_20/java/lang/InternalError.java,Java,,10,3,21,34
/jdk1.3.1_20/java/lang/InterruptedException.java,Java,,10,3,28,41
/jdk1.3.1_20/java/lang/LinkageError.java,Java,,10,3,23,36
/jdk1.3.1_20/java/lang/Long.java,Java,,223,45,525,793
/jdk1.3.1_20/java/lang/Math.java,Java,,131,43,609,783
/jdk1.3.1_20/java/lang/NegativeArraySizeException.java,Java,,10,3,21,34
/jdk1.3.1_20/java/lang/NoClassDefFoundError.java,Java,,10,3,27,40
/jdk1.3.1_20/java/lang/NoSuchFieldError.java,Java,,10,3,25,38
/jdk1.3.1_20/java/lang/NoSuchFieldException.java,Java,,9,3,19,31
/jdk1.3.1_20/java/lang/NoSuchMethodError.java,Java,,10,3,26,39
/jdk1.3.1_20/java/lang/NoSuchMethodException.java,Java,,10,3,19,32
/jdk1.3.1_20/java/lang/NullPointerException.java,Java,,10,3,33,46
/jdk1.3.1_20/java/lang/Number.java,Java,,14,8,70,92
/jdk1.3.1_20/java/lang/NumberFormatException.java,Java,,10,3,23,36
/jdk1.3.1_20/java/lang/Object.java,Java,,36,17,413,466
/jdk1.3.1_20/java/lang/OutOfMemoryError.java,Java,,10,3,22,35
/jdk1.3.1_20/java/lang/Package.java,Java,,262,35,216,513
/jdk1.3.1_20/java/lang/Process.java,Java,,11,8,105,124
/jdk1.3.1_20/java/lang/ref/Finalizer.java,Java,,129,19,29,177
/jdk1.3.1_20/java/lang/ref/FinalReference.java,Java,,6,6,5,17
/jdk1.3.1_20/java/lang/ref/PhantomReference.java,Java,,9,7,42,58
/jdk1.3.1_20/java/lang/ref/Reference.java,Java,,71,29,105,205
/jdk1.3.1_20/java/lang/ref/ReferenceQueue.java,Java,,61,14,46,121
/jdk1.3.1_20/java/lang/ref/SoftReference.java,Java,,18,10,65,93
/jdk1.3.1_20/java/lang/ref/WeakReference.java,Java,,9,7,35,51
/jdk1.3.1_20/java/lang/reflect/AccessibleObject.java,Java,,36,10,89,135
/jdk1.3.1_20/java/lang/reflect/Array.java,Java,,56,29,380,465
/jdk1.3.1_20/java/lang/reflect/Constructor.java,Java,,78,13,146,237
/jdk1.3.1_20/java/lang/reflect/Field.java,Java,,96,31,496,623
/jdk1.3.1_20/java/lang/reflect/InvocationHandler.java,Java,,5,3,68,76
/jdk1.3.1_20/java/lang/reflect/InvocationTargetException.java,Java,,45,13,50,108
/jdk1.3.1_20/java/lang/reflect/Member.java,Java,,9,8,40,57
/jdk1.3.1_20/java/lang/reflect/Method.java,Java,,94,15,169,278
/jdk1.3.1_20/java/lang/reflect/Modifier.java,Java,,71,34,124,229
/jdk1.3.1_20/java/lang/reflect/Proxy.java,Java,,168,38,424,630
/jdk1.3.1_20/java/lang/reflect/ReflectPermission.java,Java,,10,5,59,74
/jdk1.3.1_20/java/lang/reflect/UndeclaredThrowableException.java,Java,,42,10,63,115
/jdk1.3.1_20/java/lang/Runnable.java,Java,,5,2,42,49
/jdk1.3.1_20/java/lang/Runtime.java,Java,,147,36,616,799
/jdk1.3.1_20/java/lang/RuntimeException.java,Java,,10,3,27,40
/jdk1.3.1_20/java/lang/RuntimePermission.java,Java,,15,8,257,280
/jdk1.3.1_20/java/lang/SecurityException.java,Java,,9,2,21,32
/jdk1.3.1_20/java/lang/SecurityManager.java,Java,,359,73,1269,1701
/jdk1.3.1_20/java/lang/Short.java,Java,,104,30,181,315
/jdk1.3.1_20/java/lang/Shutdown.java,Java,,136,34,64,234
/jdk1.3.1_20/java/lang/StackOverflowError.java,Java,,10,3,21,34
/jdk1.3.1_20/java/lang/StrictMath.java,Java,,101,44,581,726
/jdk1.3.1_20/java/lang/String.java,Java,,778,115,1303,2196
/jdk1.3.1_20/java/lang/StringBuffer.java,Java,,306,55,722,1083
/jdk1.3.1_20/java/lang/StringIndexOutOfBoundsException.java,Java,,13,4,33,50
/jdk1.3.1_20/java/lang/System.java,Java,,172,41,653,866
/jdk1.3.1_20/java/lang/Thread.java,Java,,286,77,788,1151
/jdk1.3.1_20/java/lang/ThreadDeath.java,Java,,2,3,28,33
/jdk1.3.1_20/java/lang/ThreadGroup.java,Java,,439,43,448,930
/jdk1.3.1_20/java/lang/ThreadLocal.java,Java,,242,62,274,578
/jdk1.3.1_20/java/lang/Throwable.java,Java,,44,15,171,230
/jdk1.3.1_20/java/lang/UnknownError.java,Java,,10,3,21,34
/jdk1.3.1_20/java/lang/UnsatisfiedLinkError.java,Java,,10,3,22,35
/jdk1.3.1_20/java/lang/UnsupportedClassVersionError.java,Java,,10,3,21,34
/jdk1.3.1_20/java/lang/UnsupportedOperationException.java,Java,,8,3,20,31
/jdk1.3.1_20/java/lang/VerifyError.java,Java,,10,3,21,34
/jdk1.3.1_20/java/lang/VirtualMachineError.java,Java,,10,3,22,35
/jdk1.3.1_20/java/lang/Void.java,Java,,6,4,19,29
/jdk1.3.1_20/java/math/BigDecimal.java,Java,,297,81,569,947
/jdk1.3.1_20/java/math/BigInteger.java,Java,,1532,370,1110,3012
/jdk1.3.1_20/java/math/BitSieve.java,Java,,86,20,89,195
/jdk1.3.1_20/java/math/MutableBigInteger.java,Java,,838,182,333,1353
/jdk1.3.1_20/java/math/SignedMutableBigInteger.java,Java,,44,18,56,118
/jdk1.3.1_20/java/net/Authenticator.java,Java,,70,24,125,219
/jdk1.3.1_20/java/net/BindException.java,Java,,7,5,21,33
/jdk1.3.1_20/java/net/ConnectException.java,Java,,7,3,22,32
/jdk1.3.1_20/java/net/ContentHandler.java,Java,,14,6,70,90
/jdk1.3.1_20/java/net/ContentHandlerFactory.java,Java,,4,2,29,35
/jdk1.3.1_20/java/net/DatagramPacket.java,Java,,81,23,184,288
/jdk1.3.1_20/java/net/DatagramSocket.java,Java,,232,33,353,618
/jdk1.3.1_20/java/net/DatagramSocketImpl.java,Java,,26,21,102,149
/jdk1.3.1_20/java/net/DatagramSocketImplFactory.java,Java,,5,2,20,27
/jdk1.3.1_20/java/net/FileNameMap.java,Java,,4,3,18,25
/jdk1.3.1_20/java/net/HttpURLConnection.java,Java,,153,75,333,561
/jdk1.3.1_20/java/net/InetAddress.java,Java,,354,76,313,743
/jdk1.3.1_20/java/net/JarURLConnection.java,Java,,55,25,220,300
/jdk1.3.1_20/java/net/MalformedURLException.java,Java,,9,4,22,35
/jdk1.3.1_20/java/net/MulticastSocket.java,Java,,106,17,246,369
/jdk1.3.1_20/java/net/NetPermission.java,Java,,15,8,91,114
/jdk1.3.1_20/java/net/NoRouteToHostException.java,Java,,7,3,22,32
/jdk1.3.1_20/java/net/PasswordAuthentication.java,Java,,15,9,39,63
/jdk1.3.1_20/java/net/PlainDatagramSocketImpl.java,Java,,95,28,75,198
/jdk1.3.1_20/java/net/PlainSocketImpl.java,Java,,401,90,145,636
/jdk1.3.1_20/java/net/ProtocolException.java,Java,,10,4,21,35
/jdk1.3.1_20/java/net/ServerSocket.java,Java,,104,22,227,353
/jdk1.3.1_20/java/net/Socket.java,Java,,212,40,455,707
/jdk1.3.1_20/java/net/SocketException.java,Java,,10,4,21,35
/jdk1.3.1_20/java/net/SocketImpl.java,Java,,49,24,161,234
/jdk1.3.1_20/java/net/SocketImplFactory.java,Java,,5,2,22,29
/jdk1.3.1_20/java/net/SocketInputStream.java,Java,,82,16,68,166
/jdk1.3.1_20/java/net/SocketOptions.java,Java,,15,26,229,270
/jdk1.3.1_20/java/net/SocketOutputStream.java,Java,,48,13,53,114
/jdk1.3.1_20/java/net/SocketPermission.java,Java,,510,155,420,1085
/jdk1.3.1_20/java/net/UnknownHostException.java,Java,,10,4,21,35
/jdk1.3.1_20/java/net/UnknownServiceException.java,Java,,9,4,24,37
/jdk1.3.1_20/java/net/URL.java,Java,,379,88,567,1034
/jdk1.3.1_20/java/net/URLClassLoader.java,Java,,319,35,210,564
/jdk1.3.1_20/java/net/URLConnection.java,Java,,420,90,855,1365
/jdk1.3.1_20/java/net/URLDecoder.java,Java,,34,7,35,76
/jdk1.3.1_20/java/net/URLEncoder.java,Java,,67,9,40,116
/jdk1.3.1_20/java/net/URLStreamHandler.java,Java,,236,36,177,449
/jdk1.3.1_20/java/net/URLStreamHandlerFactory.java,Java,,4,2,26,32
/jdk1.3.1_20/java/rmi/AccessException.java,Java,,10,5,36,51
/jdk1.3.1_20/java/rmi/activation/Activatable.java,Java,,161,28,318,507
/jdk1.3.1_20/java/rmi/activation/ActivateFailedException.java,Java,,10,5,28,43
/jdk1.3.1_20/java/rmi/activation/ActivationDesc.java,Java,,99,22,200,321
/jdk1.3.1_20/java/rmi/activation/ActivationException.java,Java,,47,11,58,116
/jdk1.3.1_20/java/rmi/activation/ActivationGroup.java,Java,,179,36,308,523
/jdk1.3.1_20/java/rmi/activation/ActivationGroupDesc.java,Java,,121,31,187,339
/jdk1.3.1_20/java/rmi/activation/ActivationGroupID.java,Java,,26,9,61,96
/jdk1.3.1_20/java/rmi/activation/ActivationID.java,Java,,76,18,102,196
/jdk1.3.1_20/java/rmi/activation/ActivationInstantiator.java,Java,,8,5,44,57
/jdk1.3.1_20/java/rmi/activation/ActivationMonitor.java,Java,,15,9,66,90
/jdk1.3.1_20/java/rmi/activation/ActivationSystem.java,Java,,32,14,157,203
/jdk1.3.1_20/java/rmi/activation/Activator.java,Java,,9,4,81,94
/jdk1.3.1_20/java/rmi/activation/UnknownGroupException.java,Java,,7,4,30,41
/jdk1.3.1_20/java/rmi/activation/UnknownObjectException.java,Java,,7,4,32,43
/jdk1.3.1_20/java/rmi/AlreadyBoundException.java,Java,,10,4,29,43
/jdk1.3.1_20/java/rmi/ConnectException.java,Java,,10,5,28,43
/jdk1.3.1_20/java/rmi/ConnectIOException.java,Java,,10,6,29,45
/jdk1.3.1_20/java/rmi/dgc/DGC.java,Java,,9,4,82,95
/jdk1.3.1_20/java/rmi/dgc/Lease.java,Java,,19,6,32,57
/jdk1.3.1_20/java/rmi/dgc/VMID.java,Java,,83,18,56,157
/jdk1.3.1_20/java/rmi/MarshalException.java,Java,,10,5,37,52
/jdk1.3.1_20/java/rmi/MarshalledObject.java,Java,,106,28,155,289
/jdk1.3.1_20/java/rmi/Naming.java,Java,,127,26,138,291
/jdk1.3.1_20/java/rmi/NoSuchObjectException.java,Java,,7,4,32,43
/jdk1.3.1_20/java/rmi/NotBoundException.java,Java,,10,4,31,45
/jdk1.3.1_20/java/rmi/registry/LocateRegistry.java,Java,,64,15,112,191
/jdk1.3.1_20/java/rmi/registry/Registry.java,Java,,15,8,96,119
/jdk1.3.1_20/java/rmi/registry/RegistryHandler.java,Java,,8,5,38,51
/jdk1.3.1_20/java/rmi/Remote.java,Java,,2,2,27,31
/jdk1.3.1_20/java/rmi/RemoteException.java,Java,,47,11,63,121
/jdk1.3.1_20/java/rmi/RMISecurityException.java,Java,,10,4,29,43
/jdk1.3.1_20/java/rmi/RMISecurityManager.java,Java,,6,4,29,39
/jdk1.3.1_20/java/rmi/server/ExportException.java,Java,,10,6,33,49
/jdk1.3.1_20/java/rmi/server/LoaderHandler.java,Java,,11,7,54,72
/jdk1.3.1_20/java/rmi/server/LogStream.java,Java,,107,25,99,231
/jdk1.3.1_20/java/rmi/server/ObjID.java,Java,,71,19,92,182
/jdk1.3.1_20/java/rmi/server/Operation.java,Java,,13,5,32,50
/jdk1.3.1_20/java/rmi/server/RemoteCall.java,Java,,16,10,79,105
/jdk1.3.1_20/java/rmi/server/RemoteObject.java,Java,,81,15,111,207
/jdk1.3.1_20/java/rmi/server/RemoteRef.java,Java,,19,14,152,185
/jdk1.3.1_20/java/rmi/server/RemoteServer.java,Java,,41,9,48,98
/jdk1.3.1_20/java/rmi/server/RemoteStub.java,Java,,13,5,36,54
/jdk1.3.1_20/java/rmi/server/RMIClassLoader.java,Java,,33,9,110,152
/jdk1.3.1_20/java/rmi/server/RMIClientSocketFactory.java,Java,,7,4,37,48
/jdk1.3.1_20/java/rmi/server/RMIFailureHandler.java,Java,,4,5,33,42
/jdk1.3.1_20/java/rmi/server/RMIServerSocketFactory.java,Java,,7,4,37,48
/jdk1.3.1_20/java/rmi/server/RMISocketFactory.java,Java,,52,12,94,158
/jdk1.3.1_20/java/rmi/server/ServerCloneException.java,Java,,46,10,56,112
/jdk1.3.1_20/java/rmi/server/ServerNotActiveException.java,Java,,9,5,28,42
/jdk1.3.1_20/java/rmi/server/ServerRef.java,Java,,8,6,33,47
/jdk1.3.1_20/java/rmi/server/Skeleton.java,Java,,7,3,38,48
/jdk1.3.1_20/java/rmi/server/SkeletonMismatchException.java,Java,,8,6,27,41
/jdk1.3.1_20/java/rmi/server/SkeletonNotFoundException.java,Java,,11,6,33,50
/jdk1.3.1_20/java/rmi/server/SocketSecurityException.java,Java,,10,6,35,51
/jdk1.3.1_20/java/rmi/server/UID.java,Java,,85,17,86,188
/jdk1.3.1_20/java/rmi/server/UnicastRemoteObject.java,Java,,113,26,137,276
/jdk1.3.1_20/java/rmi/server/Unreferenced.java,Java,,4,2,20,26
/jdk1.3.1_20/java/rmi/ServerError.java,Java,,7,4,24,35
/jdk1.3.1_20/java/rmi/ServerException.java,Java,,10,5,29,44
/jdk1.3.1_20/java/rmi/ServerRuntimeException.java,Java,,7,4,26,37
/jdk1.3.1_20/java/rmi/StubNotFoundException.java,Java,,10,5,33,48
/jdk1.3.1_20/java/rmi/UnexpectedException.java,Java,,10,5,30,45
/jdk1.3.1_20/java/rmi/UnknownHostException.java,Java,,10,5,28,43
/jdk1.3.1_20/java/rmi/UnmarshalException.java,Java,,10,5,42,57
/jdk1.3.1_20/java/security/AccessControlContext.java,Java,,311,96,206,613
/jdk1.3.1_20/java/security/AccessControlException.java,Java,,14,8,40,62
/jdk1.3.1_20/java/security/AccessController.java,Java,,43,23,331,397
/jdk1.3.1_20/java/security/acl/Acl.java,Java,,16,28,190,234
/jdk1.3.1_20/java/security/acl/AclEntry.java,Java,,15,15,102,132
/jdk1.3.1_20/java/security/acl/AclNotFoundException.java,Java,,5,4,13,22
/jdk1.3.1_20/java/security/acl/Group.java,Java,,9,9,49,67
/jdk1.3.1_20/java/security/acl/LastOwnerException.java,Java,,5,3,15,23
/jdk1.3.1_20/java/security/acl/NotOwnerException.java,Java,,5,3,14,22
/jdk1.3.1_20/java/security/acl/Owner.java,Java,,9,7,59,75
/jdk1.3.1_20/java/security/acl/Permission.java,Java,,5,6,23,34
/jdk1.3.1_20/java/security/AlgorithmParameterGenerator.java,Java,,65,17,157,239
/jdk1.3.1_20/java/security/AlgorithmParameterGeneratorSpi.java,Java,,9,7,51,67
/jdk1.3.1_20/java/security/AlgorithmParameters.java,Java,,95,20,198,313
/jdk1.3.1_20/java/security/AlgorithmParametersSpi.java,Java,,19,11,101,131
/jdk1.3.1_20/java/security/AllPermission.java,Java,,67,31,119,217
/jdk1.3.1_20/java/security/BasicPermission.java,Java,,136,53,201,390
/jdk1.3.1_20/java/security/cert/Certificate.java,Java,,89,19,140,248
/jdk1.3.1_20/java/security/cert/CertificateEncodingException.java,Java,,9,4,23,36
/jdk1.3.1_20/java/security/cert/CertificateException.java,Java,,10,5,22,37
/jdk1.3.1_20/java/security/cert/CertificateExpiredException.java,Java,,9,4,25,38
/jdk1.3.1_20/java/security/cert/CertificateFactory.java,Java,,118,19,255,392
/jdk1.3.1_20/java/security/cert/CertificateFactorySpi.java,Java,,16,8,156,180
/jdk1.3.1_20/java/security/cert/CertificateNotYetValidException.java,Java,,9,4,25,38
/jdk1.3.1_20/java/security/cert/CertificateParsingException.java,Java,,9,4,24,37
/jdk1.3.1_20/java/security/cert/CRL.java,Java,,12,8,49,69
/jdk1.3.1_20/java/security/cert/CRLException.java,Java,,10,5,22,37
/jdk1.3.1_20/java/security/cert/X509Certificate.java,Java,,31,22,368,421
/jdk1.3.1_20/java/security/cert/X509CRL.java,Java,,67,23,274,364
/jdk1.3.1_20/java/security/cert/X509CRLEntry.java,Java,,40,13,83,136
/jdk1.3.1_20/java/security/cert/X509Extension.java,Java,,8,8,151,167
/jdk1.3.1_20/java/security/Certificate.java,Java,,14,11,109,134
/jdk1.3.1_20/java/security/CodeSource.java,Java,,216,42,215,473
/jdk1.3.1_20/java/security/DigestException.java,Java,,9,4,22,35
/jdk1.3.1_20/java/security/DigestInputStream.java,Java,,41,18,114,173
/jdk1.3.1_20/java/security/DigestOutputStream.java,Java,,39,16,101,156
/jdk1.3.1_20/java/security/DomainCombiner.java,Java,,5,3,82,90
/jdk1.3.1_20/java/security/GeneralSecurityException.java,Java,,9,5,27,41
/jdk1.3.1_20/java/security/Guard.java,Java,,4,4,29,37
/jdk1.3.1_20/java/security/GuardedObject.java,Java,,24,10,47,81
/jdk1.3.1_20/java/security/Identity.java,Java,,178,42,254,474
/jdk1.3.1_20/java/security/IdentityScope.java,Java,,67,26,139,232
/jdk1.3.1_20/java/security/interfaces/DSAKey.java,Java,,4,3,24,31
/jdk1.3.1_20/java/security/interfaces/DSAKeyPairGenerator.java,Java,,8,5,77,90
/jdk1.3.1_20/java/security/interfaces/DSAParams.java,Java,,7,6,32,45
/jdk1.3.1_20/java/security/interfaces/DSAPrivateKey.java,Java,,6,8,27,41
/jdk1.3.1_20/java/security/interfaces/DSAPublicKey.java,Java,,6,8,27,41
/jdk1.3.1_20/java/security/interfaces/RSAKey.java,Java,,5,5,20,30
/jdk1.3.1_20/java/security/interfaces/RSAPrivateCrtKey.java,Java,,10,10,44,64
/jdk1.3.1_20/java/security/interfaces/RSAPrivateKey.java,Java,,6,4,18,28
/jdk1.3.1_20/java/security/interfaces/RSAPublicKey.java,Java,,6,4,16,26
/jdk1.3.1_20/java/security/InvalidAlgorithmParameterException.java,Java,,10,5,30,45
/jdk1.3.1_20/java/security/InvalidKeyException.java,Java,,9,6,23,38
/jdk1.3.1_20/java/security/InvalidParameterException.java,Java,,9,5,23,37
/jdk1.3.1_20/java/security/Key.java,Java,,7,8,93,108
/jdk1.3.1_20/java/security/KeyException.java,Java,,9,5,25,39
/jdk1.3.1_20/java/security/KeyFactory.java,Java,,56,16,167,239
/jdk1.3.1_20/java/security/KeyFactorySpi.java,Java,,13,9,98,120
/jdk1.3.1_20/java/security/KeyManagementException.java,Java,,9,5,33,47
/jdk1.3.1_20/java/security/KeyPair.java,Java,,16,8,36,60
/jdk1.3.1_20/java/security/KeyPairGenerator.java,Java,,91,25,311,427
/jdk1.3.1_20/java/security/KeyPairGeneratorSpi.java,Java,,11,7,69,87
/jdk1.3.1_20/java/security/KeyStore.java,Java,,197,31,417,645
/jdk1.3.1_20/java/security/KeyStoreException.java,Java,,9,5,25,39
/jdk1.3.1_20/java/security/KeyStoreSpi.java,Java,,34,20,213,267
/jdk1.3.1_20/java/security/MessageDigest.java,Java,,187,38,241,466
/jdk1.3.1_20/java/security/MessageDigestSpi.java,Java,,35,12,105,152
/jdk1.3.1_20/java/security/NoSuchAlgorithmException.java,Java,,9,5,24,38
/jdk1.3.1_20/java/security/NoSuchProviderException.java,Java,,9,5,23,37
/jdk1.3.1_20/java/security/Permission.java,Java,,30,22,159,211
/jdk1.3.1_20/java/security/PermissionCollection.java,Java,,29,11,124,164
/jdk1.3.1_20/java/security/Permissions.java,Java,,167,60,184,411
/jdk1.3.1_20/java/security/Policy.java,Java,,60,18,139,217
/jdk1.3.1_20/java/security/Principal.java,Java,,7,6,40,53
/jdk1.3.1_20/java/security/PrivateKey.java,Java,,4,3,26,33
/jdk1.3.1_20/java/security/PrivilegedAction.java,Java,,4,4,28,36
/jdk1.3.1_20/java/security/PrivilegedActionException.java,Java,,40,11,60,111
/jdk1.3.1_20/java/security/PrivilegedExceptionAction.java,Java,,4,5,33,42
/jdk1.3.1_20/java/security/ProtectionDomain.java,Java,,29,12,54,95
/jdk1.3.1_20/java/security/Provider.java,Java,,100,33,220,353
/jdk1.3.1_20/java/security/ProviderException.java,Java,,9,5,23,37
/jdk1.3.1_20/java/security/PublicKey.java,Java,,4,3,23,30
/jdk1.3.1_20/java/security/SecureClassLoader.java,Java,,74,17,92,183
/jdk1.3.1_20/java/security/SecureRandom.java,Java,,126,29,299,454
/jdk1.3.1_20/java/security/SecureRandomSpi.java,Java,,6,6,36,48
/jdk1.3.1_20/java/security/Security.java,Java,,637,121,484,1242
/jdk1.3.1_20/java/security/SecurityPermission.java,Java,,15,8,260,283
/jdk1.3.1_20/java/security/Signature.java,Java,,239,61,406,706
/jdk1.3.1_20/java/security/SignatureException.java,Java,,9,6,22,37
/jdk1.3.1_20/java/security/SignatureSpi.java,Java,,53,25,208,286
/jdk1.3.1_20/java/security/SignedObject.java,Java,,57,15,166,238
/jdk1.3.1_20/java/security/Signer.java,Java,,58,17,86,161
/jdk1.3.1_20/java/security/spec/AlgorithmParameterSpec.java,Java,,2,3,20,25
/jdk1.3.1_20/java/security/spec/DSAParameterSpec.java,Java,,22,9,39,70
/jdk1.3.1_20/java/security/spec/DSAPrivateKeySpec.java,Java,,27,10,50,87
/jdk1.3.1_20/java/security/spec/DSAPublicKeySpec.java,Java,,27,10,50,87
/jdk1.3.1_20/java/security/spec/EncodedKeySpec.java,Java,,11,7,44,62
/jdk1.3.1_20/java/security/spec/InvalidKeySpecException.java,Java,,10,6,27,43
/jdk1.3.1_20/java/security/spec/InvalidParameterSpecException.java,Java,,10,6,29,45
/jdk1.3.1_20/java/security/spec/KeySpec.java,Java,,2,3,38,43
/jdk1.3.1_20/java/security/spec/PKCS8EncodedKeySpec.java,Java,,12,6,54,72
/jdk1.3.1_20/java/security/spec/RSAKeyGenParameterSpec.java,Java,,19,10,38,67
/jdk1.3.1_20/java/security/spec/RSAPrivateCrtKeySpec.java,Java,,46,14,66,126
/jdk1.3.1_20/java/security/spec/RSAPrivateKeySpec.java,Java,,16,8,28,52
/jdk1.3.1_20/java/security/spec/RSAPublicKeySpec.java,Java,,16,8,28,52
/jdk1.3.1_20/java/security/spec/X509EncodedKeySpec.java,Java,,12,6,44,62
/jdk1.3.1_20/java/security/UnrecoverableKeyException.java,Java,,9,5,21,35
/jdk1.3.1_20/java/security/UnresolvedPermission.java,Java,,217,37,175,429
/jdk1.3.1_20/java/security/UnresolvedPermissionCollection.java,Java,,49,16,43,108
/jdk1.3.1_20/java/sql/Array.java,Java,,15,16,274,305
/jdk1.3.1_20/java/sql/BatchUpdateException.java,Java,,29,10,119,158
/jdk1.3.1_20/java/sql/Blob.java,Java,,8,10,96,114
/jdk1.3.1_20/java/sql/CallableStatement.java,Java,,40,39,411,490
/jdk1.3.1_20/java/sql/Clob.java,Java,,9,9,102,120
/jdk1.3.1_20/java/sql/Connection.java,Java,,37,41,359,437
/jdk1.3.1_20/java/sql/DatabaseMetaData.java,Java,,222,203,2040,2465
/jdk1.3.1_20/java/sql/DataTruncation.java,Java,,38,15,73,126
/jdk1.3.1_20/java/sql/Date.java,Java,,77,25,114,216
/jdk1.3.1_20/java/sql/Driver.java,Java,,11,12,105,128
/jdk1.3.1_20/java/sql/DriverManager.java,Java,,247,71,252,570
/jdk1.3.1_20/java/sql/DriverPropertyInfo.java,Java,,12,9,41,62
/jdk1.3.1_20/java/sql/PreparedStatement.java,Java,,54,51,504,609
/jdk1.3.1_20/java/sql/Ref.java,Java,,4,4,40,48
/jdk1.3.1_20/java/sql/ResultSet.java,Java,,162,164,2050,2376
/jdk1.3.1_20/java/sql/ResultSetMetaData.java,Java,,27,28,193,248
/jdk1.3.1_20/java/sql/SQLData.java,Java,,6,6,77,89
/jdk1.3.1_20/java/sql/SQLException.java,Java,,65,14,78,157
/jdk1.3.1_20/java/sql/SQLInput.java,Java,,25,29,208,262
/jdk1.3.1_20/java/sql/SQLOutput.java,Java,,25,29,218,272
/jdk1.3.1_20/java/sql/SQLPermission.java,Java,,10,9,84,103
/jdk1.3.1_20/java/sql/SQLWarning.java,Java,,32,11,55,98
/jdk1.3.1_20/java/sql/Statement.java,Java,,31,35,403,469
/jdk1.3.1_20/java/sql/Struct.java,Java,,6,8,62,76
/jdk1.3.1_20/java/sql/Time.java,Java,,77,22,110,209
/jdk1.3.1_20/java/sql/Timestamp.java,Java,,207,29,136,372
/jdk1.3.1_20/java/sql/Types.java,Java,,32,39,167,238
/jdk1.3.1_20/java/text/Annotation.java,Java,,13,8,42,63
/jdk1.3.1_20/java/text/AttributedCharacterIterator.java,Java,,53,28,135,216
/jdk1.3.1_20/java/text/AttributedString.java,Java,,638,115,198,951
/jdk1.3.1_20/java/text/BreakIterator.java,Java,,82,27,350,459
/jdk1.3.1_20/java/text/CharacterBreakData.java,Java,,159,23,136,318
/jdk1.3.1_20/java/text/CharacterIterator.java,Java,,15,17,142,174
/jdk1.3.1_20/java/text/ChoiceFormat.java,Java,,243,35,286,564
/jdk1.3.1_20/java/text/CollationElementIterator.java,Java,,268,43,247,558
/jdk1.3.1_20/java/text/CollationKey.java,Java,,45,17,127,189
/jdk1.3.1_20/java/text/CollationRules.java,Java,,205,11,37,253
/jdk1.3.1_20/java/text/Collator.java,Java,,117,30,336,483
/jdk1.3.1_20/java/text/CompactByteArray.java,Java,,196,18,122,336
/jdk1.3.1_20/java/text/CompactCharArray.java,Java,,198,23,122,343
/jdk1.3.1_20/java/text/CompactIntArray.java,Java,,180,27,117,324
/jdk1.3.1_20/java/text/CompactShortArray.java,Java,,244,36,162,442
/jdk1.3.1_20/java/text/CompactStringArray.java,Java,,306,13,119,438
/jdk1.3.1_20/java/text/DateFormat.java,Java,,191,39,426,656
/jdk1.3.1_20/java/text/DateFormatSymbols.java,Java,,231,51,288,570
/jdk1.3.1_20/java/text/DecimalFormat.java,Java,,1053,171,1032,2256
/jdk1.3.1_20/java/text/DecimalFormatSymbols.java,Java,,200,63,277,540
/jdk1.3.1_20/java/text/DigitList.java,Java,,275,55,254,584
/jdk1.3.1_20/java/text/EntryPair.java,Java,,15,4,21,40
/jdk1.3.1_20/java/text/FieldPosition.java,Java,,43,14,90,147
/jdk1.3.1_20/java/text/Format.java,Java,,28,7,171,206
/jdk1.3.1_20/java/text/IntHashtable.java,Java,,179,34,94,307
/jdk1.3.1_20/java/text/LineBreakData.java,Java,,292,15,195,502
/jdk1.3.1_20/java/text/MergeCollation.java,Java,,187,32,105,324
/jdk1.3.1_20/java/text/MessageFormat.java,Java,,519,53,395,967
/jdk1.3.1_20/java/text/Normalizer.java,Java,,1647,109,268,2024
/jdk1.3.1_20/java/text/NumberFormat.java,Java,,218,61,525,804
/jdk1.3.1_20/java/text/ParseException.java,Java,,12,6,41,59
/jdk1.3.1_20/java/text/ParsePosition.java,Java,,38,12,68,118
/jdk1.3.1_20/java/text/PatternEntry.java,Java,,205,29,52,286
/jdk1.3.1_20/java/text/RBCollationTables.java,Java,,121,30,118,269
/jdk1.3.1_20/java/text/RBTableBuilder.java,Java,,266,55,163,484
/jdk1.3.1_20/java/text/resources/DateFormatZoneData.java,Java,,594,16,67,677
/jdk1.3.1_20/java/text/resources/DateFormatZoneData_en.java,Java,,9,3,41,53
/jdk1.3.1_20/java/text/resources/LocaleData.java,Java,,150,17,60,227
/jdk1.3.1_20/java/text/resources/LocaleElements.java,Java,,489,6,44,539
/jdk1.3.1_20/java/text/resources/LocaleElements_en.java,Java,,15,6,39,60
/jdk1.3.1_20/java/text/resources/LocaleElements_en_US.java,Java,,25,6,34,65
/jdk1.3.1_20/java/text/RuleBasedCollator.java,Java,,255,43,458,756
/jdk1.3.1_20/java/text/SentenceBreakData.java,Java,,215,33,187,435
/jdk1.3.1_20/java/text/SimpleDateFormat.java,Java,,745,89,502,1336
/jdk1.3.1_20/java/text/SimpleTextBoundary.java,Java,,199,33,108,340
/jdk1.3.1_20/java/text/SpecialMapping.java,Java,,17,6,43,66
/jdk1.3.1_20/java/text/StringCharacterIterator.java,Java,,129,26,103,258
/jdk1.3.1_20/java/text/TextBoundaryData.java,Java,,259,10,26,295
/jdk1.3.1_20/java/text/UnicodeClassMapping.java,Java,,43,8,40,91
/jdk1.3.1_20/java/text/Utility.java,Java,,273,31,140,444
/jdk1.3.1_20/java/text/WordBreakData.java,Java,,289,40,178,507
/jdk1.3.1_20/java/text/WordBreakTable.java,Java,,31,9,51,91
/jdk1.3.1_20/java/util/AbstractCollection.java,Java,,122,27,300,449
/jdk1.3.1_20/java/util/AbstractList.java,Java,,324,74,445,843
/jdk1.3.1_20/java/util/AbstractMap.java,Java,,200,41,328,569
/jdk1.3.1_20/java/util/AbstractSequentialList.java,Java,,52,14,187,253
/jdk1.3.1_20/java/util/AbstractSet.java,Java,,40,11,91,142
/jdk1.3.1_20/java/util/ArrayList.java,Java,,196,52,280,528
/jdk1.3.1_20/java/util/Arrays.java,Java,,999,211,1060,2270
/jdk1.3.1_20/java/util/BitSet.java,Java,,194,56,248,498
/jdk1.3.1_20/java/util/Calendar.java,Java,,467,112,1055,1634
/jdk1.3.1_20/java/util/Collection.java,Java,,18,24,306,348
/jdk1.3.1_20/java/util/Collections.java,Java,,944,209,795,1948
/jdk1.3.1_20/java/util/Comparator.java,Java,,5,4,123,132
/jdk1.3.1_20/java/util/ConcurrentModificationException.java,Java,,8,3,40,51
/jdk1.3.1_20/java/util/Date.java,Java,,405,47,730,1182
/jdk1.3.1_20/java/util/Dictionary.java,Java,,13,9,114,136
/jdk1.3.1_20/java/util/EmptyStackException.java,Java,,6,2,17,25
/jdk1.3.1_20/java/util/Enumeration.java,Java,,5,3,54,62
/jdk1.3.1_20/java/util/EventListener.java,Java,,3,2,8,13
/jdk1.3.1_20/java/util/EventObject.java,Java,,15,7,32,54
/jdk1.3.1_20/java/util/GregorianCalendar.java,Java,,797,194,987,1978
/jdk1.3.1_20/java/util/HashMap.java,Java,,463,97,287,847
/jdk1.3.1_20/java/util/HashSet.java,Java,,71,24,149,244
/jdk1.3.1_20/java/util/Hashtable.java,Java,,516,107,390,1013
/jdk1.3.1_20/java/util/Iterator.java,Java,,6,4,50,60
/jdk1.3.1_20/java/util/jar/Attributes.java,Java,,221,57,309,587
/jdk1.3.1_20/java/util/jar/JarEntry.java,Java,,26,8,52,86
/jdk1.3.1_20/java/util/jar/JarException.java,Java,,9,3,19,31
/jdk1.3.1_20/java/util/jar/JarFile.java,Java,,165,26,127,318
/jdk1.3.1_20/java/util/jar/JarInputStream.java,Java,,88,16,77,181
/jdk1.3.1_20/java/util/jar/JarOutputStream.java,Java,,58,10,60,128
/jdk1.3.1_20/java/util/jar/JarVerifier.java,Java,,251,62,86,399
/jdk1.3.1_20/java/util/jar/Manifest.java,Java,,241,35,110,386
/jdk1.3.1_20/java/util/LinkedList.java,Java,,312,69,303,684
/jdk1.3.1_20/java/util/List.java,Java,,28,41,428,497
/jdk1.3.1_20/java/util/ListIterator.java,Java,,12,13,132,157
/jdk1.3.1_20/java/util/ListResourceBundle.java,Java,,59,13,120,192
/jdk1.3.1_20/java/util/Locale.java,Java,,510,113,602,1225
/jdk1.3.1_20/java/util/Map.java,Java,,24,27,312,363
/jdk1.3.1_20/java/util/MissingResourceException.java,Java,,17,9,48,74
/jdk1.3.1_20/java/util/NoSuchElementException.java,Java,,10,3,26,39
/jdk1.3.1_20/java/util/Observable.java,Java,,45,15,131,191
/jdk1.3.1_20/java/util/Observer.java,Java,,4,1,23,28
/jdk1.3.1_20/java/util/Properties.java,Java,,257,39,287,583
/jdk1.3.1_20/java/util/PropertyPermission.java,Java,,218,86,248,552
/jdk1.3.1_20/java/util/PropertyResourceBundle.java,Java,,46,11,89,146
/jdk1.3.1_20/java/util/Random.java,Java,,81,24,328,433
/jdk1.3.1_20/java/util/ResourceBundle.java,Java,,400,58,515,973
/jdk1.3.1_20/java/util/Set.java,Java,,18,26,228,272
/jdk1.3.1_20/java/util/SimpleTimeZone.java,Java,,586,94,772,1452
/jdk1.3.1_20/java/util/SortedMap.java,Java,,9,8,201,218
/jdk1.3.1_20/java/util/SortedSet.java,Java,,9,8,200,217
/jdk1.3.1_20/java/util/Stack.java,Java,,34,13,69,116
/jdk1.3.1_20/java/util/StringTokenizer.java,Java,,108,23,180,311
/jdk1.3.1_20/java/util/Timer.java,Java,,190,36,335,561
/jdk1.3.1_20/java/util/TimerTask.java,Java,,27,14,98,139
/jdk1.3.1_20/java/util/TimeZone.java,Java,,960,56,1325,2341
/jdk1.3.1_20/java/util/TooManyListenersException.java,Java,,9,8,35,52
/jdk1.3.1_20/java/util/TreeMap.java,Java,,891,168,606,1665
/jdk1.3.1_20/java/util/TreeSet.java,Java,,107,35,326,468
/jdk1.3.1_20/java/util/Vector.java,Java,,322,72,593,987
/jdk1.3.1_20/java/util/WeakHashMap.java,Java,,188,66,189,443
/jdk1.3.1_20/java/util/zip/Adler32.java,Java,,35,11,36,82
/jdk1.3.1_20/java/util/zip/CheckedInputStream.java,Java,,42,8,42,92
/jdk1.3.1_20/java/util/zip/CheckedOutputStream.java,Java,,23,7,35,65
/jdk1.3.1_20/java/util/zip/Checksum.java,Java,,8,5,28,41
/jdk1.3.1_20/java/util/zip/CRC32.java,Java,,34,11,34,79
/jdk1.3.1_20/java/util/zip/DataFormatException.java,Java,,10,3,18,31
/jdk1.3.1_20/java/util/zip/Deflater.java,Java,,151,32,170,353
/jdk1.3.1_20/java/util/zip/DeflaterOutputStream.java,Java,,69,13,66,148
/jdk1.3.1_20/java/util/zip/GZIPInputStream.java,Java,,115,18,82,215
/jdk1.3.1_20/java/util/zip/GZIPOutputStream.java,Java,,56,13,60,129
/jdk1.3.1_20/java/util/zip/Inflater.java,Java,,121,22,146,289
/jdk1.3.1_20/java/util/zip/InflaterInputStream.java,Java,,109,18,86,213
/jdk1.3.1_20/java/util/zip/ZipConstants.java,Java,,43,7,29,79
/jdk1.3.1_20/java/util/zip/ZipEntry.java,Java,,148,33,149,330
/jdk1.3.1_20/java/util/zip/ZipException.java,Java,,11,6,22,39
/jdk1.3.1_20/java/util/zip/ZipFile.java,Java,,287,43,133,463
/jdk1.3.1_20/java/util/zip/ZipInputStream.java,Java,,264,21,109,394
/jdk1.3.1_20/java/util/zip/ZipOutputStream.java,Java,,331,24,120,475
/jdk1.3.1_20/javax/accessibility/Accessible.java,Java,,4,3,24,31
/jdk1.3.1_20/javax/accessibility/AccessibleAction.java,Java,,6,5,46,57
/jdk1.3.1_20/javax/accessibility/AccessibleBundle.java,Java,,49,13,61,123
/jdk1.3.1_20/javax/accessibility/AccessibleComponent.java,Java,,32,30,234,296
/jdk1.3.1_20/javax/accessibility/AccessibleContext.java,Java,,112,50,456,618
/jdk1.3.1_20/javax/accessibility/AccessibleHyperlink.java,Java,,15,13,94,122
/jdk1.3.1_20/javax/accessibility/AccessibleHypertext.java,Java,,10,8,44,62
/jdk1.3.1_20/javax/accessibility/AccessibleIcon.java,Java,,7,7,48,62
/jdk1.3.1_20/javax/accessibility/AccessibleRelation.java,Java,,51,21,149,221
/jdk1.3.1_20/javax/accessibility/AccessibleRelationSet.java,Java,,105,16,92,213
/jdk1.3.1_20/javax/accessibility/AccessibleResourceBundle.java,Java,,89,5,41,135
/jdk1.3.1_20/javax/accessibility/AccessibleRole.java,Java,,109,71,352,532
/jdk1.3.1_20/javax/accessibility/AccessibleSelection.java,Java,,10,9,76,95
/jdk1.3.1_20/javax/accessibility/AccessibleState.java,Java,,62,32,224,318
/jdk1.3.1_20/javax/accessibility/AccessibleStateSet.java,Java,,86,14,79,179
/jdk1.3.1_20/javax/accessibility/AccessibleTable.java,Java,,25,26,149,200
/jdk1.3.1_20/javax/accessibility/AccessibleTableModelChange.java,Java,,11,10,60,81
/jdk1.3.1_20/javax/accessibility/AccessibleText.java,Java,,21,19,123,163
/jdk1.3.1_20/javax/accessibility/AccessibleValue.java,Java,,7,7,59,73
/jdk1.3.1_20/javax/naming/AuthenticationException.java,Java,,10,5,41,56
/jdk1.3.1_20/javax/naming/AuthenticationNotSupportedException.java,Java,,10,5,46,61
/jdk1.3.1_20/javax/naming/BinaryRefAddr.java,Java,,50,13,101,164
/jdk1.3.1_20/javax/naming/Binding.java,Java,,40,15,126,181
/jdk1.3.1_20/javax/naming/CannotProceedException.java,Java,,42,21,204,267
/jdk1.3.1_20/javax/naming/CommunicationException.java,Java,,10,4,33,47
/jdk1.3.1_20/javax/naming/CompositeName.java,Java,,128,34,454,616
/jdk1.3.1_20/javax/naming/CompoundName.java,Java,,121,30,449,600
/jdk1.3.1_20/javax/naming/ConfigurationException.java,Java,,10,4,39,53
/jdk1.3.1_20/javax/naming/Context.java,Java,,51,49,980,1080
/jdk1.3.1_20/javax/naming/ContextNotEmptyException.java,Java,,10,4,39,53
/jdk1.3.1_20/javax/naming/directory/Attribute.java,Java,,26,22,273,321
/jdk1.3.1_20/javax/naming/directory/AttributeInUseException.java,Java,,11,5,32,48
/jdk1.3.1_20/javax/naming/directory/AttributeModificationException.java,Java,,26,12,83,121
/jdk1.3.1_20/javax/naming/directory/Attributes.java,Java,,16,15,133,164
/jdk1.3.1_20/javax/naming/directory/BasicAttribute.java,Java,,269,51,217,537
/jdk1.3.1_20/javax/naming/directory/BasicAttributes.java,Java,,169,45,143,357
/jdk1.3.1_20/javax/naming/directory/DirContext.java,Java,,71,35,908,1014
/jdk1.3.1_20/javax/naming/directory/InitialDirContext.java,Java,,165,38,60,263
/jdk1.3.1_20/javax/naming/directory/InvalidAttributeIdentifierException.java,Java,,11,6,30,47
/jdk1.3.1_20/javax/naming/directory/InvalidAttributesException.java,Java,,11,6,36,53
/jdk1.3.1_20/javax/naming/directory/InvalidAttributeValueException.java,Java,,11,6,34,51
/jdk1.3.1_20/javax/naming/directory/InvalidSearchControlsException.java,Java,,11,6,31,48
/jdk1.3.1_20/javax/naming/directory/InvalidSearchFilterException.java,Java,,11,6,31,48
/jdk1.3.1_20/javax/naming/directory/ModificationItem.java,Java,,37,14,64,115
/jdk1.3.1_20/javax/naming/directory/NoSuchAttributeException.java,Java,,11,7,29,47
/jdk1.3.1_20/javax/naming/directory/SchemaViolationException.java,Java,,11,6,41,58
/jdk1.3.1_20/javax/naming/directory/SearchControls.java,Java,,70,26,221,317
/jdk1.3.1_20/javax/naming/directory/SearchResult.java,Java,,34,14,122,170
/jdk1.3.1_20/javax/naming/event/EventContext.java,Java,,15,12,203,230
/jdk1.3.1_20/javax/naming/event/EventDirContext.java,Java,,15,6,119,140
/jdk1.3.1_20/javax/naming/event/NamespaceChangeListener.java,Java,,6,5,61,72
/jdk1.3.1_20/javax/naming/event/NamingEvent.java,Java,,52,20,209,281
/jdk1.3.1_20/javax/naming/event/NamingExceptionEvent.java,Java,,19,9,47,75
/jdk1.3.1_20/javax/naming/event/NamingListener.java,Java,,4,2,40,46
/jdk1.3.1_20/javax/naming/event/ObjectChangeListener.java,Java,,4,3,47,54
/jdk1.3.1_20/javax/naming/InitialContext.java,Java,,175,48,262,485
/jdk1.3.1_20/javax/naming/InsufficientResourcesException.java,Java,,10,5,38,53
/jdk1.3.1_20/javax/naming/InterruptedNamingException.java,Java,,10,5,42,57
/jdk1.3.1_20/javax/naming/InvalidNameException.java,Java,,10,5,38,53
/jdk1.3.1_20/javax/naming/ldap/Control.java,Java,,8,7,62,77
/jdk1.3.1_20/javax/naming/ldap/ControlFactory.java,Java,,27,13,98,138
/jdk1.3.1_20/javax/naming/ldap/ExtendedRequest.java,Java,,8,7,114,129
/jdk1.3.1_20/javax/naming/ldap/ExtendedResponse.java,Java,,5,6,69,80
/jdk1.3.1_20/javax/naming/ldap/HasControls.java,Java,,5,5,41,51
/jdk1.3.1_20/javax/naming/ldap/InitialLdapContext.java,Java,,60,19,107,186
/jdk1.3.1_20/javax/naming/ldap/LdapContext.java,Java,,17,11,304,332
/jdk1.3.1_20/javax/naming/ldap/LdapReferralException.java,Java,,18,9,112,139
/jdk1.3.1_20/javax/naming/ldap/UnsolicitedNotification.java,Java,,6,5,34,45
/jdk1.3.1_20/javax/naming/ldap/UnsolicitedNotificationEvent.java,Java,,16,8,41,65
/jdk1.3.1_20/javax/naming/ldap/UnsolicitedNotificationListener.java,Java,,5,4,40,49
/jdk1.3.1_20/javax/naming/LimitExceededException.java,Java,,11,7,37,55
/jdk1.3.1_20/javax/naming/LinkException.java,Java,,63,23,199,285
/jdk1.3.1_20/javax/naming/LinkLoopException.java,Java,,10,5,33,48
/jdk1.3.1_20/javax/naming/LinkRef.java,Java,,21,7,69,97
/jdk1.3.1_20/javax/naming/MalformedLinkException.java,Java,,10,6,32,48
/jdk1.3.1_20/javax/naming/Name.java,Java,,19,19,211,249
/jdk1.3.1_20/javax/naming/NameAlreadyBoundException.java,Java,,10,5,39,54
/jdk1.3.1_20/javax/naming/NameClassPair.java,Java,,38,16,161,215
/jdk1.3.1_20/javax/naming/NameImpl.java,Java,,518,81,101,700
/jdk1.3.1_20/javax/naming/NameNotFoundException.java,Java,,10,5,31,46
/jdk1.3.1_20/javax/naming/NameParser.java,Java,,4,3,31,38
/jdk1.3.1_20/javax/naming/NamingEnumeration.java,Java,,7,5,116,128
/jdk1.3.1_20/javax/naming/NamingException.java,Java,,125,25,255,405
/jdk1.3.1_20/javax/naming/NamingSecurityException.java,Java,,10,5,37,52
/jdk1.3.1_20/javax/naming/NoInitialContextException.java,Java,,10,4,42,56
/jdk1.3.1_20/javax/naming/NoPermissionException.java,Java,,10,4,31,45
/jdk1.3.1_20/javax/naming/NotContextException.java,Java,,10,5,39,54
/jdk1.3.1_20/javax/naming/OperationNotSupportedException.java,Java,,10,5,33,48
/jdk1.3.1_20/javax/naming/PartialResultException.java,Java,,10,5,32,47
/jdk1.3.1_20/javax/naming/RefAddr.java,Java,,36,12,84,132
/jdk1.3.1_20/javax/naming/Reference.java,Java,,109,29,238,376
/jdk1.3.1_20/javax/naming/Referenceable.java,Java,,4,2,33,39
/jdk1.3.1_20/javax/naming/ReferralException.java,Java,,16,11,156,183
/jdk1.3.1_20/javax/naming/ServiceUnavailableException.java,Java,,10,5,34,49
/jdk1.3.1_20/javax/naming/SizeLimitExceededException.java,Java,,11,6,33,50
/jdk1.3.1_20/javax/naming/spi/ContinuationContext.java,Java,,169,34,12,215
/jdk1.3.1_20/javax/naming/spi/ContinuationDirContext.java,Java,,244,52,18,314
/jdk1.3.1_20/javax/naming/spi/DirectoryManager.java,Java,,119,30,166,315
/jdk1.3.1_20/javax/naming/spi/DirObjectFactory.java,Java,,9,4,99,112
/jdk1.3.1_20/javax/naming/spi/DirStateFactory.java,Java,,19,10,139,168
/jdk1.3.1_20/javax/naming/spi/InitialContextFactory.java,Java,,7,4,42,53
/jdk1.3.1_20/javax/naming/spi/InitialContextFactoryBuilder.java,Java,,7,3,41,51
/jdk1.3.1_20/javax/naming/spi/NamingManager.java,Java,,294,82,469,845
/jdk1.3.1_20/javax/naming/spi/ObjectFactory.java,Java,,7,5,142,154
/jdk1.3.1_20/javax/naming/spi/ObjectFactoryBuilder.java,Java,,7,3,45,55
/jdk1.3.1_20/javax/naming/spi/Resolver.java,Java,,9,7,58,74
/jdk1.3.1_20/javax/naming/spi/ResolveResult.java,Java,,62,12,106,180
/jdk1.3.1_20/javax/naming/spi/StateFactory.java,Java,,8,2,109,119
/jdk1.3.1_20/javax/naming/StringRefAddr.java,Java,,12,5,50,67
/jdk1.3.1_20/javax/naming/TimeLimitExceededException.java,Java,,11,6,33,50
/jdk1.3.1_20/javax/swing/AbstractAction.java,Java,,306,42,177,525
/jdk1.3.1_20/javax/swing/AbstractActionPropertyChangeListener.java,Java,,46,10,23,79
/jdk1.3.1_20/javax/swing/AbstractButton.java,Java,,1145,173,1016,2334
/jdk1.3.1_20/javax/swing/AbstractCellEditor.java,Java,,47,14,72,133
/jdk1.3.1_20/javax/swing/AbstractListModel.java,Java,,56,17,76,149
/jdk1.3.1_20/javax/swing/Action.java,Java,,20,9,153,182
/jdk1.3.1_20/javax/swing/ActionMap.java,Java,,134,21,73,228
/jdk1.3.1_20/javax/swing/AncestorNotifier.java,Java,,142,30,41,213
/jdk1.3.1_20/javax/swing/AppContext.java,Java,,61,16,155,232
/jdk1.3.1_20/javax/swing/Autoscroller.java,Java,,73,17,8,98
/jdk1.3.1_20/javax/swing/border/AbstractBorder.java,Java,,36,10,36,82
/jdk1.3.1_20/javax/swing/border/BevelBorder.java,Java,,123,38,114,275
/jdk1.3.1_20/javax/swing/border/Border.java,Java,,11,4,56,71
/jdk1.3.1_20/javax/swing/border/CompoundBorder.java,Java,,66,16,71,153
/jdk1.3.1_20/javax/swing/border/EmptyBorder.java,Java,,38,10,48,96
/jdk1.3.1_20/javax/swing/border/EtchedBorder.java,Java,,65,22,99,186
/jdk1.3.1_20/javax/swing/border/LineBorder.java,Java,,68,17,72,157
/jdk1.3.1_20/javax/swing/border/MatteBorder.java,Java,,126,26,85,237
/jdk1.3.1_20/javax/swing/border/SoftBevelBorder.java,Java,,64,19,58,141
/jdk1.3.1_20/javax/swing/border/TitledBorder.java,Java,,379,63,187,629
/jdk1.3.1_20/javax/swing/BorderFactory.java,Java,,127,30,342,499
/jdk1.3.1_20/javax/swing/BoundedRangeModel.java,Java,,18,30,199,247
/jdk1.3.1_20/javax/swing/Box.java,Java,,94,36,281,411
/jdk1.3.1_20/javax/swing/BoxLayout.java,Java,,165,34,204,403
/jdk1.3.1_20/javax/swing/ButtonGroup.java,Java,,55,13,74,142
/jdk1.3.1_20/javax/swing/ButtonModel.java,Java,,27,25,154,206
/jdk1.3.1_20/javax/swing/CellEditor.java,Java,,12,10,87,109
/jdk1.3.1_20/javax/swing/CellRendererPane.java,Java,,87,35,93,215
/jdk1.3.1_20/javax/swing/colorchooser/AbstractColorChooserPanel.java,Java,,52,18,77,147
/jdk1.3.1_20/javax/swing/colorchooser/CenterLayout.java,Java,,41,9,10,60
/jdk1.3.1_20/javax/swing/colorchooser/ColorChooserComponentFactory.java,Java,,14,10,19,43
/jdk1.3.1_20/javax/swing/colorchooser/ColorSelectionModel.java,Java,,10,6,30,46
/jdk1.3.1_20/javax/swing/colorchooser/DefaultColorSelectionModel.java,Java,,43,15,35,93
/jdk1.3.1_20/javax/swing/colorchooser/DefaultHSBChooserPanel.java,Java,,557,159,24,740
/jdk1.3.1_20/javax/swing/colorchooser/DefaultPreviewPanel.java,Java,,139,49,18,206
/jdk1.3.1_20/javax/swing/colorchooser/DefaultRGBChooserPanel.java,Java,,148,48,31,227
/jdk1.3.1_20/javax/swing/colorchooser/DefaultSwatchChooserPanel.java,Java,,489,66,21,576
/jdk1.3.1_20/javax/swing/colorchooser/JIntegerTextField.java,Java,,130,36,10,176
/jdk1.3.1_20/javax/swing/colorchooser/SmartGridLayout.java,Java,,94,48,13,155
/jdk1.3.1_20/javax/swing/colorchooser/SyntheticImage.java,Java,,98,8,33,139
/jdk1.3.1_20/javax/swing/ComboBoxEditor.java,Java,,11,8,18,37
/jdk1.3.1_20/javax/swing/ComboBoxModel.java,Java,,5,4,16,25
/jdk1.3.1_20/javax/swing/ComponentInputMap.java,Java,,43,7,48,98
/jdk1.3.1_20/javax/swing/DebugGraphics.java,Java,,1036,176,234,1446
/jdk1.3.1_20/javax/swing/DebugGraphicsFilter.java,Java,,13,5,9,27
/jdk1.3.1_20/javax/swing/DebugGraphicsInfo.java,Java,,32,9,10,51
/jdk1.3.1_20/javax/swing/DebugGraphicsObserver.java,Java,,19,6,9,34
/jdk1.3.1_20/javax/swing/DefaultBoundedRangeModel.java,Java,,137,48,172,357
/jdk1.3.1_20/javax/swing/DefaultButtonModel.java,Java,,176,55,229,460
/jdk1.3.1_20/javax/swing/DefaultCellEditor.java,Java,,141,43,70,254
/jdk1.3.1_20/javax/swing/DefaultComboBoxModel.java,Java,,96,25,44,165
/jdk1.3.1_20/javax/swing/DefaultDesktopManager.java,Java,,425,114,109,648
/jdk1.3.1_20/javax/swing/DefaultFocusManager.java,Java,,267,52,55,374
/jdk1.3.1_20/javax/swing/DefaultListCellRenderer.java,Java,,76,29,117,222
/jdk1.3.1_20/javax/swing/DefaultListModel.java,Java,,140,42,335,517
/jdk1.3.1_20/javax/swing/DefaultListSelectionModel.java,Java,,314,79,225,618
/jdk1.3.1_20/javax/swing/DefaultPopupFactory.java,Java,,771,149,325,1245
/jdk1.3.1_20/javax/swing/DefaultSingleSelectionModel.java,Java,,48,20,52,120
/jdk1.3.1_20/javax/swing/DesktopManager.java,Java,,19,11,67,97
/jdk1.3.1_20/javax/swing/event/AncestorEvent.java,Java,,25,7,50,82
/jdk1.3.1_20/javax/swing/event/AncestorListener.java,Java,,10,8,34,52
/jdk1.3.1_20/javax/swing/event/CaretEvent.java,Java,,9,7,35,51
/jdk1.3.1_20/javax/swing/event/CaretListener.java,Java,,5,5,16,26
/jdk1.3.1_20/javax/swing/event/CellEditorListener.java,Java,,7,7,13,27
/jdk1.3.1_20/javax/swing/event/ChangeEvent.java,Java,,7,4,24,35
/jdk1.3.1_20/javax/swing/event/ChangeListener.java,Java,,5,5,15,25
/jdk1.3.1_20/javax/swing/event/DocumentEvent.java,Java,,28,20,116,164
/jdk1.3.1_20/javax/swing/event/DocumentListener.java,Java,,7,5,47,59
/jdk1.3.1_20/javax/swing/event/EventListenerList.java,Java,,112,16,136,264
/jdk1.3.1_20/javax/swing/event/HyperlinkEvent.java,Java,,40,18,74,132
/jdk1.3.1_20/javax/swing/event/HyperlinkListener.java,Java,,5,5,15,25
/jdk1.3.1_20/javax/swing/event/InternalFrameAdapter.java,Java,,10,8,43,61
/jdk1.3.1_20/javax/swing/event/InternalFrameEvent.java,Java,,49,18,76,143
/jdk1.3.1_20/javax/swing/event/InternalFrameListener.java,Java,,11,9,48,68
/jdk1.3.1_20/javax/swing/event/ListDataEvent.java,Java,,20,11,52,83
/jdk1.3.1_20/javax/swing/event/ListDataListener.java,Java,,7,9,31,47
/jdk1.3.1_20/javax/swing/event/ListSelectionEvent.java,Java,,29,10,54,93
/jdk1.3.1_20/javax/swing/event/ListSelectionListener.java,Java,,6,8,17,31
/jdk1.3.1_20/javax/swing/event/MenuDragMouseEvent.java,Java,,24,7,50,81
/jdk1.3.1_20/javax/swing/event/MenuDragMouseListener.java,Java,,8,5,34,47
/jdk1.3.1_20/javax/swing/event/MenuEvent.java,Java,,7,4,26,37
/jdk1.3.1_20/javax/swing/event/MenuKeyEvent.java,Java,,23,7,46,76
/jdk1.3.1_20/javax/swing/event/MenuKeyListener.java,Java,,7,7,20,34
/jdk1.3.1_20/javax/swing/event/MenuListener.java,Java,,7,5,25,37
/jdk1.3.1_20/javax/swing/event/MouseInputAdapter.java,Java,,11,7,22,40
/jdk1.3.1_20/javax/swing/event/MouseInputListener.java,Java,,5,5,11,21
/jdk1.3.1_20/javax/swing/event/PopupMenuEvent.java,Java,,7,2,24,33
/jdk1.3.1_20/javax/swing/event/PopupMenuListener.java,Java,,7,6,20,33
/jdk1.3.1_20/javax/swing/event/SwingPropertyChangeSupport.java,Java,,122,26,73,221
/jdk1.3.1_20/javax/swing/event/TableColumnModelEvent.java,Java,,15,10,41,66
/jdk1.3.1_20/javax/swing/event/TableColumnModelListener.java,Java,,12,9,20,41
/jdk1.3.1_20/javax/swing/event/TableModelEvent.java,Java,,38,18,100,156
/jdk1.3.1_20/javax/swing/event/TableModelListener.java,Java,,6,5,16,27
/jdk1.3.1_20/javax/swing/event/TreeExpansionEvent.java,Java,,12,5,37,54
/jdk1.3.1_20/javax/swing/event/TreeExpansionListener.java,Java,,7,5,20,32
/jdk1.3.1_20/javax/swing/event/TreeModelEvent.java,Java,,75,16,202,293
/jdk1.3.1_20/javax/swing/event/TreeModelListener.java,Java,,8,8,63,79
/jdk1.3.1_20/javax/swing/event/TreeSelectionEvent.java,Java,,71,14,82,167
/jdk1.3.1_20/javax/swing/event/TreeSelectionListener.java,Java,,6,3,22,31
/jdk1.3.1_20/javax/swing/event/TreeWillExpandListener.java,Java,,7,5,20,32
/jdk1.3.1_20/javax/swing/event/UndoableEditEvent.java,Java,,12,5,29,46
/jdk1.3.1_20/javax/swing/event/UndoableEditListener.java,Java,,5,5,14,24
/jdk1.3.1_20/javax/swing/filechooser/FileFilter.java,Java,,6,4,27,37
/jdk1.3.1_20/javax/swing/filechooser/FileSystemView.java,Java,,310,67,117,494
/jdk1.3.1_20/javax/swing/filechooser/FileView.java,Java,,20,8,62,90
/jdk1.3.1_20/javax/swing/FocusManager.java,Java,,59,14,47,120
/jdk1.3.1_20/javax/swing/GraphicsWrapper.java,Java,,10,8,10,28
/jdk1.3.1_20/javax/swing/GrayFilter.java,Java,,31,9,35,75
/jdk1.3.1_20/javax/swing/Icon.java,Java,,9,6,24,39
/jdk1.3.1_20/javax/swing/ImageIcon.java,Java,,227,60,312,599
/jdk1.3.1_20/javax/swing/InputMap.java,Java,,138,24,72,234
/jdk1.3.1_20/javax/swing/InputVerifier.java,Java,,8,11,105,124
/jdk1.3.1_20/javax/swing/JApplet.java,Java,,138,46,246,430
/jdk1.3.1_20/javax/swing/JButton.java,Java,,91,32,171,294
/jdk1.3.1_20/javax/swing/JCheckBox.java,Java,,112,35,198,345
/jdk1.3.1_20/javax/swing/JCheckBoxMenuItem.java,Java,,76,27,164,267
/jdk1.3.1_20/javax/swing/JColorChooser.java,Java,,256,89,282,627
/jdk1.3.1_20/javax/swing/JComboBox.java,Java,,584,127,777,1488
/jdk1.3.1_20/javax/swing/JComponent.java,Java,,2044,407,1745,4196
/jdk1.3.1_20/javax/swing/JDesktopPane.java,Java,,117,42,193,352
/jdk1.3.1_20/javax/swing/JDialog.java,Java,,269,68,422,759
/jdk1.3.1_20/javax/swing/JEditorPane.java,Java,,1047,159,984,2190
/jdk1.3.1_20/javax/swing/JFileChooser.java,Java,,588,167,873,1628
/jdk1.3.1_20/javax/swing/JFrame.java,Java,,211,57,443,711
/jdk1.3.1_20/javax/swing/JInternalFrame.java,Java,,815,180,1038,2033
/jdk1.3.1_20/javax/swing/JLabel.java,Java,,638,116,661,1415
/jdk1.3.1_20/javax/swing/JLayeredPane.java,Java,,287,66,362,715
/jdk1.3.1_20/javax/swing/JList.java,Java,,1080,263,1195,2538
/jdk1.3.1_20/javax/swing/JMenu.java,Java,,782,138,721,1641
/jdk1.3.1_20/javax/swing/JMenuBar.java,Java,,321,75,346,742
/jdk1.3.1_20/javax/swing/JMenuItem.java,Java,,339,69,363,771
/jdk1.3.1_20/javax/swing/JOptionPane.java,Java,,681,141,1231,2053
/jdk1.3.1_20/javax/swing/JPanel.java,Java,,57,22,117,196
/jdk1.3.1_20/javax/swing/JPasswordField.java,Java,,84,30,204,318
/jdk1.3.1_20/javax/swing/JPopupMenu.java,Java,,564,113,538,1215
/jdk1.3.1_20/javax/swing/JProgressBar.java,Java,,282,81,477,840
/jdk1.3.1_20/javax/swing/JRadioButton.java,Java,,95,33,191,319
/jdk1.3.1_20/javax/swing/JRadioButtonMenuItem.java,Java,,65,24,152,241
/jdk1.3.1_20/javax/swing/JRootPane.java,Java,,293,70,421,784
/jdk1.3.1_20/javax/swing/JScrollBar.java,Java,,289,107,448,844
/jdk1.3.1_20/javax/swing/JScrollPane.java,Java,,434,137,751,1322
/jdk1.3.1_20/javax/swing/JSeparator.java,Java,,85,28,161,274
/jdk1.3.1_20/javax/swing/JSlider.java,Java,,455,162,572,1189
/jdk1.3.1_20/javax/swing/JSplitPane.java,Java,,381,165,639,1185
/jdk1.3.1_20/javax/swing/JTabbedPane.java,Java,,708,157,741,1606
/jdk1.3.1_20/javax/swing/JTable.java,Java,,2549,499,2560,5608
/jdk1.3.1_20/javax/swing/JTextArea.java,Java,,287,54,455,796
/jdk1.3.1_20/javax/swing/JTextField.java,Java,,294,62,451,807
/jdk1.3.1_20/javax/swing/JTextPane.java,Java,,153,33,253,439
/jdk1.3.1_20/javax/swing/JToggleButton.java,Java,,132,47,194,373
/jdk1.3.1_20/javax/swing/JToolBar.java,Java,[WDW - need to add orientation from BoxLayout,318,68,376,762
/jdk1.3.1_20/javax/swing/JToolTip.java,Java,,70,28,146,244
/jdk1.3.1_20/javax/swing/JTree.java,Java,,2208,421,1952,4581
/jdk1.3.1_20/javax/swing/JViewport.java,Java,,736,173,699,1608
/jdk1.3.1_20/javax/swing/JWindow.java,Java,,126,43,307,476
/jdk1.3.1_20/javax/swing/KeyboardManager.java,Java,,202,47,77,326
/jdk1.3.1_20/javax/swing/KeyStroke.java,Java,,280,49,228,557
/jdk1.3.1_20/javax/swing/ListCellRenderer.java,Java,,11,4,53,68
/jdk1.3.1_20/javax/swing/ListModel.java,Java,,9,7,32,48
/jdk1.3.1_20/javax/swing/ListSelectionModel.java,Java,,28,36,189,253
/jdk1.3.1_20/javax/swing/LookAndFeel.java,Java,,143,41,190,374
/jdk1.3.1_20/javax/swing/MenuElement.java,Java,,10,10,41,61
/jdk1.3.1_20/javax/swing/MenuSelectionManager.java,Java,,294,50,94,438
/jdk1.3.1_20/javax/swing/MultiUIDefaults.java,Java,,114,30,9,153
/jdk1.3.1_20/javax/swing/MutableComboBoxModel.java,Java,,7,7,27,41
/jdk1.3.1_20/javax/swing/OverlayLayout.java,Java,,113,26,116,255
/jdk1.3.1_20/javax/swing/plaf/ActionMapUIResource.java,Java,,6,4,11,21
/jdk1.3.1_20/javax/swing/plaf/basic/BasicArrowButton.java,Java,,141,30,22,193
/jdk1.3.1_20/javax/swing/plaf/basic/BasicBorders.java,Java,,360,66,49,475
/jdk1.3.1_20/javax/swing/plaf/basic/BasicButtonListener.java,Java,,201,39,38,278
/jdk1.3.1_20/javax/swing/plaf/basic/BasicButtonUI.java,Java,,239,66,77,382
/jdk1.3.1_20/javax/swing/plaf/basic/BasicCheckBoxMenuItemUI.java,Java,,41,16,12,69
/jdk1.3.1_20/javax/swing/plaf/basic/BasicCheckBoxUI.java,Java,,16,10,20,46
/jdk1.3.1_20/javax/swing/plaf/basic/BasicColorChooserUI.java,Java,,150,56,16,222
/jdk1.3.1_20/javax/swing/plaf/basic/BasicComboBoxEditor.java,Java,,46,15,28,89
/jdk1.3.1_20/javax/swing/plaf/basic/BasicComboBoxRenderer.java,Java,,62,19,37,118
/jdk1.3.1_20/javax/swing/plaf/basic/BasicComboBoxUI.java,Java,,895,181,322,1398
/jdk1.3.1_20/javax/swing/plaf/basic/BasicComboPopup.java,Java,,548,120,242,910
/jdk1.3.1_20/javax/swing/plaf/basic/BasicDesktopIconUI.java,Java,,174,45,24,243
/jdk1.3.1_20/javax/swing/plaf/basic/BasicDesktopPaneUI.java,Java,,450,49,87,586
/jdk1.3.1_20/javax/swing/plaf/basic/BasicDirectoryModel.java,Java,,236,52,56,344
/jdk1.3.1_20/javax/swing/plaf/basic/BasicEditorPaneUI.java,Java,,75,15,54,144
/jdk1.3.1_20/javax/swing/plaf/basic/BasicFileChooserUI.java,Java,,525,127,56,708
/jdk1.3.1_20/javax/swing/plaf/basic/BasicGraphicsUtils.java,Java,,190,63,43,296
/jdk1.3.1_20/javax/swing/plaf/basic/BasicHTML.java,Java,,190,46,253,489
/jdk1.3.1_20/javax/swing/plaf/basic/BasicIconFactory.java,Java,,151,33,18,202
/jdk1.3.1_20/javax/swing/plaf/basic/BasicInternalFrameTitlePane.java,Java,,420,92,78,590
/jdk1.3.1_20/javax/swing/plaf/basic/BasicInternalFrameUI.java,Java,,904,186,174,1264
/jdk1.3.1_20/javax/swing/plaf/basic/BasicLabelUI.java,Java,,284,54,106,444
/jdk1.3.1_20/javax/swing/plaf/basic/BasicListUI.java,Java,,753,200,480,1433
/jdk1.3.1_20/javax/swing/plaf/basic/BasicLookAndFeel.java,Java,,972,134,92,1198
/jdk1.3.1_20/javax/swing/plaf/basic/BasicMenuBarUI.java,Java,,201,41,21,263
/jdk1.3.1_20/javax/swing/plaf/basic/BasicMenuItemUI.java,Java,,753,128,129,1010
/jdk1.3.1_20/javax/swing/plaf/basic/BasicMenuUI.java,Java,,687,84,52,823
/jdk1.3.1_20/javax/swing/plaf/basic/BasicOptionPaneUI.java,Java,,723,144,202,1069
/jdk1.3.1_20/javax/swing/plaf/basic/BasicPanelUI.java,Java,,34,11,11,56
/jdk1.3.1_20/javax/swing/plaf/basic/BasicPasswordFieldUI.java,Java,,17,12,33,62
/jdk1.3.1_20/javax/swing/plaf/basic/BasicPopupMenuSeparatorUI.java,Java,,27,9,11,47
/jdk1.3.1_20/javax/swing/plaf/basic/BasicPopupMenuUI.java,Java,,587,99,57,743
/jdk1.3.1_20/javax/swing/plaf/basic/BasicProgressBarUI.java,Java,,280,53,113,446
/jdk1.3.1_20/javax/swing/plaf/basic/BasicRadioButtonMenuItemUI.java,Java,,42,14,11,67
/jdk1.3.1_20/javax/swing/plaf/basic/BasicRadioButtonUI.java,Java,,162,41,44,247
/jdk1.3.1_20/javax/swing/plaf/basic/BasicRootPaneUI.java,Java,,113,25,22,160
/jdk1.3.1_20/javax/swing/plaf/basic/BasicScrollBarUI.java,Java,,731,179,205,1115
/jdk1.3.1_20/javax/swing/plaf/basic/BasicScrollPaneUI.java,Java,,424,93,65,582
/jdk1.3.1_20/javax/swing/plaf/basic/BasicSeparatorUI.java,Java,,68,22,12,102
/jdk1.3.1_20/javax/swing/plaf/basic/BasicSliderUI.java,Java,,1245,243,133,1621
/jdk1.3.1_20/javax/swing/plaf/basic/BasicSplitPaneDivider.java,Java,,563,140,255,958
/jdk1.3.1_20/javax/swing/plaf/basic/BasicSplitPaneUI.java,Java,,1170,264,633,2067
/jdk1.3.1_20/javax/swing/plaf/basic/BasicTabbedPaneUI.java,Java,,1495,238,194,1927
/jdk1.3.1_20/javax/swing/plaf/basic/BasicTableHeaderUI.java,Java,,284,72,95,451
/jdk1.3.1_20/javax/swing/plaf/basic/BasicTableUI.java,Java,,689,148,159,996
/jdk1.3.1_20/javax/swing/plaf/basic/BasicTextAreaUI.java,Java,,162,31,99,292
/jdk1.3.1_20/javax/swing/plaf/basic/BasicTextFieldUI.java,Java,,173,30,176,379
/jdk1.3.1_20/javax/swing/plaf/basic/BasicTextPaneUI.java,Java,,55,9,54,118
/jdk1.3.1_20/javax/swing/plaf/basic/BasicTextUI.java,Java,,806,156,854,1816
/jdk1.3.1_20/javax/swing/plaf/basic/BasicToggleButtonUI.java,Java,,117,36,26,179
/jdk1.3.1_20/javax/swing/plaf/basic/BasicToolBarSeparatorUI.java,Java,,49,16,12,77
/jdk1.3.1_20/javax/swing/plaf/basic/BasicToolBarUI.java,Java,,666,129,80,875
/jdk1.3.1_20/javax/swing/plaf/basic/BasicToolTipUI.java,Java,,131,26,22,179
/jdk1.3.1_20/javax/swing/plaf/basic/BasicTreeUI.java,Java,,2324,454,668,3446
/jdk1.3.1_20/javax/swing/plaf/basic/BasicViewportUI.java,Java,,31,11,11,53
/jdk1.3.1_20/javax/swing/plaf/basic/CenterLayout.java,Java,,41,9,10,60
/jdk1.3.1_20/javax/swing/plaf/basic/ComboPopup.java,Java,,15,11,44,70
/jdk1.3.1_20/javax/swing/plaf/basic/DefaultMenuLayout.java,Java,,9,5,13,27
/jdk1.3.1_20/javax/swing/plaf/BorderUIResource.java,Java,,152,43,29,224
/jdk1.3.1_20/javax/swing/plaf/ButtonUI.java,Java,,5,3,10,18
/jdk1.3.1_20/javax/swing/plaf/ColorChooserUI.java,Java,,6,6,11,23
/jdk1.3.1_20/javax/swing/plaf/ColorUIResource.java,Java,,18,7,20,45
/jdk1.3.1_20/javax/swing/plaf/ComboBoxUI.java,Java,,7,6,20,33
/jdk1.3.1_20/javax/swing/plaf/ComponentInputMapUIResource.java,Java,,8,4,11,23
/jdk1.3.1_20/javax/swing/plaf/ComponentUI.java,Java,,45,16,33,94
/jdk1.3.1_20/javax/swing/plaf/DesktopIconUI.java,Java,,3,4,10,17
/jdk1.3.1_20/javax/swing/plaf/DesktopPaneUI.java,Java,,3,4,10,17
/jdk1.3.1_20/javax/swing/plaf/DimensionUIResource.java,Java,,9,4,21,34
/jdk1.3.1_20/javax/swing/plaf/FileChooserUI.java,Java,,14,7,10,31
/jdk1.3.1_20/javax/swing/plaf/FontUIResource.java,Java,,12,5,21,38
/jdk1.3.1_20/javax/swing/plaf/IconUIResource.java,Java,,25,8,29,62
/jdk1.3.1_20/javax/swing/plaf/InputMapUIResource.java,Java,,6,4,11,21
/jdk1.3.1_20/javax/swing/plaf/InsetsUIResource.java,Java,,9,4,21,34
/jdk1.3.1_20/javax/swing/plaf/InternalFrameUI.java,Java,,3,3,10,16
/jdk1.3.1_20/javax/swing/plaf/LabelUI.java,Java,,3,2,10,15
/jdk1.3.1_20/javax/swing/plaf/ListUI.java,Java,,10,9,35,54
/jdk1.3.1_20/javax/swing/plaf/MenuBarUI.java,Java,,5,5,11,21
/jdk1.3.1_20/javax/swing/plaf/MenuItemUI.java,Java,,5,3,12,20
/jdk1.3.1_20/javax/swing/plaf/metal/DefaultMetalTheme.java,Java,,84,17,26,127
/jdk1.3.1_20/javax/swing/plaf/metal/MetalBorders.java,Java,,373,120,56,549
/jdk1.3.1_20/javax/swing/plaf/metal/MetalBumps.java,Java,,155,40,12,207
/jdk1.3.1_20/javax/swing/plaf/metal/MetalButtonUI.java,Java,,95,30,37,162
/jdk1.3.1_20/javax/swing/plaf/metal/MetalCheckBoxIcon.java,Java,,55,14,17,86
/jdk1.3.1_20/javax/swing/plaf/metal/MetalCheckBoxUI.java,Java,,29,14,27,70
/jdk1.3.1_20/javax/swing/plaf/metal/MetalComboBoxButton.java,Java,,123,27,22,172
/jdk1.3.1_20/javax/swing/plaf/metal/MetalComboBoxEditor.java,Java,,42,13,32,87
/jdk1.3.1_20/javax/swing/plaf/metal/MetalComboBoxIcon.java,Java,,24,11,20,55
/jdk1.3.1_20/javax/swing/plaf/metal/MetalComboBoxUI.java,Java,,273,53,42,368
/jdk1.3.1_20/javax/swing/plaf/metal/MetalDesktopIconUI.java,Java,,67,19,10,96
/jdk1.3.1_20/javax/swing/plaf/metal/MetalFileChooserUI.java,Java,,768,184,111,1063
/jdk1.3.1_20/javax/swing/plaf/metal/MetalIconFactory.java,Java,,1467,326,254,2047
/jdk1.3.1_20/javax/swing/plaf/metal/MetalInternalFrameTitlePane.java,Java,,267,62,31,360
/jdk1.3.1_20/javax/swing/plaf/metal/MetalInternalFrameUI.java,Java,,132,33,13,178
/jdk1.3.1_20/javax/swing/plaf/metal/MetalLabelUI.java,Java,,23,10,19,52
/jdk1.3.1_20/javax/swing/plaf/metal/MetalLookAndFeel.java,Java,,934,101,71,1106
/jdk1.3.1_20/javax/swing/plaf/metal/MetalPopupMenuSeparatorUI.java,Java,,29,13,11,53
/jdk1.3.1_20/javax/swing/plaf/metal/MetalProgressBarUI.java,Java,,58,11,36,105
/jdk1.3.1_20/javax/swing/plaf/metal/MetalRadioButtonUI.java,Java,,124,32,36,192
/jdk1.3.1_20/javax/swing/plaf/metal/MetalScrollBarUI.java,Java,,282,134,33,449
/jdk1.3.1_20/javax/swing/plaf/metal/MetalScrollButton.java,Java,,236,57,41,334
/jdk1.3.1_20/javax/swing/plaf/metal/MetalScrollPaneUI.java,Java,,54,19,17,90
/jdk1.3.1_20/javax/swing/plaf/metal/MetalSeparatorUI.java,Java,,45,15,18,78
/jdk1.3.1_20/javax/swing/plaf/metal/MetalSliderUI.java,Java,,256,56,36,348
/jdk1.3.1_20/javax/swing/plaf/metal/MetalSplitPaneDivider.java,Java,,255,38,79,372
/jdk1.3.1_20/javax/swing/plaf/metal/MetalSplitPaneUI.java,Java,,13,6,23,42
/jdk1.3.1_20/javax/swing/plaf/metal/MetalTabbedPaneUI.java,Java,,637,157,145,939
/jdk1.3.1_20/javax/swing/plaf/metal/MetalTextFieldUI.java,Java,,37,8,17,62
/jdk1.3.1_20/javax/swing/plaf/metal/MetalTheme.java,Java,,57,18,12,87
/jdk1.3.1_20/javax/swing/plaf/metal/MetalToggleButtonUI.java,Java,,86,24,34,144
/jdk1.3.1_20/javax/swing/plaf/metal/MetalToolBarUI.java,Java,,297,76,15,388
/jdk1.3.1_20/javax/swing/plaf/metal/MetalToolTipUI.java,Java,,99,24,26,149
/jdk1.3.1_20/javax/swing/plaf/metal/MetalTreeUI.java,Java,,127,40,36,203
/jdk1.3.1_20/javax/swing/plaf/metal/MetalUtils.java,Java,,76,21,35,132
/jdk1.3.1_20/javax/swing/plaf/multi/MultiButtonUI.java,Java,,88,18,79,185
/jdk1.3.1_20/javax/swing/plaf/multi/MultiColorChooserUI.java,Java,,88,18,79,185
/jdk1.3.1_20/javax/swing/plaf/multi/MultiComboBoxUI.java,Java,,110,21,92,223
/jdk1.3.1_20/javax/swing/plaf/multi/MultiDesktopIconUI.java,Java,,88,18,79,185
/jdk1.3.1_20/javax/swing/plaf/multi/MultiDesktopPaneUI.java,Java,,88,18,79,185
/jdk1.3.1_20/javax/swing/plaf/multi/MultiFileChooserUI.java,Java,,135,24,105,264
/jdk1.3.1_20/javax/swing/plaf/multi/MultiInternalFrameUI.java,Java,,88,18,79,185
/jdk1.3.1_20/javax/swing/plaf/multi/MultiLabelUI.java,Java,,88,18,79,185
/jdk1.3.1_20/javax/swing/plaf/multi/MultiListUI.java,Java,,115,21,94,230
/jdk1.3.1_20/javax/swing/plaf/multi/MultiLookAndFeel.java,Java,,117,16,44,177
/jdk1.3.1_20/javax/swing/plaf/multi/MultiMenuBarUI.java,Java,,88,18,79,185
/jdk1.3.1_20/javax/swing/plaf/multi/MultiMenuItemUI.java,Java,,89,19,82,190
/jdk1.3.1_20/javax/swing/plaf/multi/MultiOptionPaneUI.java,Java,,102,20,87,209
/jdk1.3.1_20/javax/swing/plaf/multi/MultiPanelUI.java,Java,,88,18,79,185
/jdk1.3.1_20/javax/swing/plaf/multi/MultiPopupMenuUI.java,Java,,88,18,79,185
/jdk1.3.1_20/javax/swing/plaf/multi/MultiProgressBarUI.java,Java,,88,18,79,185
/jdk1.3.1_20/javax/swing/plaf/multi/MultiScrollBarUI.java,Java,,88,18,79,185
/jdk1.3.1_20/javax/swing/plaf/multi/MultiScrollPaneUI.java,Java,,88,18,79,185
/jdk1.3.1_20/javax/swing/plaf/multi/MultiSeparatorUI.java,Java,,88,18,79,185
/jdk1.3.1_20/javax/swing/plaf/multi/MultiSliderUI.java,Java,,88,18,79,185
/jdk1.3.1_20/javax/swing/plaf/multi/MultiSplitPaneUI.java,Java,,128,24,103,255
/jdk1.3.1_20/javax/swing/plaf/multi/MultiTabbedPaneUI.java,Java,,114,21,94,229
/jdk1.3.1_20/javax/swing/plaf/multi/MultiTableHeaderUI.java,Java,,88,18,79,185
/jdk1.3.1_20/javax/swing/plaf/multi/MultiTableUI.java,Java,,88,18,79,185
/jdk1.3.1_20/javax/swing/plaf/multi/MultiTextUI.java,Java,,171,26,149,346
/jdk1.3.1_20/javax/swing/plaf/multi/MultiToolBarUI.java,Java,,88,18,79,185
/jdk1.3.1_20/javax/swing/plaf/multi/MultiToolTipUI.java,Java,,88,18,79,185
/jdk1.3.1_20/javax/swing/plaf/multi/MultiTreeUI.java,Java,,165,28,125,318
/jdk1.3.1_20/javax/swing/plaf/multi/MultiViewportUI.java,Java,,88,18,79,185
/jdk1.3.1_20/javax/swing/plaf/OptionPaneUI.java,Java,,7,5,18,30
/jdk1.3.1_20/javax/swing/plaf/PanelUI.java,Java,,3,4,10,17
/jdk1.3.1_20/javax/swing/plaf/PopupMenuUI.java,Java,,8,5,11,24
/jdk1.3.1_20/javax/swing/plaf/ProgressBarUI.java,Java,,3,3,10,16
/jdk1.3.1_20/javax/swing/plaf/RootPaneUI.java,Java,,3,2,10,15
/jdk1.3.1_20/javax/swing/plaf/ScrollBarUI.java,Java,,3,2,10,15
/jdk1.3.1_20/javax/swing/plaf/ScrollPaneUI.java,Java,,3,4,10,17
/jdk1.3.1_20/javax/swing/plaf/SeparatorUI.java,Java,,3,4,11,18
/jdk1.3.1_20/javax/swing/plaf/SliderUI.java,Java,,3,3,10,16
/jdk1.3.1_20/javax/swing/plaf/SplitPaneUI.java,Java,,12,8,30,50
/jdk1.3.1_20/javax/swing/plaf/TabbedPaneUI.java,Java,,8,3,11,22
/jdk1.3.1_20/javax/swing/plaf/TableHeaderUI.java,Java,,3,2,10,15
/jdk1.3.1_20/javax/swing/plaf/TableUI.java,Java,,3,2,10,15
/jdk1.3.1_20/javax/swing/plaf/TextUI.java,Java,,25,12,98,135
/jdk1.3.1_20/javax/swing/plaf/ToolBarUI.java,Java,,5,5,10,20
/jdk1.3.1_20/javax/swing/plaf/ToolTipUI.java,Java,,3,2,10,15
/jdk1.3.1_20/javax/swing/plaf/TreeUI.java,Java,,18,12,56,86
/jdk1.3.1_20/javax/swing/plaf/UIResource.java,Java,,3,4,41,48
/jdk1.3.1_20/javax/swing/plaf/ViewportUI.java,Java,,3,4,10,17
/jdk1.3.1_20/javax/swing/Popup.java,Java,,15,7,9,31
/jdk1.3.1_20/javax/swing/PopupFactory.java,Java,,14,8,5,27
/jdk1.3.1_20/javax/swing/ProgressMonitor.java,Java,,199,51,145,395
/jdk1.3.1_20/javax/swing/ProgressMonitorInputStream.java,Java,,73,25,71,169
/jdk1.3.1_20/javax/swing/Renderer.java,Java,,6,3,23,32
/jdk1.3.1_20/javax/swing/RepaintManager.java,Java,,334,88,175,597
/jdk1.3.1_20/javax/swing/RootPaneContainer.java,Java,,13,18,106,137
/jdk1.3.1_20/javax/swing/Scrollable.java,Java,,11,11,84,106
/jdk1.3.1_20/javax/swing/ScrollPaneConstants.java,Java,,25,8,66,99
/jdk1.3.1_20/javax/swing/ScrollPaneLayout.java,Java,,504,136,387,1027
/jdk1.3.1_20/javax/swing/SingleSelectionModel.java,Java,,10,8,40,58
/jdk1.3.1_20/javax/swing/SizeRequirements.java,Java,,131,25,193,349
/jdk1.3.1_20/javax/swing/SizeSequence.java,Java,,126,22,192,340
/jdk1.3.1_20/javax/swing/SwingConstants.java,Java,,20,7,79,106
/jdk1.3.1_20/javax/swing/SwingGraphics.java,Java,,449,86,46,581
/jdk1.3.1_20/javax/swing/SwingUtilities.java,Java,,920,150,486,1556
/jdk1.3.1_20/javax/swing/SystemEventQueueUtilities.java,Java,,449,91,275,815
/jdk1.3.1_20/javax/swing/table/AbstractTableModel.java,Java,,70,23,181,274
/jdk1.3.1_20/javax/swing/table/DefaultTableCellRenderer.java,Java,,86,35,148,269
/jdk1.3.1_20/javax/swing/table/DefaultTableColumnModel.java,Java,,264,71,329,664
/jdk1.3.1_20/javax/swing/table/DefaultTableModel.java,Java,,228,74,412,714
/jdk1.3.1_20/javax/swing/table/JTableHeader.java,Java,,763,152,491,1406
/jdk1.3.1_20/javax/swing/table/TableCellEditor.java,Java,,9,7,38,54
/jdk1.3.1_20/javax/swing/table/TableCellRenderer.java,Java,,8,5,36,49
/jdk1.3.1_20/javax/swing/table/TableColumn.java,Java,,216,74,456,746
/jdk1.3.1_20/javax/swing/table/TableColumnModel.java,Java,,27,26,154,207
/jdk1.3.1_20/javax/swing/table/TableModel.java,Java,,15,13,97,125
/jdk1.3.1_20/javax/swing/text/AbstractDocument.java,Java,,1137,277,1337,2751
/jdk1.3.1_20/javax/swing/text/AbstractWriter.java,Java,,328,53,314,695
/jdk1.3.1_20/javax/swing/text/AsyncBoxView.java,Java,,610,104,588,1302
/jdk1.3.1_20/javax/swing/text/AttributeSet.java,Java,,23,18,118,159
/jdk1.3.1_20/javax/swing/text/BadLocationException.java,Java,,12,3,29,44
/jdk1.3.1_20/javax/swing/text/Bidi.java,Java,,740,130,193,1063
/jdk1.3.1_20/javax/swing/text/BoxView.java,Java,,517,58,352,927
/jdk1.3.1_20/javax/swing/text/Caret.java,Java,,24,21,138,183
/jdk1.3.1_20/javax/swing/text/ChangedCharSetException.java,Java,,16,7,11,34
/jdk1.3.1_20/javax/swing/text/ComponentView.java,Java,,194,31,172,397
/jdk1.3.1_20/javax/swing/text/CompositeView.java,Java,,427,48,354,829
/jdk1.3.1_20/javax/swing/text/DefaultCaret.java,Java,,586,102,520,1208
/jdk1.3.1_20/javax/swing/text/DefaultEditorKit.java,Java,,992,197,830,2019
/jdk1.3.1_20/javax/swing/text/DefaultHighlighter.java,Java,,294,43,154,491
/jdk1.3.1_20/javax/swing/text/DefaultStyledDocument.java,Java,,1429,197,784,2410
/jdk1.3.1_20/javax/swing/text/DefaultTextUI.java,Java,,4,5,13,22
/jdk1.3.1_20/javax/swing/text/Document.java,Java,,23,23,370,416
/jdk1.3.1_20/javax/swing/text/EditorKit.java,Java,,34,16,139,189
/jdk1.3.1_20/javax/swing/text/Element.java,Java,,13,14,79,106
/jdk1.3.1_20/javax/swing/text/ElementIterator.java,Java,,167,42,153,362
/jdk1.3.1_20/javax/swing/text/FieldView.java,Java,,136,19,124,279
/jdk1.3.1_20/javax/swing/text/FlowView.java,Java,,327,59,387,773
/jdk1.3.1_20/javax/swing/text/GapContent.java,Java,,511,93,294,898
/jdk1.3.1_20/javax/swing/text/GapVector.java,Java,,117,32,123,272
/jdk1.3.1_20/javax/swing/text/GlyphPainter1.java,Java,,100,20,79,199
/jdk1.3.1_20/javax/swing/text/GlyphPainter2.java,Java,,203,28,120,351
/jdk1.3.1_20/javax/swing/text/GlyphView.java,Java,,487,75,476,1038
/jdk1.3.1_20/javax/swing/text/Highlighter.java,Java,,22,20,92,134
/jdk1.3.1_20/javax/swing/text/html/BlockView.java,Java,,164,30,143,337
/jdk1.3.1_20/javax/swing/text/html/BRView.java,Java,,17,5,20,42
/jdk1.3.1_20/javax/swing/text/html/CommentView.java,Java,,87,13,17,117
/jdk1.3.1_20/javax/swing/text/html/CSS.java,Java,,1957,300,753,3010
/jdk1.3.1_20/javax/swing/text/html/CSSParser.java,Java,,583,77,171,831
/jdk1.3.1_20/javax/swing/text/html/EditableView.java,Java,,63,11,28,102
/jdk1.3.1_20/javax/swing/text/html/FormView.java,Java,,297,49,184,530
/jdk1.3.1_20/javax/swing/text/html/FrameSetView.java,Java,,178,33,104,315
/jdk1.3.1_20/javax/swing/text/html/FrameView.java,Java,,211,43,109,363
/jdk1.3.1_20/javax/swing/text/html/HiddenTagView.java,Java,,252,39,49,340
/jdk1.3.1_20/javax/swing/text/html/HRuleView.java,Java,,167,25,92,284
/jdk1.3.1_20/javax/swing/text/html/HTML.java,Java,,384,44,115,543
/jdk1.3.1_20/javax/swing/text/html/HTMLDocument.java,Java,,2136,306,1302,3744
/jdk1.3.1_20/javax/swing/text/html/HTMLEditorKit.java,Java,,972,127,674,1773
/jdk1.3.1_20/javax/swing/text/html/HTMLFrameHyperlinkEvent.java,Java,,38,12,58,108
/jdk1.3.1_20/javax/swing/text/html/HTMLWriter.java,Java,,766,102,323,1191
/jdk1.3.1_20/javax/swing/text/html/ImageView.java,Java,,479,82,186,747
/jdk1.3.1_20/javax/swing/text/html/InlineView.java,Java,,87,14,78,179
/jdk1.3.1_20/javax/swing/text/html/IsindexView.java,Java,,52,15,29,96
/jdk1.3.1_20/javax/swing/text/html/LineView.java,Java,,62,11,92,165
/jdk1.3.1_20/javax/swing/text/html/ListView.java,Java,,53,8,42,103
/jdk1.3.1_20/javax/swing/text/html/Map.java,Java,,341,47,88,476
/jdk1.3.1_20/javax/swing/text/html/MinimalHTMLWriter.java,Java,,348,82,277,707
/jdk1.3.1_20/javax/swing/text/html/NoFramesView.java,Java,,57,15,80,152
/jdk1.3.1_20/javax/swing/text/html/ObjectView.java,Java,,74,11,80,165
/jdk1.3.1_20/javax/swing/text/html/Option.java,Java,,38,12,44,94
/jdk1.3.1_20/javax/swing/text/html/OptionComboBoxModel.java,Java,,13,7,24,44
/jdk1.3.1_20/javax/swing/text/html/OptionListModel.java,Java,,301,73,166,540
/jdk1.3.1_20/javax/swing/text/html/ParagraphView.java,Java,,131,21,106,258
/jdk1.3.1_20/javax/swing/text/html/parser/AttributeList.java,Java,,83,19,51,153
/jdk1.3.1_20/javax/swing/text/html/parser/ContentModel.java,Java,,144,26,55,225
/jdk1.3.1_20/javax/swing/text/html/parser/ContentModelState.java,Java,,169,27,59,255
/jdk1.3.1_20/javax/swing/text/html/parser/DocumentParser.java,Java,,141,20,91,252
/jdk1.3.1_20/javax/swing/text/html/parser/DTD.java,Java,,251,33,85,369
/jdk1.3.1_20/javax/swing/text/html/parser/DTDConstants.java,Java,,39,6,18,63
/jdk1.3.1_20/javax/swing/text/html/parser/Element.java,Java,,79,22,55,156
/jdk1.3.1_20/javax/swing/text/html/parser/Entity.java,Java,,53,15,33,101
/jdk1.3.1_20/javax/swing/text/html/parser/Parser.java,Java,,1433,231,403,2067
/jdk1.3.1_20/javax/swing/text/html/parser/ParserDelegator.java,Java,,70,15,26,111
/jdk1.3.1_20/javax/swing/text/html/parser/ResourceLoader.java,Java,,16,7,18,41
/jdk1.3.1_20/javax/swing/text/html/parser/TagElement.java,Java,,33,15,11,59
/jdk1.3.1_20/javax/swing/text/html/parser/TagStack.java,Java,,123,29,51,203
/jdk1.3.1_20/javax/swing/text/html/ResourceLoader.java,Java,,16,7,18,41
/jdk1.3.1_20/javax/swing/text/html/StyleSheet.java,Java,,2054,230,1006,3290
/jdk1.3.1_20/javax/swing/text/html/TableView.java,Java,,892,151,588,1631
/jdk1.3.1_20/javax/swing/text/html/TextAreaDocument.java,Java,,20,12,21,53
/jdk1.3.1_20/javax/swing/text/IconView.java,Java,,58,13,90,161
/jdk1.3.1_20/javax/swing/text/JTextComponent.java,Java,,1498,252,1289,3039
/jdk1.3.1_20/javax/swing/text/Keymap.java,Java,,18,16,92,126
/jdk1.3.1_20/javax/swing/text/LabelView.java,Java,,89,24,88,201
/jdk1.3.1_20/javax/swing/text/LayeredHighlighter.java,Java,,14,4,26,44
/jdk1.3.1_20/javax/swing/text/LayoutQueue.java,Java,,54,15,33,102
/jdk1.3.1_20/javax/swing/text/MutableAttributeSet.java,Java,,10,20,53,83
/jdk1.3.1_20/javax/swing/text/ParagraphView.java,Java,,414,52,311,777
/jdk1.3.1_20/javax/swing/text/PasswordView.java,Java,,89,11,82,182
/jdk1.3.1_20/javax/swing/text/PlainDocument.java,Java,,152,15,94,261
/jdk1.3.1_20/javax/swing/text/PlainView.java,Java,,336,43,225,604
/jdk1.3.1_20/javax/swing/text/Position.java,Java,,15,8,37,60
/jdk1.3.1_20/javax/swing/text/RLEUtilities.java,Java,,110,25,66,201
/jdk1.3.1_20/javax/swing/text/rtf/AbstractFilter.java,Java,,108,27,75,210
/jdk1.3.1_20/javax/swing/text/rtf/Constants.java,Java,,28,10,20,58
/jdk1.3.1_20/javax/swing/text/rtf/MockAttributeSet.java,Java,,78,22,6,106
/jdk1.3.1_20/javax/swing/text/rtf/RTFAttribute.java,Java,,26,7,14,47
/jdk1.3.1_20/javax/swing/text/rtf/RTFAttributes.java,Java,,324,64,14,402
/jdk1.3.1_20/javax/swing/text/rtf/RTFEditorKit.java,Java,,46,14,87,147
/jdk1.3.1_20/javax/swing/text/rtf/RTFGenerator.java,Java,,764,130,95,989
/jdk1.3.1_20/javax/swing/text/rtf/RTFParser.java,Java,,228,35,51,314
/jdk1.3.1_20/javax/swing/text/rtf/RTFReader.java,Java,,1115,227,281,1623
/jdk1.3.1_20/javax/swing/text/Segment.java,Java,,90,24,107,221
/jdk1.3.1_20/javax/swing/text/SimpleAttributeSet.java,Java,,183,33,149,365
/jdk1.3.1_20/javax/swing/text/StateInvariantError.java,Java,,7,2,17,26
/jdk1.3.1_20/javax/swing/text/StringContent.java,Java,,264,40,167,471
/jdk1.3.1_20/javax/swing/text/Style.java,Java,,11,10,34,55
/jdk1.3.1_20/javax/swing/text/StyleConstants.java,Java,,308,131,548,987
/jdk1.3.1_20/javax/swing/text/StyleContext.java,Java,,714,143,720,1577
/jdk1.3.1_20/javax/swing/text/StyledDocument.java,Java,,17,16,125,158
/jdk1.3.1_20/javax/swing/text/StyledEditorKit.java,Java,,338,64,372,774
/jdk1.3.1_20/javax/swing/text/TabableView.java,Java,,5,4,43,52
/jdk1.3.1_20/javax/swing/text/TabExpander.java,Java,,4,4,20,28
/jdk1.3.1_20/javax/swing/text/TableView.java,Java,,425,75,392,892
/jdk1.3.1_20/javax/swing/text/TabSet.java,Java,,66,15,50,131
/jdk1.3.1_20/javax/swing/text/TabStop.java,Java,,76,15,62,153
/jdk1.3.1_20/javax/swing/text/TextAction.java,Java,,43,7,64,114
/jdk1.3.1_20/javax/swing/text/TextLayoutStrategy.java,Java,,292,51,190,533
/jdk1.3.1_20/javax/swing/text/Utilities.java,Java,,409,42,223,674
/jdk1.3.1_20/javax/swing/text/View.java,Java,,339,62,826,1227
/jdk1.3.1_20/javax/swing/text/ViewFactory.java,Java,,5,4,20,29
/jdk1.3.1_20/javax/swing/text/WrappedPlainView.java,Java,,361,57,307,725
/jdk1.3.1_20/javax/swing/text/ZoneView.java,Java,,263,49,382,694
/jdk1.3.1_20/javax/swing/Timer.java,Java,,127,62,151,340
/jdk1.3.1_20/javax/swing/TimerQueue.java,Java,,171,60,38,269
/jdk1.3.1_20/javax/swing/ToolTipManager.java,Java,,446,69,157,672
/jdk1.3.1_20/javax/swing/tree/AbstractLayoutCache.java,Java,,140,56,235,431
/jdk1.3.1_20/javax/swing/tree/DefaultMutableTreeNode.java,Java,,646,227,612,1485
/jdk1.3.1_20/javax/swing/tree/DefaultTreeCellEditor.java,Java,,317,85,208,610
/jdk1.3.1_20/javax/swing/tree/DefaultTreeCellRenderer.java,Java,,214,63,214,491
/jdk1.3.1_20/javax/swing/tree/DefaultTreeModel.java,Java,,247,55,260,562
/jdk1.3.1_20/javax/swing/tree/DefaultTreeSelectionModel.java,Java,,688,117,331,1136
/jdk1.3.1_20/javax/swing/tree/ExpandVetoException.java,Java,,12,6,26,44
/jdk1.3.1_20/javax/swing/tree/FixedHeightLayoutCache.java,Java,,950,182,426,1558
/jdk1.3.1_20/javax/swing/tree/MutableTreeNode.java,Java,,10,8,36,54
/jdk1.3.1_20/javax/swing/tree/RowMapper.java,Java,,6,3,18,27
/jdk1.3.1_20/javax/swing/tree/TreeCellEditor.java,Java,,10,4,32,46
/jdk1.3.1_20/javax/swing/tree/TreeCellRenderer.java,Java,,8,4,29,41
/jdk1.3.1_20/javax/swing/tree/TreeModel.java,Java,,13,15,76,104
/jdk1.3.1_20/javax/swing/tree/TreeNode.java,Java,,12,10,44,66
/jdk1.3.1_20/javax/swing/tree/TreePath.java,Java,,138,33,143,314
/jdk1.3.1_20/javax/swing/tree/TreeSelectionModel.java,Java,,36,33,223,292
/jdk1.3.1_20/javax/swing/tree/VariableHeightLayoutCache.java,Java,,1043,191,462,1696
/jdk1.3.1_20/javax/swing/UIDefaults.java,Java,,319,58,391,768
/jdk1.3.1_20/javax/swing/UIManager.java,Java,,452,118,378,948
/jdk1.3.1_20/javax/swing/undo/AbstractUndoableEdit.java,Java,,73,24,114,211
/jdk1.3.1_20/javax/swing/undo/CannotRedoException.java,Java,,3,2,17,22
/jdk1.3.1_20/javax/swing/undo/CannotUndoException.java,Java,,3,3,17,23
/jdk1.3.1_20/javax/swing/undo/CompoundEdit.java,Java,,110,21,94,225
/jdk1.3.1_20/javax/swing/undo/StateEdit.java,Java,,59,27,88,174
/jdk1.3.1_20/javax/swing/undo/StateEditable.java,Java,,7,8,19,34
/jdk1.3.1_20/javax/swing/undo/UndoableEdit.java,Java,,15,14,83,112
/jdk1.3.1_20/javax/swing/undo/UndoableEditSupport.java,Java,,66,16,65,147
/jdk1.3.1_20/javax/swing/undo/UndoManager.java,Java,,210,44,200,454
/jdk1.3.1_20/javax/swing/UnsupportedLookAndFeelException.java,Java,,7,1,22,30
/jdk1.3.1_20/javax/swing/ViewportLayout.java,Java,,71,19,79,169
/jdk1.3.1_20/javax/swing/WindowConstants.java,Java,,7,6,30,43
/jdk1.3.1_20/launcher/java.c,C/C++/ObjC,,735,91,127,953
/jdk1.3.1_20/launcher/java.h,h,,26,12,16,54
/jdk1.3.1_20/launcher/java_md.c,C/C++/ObjC,,222,41,45,308
/jdk1.3.1_20/launcher/java_md.h,h,,19,8,12,39
/jdk1.3.1_20/org/omg/CORBA/Any.java,Java,,76,91,532,699
/jdk1.3.1_20/org/omg/CORBA/AnyHolder.java,Java,,21,9,55,85
/jdk1.3.1_20/org/omg/CORBA/AnySeqHelper.java,Java,,49,11,10,70
/jdk1.3.1_20/org/omg/CORBA/AnySeqHolder.java,Java,,24,9,10,43
/jdk1.3.1_20/org/omg/CORBA/ARG_IN.java,Java,,4,4,27,35
/jdk1.3.1_20/org/omg/CORBA/ARG_INOUT.java,Java,,4,7,28,39
/jdk1.3.1_20/org/omg/CORBA/ARG_OUT.java,Java,,4,6,27,37
/jdk1.3.1_20/org/omg/CORBA/BAD_CONTEXT.java,Java,,15,7,45,67
/jdk1.3.1_20/org/omg/CORBA/BAD_INV_ORDER.java,Java,,15,8,41,64
/jdk1.3.1_20/org/omg/CORBA/BAD_OPERATION.java,Java,,15,7,41,63
/jdk1.3.1_20/org/omg/CORBA/BAD_PARAM.java,Java,,15,7,45,67
/jdk1.3.1_20/org/omg/CORBA/BAD_POLICY.java,Java,,4,2,14,20
/jdk1.3.1_20/org/omg/CORBA/BAD_POLICY_TYPE.java,Java,,4,2,14,20
/jdk1.3.1_20/org/omg/CORBA/BAD_POLICY_VALUE.java,Java,,4,2,16,22
/jdk1.3.1_20/org/omg/CORBA/BAD_TYPECODE.java,Java,,15,7,42,64
/jdk1.3.1_20/org/omg/CORBA/BooleanHolder.java,Java,,21,9,57,87
/jdk1.3.1_20/org/omg/CORBA/BooleanSeqHelper.java,Java,,47,11,10,68
/jdk1.3.1_20/org/omg/CORBA/BooleanSeqHolder.java,Java,,24,9,10,43
/jdk1.3.1_20/org/omg/CORBA/Bounds.java,Java,,9,5,20,34
/jdk1.3.1_20/org/omg/CORBA/ByteHolder.java,Java,,21,10,57,88
/jdk1.3.1_20/org/omg/CORBA/CharHolder.java,Java,,21,10,58,89
/jdk1.3.1_20/org/omg/CORBA/CharSeqHelper.java,Java,,47,11,10,68
/jdk1.3.1_20/org/omg/CORBA/CharSeqHolder.java,Java,,24,9,10,43
/jdk1.3.1_20/org/omg/CORBA/COMM_FAILURE.java,Java,,15,7,48,70
/jdk1.3.1_20/org/omg/CORBA/CompletionStatus.java,Java,,27,13,83,123
/jdk1.3.1_20/org/omg/CORBA/CompletionStatusHelper.java,Java,,37,10,9,56
/jdk1.3.1_20/org/omg/CORBA/Context.java,Java,,11,19,194,224
/jdk1.3.1_20/org/omg/CORBA/ContextList.java,Java,,7,12,68,87
/jdk1.3.1_20/org/omg/CORBA/CTX_RESTRICT_SCOPE.java,Java,,4,4,26,34
/jdk1.3.1_20/org/omg/CORBA/Current.java,Java,,4,3,10,17
/jdk1.3.1_20/org/omg/CORBA/CurrentHelper.java,Java,,43,11,10,64
/jdk1.3.1_20/org/omg/CORBA/CurrentHolder.java,Java,,24,8,10,42
/jdk1.3.1_20/org/omg/CORBA/CurrentOperations.java,Java,,4,3,10,17
/jdk1.3.1_20/org/omg/CORBA/CustomMarshal.java,Java,,7,3,28,38
/jdk1.3.1_20/org/omg/CORBA/DataInputStream.java,Java,,36,34,256,326
/jdk1.3.1_20/org/omg/CORBA/DataOutputStream.java,Java,,36,34,194,264
/jdk1.3.1_20/org/omg/CORBA/DATA_CONVERSION.java,Java,,15,7,41,63
/jdk1.3.1_20/org/omg/CORBA/DefinitionKind.java,Java,,112,110,246,468
/jdk1.3.1_20/org/omg/CORBA/DefinitionKindHelper.java,Java,,37,10,10,57
/jdk1.3.1_20/org/omg/CORBA/DomainManager.java,Java,,5,4,12,21
/jdk1.3.1_20/org/omg/CORBA/DomainManagerOperations.java,Java,,5,4,15,24
/jdk1.3.1_20/org/omg/CORBA/DoubleHolder.java,Java,,21,12,54,87
/jdk1.3.1_20/org/omg/CORBA/DoubleSeqHelper.java,Java,,47,11,10,68
/jdk1.3.1_20/org/omg/CORBA/DoubleSeqHolder.java,Java,,24,9,10,43
/jdk1.3.1_20/org/omg/CORBA/DynamicImplementation.java,Java,,6,6,25,37
/jdk1.3.1_20/org/omg/CORBA/DynAny.java,Java,,89,68,554,711
/jdk1.3.1_20/org/omg/CORBA/DynAnyPackage/Invalid.java,Java,,10,5,16,31
/jdk1.3.1_20/org/omg/CORBA/DynAnyPackage/InvalidSeq.java,Java,,10,5,17,32
/jdk1.3.1_20/org/omg/CORBA/DynAnyPackage/InvalidValue.java,Java,,10,5,20,35
/jdk1.3.1_20/org/omg/CORBA/DynAnyPackage/TypeMismatch.java,Java,,10,5,17,32
/jdk1.3.1_20/org/omg/CORBA/DynArray.java,Java,,7,6,22,35
/jdk1.3.1_20/org/omg/CORBA/DynEnum.java,Java,,8,7,28,43
/jdk1.3.1_20/org/omg/CORBA/DynFixed.java,Java,,7,5,24,36
/jdk1.3.1_20/org/omg/CORBA/DynSequence.java,Java,,9,7,35,51
/jdk1.3.1_20/org/omg/CORBA/DynStruct.java,Java,,9,7,33,49
/jdk1.3.1_20/org/omg/CORBA/DynUnion.java,Java,,12,11,50,73
/jdk1.3.1_20/org/omg/CORBA/DynValue.java,Java,,8,6,37,51
/jdk1.3.1_20/org/omg/CORBA/Environment.java,Java,,6,10,26,42
/jdk1.3.1_20/org/omg/CORBA/ExceptionList.java,Java,,9,11,71,91
/jdk1.3.1_20/org/omg/CORBA/FieldNameHelper.java,Java,,40,10,9,59
/jdk1.3.1_20/org/omg/CORBA/FixedHolder.java,Java,,21,11,44,76
/jdk1.3.1_20/org/omg/CORBA/FloatHolder.java,Java,,21,9,53,83
/jdk1.3.1_20/org/omg/CORBA/FloatSeqHelper.java,Java,,47,11,10,68
/jdk1.3.1_20/org/omg/CORBA/FloatSeqHolder.java,Java,,24,9,10,43
/jdk1.3.1_20/org/omg/CORBA/FREE_MEM.java,Java,,15,6,40,61
/jdk1.3.1_20/org/omg/CORBA/IdentifierHelper.java,Java,,40,10,10,60
/jdk1.3.1_20/org/omg/CORBA/IDLType.java,Java,,4,6,22,32
/jdk1.3.1_20/org/omg/CORBA/IDLTypeHelper.java,Java,,51,11,10,72
/jdk1.3.1_20/org/omg/CORBA/IDLTypeOperations.java,Java,,5,4,24,33
/jdk1.3.1_20/org/omg/CORBA/IMP_LIMIT.java,Java,,15,7,40,62
/jdk1.3.1_20/org/omg/CORBA/INITIALIZE.java,Java,,15,6,45,66
/jdk1.3.1_20/org/omg/CORBA/Initializer.java,Java,,12,7,61,80
/jdk1.3.1_20/org/omg/CORBA/INTERNAL.java,Java,,15,6,46,67
/jdk1.3.1_20/org/omg/CORBA/INTF_REPOS.java,Java,,15,6,38,59
/jdk1.3.1_20/org/omg/CORBA/IntHolder.java,Java,,21,9,60,90
/jdk1.3.1_20/org/omg/CORBA/INVALID_TRANSACTION.java,Java,,15,6,40,61
/jdk1.3.1_20/org/omg/CORBA/INV_FLAG.java,Java,,15,6,41,62
/jdk1.3.1_20/org/omg/CORBA/INV_IDENT.java,Java,,15,6,41,62
/jdk1.3.1_20/org/omg/CORBA/INV_OBJREF.java,Java,,15,6,44,65
/jdk1.3.1_20/org/omg/CORBA/INV_POLICY.java,Java,,15,6,40,61
/jdk1.3.1_20/org/omg/CORBA/IRObject.java,Java,,5,2,15,22
/jdk1.3.1_20/org/omg/CORBA/IRObjectOperations.java,Java,,6,5,44,55
/jdk1.3.1_20/org/omg/CORBA/LongHolder.java,Java,,21,10,55,86
/jdk1.3.1_20/org/omg/CORBA/LongLongSeqHelper.java,Java,,47,11,10,68
/jdk1.3.1_20/org/omg/CORBA/LongLongSeqHolder.java,Java,,24,9,10,43
/jdk1.3.1_20/org/omg/CORBA/LongSeqHelper.java,Java,,47,11,10,68
/jdk1.3.1_20/org/omg/CORBA/LongSeqHolder.java,Java,,24,9,10,43
/jdk1.3.1_20/org/omg/CORBA/MARSHAL.java,Java,,15,6,40,61
/jdk1.3.1_20/org/omg/CORBA/NamedValue.java,Java,,6,10,90,106
/jdk1.3.1_20/org/omg/CORBA/NameValuePair.java,Java,,10,8,25,43
/jdk1.3.1_20/org/omg/CORBA/NameValuePairHelper.java,Java,,67,10,9,86
/jdk1.3.1_20/org/omg/CORBA/NO_IMPLEMENT.java,Java,,15,6,41,62
/jdk1.3.1_20/org/omg/CORBA/NO_MEMORY.java,Java,,15,7,40,62
/jdk1.3.1_20/org/omg/CORBA/NO_PERMISSION.java,Java,,15,6,39,60
/jdk1.3.1_20/org/omg/CORBA/NO_RESOURCES.java,Java,,15,6,40,61
/jdk1.3.1_20/org/omg/CORBA/NO_RESPONSE.java,Java,,15,6,39,60
/jdk1.3.1_20/org/omg/CORBA/NVList.java,Java,,9,16,135,160
/jdk1.3.1_20/org/omg/CORBA/Object.java,Java,,25,35,202,262
/jdk1.3.1_20/org/omg/CORBA/ObjectHelper.java,Java,,37,9,12,58
/jdk1.3.1_20/org/omg/CORBA/ObjectHolder.java,Java,,21,9,59,89
/jdk1.3.1_20/org/omg/CORBA/OBJECT_NOT_EXIST.java,Java,,15,6,42,63
/jdk1.3.1_20/org/omg/CORBA/OBJ_ADAPTER.java,Java,,15,6,42,63
/jdk1.3.1_20/org/omg/CORBA/OctetSeqHelper.java,Java,,47,11,10,68
/jdk1.3.1_20/org/omg/CORBA/OctetSeqHolder.java,Java,,24,9,10,43
/jdk1.3.1_20/org/omg/CORBA/OMGVMCID.java,Java,,4,5,14,23
/jdk1.3.1_20/org/omg/CORBA/ORB.java,Java,,292,105,792,1189
/jdk1.3.1_20/org/omg/CORBA/ORBPackage/InconsistentTypeCode.java,Java,,10,4,18,32
/jdk1.3.1_20/org/omg/CORBA/ORBPackage/InvalidName.java,Java,,9,4,21,34
/jdk1.3.1_20/org/omg/CORBA/PERSIST_STORE.java,Java,,15,6,38,59
/jdk1.3.1_20/org/omg/CORBA/Policy.java,Java,,4,3,10,17
/jdk1.3.1_20/org/omg/CORBA/PolicyError.java,Java,,15,7,28,50
/jdk1.3.1_20/org/omg/CORBA/PolicyHelper.java,Java,,51,11,10,72
/jdk1.3.1_20/org/omg/CORBA/PolicyHolder.java,Java,,24,8,10,42
/jdk1.3.1_20/org/omg/CORBA/PolicyListHelper.java,Java,,46,10,10,66
/jdk1.3.1_20/org/omg/CORBA/PolicyListHolder.java,Java,,24,9,10,43
/jdk1.3.1_20/org/omg/CORBA/PolicyOperations.java,Java,,7,6,27,40
/jdk1.3.1_20/org/omg/CORBA/PolicyTypeHelper.java,Java,,40,11,11,62
/jdk1.3.1_20/org/omg/CORBA/portable/ApplicationException.java,Java,,16,6,22,44
/jdk1.3.1_20/org/omg/CORBA/portable/BoxedValueHelper.java,Java,,7,2,12,21
/jdk1.3.1_20/org/omg/CORBA/portable/CustomValue.java,Java,,4,6,14,24
/jdk1.3.1_20/org/omg/CORBA/portable/Delegate.java,Java,,86,30,264,380
/jdk1.3.1_20/org/omg/CORBA/portable/IDLEntity.java,Java,,3,3,11,17
/jdk1.3.1_20/org/omg/CORBA/portable/IndirectionException.java,Java,,9,4,37,50
/jdk1.3.1_20/org/omg/CORBA/portable/InputStream.java,Java,,53,12,182,247
/jdk1.3.1_20/org/omg/CORBA/portable/InvokeHandler.java,Java,,6,4,43,53
/jdk1.3.1_20/org/omg/CORBA/portable/ObjectImpl.java,Java,,155,37,322,514
/jdk1.3.1_20/org/omg/CORBA/portable/OutputStream.java,Java,,63,11,190,264
/jdk1.3.1_20/org/omg/CORBA/portable/RemarshalException.java,Java,,6,2,18,26
/jdk1.3.1_20/org/omg/CORBA/portable/ResponseHandler.java,Java,,5,3,26,34
/jdk1.3.1_20/org/omg/CORBA/portable/ServantObject.java,Java,,5,4,20,29
/jdk1.3.1_20/org/omg/CORBA/portable/Streamable.java,Java,,7,4,30,41
/jdk1.3.1_20/org/omg/CORBA/portable/StreamableValue.java,Java,,3,5,15,23
/jdk1.3.1_20/org/omg/CORBA/portable/UnknownException.java,Java,,8,1,31,40
/jdk1.3.1_20/org/omg/CORBA/portable/ValueBase.java,Java,,4,2,27,33
/jdk1.3.1_20/org/omg/CORBA/portable/ValueFactory.java,Java,,5,3,31,39
/jdk1.3.1_20/org/omg/CORBA/Principal.java,Java,,5,6,22,33
/jdk1.3.1_20/org/omg/CORBA/PrincipalHolder.java,Java,,21,11,39,71
/jdk1.3.1_20/org/omg/CORBA/PRIVATE_MEMBER.java,Java,,4,2,20,26
/jdk1.3.1_20/org/omg/CORBA/PUBLIC_MEMBER.java,Java,,4,2,20,26
/jdk1.3.1_20/org/omg/CORBA/Repository.java,Java,,4,1,10,15
/jdk1.3.1_20/org/omg/CORBA/RepositoryIdHelper.java,Java,,40,10,10,60
/jdk1.3.1_20/org/omg/CORBA/Request.java,Java,,25,50,207,282
/jdk1.3.1_20/org/omg/CORBA/ServerRequest.java,Java,,35,19,228,282
/jdk1.3.1_20/org/omg/CORBA/ServiceDetail.java,Java,,11,5,32,48
/jdk1.3.1_20/org/omg/CORBA/ServiceDetailHelper.java,Java,,51,6,5,62
/jdk1.3.1_20/org/omg/CORBA/ServiceInformation.java,Java,,13,7,9,29
/jdk1.3.1_20/org/omg/CORBA/ServiceInformationHelper.java,Java,,59,7,5,71
/jdk1.3.1_20/org/omg/CORBA/ServiceInformationHolder.java,Java,,20,10,58,88
/jdk1.3.1_20/org/omg/CORBA/SetOverrideType.java,Java,,25,10,62,97
/jdk1.3.1_20/org/omg/CORBA/SetOverrideTypeHelper.java,Java,,37,10,9,56
/jdk1.3.1_20/org/omg/CORBA/ShortHolder.java,Java,,21,9,58,88
/jdk1.3.1_20/org/omg/CORBA/ShortSeqHelper.java,Java,,47,11,10,68
/jdk1.3.1_20/org/omg/CORBA/ShortSeqHolder.java,Java,,24,9,10,43
/jdk1.3.1_20/org/omg/CORBA/StringHolder.java,Java,,21,9,57,87
/jdk1.3.1_20/org/omg/CORBA/StringValueHelper.java,Java,,76,15,18,109
/jdk1.3.1_20/org/omg/CORBA/StructMember.java,Java,,12,8,37,57
/jdk1.3.1_20/org/omg/CORBA/StructMemberHelper.java,Java,,74,10,10,94
/jdk1.3.1_20/org/omg/CORBA/SystemException.java,Java,,31,11,39,81
/jdk1.3.1_20/org/omg/CORBA/TCKind.java,Java,,148,79,308,535
/jdk1.3.1_20/org/omg/CORBA/TRANSACTION_REQUIRED.java,Java,,15,6,41,62
/jdk1.3.1_20/org/omg/CORBA/TRANSACTION_ROLLEDBACK.java,Java,,15,6,41,62
/jdk1.3.1_20/org/omg/CORBA/TRANSIENT.java,Java,,15,6,39,60
/jdk1.3.1_20/org/omg/CORBA/TypeCode.java,Java,,44,39,451,534
/jdk1.3.1_20/org/omg/CORBA/TypeCodeHolder.java,Java,,21,9,58,88
/jdk1.3.1_20/org/omg/CORBA/TypeCodePackage/BadKind.java,Java,,9,4,23,36
/jdk1.3.1_20/org/omg/CORBA/TypeCodePackage/Bounds.java,Java,,9,5,22,36
/jdk1.3.1_20/org/omg/CORBA/ULongLongSeqHelper.java,Java,,47,11,10,68
/jdk1.3.1_20/org/omg/CORBA/ULongLongSeqHolder.java,Java,,24,9,10,43
/jdk1.3.1_20/org/omg/CORBA/ULongSeqHelper.java,Java,,47,11,10,68
/jdk1.3.1_20/org/omg/CORBA/ULongSeqHolder.java,Java,,24,9,10,43
/jdk1.3.1_20/org/omg/CORBA/UnionMember.java,Java,,14,9,43,66
/jdk1.3.1_20/org/omg/CORBA/UnionMemberHelper.java,Java,,81,10,10,101
/jdk1.3.1_20/org/omg/CORBA/UNKNOWN.java,Java,,15,6,41,62
/jdk1.3.1_20/org/omg/CORBA/UnknownUserException.java,Java,,11,7,26,44
/jdk1.3.1_20/org/omg/CORBA/UNSUPPORTED_POLICY.java,Java,,4,2,17,23
/jdk1.3.1_20/org/omg/CORBA/UNSUPPORTED_POLICY_VALUE.java,Java,,4,2,18,24
/jdk1.3.1_20/org/omg/CORBA/UserException.java,Java,,9,5,22,36
/jdk1.3.1_20/org/omg/CORBA/UShortSeqHelper.java,Java,,47,11,10,68
/jdk1.3.1_20/org/omg/CORBA/UShortSeqHolder.java,Java,,24,9,10,43
/jdk1.3.1_20/org/omg/CORBA/ValueBaseHelper.java,Java,,37,10,12,59
/jdk1.3.1_20/org/omg/CORBA/ValueBaseHolder.java,Java,,21,10,53,84
/jdk1.3.1_20/org/omg/CORBA/ValueMember.java,Java,,20,12,58,90
/jdk1.3.1_20/org/omg/CORBA/ValueMemberHelper.java,Java,,106,10,10,126
/jdk1.3.1_20/org/omg/CORBA/VersionSpecHelper.java,Java,,40,10,10,60
/jdk1.3.1_20/org/omg/CORBA/VisibilityHelper.java,Java,,40,11,11,62
/jdk1.3.1_20/org/omg/CORBA/VM_ABSTRACT.java,Java,,4,2,4,10
/jdk1.3.1_20/org/omg/CORBA/VM_CUSTOM.java,Java,,4,2,14,20
/jdk1.3.1_20/org/omg/CORBA/VM_NONE.java,Java,,4,4,17,25
/jdk1.3.1_20/org/omg/CORBA/VM_TRUNCATABLE.java,Java,,4,2,16,22
/jdk1.3.1_20/org/omg/CORBA/WCharSeqHelper.java,Java,,47,11,10,68
/jdk1.3.1_20/org/omg/CORBA/WCharSeqHolder.java,Java,,24,9,10,43
/jdk1.3.1_20/org/omg/CORBA/WrongTransaction.java,Java,,9,4,23,36
/jdk1.3.1_20/org/omg/CORBA/WStringValueHelper.java,Java,,76,15,19,110
/jdk1.3.1_20/org/omg/CORBA/_IDLTypeStub.java,Java,,90,13,25,128
/jdk1.3.1_20/org/omg/CORBA/_PolicyStub.java,Java,,89,14,38,141
/jdk1.3.1_20/org/omg/CORBA_2_3/ORB.java,Java,,23,13,38,74
/jdk1.3.1_20/org/omg/CORBA_2_3/portable/Delegate.java,Java,,6,4,27,37
/jdk1.3.1_20/org/omg/CORBA_2_3/portable/InputStream.java,Java,,24,11,58,93
/jdk1.3.1_20/org/omg/CORBA_2_3/portable/ObjectImpl.java,Java,,10,6,26,42
/jdk1.3.1_20/org/omg/CORBA_2_3/portable/OutputStream.java,Java,,18,9,47,74
/jdk1.3.1_20/org/omg/CosNaming/Binding.java,Java,,10,1,12,23
/jdk1.3.1_20/org/omg/CosNaming/BindingHelper.java,Java,,55,3,11,69
/jdk1.3.1_20/org/omg/CosNaming/BindingHolder.java,Java,,20,4,12,36
/jdk1.3.1_20/org/omg/CosNaming/BindingIterator.java,Java,,4,4,17,25
/jdk1.3.1_20/org/omg/CosNaming/BindingIteratorHelper.java,Java,,41,2,11,54
/jdk1.3.1_20/org/omg/CosNaming/BindingIteratorHolder.java,Java,,20,4,12,36
/jdk1.3.1_20/org/omg/CosNaming/BindingIteratorOperations.java,Java,,7,5,23,35
/jdk1.3.1_20/org/omg/CosNaming/BindingListHelper.java,Java,,42,2,11,55
/jdk1.3.1_20/org/omg/CosNaming/BindingListHolder.java,Java,,21,3,12,36
/jdk1.3.1_20/org/omg/CosNaming/BindingType.java,Java,,24,1,10,35
/jdk1.3.1_20/org/omg/CosNaming/BindingTypeHelper.java,Java,,33,2,11,46
/jdk1.3.1_20/org/omg/CosNaming/BindingTypeHolder.java,Java,,20,4,12,36
/jdk1.3.1_20/org/omg/CosNaming/IstringHelper.java,Java,,31,2,11,44
/jdk1.3.1_20/org/omg/CosNaming/NameComponent.java,Java,,10,1,12,23
/jdk1.3.1_20/org/omg/CosNaming/NameComponentHelper.java,Java,,44,3,11,58
/jdk1.3.1_20/org/omg/CosNaming/NameComponentHolder.java,Java,,20,4,12,36
/jdk1.3.1_20/org/omg/CosNaming/NameHelper.java,Java,,42,2,11,55
/jdk1.3.1_20/org/omg/CosNaming/NameHolder.java,Java,,21,3,12,36
/jdk1.3.1_20/org/omg/CosNaming/NamingContext.java,Java,,4,5,17,26
/jdk1.3.1_20/org/omg/CosNaming/NamingContextHelper.java,Java,,41,2,11,54
/jdk1.3.1_20/org/omg/CosNaming/NamingContextHolder.java,Java,,20,4,12,36
/jdk1.3.1_20/org/omg/CosNaming/NamingContextOperations.java,Java,,14,3,128,145
/jdk1.3.1_20/org/omg/CosNaming/NamingContextPackage/AlreadyBound.java,Java,,7,1,11,19
/jdk1.3.1_20/org/omg/CosNaming/NamingContextPackage/AlreadyBoundHelper.java,Java,,34,2,12,48
/jdk1.3.1_20/org/omg/CosNaming/NamingContextPackage/AlreadyBoundHolder.java,Java,,20,4,12,36
/jdk1.3.1_20/org/omg/CosNaming/NamingContextPackage/CannotProceed.java,Java,,14,1,12,27
/jdk1.3.1_20/org/omg/CosNaming/NamingContextPackage/CannotProceedHelper.java,Java,,57,5,12,74
/jdk1.3.1_20/org/omg/CosNaming/NamingContextPackage/CannotProceedHolder.java,Java,,20,4,12,36
/jdk1.3.1_20/org/omg/CosNaming/NamingContextPackage/InvalidName.java,Java,,7,1,11,19
/jdk1.3.1_20/org/omg/CosNaming/NamingContextPackage/InvalidNameHelper.java,Java,,34,2,12,48
/jdk1.3.1_20/org/omg/CosNaming/NamingContextPackage/InvalidNameHolder.java,Java,,20,4,12,36
/jdk1.3.1_20/org/omg/CosNaming/NamingContextPackage/NotEmpty.java,Java,,7,1,11,19
/jdk1.3.1_20/org/omg/CosNaming/NamingContextPackage/NotEmptyHelper.java,Java,,34,2,12,48
/jdk1.3.1_20/org/omg/CosNaming/NamingContextPackage/NotEmptyHolder.java,Java,,20,4,12,36
/jdk1.3.1_20/org/omg/CosNaming/NamingContextPackage/NotFound.java,Java,,14,1,12,27
/jdk1.3.1_20/org/omg/CosNaming/NamingContextPackage/NotFoundHelper.java,Java,,57,5,12,74
/jdk1.3.1_20/org/omg/CosNaming/NamingContextPackage/NotFoundHolder.java,Java,,20,4,12,36
/jdk1.3.1_20/org/omg/CosNaming/NamingContextPackage/NotFoundReason.java,Java,,28,1,10,39
/jdk1.3.1_20/org/omg/CosNaming/NamingContextPackage/NotFoundReasonHelper.java,Java,,34,2,11,47
/jdk1.3.1_20/org/omg/CosNaming/NamingContextPackage/NotFoundReasonHolder.java,Java,,20,4,12,36
/jdk1.3.1_20/org/omg/CosNaming/_BindingIteratorImplBase.java,Java,,71,3,13,87
/jdk1.3.1_20/org/omg/CosNaming/_BindingIteratorStub.java,Java,,44,6,14,64
/jdk1.3.1_20/org/omg/CosNaming/_NamingContextImplBase.java,Java,,370,3,13,386
/jdk1.3.1_20/org/omg/CosNaming/_NamingContextStub.java,Java,,237,6,21,264
/jdk1.3.1_20/org/omg/SendingContext/RunTime.java,Java,,4,4,18,26
/jdk1.3.1_20/org/omg/SendingContext/RunTimeOperations.java,Java,,4,4,18,26
/jdk1.3.1_20/org/omg/stub/java/rmi/_Remote_Stub.java,Java,,11,6,26,43
/jdk1.3.1_20/sun/tools/ttydebug/TTY.java,Java,,1555,155,105,1815
/jdk1.3.1_20/sunw/io/Serializable.java,Java,,3,3,28,34
/jdk1.3.1_20/sunw/util/EventListener.java,Java,,3,3,28,34
/jdk1.3.1_20/sunw/util/EventObject.java,Java,,6,5,28,39
