/jdk1.4.2_19/com/sun/corba/se/ActivationIDL/Activator.java,Java,,4,3,6,13
/jdk1.4.2_19/com/sun/corba/se/ActivationIDL/ActivatorHelper.java,Java,,53,11,6,70
/jdk1.4.2_19/com/sun/corba/se/ActivationIDL/ActivatorHolder.java,Java,,24,8,6,38
/jdk1.4.2_19/com/sun/corba/se/ActivationIDL/ActivatorOperations.java,Java,,12,11,14,37
/jdk1.4.2_19/com/sun/corba/se/ActivationIDL/BadServerDefinition.java,Java,,19,8,6,33
/jdk1.4.2_19/com/sun/corba/se/ActivationIDL/BadServerDefinitionHelper.java,Java,,61,10,8,79
/jdk1.4.2_19/com/sun/corba/se/ActivationIDL/BadServerDefinitionHolder.java,Java,,24,8,6,38
/jdk1.4.2_19/com/sun/corba/se/ActivationIDL/EndPointInfo.java,Java,,14,7,7,28
/jdk1.4.2_19/com/sun/corba/se/ActivationIDL/EndPointInfoHelper.java,Java,,67,11,7,85
/jdk1.4.2_19/com/sun/corba/se/ActivationIDL/EndPointInfoHolder.java,Java,,24,9,7,40
/jdk1.4.2_19/com/sun/corba/se/ActivationIDL/EndpointInfoListHelper.java,Java,,46,10,6,62
/jdk1.4.2_19/com/sun/corba/se/ActivationIDL/EndpointInfoListHolder.java,Java,,24,9,6,39
/jdk1.4.2_19/com/sun/corba/se/ActivationIDL/IIOP_CLEAR_TEXT.java,Java,,5,4,7,16
/jdk1.4.2_19/com/sun/corba/se/ActivationIDL/InitialNameService.java,Java,,4,3,6,13
/jdk1.4.2_19/com/sun/corba/se/ActivationIDL/InitialNameServiceHelper.java,Java,,53,11,6,70
/jdk1.4.2_19/com/sun/corba/se/ActivationIDL/InitialNameServiceHolder.java,Java,,24,8,6,38
/jdk1.4.2_19/com/sun/corba/se/ActivationIDL/InitialNameServiceOperations.java,Java,,5,4,7,16
/jdk1.4.2_19/com/sun/corba/se/ActivationIDL/InitialNameServicePackage/NameAlreadyBound.java,Java,,12,7,6,25
/jdk1.4.2_19/com/sun/corba/se/ActivationIDL/InitialNameServicePackage/NameAlreadyBoundHelper.java,Java,,54,10,8,72
/jdk1.4.2_19/com/sun/corba/se/ActivationIDL/InitialNameServicePackage/NameAlreadyBoundHolder.java,Java,,24,8,6,38
/jdk1.4.2_19/com/sun/corba/se/ActivationIDL/InvalidORBid.java,Java,,12,7,6,25
/jdk1.4.2_19/com/sun/corba/se/ActivationIDL/InvalidORBidHelper.java,Java,,54,10,8,72
/jdk1.4.2_19/com/sun/corba/se/ActivationIDL/InvalidORBidHolder.java,Java,,24,8,6,38
/jdk1.4.2_19/com/sun/corba/se/ActivationIDL/Locator.java,Java,,4,3,6,13
/jdk1.4.2_19/com/sun/corba/se/ActivationIDL/LocatorHelper.java,Java,,53,11,6,70
/jdk1.4.2_19/com/sun/corba/se/ActivationIDL/LocatorHolder.java,Java,,24,8,6,38
/jdk1.4.2_19/com/sun/corba/se/ActivationIDL/LocatorOperations.java,Java,,8,7,10,25
/jdk1.4.2_19/com/sun/corba/se/ActivationIDL/LocatorPackage/ServerLocation.java,Java,,14,7,7,28
/jdk1.4.2_19/com/sun/corba/se/ActivationIDL/LocatorPackage/ServerLocationHelper.java,Java,,68,11,7,86
/jdk1.4.2_19/com/sun/corba/se/ActivationIDL/LocatorPackage/ServerLocationHolder.java,Java,,24,9,7,40
/jdk1.4.2_19/com/sun/corba/se/ActivationIDL/LocatorPackage/ServerLocationPerORB.java,Java,,14,7,7,28
/jdk1.4.2_19/com/sun/corba/se/ActivationIDL/LocatorPackage/ServerLocationPerORBHelper.java,Java,,68,11,7,86
/jdk1.4.2_19/com/sun/corba/se/ActivationIDL/LocatorPackage/ServerLocationPerORBHolder.java,Java,,24,9,7,40
/jdk1.4.2_19/com/sun/corba/se/ActivationIDL/NoSuchEndPoint.java,Java,,12,7,6,25
/jdk1.4.2_19/com/sun/corba/se/ActivationIDL/NoSuchEndPointHelper.java,Java,,54,10,8,72
/jdk1.4.2_19/com/sun/corba/se/ActivationIDL/NoSuchEndPointHolder.java,Java,,24,8,6,38
/jdk1.4.2_19/com/sun/corba/se/ActivationIDL/ORBAlreadyRegistered.java,Java,,19,8,6,33
/jdk1.4.2_19/com/sun/corba/se/ActivationIDL/ORBAlreadyRegisteredHelper.java,Java,,62,10,8,80
/jdk1.4.2_19/com/sun/corba/se/ActivationIDL/ORBAlreadyRegisteredHolder.java,Java,,24,8,6,38
/jdk1.4.2_19/com/sun/corba/se/ActivationIDL/ORBidHelper.java,Java,,40,11,7,58
/jdk1.4.2_19/com/sun/corba/se/ActivationIDL/ORBidListHelper.java,Java,,47,10,6,63
/jdk1.4.2_19/com/sun/corba/se/ActivationIDL/ORBidListHolder.java,Java,,24,9,6,39
/jdk1.4.2_19/com/sun/corba/se/ActivationIDL/ORBPortInfo.java,Java,,14,7,7,28
/jdk1.4.2_19/com/sun/corba/se/ActivationIDL/ORBPortInfoHelper.java,Java,,68,11,7,86
/jdk1.4.2_19/com/sun/corba/se/ActivationIDL/ORBPortInfoHolder.java,Java,,24,9,7,40
/jdk1.4.2_19/com/sun/corba/se/ActivationIDL/ORBPortInfoListHelper.java,Java,,46,10,6,62
/jdk1.4.2_19/com/sun/corba/se/ActivationIDL/ORBPortInfoListHolder.java,Java,,24,9,6,39
/jdk1.4.2_19/com/sun/corba/se/ActivationIDL/POANameHelper.java,Java,,46,10,6,62
/jdk1.4.2_19/com/sun/corba/se/ActivationIDL/POANameHolder.java,Java,,24,9,6,39
/jdk1.4.2_19/com/sun/corba/se/ActivationIDL/Repository.java,Java,,4,3,6,13
/jdk1.4.2_19/com/sun/corba/se/ActivationIDL/RepositoryHelper.java,Java,,53,11,6,70
/jdk1.4.2_19/com/sun/corba/se/ActivationIDL/RepositoryHolder.java,Java,,24,8,6,38
/jdk1.4.2_19/com/sun/corba/se/ActivationIDL/RepositoryOperations.java,Java,,13,12,15,40
/jdk1.4.2_19/com/sun/corba/se/ActivationIDL/RepositoryPackage/ServerDef.java,Java,,20,10,10,40
/jdk1.4.2_19/com/sun/corba/se/ActivationIDL/RepositoryPackage/ServerDefHelper.java,Java,,87,11,7,105
/jdk1.4.2_19/com/sun/corba/se/ActivationIDL/RepositoryPackage/ServerDefHolder.java,Java,,24,9,7,40
/jdk1.4.2_19/com/sun/corba/se/ActivationIDL/RepositoryPackage/StringSeqHelper.java,Java,,46,10,6,62
/jdk1.4.2_19/com/sun/corba/se/ActivationIDL/RepositoryPackage/StringSeqHolder.java,Java,,24,9,6,39
/jdk1.4.2_19/com/sun/corba/se/ActivationIDL/Server.java,Java,,4,4,8,16
/jdk1.4.2_19/com/sun/corba/se/ActivationIDL/ServerAlreadyActive.java,Java,,19,8,6,33
/jdk1.4.2_19/com/sun/corba/se/ActivationIDL/ServerAlreadyActiveHelper.java,Java,,62,10,8,80
/jdk1.4.2_19/com/sun/corba/se/ActivationIDL/ServerAlreadyActiveHolder.java,Java,,24,8,6,38
/jdk1.4.2_19/com/sun/corba/se/ActivationIDL/ServerAlreadyInstalled.java,Java,,19,8,6,33
/jdk1.4.2_19/com/sun/corba/se/ActivationIDL/ServerAlreadyInstalledHelper.java,Java,,62,10,8,80
/jdk1.4.2_19/com/sun/corba/se/ActivationIDL/ServerAlreadyInstalledHolder.java,Java,,24,8,6,38
/jdk1.4.2_19/com/sun/corba/se/ActivationIDL/ServerAlreadyRegistered.java,Java,,19,8,6,33
/jdk1.4.2_19/com/sun/corba/se/ActivationIDL/ServerAlreadyRegisteredHelper.java,Java,,62,10,8,80
/jdk1.4.2_19/com/sun/corba/se/ActivationIDL/ServerAlreadyRegisteredHolder.java,Java,,24,8,6,38
/jdk1.4.2_19/com/sun/corba/se/ActivationIDL/ServerAlreadyUninstalled.java,Java,,19,8,6,33
/jdk1.4.2_19/com/sun/corba/se/ActivationIDL/ServerAlreadyUninstalledHelper.java,Java,,62,10,8,80
/jdk1.4.2_19/com/sun/corba/se/ActivationIDL/ServerAlreadyUninstalledHolder.java,Java,,24,8,6,38
/jdk1.4.2_19/com/sun/corba/se/ActivationIDL/ServerHeldDown.java,Java,,19,8,6,33
/jdk1.4.2_19/com/sun/corba/se/ActivationIDL/ServerHeldDownHelper.java,Java,,62,10,8,80
/jdk1.4.2_19/com/sun/corba/se/ActivationIDL/ServerHeldDownHolder.java,Java,,24,8,6,38
/jdk1.4.2_19/com/sun/corba/se/ActivationIDL/ServerHelper.java,Java,,53,12,8,73
/jdk1.4.2_19/com/sun/corba/se/ActivationIDL/ServerHolder.java,Java,,24,9,8,41
/jdk1.4.2_19/com/sun/corba/se/ActivationIDL/ServerIdHelper.java,Java,,40,10,6,56
/jdk1.4.2_19/com/sun/corba/se/ActivationIDL/ServerIdsHelper.java,Java,,47,10,6,63
/jdk1.4.2_19/com/sun/corba/se/ActivationIDL/ServerIdsHolder.java,Java,,24,9,6,39
/jdk1.4.2_19/com/sun/corba/se/ActivationIDL/ServerManager.java,Java,,4,3,6,13
/jdk1.4.2_19/com/sun/corba/se/ActivationIDL/ServerManagerHelper.java,Java,,53,11,6,70
/jdk1.4.2_19/com/sun/corba/se/ActivationIDL/ServerManagerHolder.java,Java,,24,8,6,38
/jdk1.4.2_19/com/sun/corba/se/ActivationIDL/ServerManagerOperations.java,Java,,4,3,6,13
/jdk1.4.2_19/com/sun/corba/se/ActivationIDL/ServerNotActive.java,Java,,19,8,6,33
/jdk1.4.2_19/com/sun/corba/se/ActivationIDL/ServerNotActiveHelper.java,Java,,62,10,8,80
/jdk1.4.2_19/com/sun/corba/se/ActivationIDL/ServerNotActiveHolder.java,Java,,24,8,6,38
/jdk1.4.2_19/com/sun/corba/se/ActivationIDL/ServerNotRegistered.java,Java,,19,8,6,33
/jdk1.4.2_19/com/sun/corba/se/ActivationIDL/ServerNotRegisteredHelper.java,Java,,62,10,8,80
/jdk1.4.2_19/com/sun/corba/se/ActivationIDL/ServerNotRegisteredHolder.java,Java,,24,8,6,38
/jdk1.4.2_19/com/sun/corba/se/ActivationIDL/ServerOperations.java,Java,,7,7,16,30
/jdk1.4.2_19/com/sun/corba/se/ActivationIDL/TCPPortHelper.java,Java,,40,10,6,56
/jdk1.4.2_19/com/sun/corba/se/ActivationIDL/_ActivatorImplBase.java,Java,,165,28,16,209
/jdk1.4.2_19/com/sun/corba/se/ActivationIDL/_ActivatorStub.java,Java,,213,23,15,251
/jdk1.4.2_19/com/sun/corba/se/ActivationIDL/_InitialNameServiceImplBase.java,Java,,48,14,9,71
/jdk1.4.2_19/com/sun/corba/se/ActivationIDL/_InitialNameServiceStub.java,Java,,49,9,8,66
/jdk1.4.2_19/com/sun/corba/se/ActivationIDL/_LocatorImplBase.java,Java,,108,20,12,140
/jdk1.4.2_19/com/sun/corba/se/ActivationIDL/_LocatorStub.java,Java,,125,15,11,151
/jdk1.4.2_19/com/sun/corba/se/ActivationIDL/_RepositoryImplBase.java,Java,,159,30,17,206
/jdk1.4.2_19/com/sun/corba/se/ActivationIDL/_RepositoryStub.java,Java,,219,25,16,260
/jdk1.4.2_19/com/sun/corba/se/ActivationIDL/_ServerImplBase.java,Java,,54,19,18,91
/jdk1.4.2_19/com/sun/corba/se/ActivationIDL/_ServerManagerImplBase.java,Java,,242,36,20,298
/jdk1.4.2_19/com/sun/corba/se/ActivationIDL/_ServerManagerStub.java,Java,,314,31,19,364
/jdk1.4.2_19/com/sun/corba/se/ActivationIDL/_ServerStub.java,Java,,77,14,17,108
/jdk1.4.2_19/com/sun/corba/se/connection/Connection.java,Java,,5,3,9,17
/jdk1.4.2_19/com/sun/corba/se/connection/EndPointInfo.java,Java,,7,5,12,24
/jdk1.4.2_19/com/sun/corba/se/connection/GetEndPointInfoAgainException.java,Java,,14,5,13,32
/jdk1.4.2_19/com/sun/corba/se/connection/ORBSocketFactory.java,Java,,19,15,325,359
/jdk1.4.2_19/com/sun/corba/se/extension/ServantCachingPolicy.java,Java,,28,9,8,45
/jdk1.4.2_19/com/sun/corba/se/interceptor/IORInfoExt.java,Java,,7,2,6,15
/jdk1.4.2_19/com/sun/corba/se/interceptor/RequestInfoExt.java,Java,,6,4,17,27
/jdk1.4.2_19/com/sun/corba/se/interceptor/UnknownType.java,Java,,14,3,6,23
/jdk1.4.2_19/com/sun/corba/se/internal/Activation/BootStrapActivation.java,Java,,95,24,14,133
/jdk1.4.2_19/com/sun/corba/se/internal/Activation/CommandHandler.java,Java,,13,8,11,32
/jdk1.4.2_19/com/sun/corba/se/internal/Activation/InitialNamingImpl.java,Java,,35,8,13,56
/jdk1.4.2_19/com/sun/corba/se/internal/Activation/MinorCodes.java,Java,,11,5,19,35
/jdk1.4.2_19/com/sun/corba/se/internal/Activation/NameServiceStartThread.java,Java,,36,7,9,52
/jdk1.4.2_19/com/sun/corba/se/internal/Activation/ORBD.java,Java,,241,50,54,345
/jdk1.4.2_19/com/sun/corba/se/internal/Activation/ProcessMonitorThread.java,Java,,49,12,21,82
/jdk1.4.2_19/com/sun/corba/se/internal/Activation/RepositoryImpl.java,Java,,344,79,46,469
/jdk1.4.2_19/com/sun/corba/se/internal/Activation/ServerMain.java,Java,,245,71,64,380
/jdk1.4.2_19/com/sun/corba/se/internal/Activation/ServerManagerImpl.java,Java,,453,110,52,615
/jdk1.4.2_19/com/sun/corba/se/internal/Activation/ServerTableEntry.java,Java,,363,88,70,521
/jdk1.4.2_19/com/sun/corba/se/internal/Activation/ServerTool.java,Java,,729,164,61,954
/jdk1.4.2_19/com/sun/corba/se/internal/corba/AnyImpl.java,Java,,789,185,520,1494
/jdk1.4.2_19/com/sun/corba/se/internal/corba/AnyImplHelper.java,Java,,37,9,17,63
/jdk1.4.2_19/com/sun/corba/se/internal/corba/AsynchInvoke.java,Java,,26,16,36,78
/jdk1.4.2_19/com/sun/corba/se/internal/corba/ClientDelegate.java,Java,,639,170,293,1102
/jdk1.4.2_19/com/sun/corba/se/internal/corba/ContextImpl.java,Java,,47,16,14,77
/jdk1.4.2_19/com/sun/corba/se/internal/corba/ContextListImpl.java,Java,,43,10,15,68
/jdk1.4.2_19/com/sun/corba/se/internal/corba/CorbaLoc.java,Java,,48,9,19,76
/jdk1.4.2_19/com/sun/corba/se/internal/corba/CorbaName.java,Java,,32,9,16,57
/jdk1.4.2_19/com/sun/corba/se/internal/corba/CORBAObjectImpl.java,Java,,8,2,17,27
/jdk1.4.2_19/com/sun/corba/se/internal/corba/EncapsInputStream.java,Java,,60,17,45,122
/jdk1.4.2_19/com/sun/corba/se/internal/corba/EncapsOutputStream.java,Java,,47,14,38,99
/jdk1.4.2_19/com/sun/corba/se/internal/corba/EnvironmentImpl.java,Java,,22,9,14,45
/jdk1.4.2_19/com/sun/corba/se/internal/corba/ExceptionListImpl.java,Java,,40,14,14,68
/jdk1.4.2_19/com/sun/corba/se/internal/corba/HostInfo.java,Java,,40,14,17,71
/jdk1.4.2_19/com/sun/corba/se/internal/corba/InitialNamingClient.java,Java,,839,100,309,1248
/jdk1.4.2_19/com/sun/corba/se/internal/corba/INSSubcontract.java,Java,,66,25,32,123
/jdk1.4.2_19/com/sun/corba/se/internal/corba/NamedValueImpl.java,Java,,38,8,16,62
/jdk1.4.2_19/com/sun/corba/se/internal/corba/NVListImpl.java,Java,,65,16,16,97
/jdk1.4.2_19/com/sun/corba/se/internal/corba/ORB.java,Java,,1606,338,763,2707
/jdk1.4.2_19/com/sun/corba/se/internal/corba/ORBSingleton.java,Java,,391,107,89,587
/jdk1.4.2_19/com/sun/corba/se/internal/corba/PrincipalImpl.java,Java,,13,5,14,32
/jdk1.4.2_19/com/sun/corba/se/internal/corba/RequestImpl.java,Java,,382,101,165,648
/jdk1.4.2_19/com/sun/corba/se/internal/corba/ServerDelegate.java,Java,,374,113,142,629
/jdk1.4.2_19/com/sun/corba/se/internal/corba/ServerRequestImpl.java,Java,,134,43,62,239
/jdk1.4.2_19/com/sun/corba/se/internal/corba/SpecialMethod.java,Java,,92,17,6,115
/jdk1.4.2_19/com/sun/corba/se/internal/corba/TCUtility.java,Java,,226,56,25,307
/jdk1.4.2_19/com/sun/corba/se/internal/corba/TypeCodeFactory.java,Java,,5,2,6,13
/jdk1.4.2_19/com/sun/corba/se/internal/corba/TypeCodeImpl.java,Java,,2048,339,537,2924
/jdk1.4.2_19/com/sun/corba/se/internal/corba/TypeCodeImplHelper.java,Java,,37,9,14,60
/jdk1.4.2_19/com/sun/corba/se/internal/core/ClientGIOP.java,Java,,9,8,24,41
/jdk1.4.2_19/com/sun/corba/se/internal/core/ClientRequest.java,Java,,4,10,45,59
/jdk1.4.2_19/com/sun/corba/se/internal/core/ClientResponse.java,Java,,6,4,10,20
/jdk1.4.2_19/com/sun/corba/se/internal/core/ClientSubcontract.java,Java,,15,12,46,73
/jdk1.4.2_19/com/sun/corba/se/internal/core/Closure.java,Java,,4,2,6,12
/jdk1.4.2_19/com/sun/corba/se/internal/core/CodeSetCache.java,Java,,34,15,44,93
/jdk1.4.2_19/com/sun/corba/se/internal/core/CodeSetComponentInfo.java,Java,,162,51,67,280
/jdk1.4.2_19/com/sun/corba/se/internal/core/CodeSetConversion.java,Java,,306,109,259,674
/jdk1.4.2_19/com/sun/corba/se/internal/core/CodeSetServiceContext.java,Java,,33,9,7,49
/jdk1.4.2_19/com/sun/corba/se/internal/core/Constant.java,Java,,13,6,6,25
/jdk1.4.2_19/com/sun/corba/se/internal/core/DuplicateServiceContext.java,Java,,12,4,9,25
/jdk1.4.2_19/com/sun/corba/se/internal/core/EndPoint.java,Java,,10,8,30,48
/jdk1.4.2_19/com/sun/corba/se/internal/core/Future.java,Java,,21,6,6,33
/jdk1.4.2_19/com/sun/corba/se/internal/core/GIOPVersion.java,Java,,108,39,29,176
/jdk1.4.2_19/com/sun/corba/se/internal/core/INSObjectKeyEntry.java,Java,,16,5,15,36
/jdk1.4.2_19/com/sun/corba/se/internal/core/INSObjectKeyMap.java,Java,,23,11,18,52
/jdk1.4.2_19/com/sun/corba/se/internal/core/InternalRuntimeForwardRequest.java,Java,,9,2,21,32
/jdk1.4.2_19/com/sun/corba/se/internal/core/IOR.java,Java,,330,86,66,482
/jdk1.4.2_19/com/sun/corba/se/internal/core/MarshalInputStream.java,Java,,44,10,30,84
/jdk1.4.2_19/com/sun/corba/se/internal/core/MarshalOutputStream.java,Java,,46,13,12,71
/jdk1.4.2_19/com/sun/corba/se/internal/core/NoSuchServiceContext.java,Java,,12,4,9,25
/jdk1.4.2_19/com/sun/corba/se/internal/core/ORB.java,Java,,22,19,63,104
/jdk1.4.2_19/com/sun/corba/se/internal/core/ORBVersion.java,Java,,11,10,21,42
/jdk1.4.2_19/com/sun/corba/se/internal/core/ORBVersionFactory.java,Java,,28,7,14,49
/jdk1.4.2_19/com/sun/corba/se/internal/core/ORBVersionImpl.java,Java,,44,16,10,70
/jdk1.4.2_19/com/sun/corba/se/internal/core/ORBVersionServiceContext.java,Java,,38,12,12,62
/jdk1.4.2_19/com/sun/corba/se/internal/core/OSFCodeSetRegistry.java,Java,,104,21,87,212
/jdk1.4.2_19/com/sun/corba/se/internal/core/Request.java,Java,,11,12,37,60
/jdk1.4.2_19/com/sun/corba/se/internal/core/RequestHandler.java,Java,,7,5,17,29
/jdk1.4.2_19/com/sun/corba/se/internal/core/Response.java,Java,,13,15,43,71
/jdk1.4.2_19/com/sun/corba/se/internal/core/SendingContextServiceContext.java,Java,,33,9,7,49
/jdk1.4.2_19/com/sun/corba/se/internal/core/ServerGIOP.java,Java,,15,14,55,84
/jdk1.4.2_19/com/sun/corba/se/internal/core/ServerRequest.java,Java,,23,18,34,75
/jdk1.4.2_19/com/sun/corba/se/internal/core/ServerResponse.java,Java,,3,2,10,15
/jdk1.4.2_19/com/sun/corba/se/internal/core/ServerSubcontract.java,Java,,15,13,52,80
/jdk1.4.2_19/com/sun/corba/se/internal/core/ServiceContext.java,Java,,39,13,52,104
/jdk1.4.2_19/com/sun/corba/se/internal/core/ServiceContextData.java,Java,,112,21,13,146
/jdk1.4.2_19/com/sun/corba/se/internal/core/ServiceContextRegistry.java,Java,,50,13,17,80
/jdk1.4.2_19/com/sun/corba/se/internal/core/ServiceContexts.java,Java,,218,80,106,404
/jdk1.4.2_19/com/sun/corba/se/internal/core/StandardIIOPProfileTemplate.java,Java,,31,9,8,48
/jdk1.4.2_19/com/sun/corba/se/internal/core/SubcontractRegistry.java,Java,,142,30,49,221
/jdk1.4.2_19/com/sun/corba/se/internal/core/UEInfoServiceContext.java,Java,,37,12,7,56
/jdk1.4.2_19/com/sun/corba/se/internal/core/UnknownServiceContext.java,Java,,36,11,6,53
/jdk1.4.2_19/com/sun/corba/se/internal/CosNaming/BindingIteratorImpl.java,Java,,55,17,92,164
/jdk1.4.2_19/com/sun/corba/se/internal/CosNaming/BootstrapServer.java,Java,,262,61,193,516
/jdk1.4.2_19/com/sun/corba/se/internal/CosNaming/InternalBindingKey.java,Java,,52,8,24,84
/jdk1.4.2_19/com/sun/corba/se/internal/CosNaming/InternalBindingValue.java,Java,,15,5,13,33
/jdk1.4.2_19/com/sun/corba/se/internal/CosNaming/InterOperableNamingImpl.java,Java,,297,22,77,396
/jdk1.4.2_19/com/sun/corba/se/internal/CosNaming/MinorCodes.java,Java,,23,24,71,118
/jdk1.4.2_19/com/sun/corba/se/internal/CosNaming/NamingContextDataStore.java,Java,,25,11,61,97
/jdk1.4.2_19/com/sun/corba/se/internal/CosNaming/NamingContextImpl.java,Java,,449,61,421,931
/jdk1.4.2_19/com/sun/corba/se/internal/CosNaming/NamingUtils.java,Java,,44,13,42,99
/jdk1.4.2_19/com/sun/corba/se/internal/CosNaming/NSORB.java,Java,,43,15,9,67
/jdk1.4.2_19/com/sun/corba/se/internal/CosNaming/TransientBindingIterator.java,Java,,59,10,49,118
/jdk1.4.2_19/com/sun/corba/se/internal/CosNaming/TransientNameServer.java,Java,,113,32,56,201
/jdk1.4.2_19/com/sun/corba/se/internal/CosNaming/TransientNameService.java,Java,,71,17,53,141
/jdk1.4.2_19/com/sun/corba/se/internal/CosNaming/TransientNamingContext.java,Java,,151,31,131,313
/jdk1.4.2_19/com/sun/corba/se/internal/DynamicAny/DynAnyBasicImpl.java,Java,,535,56,25,616
/jdk1.4.2_19/com/sun/corba/se/internal/DynamicAny/DynAnyCollectionImpl.java,Java,,116,24,45,185
/jdk1.4.2_19/com/sun/corba/se/internal/DynamicAny/DynAnyComplexImpl.java,Java,,278,39,85,402
/jdk1.4.2_19/com/sun/corba/se/internal/DynamicAny/DynAnyConstructedImpl.java,Java,,790,71,57,918
/jdk1.4.2_19/com/sun/corba/se/internal/DynamicAny/DynAnyFactoryImpl.java,Java,,34,14,18,66
/jdk1.4.2_19/com/sun/corba/se/internal/DynamicAny/DynAnyImpl.java,Java,,109,24,37,170
/jdk1.4.2_19/com/sun/corba/se/internal/DynamicAny/DynAnyUtil.java,Java,,211,15,89,315
/jdk1.4.2_19/com/sun/corba/se/internal/DynamicAny/DynArrayImpl.java,Java,,65,17,37,119
/jdk1.4.2_19/com/sun/corba/se/internal/DynamicAny/DynEnumImpl.java,Java,,109,20,40,169
/jdk1.4.2_19/com/sun/corba/se/internal/DynamicAny/DynFixedImpl.java,Java,,121,10,59,190
/jdk1.4.2_19/com/sun/corba/se/internal/DynamicAny/DynSequenceImpl.java,Java,,129,24,85,238
/jdk1.4.2_19/com/sun/corba/se/internal/DynamicAny/DynStructImpl.java,Java,,40,9,19,68
/jdk1.4.2_19/com/sun/corba/se/internal/DynamicAny/DynUnionImpl.java,Java,,249,31,86,366
/jdk1.4.2_19/com/sun/corba/se/internal/DynamicAny/DynValueBoxImpl.java,Java,,88,14,12,114
/jdk1.4.2_19/com/sun/corba/se/internal/DynamicAny/DynValueCommonImpl.java,Java,,79,17,32,128
/jdk1.4.2_19/com/sun/corba/se/internal/DynamicAny/DynValueImpl.java,Java,,25,6,9,40
/jdk1.4.2_19/com/sun/corba/se/internal/iiop/AddressingDispositionException.java,Java,,11,6,21,38
/jdk1.4.2_19/com/sun/corba/se/internal/iiop/BufferManagerFactory.java,Java,,120,24,84,228
/jdk1.4.2_19/com/sun/corba/se/internal/iiop/BufferManagerRead.java,Java,,14,14,46,74
/jdk1.4.2_19/com/sun/corba/se/internal/iiop/BufferManagerReadGrow.java,Java,,38,14,8,60
/jdk1.4.2_19/com/sun/corba/se/internal/iiop/BufferManagerReadStream.java,Java,,100,32,20,152
/jdk1.4.2_19/com/sun/corba/se/internal/iiop/BufferManagerWrite.java,Java,,17,19,83,119
/jdk1.4.2_19/com/sun/corba/se/internal/iiop/BufferManagerWriteCollect.java,Java,,69,30,26,125
/jdk1.4.2_19/com/sun/corba/se/internal/iiop/BufferManagerWriteGrow.java,Java,,44,17,41,102
/jdk1.4.2_19/com/sun/corba/se/internal/iiop/BufferManagerWriteStream.java,Java,,57,29,55,141
/jdk1.4.2_19/com/sun/corba/se/internal/iiop/BufferQueue.java,Java,,24,6,11,41
/jdk1.4.2_19/com/sun/corba/se/internal/iiop/ByteBufferWithInfo.java,Java,,48,10,8,66
/jdk1.4.2_19/com/sun/corba/se/internal/iiop/CachedCodeBase.java,Java,,94,38,42,174
/jdk1.4.2_19/com/sun/corba/se/internal/iiop/CDRInputStream.java,Java,,354,110,66,530
/jdk1.4.2_19/com/sun/corba/se/internal/iiop/CDRInputStreamBase.java,Java,,145,38,41,224
/jdk1.4.2_19/com/sun/corba/se/internal/iiop/CDRInputStream_1_0.java,Java,,1517,453,371,2341
/jdk1.4.2_19/com/sun/corba/se/internal/iiop/CDRInputStream_1_1.java,Java,,77,44,45,166
/jdk1.4.2_19/com/sun/corba/se/internal/iiop/CDRInputStream_1_2.java,Java,,35,13,24,72
/jdk1.4.2_19/com/sun/corba/se/internal/iiop/CDROutputStream.java,Java,,313,70,34,417
/jdk1.4.2_19/com/sun/corba/se/internal/iiop/CDROutputStreamBase.java,Java,,103,31,23,157
/jdk1.4.2_19/com/sun/corba/se/internal/iiop/CDROutputStream_1_0.java,Java,,1268,411,321,2000
/jdk1.4.2_19/com/sun/corba/se/internal/iiop/CDROutputStream_1_1.java,Java,,59,30,48,137
/jdk1.4.2_19/com/sun/corba/se/internal/iiop/CDROutputStream_1_2.java,Java,,132,62,123,317
/jdk1.4.2_19/com/sun/corba/se/internal/iiop/ClientRequestImpl.java,Java,,64,15,9,88
/jdk1.4.2_19/com/sun/corba/se/internal/iiop/ClientResponseImpl.java,Java,,95,21,10,126
/jdk1.4.2_19/com/sun/corba/se/internal/iiop/Connection.java,Java,,132,48,54,234
/jdk1.4.2_19/com/sun/corba/se/internal/iiop/ConnectionTable.java,Java,,235,55,67,357
/jdk1.4.2_19/com/sun/corba/se/internal/iiop/DefaultSocketFactory.java,Java,,54,9,6,69
/jdk1.4.2_19/com/sun/corba/se/internal/iiop/EndPointImpl.java,Java,,69,13,6,88
/jdk1.4.2_19/com/sun/corba/se/internal/iiop/ForwardException.java,Java,,13,6,9,28
/jdk1.4.2_19/com/sun/corba/se/internal/iiop/GIOPImpl.java,Java,,210,47,53,310
/jdk1.4.2_19/com/sun/corba/se/internal/iiop/IIOPConnection.java,Java,,557,157,307,1021
/jdk1.4.2_19/com/sun/corba/se/internal/iiop/IIOPInputStream.java,Java,,139,48,72,259
/jdk1.4.2_19/com/sun/corba/se/internal/iiop/IIOPOutputStream.java,Java,,178,58,76,312
/jdk1.4.2_19/com/sun/corba/se/internal/iiop/ListenerThread.java,Java,,70,18,20,108
/jdk1.4.2_19/com/sun/corba/se/internal/iiop/LocalClientRequestImpl.java,Java,,78,22,15,115
/jdk1.4.2_19/com/sun/corba/se/internal/iiop/LocalClientResponseImpl.java,Java,,96,24,23,143
/jdk1.4.2_19/com/sun/corba/se/internal/iiop/LocalServerRequestImpl.java,Java,,132,37,18,187
/jdk1.4.2_19/com/sun/corba/se/internal/iiop/LocalServerResponseImpl.java,Java,,109,29,33,171
/jdk1.4.2_19/com/sun/corba/se/internal/iiop/MarkAndResetHandler.java,Java,,7,4,10,21
/jdk1.4.2_19/com/sun/corba/se/internal/iiop/MessageMediator.java,Java,,322,130,163,615
/jdk1.4.2_19/com/sun/corba/se/internal/iiop/messages/AddressingDispositionHelper.java,Java,,40,11,12,63
/jdk1.4.2_19/com/sun/corba/se/internal/iiop/messages/CancelRequestMessage.java,Java,,5,3,12,20
/jdk1.4.2_19/com/sun/corba/se/internal/iiop/messages/CancelRequestMessage_1_0.java,Java,,28,15,16,59
/jdk1.4.2_19/com/sun/corba/se/internal/iiop/messages/CancelRequestMessage_1_1.java,Java,,28,15,16,59
/jdk1.4.2_19/com/sun/corba/se/internal/iiop/messages/CancelRequestMessage_1_2.java,Java,,28,15,16,59
/jdk1.4.2_19/com/sun/corba/se/internal/iiop/messages/FragmentMessage.java,Java,,5,3,12,20
/jdk1.4.2_19/com/sun/corba/se/internal/iiop/messages/FragmentMessage_1_1.java,Java,,29,13,20,62
/jdk1.4.2_19/com/sun/corba/se/internal/iiop/messages/FragmentMessage_1_2.java,Java,,55,16,20,91
/jdk1.4.2_19/com/sun/corba/se/internal/iiop/messages/IORAddressingInfo.java,Java,,14,7,12,33
/jdk1.4.2_19/com/sun/corba/se/internal/iiop/messages/IORAddressingInfoHelper.java,Java,,66,11,12,89
/jdk1.4.2_19/com/sun/corba/se/internal/iiop/messages/KeyAddr.java,Java,,5,4,12,21
/jdk1.4.2_19/com/sun/corba/se/internal/iiop/messages/LocateReplyMessage.java,Java,,16,6,12,34
/jdk1.4.2_19/com/sun/corba/se/internal/iiop/messages/LocateReplyMessage_1_0.java,Java,,73,23,20,116
/jdk1.4.2_19/com/sun/corba/se/internal/iiop/messages/LocateReplyMessage_1_1.java,Java,,74,23,20,117
/jdk1.4.2_19/com/sun/corba/se/internal/iiop/messages/LocateReplyMessage_1_2.java,Java,,115,33,30,178
/jdk1.4.2_19/com/sun/corba/se/internal/iiop/messages/LocateRequestMessage.java,Java,,6,4,12,22
/jdk1.4.2_19/com/sun/corba/se/internal/iiop/messages/LocateRequestMessage_1_0.java,Java,,48,17,17,82
/jdk1.4.2_19/com/sun/corba/se/internal/iiop/messages/LocateRequestMessage_1_1.java,Java,,49,17,17,83
/jdk1.4.2_19/com/sun/corba/se/internal/iiop/messages/LocateRequestMessage_1_2.java,Java,,46,17,17,80
/jdk1.4.2_19/com/sun/corba/se/internal/iiop/messages/Message.java,Java,,30,15,17,62
/jdk1.4.2_19/com/sun/corba/se/internal/iiop/messages/MessageBase.java,Java,,516,82,111,709
/jdk1.4.2_19/com/sun/corba/se/internal/iiop/messages/Message_1_0.java,Java,,66,23,31,120
/jdk1.4.2_19/com/sun/corba/se/internal/iiop/messages/Message_1_1.java,Java,,85,27,44,156
/jdk1.4.2_19/com/sun/corba/se/internal/iiop/messages/Message_1_2.java,Java,,30,9,11,50
/jdk1.4.2_19/com/sun/corba/se/internal/iiop/messages/ProfileAddr.java,Java,,5,4,12,21
/jdk1.4.2_19/com/sun/corba/se/internal/iiop/messages/ReferenceAddr.java,Java,,5,4,12,21
/jdk1.4.2_19/com/sun/corba/se/internal/iiop/messages/ReplyMessage.java,Java,,20,6,14,40
/jdk1.4.2_19/com/sun/corba/se/internal/iiop/messages/ReplyMessage_1_0.java,Java,,130,33,22,185
/jdk1.4.2_19/com/sun/corba/se/internal/iiop/messages/ReplyMessage_1_1.java,Java,,131,33,22,186
/jdk1.4.2_19/com/sun/corba/se/internal/iiop/messages/ReplyMessage_1_2.java,Java,,140,35,31,206
/jdk1.4.2_19/com/sun/corba/se/internal/iiop/messages/RequestMessage.java,Java,,14,7,12,33
/jdk1.4.2_19/com/sun/corba/se/internal/iiop/messages/RequestMessage_1_0.java,Java,,95,22,18,135
/jdk1.4.2_19/com/sun/corba/se/internal/iiop/messages/RequestMessage_1_1.java,Java,,111,22,17,150
/jdk1.4.2_19/com/sun/corba/se/internal/iiop/messages/RequestMessage_1_2.java,Java,,107,26,33,166
/jdk1.4.2_19/com/sun/corba/se/internal/iiop/messages/TargetAddress.java,Java,,77,17,12,106
/jdk1.4.2_19/com/sun/corba/se/internal/iiop/messages/TargetAddressHelper.java,Java,,108,14,15,137
/jdk1.4.2_19/com/sun/corba/se/internal/iiop/ORB.java,Java,,329,94,150,573
/jdk1.4.2_19/com/sun/corba/se/internal/iiop/ORBThread.java,Java,,3,1,6,10
/jdk1.4.2_19/com/sun/corba/se/internal/iiop/ReaderThread.java,Java,,78,17,66,161
/jdk1.4.2_19/com/sun/corba/se/internal/iiop/RequestCanceledException.java,Java,,10,5,9,24
/jdk1.4.2_19/com/sun/corba/se/internal/iiop/RequestProcessor.java,Java,,150,59,75,284
/jdk1.4.2_19/com/sun/corba/se/internal/iiop/RestorableInputStream.java,Java,,6,2,11,19
/jdk1.4.2_19/com/sun/corba/se/internal/iiop/ServerRequestImpl.java,Java,,200,52,39,291
/jdk1.4.2_19/com/sun/corba/se/internal/iiop/ServerResponseImpl.java,Java,,124,25,34,183
/jdk1.4.2_19/com/sun/corba/se/internal/iiop/ShutdownUtilDelegate.java,Java,,154,43,63,260
/jdk1.4.2_19/com/sun/corba/se/internal/Interceptors/CDREncapsCodec.java,Java,,91,30,79,200
/jdk1.4.2_19/com/sun/corba/se/internal/Interceptors/ClientRequestInfoImpl.java,Java,,528,125,323,976
/jdk1.4.2_19/com/sun/corba/se/internal/Interceptors/CodecFactoryImpl.java,Java,,50,16,37,103
/jdk1.4.2_19/com/sun/corba/se/internal/Interceptors/InterceptorInvoker.java,Java,,314,69,226,609
/jdk1.4.2_19/com/sun/corba/se/internal/Interceptors/InterceptorList.java,Java,,127,30,83,240
/jdk1.4.2_19/com/sun/corba/se/internal/Interceptors/IORInfoImpl.java,Java,,83,19,79,181
/jdk1.4.2_19/com/sun/corba/se/internal/Interceptors/MinorCodes.java,Java,,74,14,41,129
/jdk1.4.2_19/com/sun/corba/se/internal/Interceptors/ORBInitInfoImpl.java,Java,,157,46,121,324
/jdk1.4.2_19/com/sun/corba/se/internal/Interceptors/PICurrent.java,Java,,69,23,61,153
/jdk1.4.2_19/com/sun/corba/se/internal/Interceptors/PIORB.java,Java,,651,167,465,1283
/jdk1.4.2_19/com/sun/corba/se/internal/Interceptors/RequestInfoImpl.java,Java,,459,118,404,981
/jdk1.4.2_19/com/sun/corba/se/internal/Interceptors/ServerRequestInfoImpl.java,Java,,456,119,298,873
/jdk1.4.2_19/com/sun/corba/se/internal/Interceptors/SlotTable.java,Java,,45,14,33,92
/jdk1.4.2_19/com/sun/corba/se/internal/Interceptors/SlotTableStack.java,Java,,76,21,67,164
/jdk1.4.2_19/com/sun/corba/se/internal/Interceptors/ThreadCurrentStack.java,Java,,67,20,58,145
/jdk1.4.2_19/com/sun/corba/se/internal/io/FVDCodeBaseImpl.java,Java,,109,41,38,188
/jdk1.4.2_19/com/sun/corba/se/internal/io/IIOPInputStream.java,Java,,1343,280,558,2181
/jdk1.4.2_19/com/sun/corba/se/internal/io/IIOPOutputStream.java,Java,,534,95,147,776
/jdk1.4.2_19/com/sun/corba/se/internal/io/InputStreamHook.java,Java,,100,31,50,181
/jdk1.4.2_19/com/sun/corba/se/internal/io/LibraryManager.java,Java,,62,16,21,99
/jdk1.4.2_19/com/sun/corba/se/internal/io/ObjectStreamClass.java,Java,,841,194,501,1536
/jdk1.4.2_19/com/sun/corba/se/internal/io/ObjectStreamClassCorbaExt.java,Java,,51,14,29,94
/jdk1.4.2_19/com/sun/corba/se/internal/io/ObjectStreamField.java,Java,,149,34,65,248
/jdk1.4.2_19/com/sun/corba/se/internal/io/OptionalDataException.java,Java,,13,6,41,60
/jdk1.4.2_19/com/sun/corba/se/internal/io/OutputStreamHook.java,Java,,68,32,52,152
/jdk1.4.2_19/com/sun/corba/se/internal/io/TypeMismatchException.java,Java,,12,3,14,29
/jdk1.4.2_19/com/sun/corba/se/internal/io/ValueHandlerImpl.java,Java,,542,120,148,810
/jdk1.4.2_19/com/sun/corba/se/internal/io/ValueUtility.java,Java,,321,65,65,451
/jdk1.4.2_19/com/sun/corba/se/internal/ior/AlternateIIOPAddressComponent.java,Java,,37,12,29,78
/jdk1.4.2_19/com/sun/corba/se/internal/ior/ByteBuffer.java,Java,,80,18,92,190
/jdk1.4.2_19/com/sun/corba/se/internal/ior/CodeSetsComponent.java,Java,,37,11,31,79
/jdk1.4.2_19/com/sun/corba/se/internal/ior/FreezableList.java,Java,,220,59,14,293
/jdk1.4.2_19/com/sun/corba/se/internal/ior/GenericIdEncapsulation.java,Java,,47,15,59,121
/jdk1.4.2_19/com/sun/corba/se/internal/ior/GenericTaggedComponent.java,Java,,22,6,16,44
/jdk1.4.2_19/com/sun/corba/se/internal/ior/GenericTaggedProfile.java,Java,,28,7,22,57
/jdk1.4.2_19/com/sun/corba/se/internal/ior/IdEncapsulation.java,Java,,4,4,10,18
/jdk1.4.2_19/com/sun/corba/se/internal/ior/IdEncapsulationBase.java,Java,,41,10,32,83
/jdk1.4.2_19/com/sun/corba/se/internal/ior/IdEncapsulationContainerBase.java,Java,,35,5,27,67
/jdk1.4.2_19/com/sun/corba/se/internal/ior/IdEncapsulationFactory.java,Java,,6,4,9,19
/jdk1.4.2_19/com/sun/corba/se/internal/ior/IdEncapsulationFactoryFinder.java,Java,,7,5,18,30
/jdk1.4.2_19/com/sun/corba/se/internal/ior/Identifiable.java,Java,,5,5,16,26
/jdk1.4.2_19/com/sun/corba/se/internal/ior/IdentifiableContainerBase.java,Java,,44,10,23,77
/jdk1.4.2_19/com/sun/corba/se/internal/ior/IIOPAddress.java,Java,,8,6,10,24
/jdk1.4.2_19/com/sun/corba/se/internal/ior/IIOPAddressBase.java,Java,,37,11,16,64
/jdk1.4.2_19/com/sun/corba/se/internal/ior/IIOPAddressFutureImpl.java,Java,,24,9,10,43
/jdk1.4.2_19/com/sun/corba/se/internal/ior/IIOPAddressImpl.java,Java,,30,10,10,50
/jdk1.4.2_19/com/sun/corba/se/internal/ior/IIOPProfile.java,Java,,138,32,33,203
/jdk1.4.2_19/com/sun/corba/se/internal/ior/IIOPProfileTemplate.java,Java,,85,24,30,139
/jdk1.4.2_19/com/sun/corba/se/internal/ior/IOR.java,Java,,138,40,55,233
/jdk1.4.2_19/com/sun/corba/se/internal/ior/IORTemplate.java,Java,,19,6,16,41
/jdk1.4.2_19/com/sun/corba/se/internal/ior/JavaCodebaseComponent.java,Java,,37,13,29,79
/jdk1.4.2_19/com/sun/corba/se/internal/ior/JIDLObjectKeyTemplate.java,Java,,31,7,18,56
/jdk1.4.2_19/com/sun/corba/se/internal/ior/MinorCodes.java,Java,,5,4,9,18
/jdk1.4.2_19/com/sun/corba/se/internal/ior/NewObjectKeyTemplateBase.java,Java,,31,7,27,65
/jdk1.4.2_19/com/sun/corba/se/internal/ior/ObjectId.java,Java,,21,9,10,40
/jdk1.4.2_19/com/sun/corba/se/internal/ior/ObjectIds.java,Java,,3,4,10,17
/jdk1.4.2_19/com/sun/corba/se/internal/ior/ObjectKey.java,Java,,45,13,10,68
/jdk1.4.2_19/com/sun/corba/se/internal/ior/ObjectKeyFactory.java,Java,,57,17,29,103
/jdk1.4.2_19/com/sun/corba/se/internal/ior/ObjectKeyTemplate.java,Java,,20,15,34,69
/jdk1.4.2_19/com/sun/corba/se/internal/ior/ObjectKeyTemplateBase.java,Java,,71,16,44,131
/jdk1.4.2_19/com/sun/corba/se/internal/ior/OldJIDLObjectKeyTemplate.java,Java,,53,13,38,104
/jdk1.4.2_19/com/sun/corba/se/internal/ior/OldObjectKeyTemplateBase.java,Java,,21,5,19,45
/jdk1.4.2_19/com/sun/corba/se/internal/ior/OldPOAObjectKeyTemplate.java,Java,,64,15,28,107
/jdk1.4.2_19/com/sun/corba/se/internal/ior/ORBTypeComponent.java,Java,,37,13,36,86
/jdk1.4.2_19/com/sun/corba/se/internal/ior/POAId.java,Java,,8,6,7,21
/jdk1.4.2_19/com/sun/corba/se/internal/ior/POAIdArray.java,Java,,30,10,7,47
/jdk1.4.2_19/com/sun/corba/se/internal/ior/POAIdBase.java,Java,,46,15,7,68
/jdk1.4.2_19/com/sun/corba/se/internal/ior/POAIdPOAView.java,Java,,42,13,7,62
/jdk1.4.2_19/com/sun/corba/se/internal/ior/POAObjectKeyTemplate.java,Java,,81,22,30,133
/jdk1.4.2_19/com/sun/corba/se/internal/ior/POAView.java,Java,,6,4,6,16
/jdk1.4.2_19/com/sun/corba/se/internal/ior/PoliciesComponent.java,Java,,17,7,29,53
/jdk1.4.2_19/com/sun/corba/se/internal/ior/TaggedComponent.java,Java,,6,5,16,27
/jdk1.4.2_19/com/sun/corba/se/internal/ior/TaggedComponentBase.java,Java,,16,4,10,30
/jdk1.4.2_19/com/sun/corba/se/internal/ior/TaggedComponentFactories.java,Java,,69,17,27,113
/jdk1.4.2_19/com/sun/corba/se/internal/ior/TaggedComponentFactoryFinder.java,Java,,55,14,41,110
/jdk1.4.2_19/com/sun/corba/se/internal/ior/TaggedProfile.java,Java,,8,6,22,36
/jdk1.4.2_19/com/sun/corba/se/internal/ior/TaggedProfileFactoryFinder.java,Java,,27,8,19,54
/jdk1.4.2_19/com/sun/corba/se/internal/ior/TaggedProfileTemplate.java,Java,,7,4,10,21
/jdk1.4.2_19/com/sun/corba/se/internal/ior/WireObjectKeyTemplate.java,Java,,57,12,20,89
/jdk1.4.2_19/com/sun/corba/se/internal/ior/Writeable.java,Java,,6,5,17,28
/jdk1.4.2_19/com/sun/corba/se/internal/javax/rmi/CORBA/StubDelegateImpl.java,Java,,166,68,95,329
/jdk1.4.2_19/com/sun/corba/se/internal/javax/rmi/CORBA/Util.java,Java,,314,113,173,600
/jdk1.4.2_19/com/sun/corba/se/internal/javax/rmi/PortableRemoteObject.java,Java,,186,131,135,452
/jdk1.4.2_19/com/sun/corba/se/internal/orbutil/CacheTable.java,Java,,117,1,9,127
/jdk1.4.2_19/com/sun/corba/se/internal/orbutil/Condition.java,Java,,33,9,11,53
/jdk1.4.2_19/com/sun/corba/se/internal/orbutil/CorbaResourceUtil.java,Java,,57,14,6,77
/jdk1.4.2_19/com/sun/corba/se/internal/orbutil/HexOutputStream.java,Java,,30,10,23,63
/jdk1.4.2_19/com/sun/corba/se/internal/orbutil/IIOPInputStream_1_3.java,Java,,19,4,16,39
/jdk1.4.2_19/com/sun/corba/se/internal/orbutil/IIOPInputStream_1_3_1.java,Java,,15,5,15,35
/jdk1.4.2_19/com/sun/corba/se/internal/orbutil/IIOPOutputStream_1_3.java,Java,,24,6,20,50
/jdk1.4.2_19/com/sun/corba/se/internal/orbutil/IIOPOutputStream_1_3_1.java,Java,,20,9,19,48
/jdk1.4.2_19/com/sun/corba/se/internal/orbutil/LegacyHookGetFields.java,Java,,73,24,41,138
/jdk1.4.2_19/com/sun/corba/se/internal/orbutil/LegacyHookPutFields.java,Java,,37,13,42,92
/jdk1.4.2_19/com/sun/corba/se/internal/orbutil/Lock.java,Java,,22,7,10,39
/jdk1.4.2_19/com/sun/corba/se/internal/orbutil/MinorCodes.java,Java,,130,90,371,591
/jdk1.4.2_19/com/sun/corba/se/internal/orbutil/ObjectStreamClassUtil_1_3.java,Java,,370,71,112,553
/jdk1.4.2_19/com/sun/corba/se/internal/orbutil/ObjectStreamClass_1_3_1.java,Java,,713,162,394,1269
/jdk1.4.2_19/com/sun/corba/se/internal/orbutil/ObjectStreamField.java,Java,,149,34,70,253
/jdk1.4.2_19/com/sun/corba/se/internal/orbutil/ORBClassLoader.java,Java,,15,2,12,29
/jdk1.4.2_19/com/sun/corba/se/internal/orbutil/ORBConstants.java,Java,,124,68,103,295
/jdk1.4.2_19/com/sun/corba/se/internal/orbutil/ORBUtility.java,Java,,466,76,120,662
/jdk1.4.2_19/com/sun/corba/se/internal/orbutil/RepIdDelegator.java,Java,,102,31,18,151
/jdk1.4.2_19/com/sun/corba/se/internal/orbutil/RepIdDelegator_1_3.java,Java,,102,31,18,151
/jdk1.4.2_19/com/sun/corba/se/internal/orbutil/RepIdDelegator_1_3_1.java,Java,,102,31,18,151
/jdk1.4.2_19/com/sun/corba/se/internal/orbutil/RepositoryIdCache_1_3.java,Java,,41,18,35,94
/jdk1.4.2_19/com/sun/corba/se/internal/orbutil/RepositoryIdCache_1_3_1.java,Java,,41,18,27,86
/jdk1.4.2_19/com/sun/corba/se/internal/orbutil/RepositoryIdFactory.java,Java,,56,9,20,85
/jdk1.4.2_19/com/sun/corba/se/internal/orbutil/RepositoryIdInterface.java,Java,,14,6,10,30
/jdk1.4.2_19/com/sun/corba/se/internal/orbutil/RepositoryIdStrings.java,Java,,16,9,10,35
/jdk1.4.2_19/com/sun/corba/se/internal/orbutil/RepositoryIdUtility.java,Java,,18,6,15,39
/jdk1.4.2_19/com/sun/corba/se/internal/orbutil/RepositoryId_1_3.java,Java,,671,168,136,975
/jdk1.4.2_19/com/sun/corba/se/internal/orbutil/RepositoryId_1_3_1.java,Java,,717,182,148,1047
/jdk1.4.2_19/com/sun/corba/se/internal/orbutil/resources/sunorb.java,Java,,77,2,0,79
/jdk1.4.2_19/com/sun/corba/se/internal/orbutil/resources/sunorb_de.java,Java,,77,2,0,79
/jdk1.4.2_19/com/sun/corba/se/internal/orbutil/resources/sunorb_es.java,Java,,77,2,0,79
/jdk1.4.2_19/com/sun/corba/se/internal/orbutil/resources/sunorb_fr.java,Java,,78,2,0,80
/jdk1.4.2_19/com/sun/corba/se/internal/orbutil/resources/sunorb_it.java,Java,,77,2,0,79
/jdk1.4.2_19/com/sun/corba/se/internal/orbutil/resources/sunorb_ja.java,Java,,77,2,0,79
/jdk1.4.2_19/com/sun/corba/se/internal/orbutil/resources/sunorb_ko.java,Java,,77,2,0,79
/jdk1.4.2_19/com/sun/corba/se/internal/orbutil/resources/sunorb_sv.java,Java,,77,2,0,79
/jdk1.4.2_19/com/sun/corba/se/internal/orbutil/resources/sunorb_zh_CN.java,Java,,77,2,0,79
/jdk1.4.2_19/com/sun/corba/se/internal/orbutil/resources/sunorb_zh_TW.java,Java,,77,2,0,79
/jdk1.4.2_19/com/sun/corba/se/internal/orbutil/SubcontractList.java,Java,,20,9,18,47
/jdk1.4.2_19/com/sun/corba/se/internal/orbutil/ThreadPool.java,Java,,90,37,60,187
/jdk1.4.2_19/com/sun/corba/se/internal/orbutil/TransientObjectManager.java,Java,,135,37,21,193
/jdk1.4.2_19/com/sun/corba/se/internal/orbutil/ValueHandlerImpl_1_3.java,Java,,124,33,79,236
/jdk1.4.2_19/com/sun/corba/se/internal/orbutil/ValueHandlerImpl_1_3_1.java,Java,,24,7,28,59
/jdk1.4.2_19/com/sun/corba/se/internal/orbutil/Work.java,Java,,6,3,23,32
/jdk1.4.2_19/com/sun/corba/se/internal/PCosNaming/InternalBindingKey.java,Java,,79,13,41,133
/jdk1.4.2_19/com/sun/corba/se/internal/PCosNaming/InternalBindingValue.java,Java,,25,8,33,66
/jdk1.4.2_19/com/sun/corba/se/internal/PCosNaming/NameServer.java,Java,,47,17,21,85
/jdk1.4.2_19/com/sun/corba/se/internal/PCosNaming/NameService.java,Java,,128,23,75,226
/jdk1.4.2_19/com/sun/corba/se/internal/PCosNaming/NamingContextImpl.java,Java,,699,103,562,1364
/jdk1.4.2_19/com/sun/corba/se/internal/PCosNaming/PersistentBindingIterator.java,Java,,66,12,61,139
/jdk1.4.2_19/com/sun/corba/se/internal/PCosNaming/ServantManagerImpl.java,Java,,180,50,30,260
/jdk1.4.2_19/com/sun/corba/se/internal/POA/ActiveObjectMap.java,Java,,137,25,12,174
/jdk1.4.2_19/com/sun/corba/se/internal/POA/BadServerIdHandler.java,Java,,7,3,28,38
/jdk1.4.2_19/com/sun/corba/se/internal/POA/ClientSC.java,Java,,7,4,12,23
/jdk1.4.2_19/com/sun/corba/se/internal/POA/DelegateImpl.java,Java,,92,20,23,135
/jdk1.4.2_19/com/sun/corba/se/internal/POA/ForwardException.java,Java,,13,6,24,43
/jdk1.4.2_19/com/sun/corba/se/internal/POA/GenericPOAClientSC.java,Java,,270,70,140,480
/jdk1.4.2_19/com/sun/corba/se/internal/POA/GenericPOAServerSC.java,Java,,485,122,152,759
/jdk1.4.2_19/com/sun/corba/se/internal/POA/IdAssignmentPolicyImpl.java,Java,,30,10,6,46
/jdk1.4.2_19/com/sun/corba/se/internal/POA/IdUniquenessPolicyImpl.java,Java,,29,10,6,45
/jdk1.4.2_19/com/sun/corba/se/internal/POA/ImplicitActivationPolicyImpl.java,Java,,31,10,6,47
/jdk1.4.2_19/com/sun/corba/se/internal/POA/InvocationInfo.java,Java,,35,11,10,56
/jdk1.4.2_19/com/sun/corba/se/internal/POA/LifespanPolicyImpl.java,Java,,29,10,6,45
/jdk1.4.2_19/com/sun/corba/se/internal/POA/MinorCodes.java,Java,,51,11,38,100
/jdk1.4.2_19/com/sun/corba/se/internal/POA/POACurrent.java,Java,,154,30,28,212
/jdk1.4.2_19/com/sun/corba/se/internal/POA/POADestroyed.java,Java,,3,1,6,10
/jdk1.4.2_19/com/sun/corba/se/internal/POA/POAImpl.java,Java,,864,192,272,1328
/jdk1.4.2_19/com/sun/corba/se/internal/POA/POAManagerImpl.java,Java,,159,39,86,284
/jdk1.4.2_19/com/sun/corba/se/internal/POA/POAORB.java,Java,,533,125,329,987
/jdk1.4.2_19/com/sun/corba/se/internal/POA/POAPolicyCombinationValidator.java,Java,,190,18,50,258
/jdk1.4.2_19/com/sun/corba/se/internal/POA/Policies.java,Java,,167,29,17,213
/jdk1.4.2_19/com/sun/corba/se/internal/POA/RequestProcessingPolicyImpl.java,Java,,40,11,6,57
/jdk1.4.2_19/com/sun/corba/se/internal/POA/ServantCachePOAClientSC.java,Java,,90,22,35,147
/jdk1.4.2_19/com/sun/corba/se/internal/POA/ServantRetentionPolicyImpl.java,Java,,29,10,6,45
/jdk1.4.2_19/com/sun/corba/se/internal/POA/ShutdownUtilDelegate.java,Java,,23,7,8,38
/jdk1.4.2_19/com/sun/corba/se/internal/POA/SpecialMethod.java,Java,,84,16,6,106
/jdk1.4.2_19/com/sun/corba/se/internal/POA/SubcontractResponseHandler.java,Java,,87,27,31,145
/jdk1.4.2_19/com/sun/corba/se/internal/POA/ThreadPolicyImpl.java,Java,,29,10,6,45
/jdk1.4.2_19/com/sun/corba/se/internal/util/IdentityHashtable.java,Java,,195,37,176,408
/jdk1.4.2_19/com/sun/corba/se/internal/util/JDKBridge.java,Java,,97,22,74,193
/jdk1.4.2_19/com/sun/corba/se/internal/util/JDKClassLoader.java,Java,,116,31,79,226
/jdk1.4.2_19/com/sun/corba/se/internal/util/MinorCodes.java,Java,,14,12,48,74
/jdk1.4.2_19/com/sun/corba/se/internal/util/ORBProperties.java,Java,,29,11,16,56
/jdk1.4.2_19/com/sun/corba/se/internal/util/PackagePrefixChecker.java,Java,,37,14,10,61
/jdk1.4.2_19/com/sun/corba/se/internal/util/RepositoryId.java,Java,,672,177,125,974
/jdk1.4.2_19/com/sun/corba/se/internal/util/RepositoryIdCache.java,Java,,41,18,35,94
/jdk1.4.2_19/com/sun/corba/se/internal/util/SUNVMCID.java,Java,,4,4,15,23
/jdk1.4.2_19/com/sun/corba/se/internal/util/Utility.java,Java,,661,184,268,1113
/jdk1.4.2_19/com/sun/corba/se/internal/util/Version.java,Java,,16,5,14,35
/jdk1.4.2_19/com/sun/corba/se/org/omg/CORBA/ORB.java,Java,,11,3,25,39
/jdk1.4.2_19/com/sun/image/codec/jpeg/ImageFormatException.java,Java,,10,4,40,54
/jdk1.4.2_19/com/sun/image/codec/jpeg/JPEGCodec.java,Java,,49,13,90,152
/jdk1.4.2_19/com/sun/image/codec/jpeg/JPEGDecodeParam.java,Java,,62,45,264,371
/jdk1.4.2_19/com/sun/image/codec/jpeg/JPEGEncodeParam.java,Java,,27,20,211,258
/jdk1.4.2_19/com/sun/image/codec/jpeg/JPEGHuffmanTable.java,Java,,139,31,73,243
/jdk1.4.2_19/com/sun/image/codec/jpeg/JPEGImageDecoder.java,Java,,23,14,105,142
/jdk1.4.2_19/com/sun/image/codec/jpeg/JPEGImageEncoder.java,Java,,29,23,180,232
/jdk1.4.2_19/com/sun/image/codec/jpeg/JPEGQTable.java,Java,,62,20,70,152
/jdk1.4.2_19/com/sun/image/codec/jpeg/TruncatedFileException.java,Java,,19,8,57,84
/jdk1.4.2_19/com/sun/imageio/plugins/common/InputStreamAdapter.java,Java,,17,8,9,34
/jdk1.4.2_19/com/sun/imageio/plugins/common/StandardMetadataFormat.java,Java,,363,61,57,481
/jdk1.4.2_19/com/sun/imageio/plugins/common/StandardMetadataFormatResources.java,Java,,129,55,8,192
/jdk1.4.2_19/com/sun/imageio/plugins/common/SubImageInputStream.java,Java,,40,10,9,59
/jdk1.4.2_19/com/sun/imageio/plugins/gif/GIFImageMetadata.java,Java,,293,70,46,409
/jdk1.4.2_19/com/sun/imageio/plugins/gif/GIFImageMetadataFormat.java,Java,,122,16,15,153
/jdk1.4.2_19/com/sun/imageio/plugins/gif/GIFImageMetadataFormatResources.java,Java,,70,8,8,86
/jdk1.4.2_19/com/sun/imageio/plugins/gif/GIFImageReader.java,Java,,801,161,183,1145
/jdk1.4.2_19/com/sun/imageio/plugins/gif/GIFImageReaderSpi.java,Java,,56,17,9,82
/jdk1.4.2_19/com/sun/imageio/plugins/gif/GIFStreamMetadata.java,Java,,181,54,35,270
/jdk1.4.2_19/com/sun/imageio/plugins/gif/GIFStreamMetadataFormat.java,Java,,67,11,10,88
/jdk1.4.2_19/com/sun/imageio/plugins/gif/GIFStreamMetadataFormatResources.java,Java,,37,8,8,53
/jdk1.4.2_19/com/sun/imageio/plugins/jpeg/AdobeMarkerSegment.java,Java,,90,15,14,119
/jdk1.4.2_19/com/sun/imageio/plugins/jpeg/COMMarkerSegment.java,Java,,57,13,46,116
/jdk1.4.2_19/com/sun/imageio/plugins/jpeg/DHTMarkerSegment.java,Java,,177,30,35,242
/jdk1.4.2_19/com/sun/imageio/plugins/jpeg/DQTMarkerSegment.java,Java,,218,26,48,292
/jdk1.4.2_19/com/sun/imageio/plugins/jpeg/DRIMarkerSegment.java,Java,,37,12,17,66
/jdk1.4.2_19/com/sun/imageio/plugins/jpeg/JFIFMarkerSegment.java,Java,,1201,131,215,1547
/jdk1.4.2_19/com/sun/imageio/plugins/jpeg/JPEG.java,Java,,196,48,96,340
/jdk1.4.2_19/com/sun/imageio/plugins/jpeg/JPEGBuffer.java,Java,,134,20,83,237
/jdk1.4.2_19/com/sun/imageio/plugins/jpeg/JPEGImageMetadataFormat.java,Java,,302,37,9,348
/jdk1.4.2_19/com/sun/imageio/plugins/jpeg/JPEGImageMetadataFormatResources.java,Java,,106,7,12,125
/jdk1.4.2_19/com/sun/imageio/plugins/jpeg/JPEGImageReader.java,Java,,897,162,295,1354
/jdk1.4.2_19/com/sun/imageio/plugins/jpeg/JPEGImageReaderResources.java,Java,,13,7,6,26
/jdk1.4.2_19/com/sun/imageio/plugins/jpeg/JPEGImageReaderSpi.java,Java,,68,12,12,92
/jdk1.4.2_19/com/sun/imageio/plugins/jpeg/JPEGImageWriter.java,Java,,1233,164,211,1608
/jdk1.4.2_19/com/sun/imageio/plugins/jpeg/JPEGImageWriterResources.java,Java,,51,7,6,64
/jdk1.4.2_19/com/sun/imageio/plugins/jpeg/JPEGImageWriterSpi.java,Java,,73,16,9,98
/jdk1.4.2_19/com/sun/imageio/plugins/jpeg/JPEGMetadata.java,Java,,1788,186,424,2398
/jdk1.4.2_19/com/sun/imageio/plugins/jpeg/JPEGMetadataFormat.java,Java,,105,17,17,139
/jdk1.4.2_19/com/sun/imageio/plugins/jpeg/JPEGMetadataFormatResources.java,Java,,30,5,8,43
/jdk1.4.2_19/com/sun/imageio/plugins/jpeg/JPEGStreamMetadataFormat.java,Java,,17,6,6,29
/jdk1.4.2_19/com/sun/imageio/plugins/jpeg/JPEGStreamMetadataFormatResources.java,Java,,14,5,9,28
/jdk1.4.2_19/com/sun/imageio/plugins/jpeg/MarkerSegment.java,Java,,139,21,47,207
/jdk1.4.2_19/com/sun/imageio/plugins/jpeg/SOFMarkerSegment.java,Java,,219,25,22,266
/jdk1.4.2_19/com/sun/imageio/plugins/jpeg/SOSMarkerSegment.java,Java,,179,24,20,223
/jdk1.4.2_19/com/sun/imageio/plugins/png/PNGImageReader.java,Java,,1208,224,162,1594
/jdk1.4.2_19/com/sun/imageio/plugins/png/PNGImageReaderSpi.java,Java,,63,16,9,88
/jdk1.4.2_19/com/sun/imageio/plugins/png/PNGImageWriter.java,Java,,860,171,76,1107
/jdk1.4.2_19/com/sun/imageio/plugins/png/PNGImageWriterSpi.java,Java,,75,19,16,110
/jdk1.4.2_19/com/sun/imageio/plugins/png/PNGMetadata.java,Java,,1598,243,151,1992
/jdk1.4.2_19/com/sun/imageio/plugins/png/PNGMetadataFormat.java,Java,,323,118,41,482
/jdk1.4.2_19/com/sun/imageio/plugins/png/PNGMetadataFormatResources.java,Java,,169,24,8,201
/jdk1.4.2_19/com/sun/imageio/plugins/png/RowFilter.java,Java,,132,33,12,177
/jdk1.4.2_19/com/sun/imageio/spi/FileImageInputStreamSpi.java,Java,,30,9,6,45
/jdk1.4.2_19/com/sun/imageio/spi/FileImageOutputStreamSpi.java,Java,,31,9,6,46
/jdk1.4.2_19/com/sun/imageio/spi/InputStreamImageInputStreamSpi.java,Java,,41,12,6,59
/jdk1.4.2_19/com/sun/imageio/spi/OutputStreamImageOutputStreamSpi.java,Java,,41,11,6,58
/jdk1.4.2_19/com/sun/imageio/spi/RAFImageInputStreamSpi.java,Java,,32,9,6,47
/jdk1.4.2_19/com/sun/imageio/spi/RAFImageOutputStreamSpi.java,Java,,33,9,6,48
/jdk1.4.2_19/com/sun/imageio/stream/StreamCloser.java,Java,,61,9,21,91
/jdk1.4.2_19/com/sun/java/swing/plaf/gtk/BluecurveColorType.java,Java,,23,8,17,48
/jdk1.4.2_19/com/sun/java/swing/plaf/gtk/BluecurveEngine.java,Java,,399,28,23,450
/jdk1.4.2_19/com/sun/java/swing/plaf/gtk/BluecurveEngineParser.java,Java,,79,19,16,114
/jdk1.4.2_19/com/sun/java/swing/plaf/gtk/BluecurveStyle.java,Java,,106,17,33,156
/jdk1.4.2_19/com/sun/java/swing/plaf/gtk/BlueprintEngine.java,Java,,871,102,163,1136
/jdk1.4.2_19/com/sun/java/swing/plaf/gtk/BlueprintEngineParser.java,Java,,896,175,39,1110
/jdk1.4.2_19/com/sun/java/swing/plaf/gtk/BlueprintGraphics.java,Java,,26,6,11,43
/jdk1.4.2_19/com/sun/java/swing/plaf/gtk/BlueprintStyle.java,Java,,481,118,91,690
/jdk1.4.2_19/com/sun/java/swing/plaf/gtk/CircularIdentityList.java,Java,,93,16,28,137
/jdk1.4.2_19/com/sun/java/swing/plaf/gtk/ColorType.java,Java,,30,12,37,79
/jdk1.4.2_19/com/sun/java/swing/plaf/gtk/DefaultMenuLayout.java,Java,,18,7,17,42
/jdk1.4.2_19/com/sun/java/swing/plaf/gtk/DefaultSynthStyle.java,Java,,285,39,59,383
/jdk1.4.2_19/com/sun/java/swing/plaf/gtk/GTKColorChooserPanel.java,Java,,852,147,279,1278
/jdk1.4.2_19/com/sun/java/swing/plaf/gtk/GTKColorType.java,Java,,107,14,28,149
/jdk1.4.2_19/com/sun/java/swing/plaf/gtk/GTKConstants.java,Java,,23,16,15,54
/jdk1.4.2_19/com/sun/java/swing/plaf/gtk/GTKEngine.java,Java,,1032,119,95,1246
/jdk1.4.2_19/com/sun/java/swing/plaf/gtk/GTKEngineParser.java,Java,,8,6,64,78
/jdk1.4.2_19/com/sun/java/swing/plaf/gtk/GTKFileChooserUI.java,Java,,848,184,86,1118
/jdk1.4.2_19/com/sun/java/swing/plaf/gtk/GTKGraphics.java,Java,,42,6,21,69
/jdk1.4.2_19/com/sun/java/swing/plaf/gtk/GTKIconFactory.java,Java,,339,51,36,426
/jdk1.4.2_19/com/sun/java/swing/plaf/gtk/GTKLookAndFeel.java,Java,,275,51,112,438
/jdk1.4.2_19/com/sun/java/swing/plaf/gtk/GTKPainter.java,Java,,1082,121,144,1347
/jdk1.4.2_19/com/sun/java/swing/plaf/gtk/GTKParser.java,Java,,1433,356,54,1843
/jdk1.4.2_19/com/sun/java/swing/plaf/gtk/GTKRegion.java,Java,,7,2,13,22
/jdk1.4.2_19/com/sun/java/swing/plaf/gtk/GTKScanner.java,Java,,639,123,15,777
/jdk1.4.2_19/com/sun/java/swing/plaf/gtk/GTKStyle.java,Java,,1701,283,212,2196
/jdk1.4.2_19/com/sun/java/swing/plaf/gtk/GTKStyleFactory.java,Java,,613,95,183,891
/jdk1.4.2_19/com/sun/java/swing/plaf/gtk/GTKTransferable.java,Java,,154,31,80,265
/jdk1.4.2_19/com/sun/java/swing/plaf/gtk/ImagePainter.java,Java,,157,24,25,206
/jdk1.4.2_19/com/sun/java/swing/plaf/gtk/LazyActionMap.java,Java,,96,19,65,180
/jdk1.4.2_19/com/sun/java/swing/plaf/gtk/Metacity.java,Java,,366,71,15,452
/jdk1.4.2_19/com/sun/java/swing/plaf/gtk/MetacityBluecurve.java,Java,,608,112,413,1133
/jdk1.4.2_19/com/sun/java/swing/plaf/gtk/MetacityCrux.java,Java,,464,79,308,851
/jdk1.4.2_19/com/sun/java/swing/plaf/gtk/PangoFonts.java,Java,,72,19,31,122
/jdk1.4.2_19/com/sun/java/swing/plaf/gtk/PixmapEngine.java,Java,,407,34,104,545
/jdk1.4.2_19/com/sun/java/swing/plaf/gtk/PixmapEngineParser.java,Java,,626,117,18,761
/jdk1.4.2_19/com/sun/java/swing/plaf/gtk/PixmapStyle.java,Java,,373,90,76,539
/jdk1.4.2_19/com/sun/java/swing/plaf/gtk/PropertyParser.java,Java,,103,34,10,147
/jdk1.4.2_19/com/sun/java/swing/plaf/gtk/Region.java,Java,,135,59,23,217
/jdk1.4.2_19/com/sun/java/swing/plaf/gtk/resources/gtk.java,Java,,43,2,0,45
/jdk1.4.2_19/com/sun/java/swing/plaf/gtk/resources/gtk_de.java,Java,,43,2,0,45
/jdk1.4.2_19/com/sun/java/swing/plaf/gtk/resources/gtk_es.java,Java,,43,2,0,45
/jdk1.4.2_19/com/sun/java/swing/plaf/gtk/resources/gtk_fr.java,Java,,43,2,0,45
/jdk1.4.2_19/com/sun/java/swing/plaf/gtk/resources/gtk_it.java,Java,,43,2,0,45
/jdk1.4.2_19/com/sun/java/swing/plaf/gtk/resources/gtk_ja.java,Java,,43,2,0,45
/jdk1.4.2_19/com/sun/java/swing/plaf/gtk/resources/gtk_ko.java,Java,,43,2,0,45
/jdk1.4.2_19/com/sun/java/swing/plaf/gtk/resources/gtk_sv.java,Java,,43,2,0,45
/jdk1.4.2_19/com/sun/java/swing/plaf/gtk/resources/gtk_zh_CN.java,Java,,43,2,0,45
/jdk1.4.2_19/com/sun/java/swing/plaf/gtk/resources/gtk_zh_TW.java,Java,,43,2,0,45
/jdk1.4.2_19/com/sun/java/swing/plaf/gtk/SynthArrowButton.java,Java,,46,14,21,81
/jdk1.4.2_19/com/sun/java/swing/plaf/gtk/SynthBorder.java,Java,,55,9,31,95
/jdk1.4.2_19/com/sun/java/swing/plaf/gtk/SynthButtonListener.java,Java,,233,42,44,319
/jdk1.4.2_19/com/sun/java/swing/plaf/gtk/SynthButtonUI.java,Java,,269,59,61,389
/jdk1.4.2_19/com/sun/java/swing/plaf/gtk/SynthCheckBoxMenuItemUI.java,Java,,34,16,15,65
/jdk1.4.2_19/com/sun/java/swing/plaf/gtk/SynthCheckBoxUI.java,Java,,14,6,15,35
/jdk1.4.2_19/com/sun/java/swing/plaf/gtk/SynthColorChooserUI.java,Java,,287,77,18,382
/jdk1.4.2_19/com/sun/java/swing/plaf/gtk/SynthComboBoxUI.java,Java,,1016,227,492,1735
/jdk1.4.2_19/com/sun/java/swing/plaf/gtk/SynthComboPopup.java,Java,,545,122,462,1129
/jdk1.4.2_19/com/sun/java/swing/plaf/gtk/SynthConstants.java,Java,,11,3,33,47
/jdk1.4.2_19/com/sun/java/swing/plaf/gtk/SynthContext.java,Java,,88,25,46,159
/jdk1.4.2_19/com/sun/java/swing/plaf/gtk/SynthDesktopIconUI.java,Java,,219,56,29,304
/jdk1.4.2_19/com/sun/java/swing/plaf/gtk/SynthDesktopPaneUI.java,Java,,505,68,99,672
/jdk1.4.2_19/com/sun/java/swing/plaf/gtk/SynthDragGestureRecognizer.java,Java,,83,25,31,139
/jdk1.4.2_19/com/sun/java/swing/plaf/gtk/SynthDropTargetListener.java,Java,,145,34,104,283
/jdk1.4.2_19/com/sun/java/swing/plaf/gtk/SynthEditorPaneUI.java,Java,,73,11,56,140
/jdk1.4.2_19/com/sun/java/swing/plaf/gtk/SynthEventListener.java,Java,,3,1,9,13
/jdk1.4.2_19/com/sun/java/swing/plaf/gtk/SynthFileChooserUI.java,Java,,762,149,94,1005
/jdk1.4.2_19/com/sun/java/swing/plaf/gtk/SynthFormattedTextFieldUI.java,Java,,11,3,25,39
/jdk1.4.2_19/com/sun/java/swing/plaf/gtk/SynthGraphics.java,Java,,209,38,146,393
/jdk1.4.2_19/com/sun/java/swing/plaf/gtk/SynthIcon.java,Java,,47,10,49,106
/jdk1.4.2_19/com/sun/java/swing/plaf/gtk/SynthInternalFrameTitlePane.java,Java,,494,92,85,671
/jdk1.4.2_19/com/sun/java/swing/plaf/gtk/SynthInternalFrameUI.java,Java,,1137,169,179,1485
/jdk1.4.2_19/com/sun/java/swing/plaf/gtk/SynthLabelUI.java,Java,,239,45,36,320
/jdk1.4.2_19/com/sun/java/swing/plaf/gtk/SynthListUI.java,Java,,1350,279,712,2341
/jdk1.4.2_19/com/sun/java/swing/plaf/gtk/SynthLookAndFeel.java,Java,,364,47,116,527
/jdk1.4.2_19/com/sun/java/swing/plaf/gtk/SynthMenuBarUI.java,Java,,211,48,27,286
/jdk1.4.2_19/com/sun/java/swing/plaf/gtk/SynthMenuItemUI.java,Java,,769,134,162,1065
/jdk1.4.2_19/com/sun/java/swing/plaf/gtk/SynthMenuUI.java,Java,,428,78,79,585
/jdk1.4.2_19/com/sun/java/swing/plaf/gtk/SynthOptionPaneUI.java,Java,,945,171,260,1376
/jdk1.4.2_19/com/sun/java/swing/plaf/gtk/SynthPainter.java,Java,,8,2,24,34
/jdk1.4.2_19/com/sun/java/swing/plaf/gtk/SynthPanelUI.java,Java,,78,24,13,115
/jdk1.4.2_19/com/sun/java/swing/plaf/gtk/SynthPasswordFieldUI.java,Java,,15,7,35,57
/jdk1.4.2_19/com/sun/java/swing/plaf/gtk/SynthPopupMenuUI.java,Java,,897,164,144,1205
/jdk1.4.2_19/com/sun/java/swing/plaf/gtk/SynthProgressBarUI.java,Java,,706,147,376,1229
/jdk1.4.2_19/com/sun/java/swing/plaf/gtk/SynthRadioButtonMenuItemUI.java,Java,,32,13,13,58
/jdk1.4.2_19/com/sun/java/swing/plaf/gtk/SynthRadioButtonUI.java,Java,,45,12,24,81
/jdk1.4.2_19/com/sun/java/swing/plaf/gtk/SynthRootPaneUI.java,Java,,157,34,24,215
/jdk1.4.2_19/com/sun/java/swing/plaf/gtk/SynthScrollBarUI.java,Java,,935,191,248,1374
/jdk1.4.2_19/com/sun/java/swing/plaf/gtk/SynthScrollPaneUI.java,Java,,697,131,165,993
/jdk1.4.2_19/com/sun/java/swing/plaf/gtk/SynthSeparatorUI.java,Java,,109,30,13,152
/jdk1.4.2_19/com/sun/java/swing/plaf/gtk/SynthSliderUI.java,Java,,1208,223,144,1575
/jdk1.4.2_19/com/sun/java/swing/plaf/gtk/SynthSpinnerUI.java,Java,,438,117,262,817
/jdk1.4.2_19/com/sun/java/swing/plaf/gtk/SynthSplitPaneUI.java,Java,,1506,333,563,2402
/jdk1.4.2_19/com/sun/java/swing/plaf/gtk/SynthStyle.java,Java,,136,32,105,273
/jdk1.4.2_19/com/sun/java/swing/plaf/gtk/SynthStyleFactory.java,Java,,12,3,19,34
/jdk1.4.2_19/com/sun/java/swing/plaf/gtk/SynthTabbedPaneUI.java,Java,,2237,346,374,2957
/jdk1.4.2_19/com/sun/java/swing/plaf/gtk/SynthTableHeaderUI.java,Java,,392,90,104,586
/jdk1.4.2_19/com/sun/java/swing/plaf/gtk/SynthTableUI.java,Java,,959,201,250,1410
/jdk1.4.2_19/com/sun/java/swing/plaf/gtk/SynthTextAreaUI.java,Java,,159,30,99,288
/jdk1.4.2_19/com/sun/java/swing/plaf/gtk/SynthTextFieldUI.java,Java,,155,27,158,340
/jdk1.4.2_19/com/sun/java/swing/plaf/gtk/SynthTextPaneUI.java,Java,,62,16,58,136
/jdk1.4.2_19/com/sun/java/swing/plaf/gtk/SynthTextUI.java,Java,,1217,224,950,2391
/jdk1.4.2_19/com/sun/java/swing/plaf/gtk/SynthToggleButtonUI.java,Java,,15,4,15,34
/jdk1.4.2_19/com/sun/java/swing/plaf/gtk/SynthToolBarUI.java,Java,,872,159,54,1085
/jdk1.4.2_19/com/sun/java/swing/plaf/gtk/SynthToolTipUI.java,Java,,163,35,28,226
/jdk1.4.2_19/com/sun/java/swing/plaf/gtk/SynthTransferable.java,Java,,154,32,80,266
/jdk1.4.2_19/com/sun/java/swing/plaf/gtk/SynthTreeUI.java,Java,,2376,449,705,3530
/jdk1.4.2_19/com/sun/java/swing/plaf/gtk/SynthUI.java,Java,,5,2,18,25
/jdk1.4.2_19/com/sun/java/swing/plaf/gtk/SynthViewportUI.java,Java,,86,24,15,125
/jdk1.4.2_19/com/sun/java/swing/plaf/gtk/TabContext.java,Java,,30,4,10,44
/jdk1.4.2_19/com/sun/java/swing/plaf/gtk/XColors.java,Java,,788,16,10,814
/jdk1.4.2_19/com/sun/java/swing/plaf/motif/MotifBorders.java,Java,,521,130,95,746
/jdk1.4.2_19/com/sun/java/swing/plaf/motif/MotifButtonListener.java,Java,,14,7,13,34
/jdk1.4.2_19/com/sun/java/swing/plaf/motif/MotifButtonUI.java,Java,,67,23,36,126
/jdk1.4.2_19/com/sun/java/swing/plaf/motif/MotifCheckBoxMenuItemUI.java,Java,,72,25,14,111
/jdk1.4.2_19/com/sun/java/swing/plaf/motif/MotifCheckBoxUI.java,Java,,26,13,25,64
/jdk1.4.2_19/com/sun/java/swing/plaf/motif/MotifComboBoxRenderer.java,Java,,44,17,35,96
/jdk1.4.2_19/com/sun/java/swing/plaf/motif/MotifComboBoxUI.java,Java,,245,41,30,316
/jdk1.4.2_19/com/sun/java/swing/plaf/motif/MotifDesktopIconUI.java,Java,,254,52,30,336
/jdk1.4.2_19/com/sun/java/swing/plaf/motif/MotifDesktopPaneUI.java,Java,,176,31,42,249
/jdk1.4.2_19/com/sun/java/swing/plaf/motif/MotifEditorPaneUI.java,Java,,13,7,33,53
/jdk1.4.2_19/com/sun/java/swing/plaf/motif/MotifFileChooserUI.java,Java,,565,122,60,747
/jdk1.4.2_19/com/sun/java/swing/plaf/motif/MotifGraphicsUtils.java,Java,,310,61,75,446
/jdk1.4.2_19/com/sun/java/swing/plaf/motif/MotifIconFactory.java,Java,,355,58,38,451
/jdk1.4.2_19/com/sun/java/swing/plaf/motif/MotifInternalFrameTitlePane.java,Java,,341,51,20,412
/jdk1.4.2_19/com/sun/java/swing/plaf/motif/MotifInternalFrameUI.java,Java,,136,29,42,207
/jdk1.4.2_19/com/sun/java/swing/plaf/motif/MotifLabelUI.java,Java,,11,4,20,35
/jdk1.4.2_19/com/sun/java/swing/plaf/motif/MotifLookAndFeel.java,Java,,977,128,58,1163
/jdk1.4.2_19/com/sun/java/swing/plaf/motif/MotifMenuBarUI.java,Java,,23,8,22,53
/jdk1.4.2_19/com/sun/java/swing/plaf/motif/MotifMenuItemUI.java,Java,,71,23,13,107
/jdk1.4.2_19/com/sun/java/swing/plaf/motif/MotifMenuMouseListener.java,Java,,17,2,12,31
/jdk1.4.2_19/com/sun/java/swing/plaf/motif/MotifMenuMouseMotionListener.java,Java,,11,3,12,26
/jdk1.4.2_19/com/sun/java/swing/plaf/motif/MotifMenuUI.java,Java,,95,24,27,146
/jdk1.4.2_19/com/sun/java/swing/plaf/motif/MotifOptionPaneUI.java,Java,,49,13,35,97
/jdk1.4.2_19/com/sun/java/swing/plaf/motif/MotifPasswordFieldUI.java,Java,,13,10,33,56
/jdk1.4.2_19/com/sun/java/swing/plaf/motif/MotifPopupMenuSeparatorUI.java,Java,,27,9,13,49
/jdk1.4.2_19/com/sun/java/swing/plaf/motif/MotifPopupMenuUI.java,Java,,62,15,23,100
/jdk1.4.2_19/com/sun/java/swing/plaf/motif/MotifProgressBarUI.java,Java,,13,6,22,41
/jdk1.4.2_19/com/sun/java/swing/plaf/motif/MotifRadioButtonMenuItemUI.java,Java,,75,23,20,118
/jdk1.4.2_19/com/sun/java/swing/plaf/motif/MotifRadioButtonUI.java,Java,,33,15,31,79
/jdk1.4.2_19/com/sun/java/swing/plaf/motif/MotifScrollBarButton.java,Java,,154,25,16,195
/jdk1.4.2_19/com/sun/java/swing/plaf/motif/MotifScrollBarUI.java,Java,,54,18,20,92
/jdk1.4.2_19/com/sun/java/swing/plaf/motif/MotifScrollPaneUI.java,Java,,85,20,19,124
/jdk1.4.2_19/com/sun/java/swing/plaf/motif/MotifSeparatorUI.java,Java,,16,9,21,46
/jdk1.4.2_19/com/sun/java/swing/plaf/motif/MotifSliderUI.java,Java,,82,29,32,143
/jdk1.4.2_19/com/sun/java/swing/plaf/motif/MotifSplitPaneDivider.java,Java,,181,36,61,278
/jdk1.4.2_19/com/sun/java/swing/plaf/motif/MotifSplitPaneUI.java,Java,,18,6,25,49
/jdk1.4.2_19/com/sun/java/swing/plaf/motif/MotifTabbedPaneUI.java,Java,,218,33,38,289
/jdk1.4.2_19/com/sun/java/swing/plaf/motif/MotifTextAreaUI.java,Java,,13,5,35,53
/jdk1.4.2_19/com/sun/java/swing/plaf/motif/MotifTextFieldUI.java,Java,,13,5,33,51
/jdk1.4.2_19/com/sun/java/swing/plaf/motif/MotifTextPaneUI.java,Java,,13,7,33,53
/jdk1.4.2_19/com/sun/java/swing/plaf/motif/MotifTextUI.java,Java,,69,13,76,158
/jdk1.4.2_19/com/sun/java/swing/plaf/motif/MotifToggleButtonUI.java,Java,,52,18,31,101
/jdk1.4.2_19/com/sun/java/swing/plaf/motif/MotifTreeCellRenderer.java,Java,,51,16,29,96
/jdk1.4.2_19/com/sun/java/swing/plaf/motif/MotifTreeUI.java,Java,,74,24,47,145
/jdk1.4.2_19/com/sun/java/swing/plaf/motif/resources/motif.java,Java,,26,2,0,28
/jdk1.4.2_19/com/sun/java/swing/plaf/motif/resources/motif_de.java,Java,,26,2,0,28
/jdk1.4.2_19/com/sun/java/swing/plaf/motif/resources/motif_es.java,Java,,26,2,0,28
/jdk1.4.2_19/com/sun/java/swing/plaf/motif/resources/motif_fr.java,Java,,26,2,0,28
/jdk1.4.2_19/com/sun/java/swing/plaf/motif/resources/motif_it.java,Java,,26,2,0,28
/jdk1.4.2_19/com/sun/java/swing/plaf/motif/resources/motif_ja.java,Java,,26,2,0,28
/jdk1.4.2_19/com/sun/java/swing/plaf/motif/resources/motif_ko.java,Java,,26,2,0,28
/jdk1.4.2_19/com/sun/java/swing/plaf/motif/resources/motif_sv.java,Java,,26,2,0,28
/jdk1.4.2_19/com/sun/java/swing/plaf/motif/resources/motif_zh_CN.java,Java,,26,2,0,28
/jdk1.4.2_19/com/sun/java/swing/plaf/motif/resources/motif_zh_TW.java,Java,,26,2,0,28
/jdk1.4.2_19/com/sun/java/swing/plaf/windows/DesktopProperty.java,Java,,137,31,106,274
/jdk1.4.2_19/com/sun/java/swing/plaf/windows/resources/windows.java,Java,,27,2,0,29
/jdk1.4.2_19/com/sun/java/swing/plaf/windows/resources/windows_de.java,Java,,27,2,0,29
/jdk1.4.2_19/com/sun/java/swing/plaf/windows/resources/windows_es.java,Java,,27,2,0,29
/jdk1.4.2_19/com/sun/java/swing/plaf/windows/resources/windows_fr.java,Java,,27,2,0,29
/jdk1.4.2_19/com/sun/java/swing/plaf/windows/resources/windows_it.java,Java,,27,2,0,29
/jdk1.4.2_19/com/sun/java/swing/plaf/windows/resources/windows_ja.java,Java,,27,2,0,29
/jdk1.4.2_19/com/sun/java/swing/plaf/windows/resources/windows_ko.java,Java,,27,2,0,29
/jdk1.4.2_19/com/sun/java/swing/plaf/windows/resources/windows_sv.java,Java,,27,2,0,29
/jdk1.4.2_19/com/sun/java/swing/plaf/windows/resources/windows_zh_CN.java,Java,,27,2,0,29
/jdk1.4.2_19/com/sun/java/swing/plaf/windows/resources/windows_zh_TW.java,Java,,27,2,0,29
/jdk1.4.2_19/com/sun/java/swing/plaf/windows/WindowsBorders.java,Java,,207,40,43,290
/jdk1.4.2_19/com/sun/java/swing/plaf/windows/WindowsButtonListener.java,Java,,12,8,32,52
/jdk1.4.2_19/com/sun/java/swing/plaf/windows/WindowsButtonUI.java,Java,,158,33,66,257
/jdk1.4.2_19/com/sun/java/swing/plaf/windows/WindowsCheckBoxMenuItemUI.java,Java,,6,6,16,28
/jdk1.4.2_19/com/sun/java/swing/plaf/windows/WindowsCheckBoxUI.java,Java,,28,14,28,70
/jdk1.4.2_19/com/sun/java/swing/plaf/windows/WindowsComboBoxUI.java,Java,,128,28,60,216
/jdk1.4.2_19/com/sun/java/swing/plaf/windows/WindowsDesktopIconUI.java,Java,,52,18,25,95
/jdk1.4.2_19/com/sun/java/swing/plaf/windows/WindowsDesktopManager.java,Java,,34,9,27,70
/jdk1.4.2_19/com/sun/java/swing/plaf/windows/WindowsDesktopPaneUI.java,Java,,26,7,20,53
/jdk1.4.2_19/com/sun/java/swing/plaf/windows/WindowsEditorPaneUI.java,Java,,14,7,30,51
/jdk1.4.2_19/com/sun/java/swing/plaf/windows/WindowsFileChooserUI.java,Java,,1724,290,173,2187
/jdk1.4.2_19/com/sun/java/swing/plaf/windows/WindowsGraphicsUtils.java,Java,,50,10,28,88
/jdk1.4.2_19/com/sun/java/swing/plaf/windows/WindowsIconFactory.java,Java,,404,63,47,514
/jdk1.4.2_19/com/sun/java/swing/plaf/windows/WindowsInternalFrameTitlePane.java,Java,,267,40,16,323
/jdk1.4.2_19/com/sun/java/swing/plaf/windows/WindowsInternalFrameUI.java,Java,,113,30,23,166
/jdk1.4.2_19/com/sun/java/swing/plaf/windows/WindowsLabelUI.java,Java,,51,14,21,86
/jdk1.4.2_19/com/sun/java/swing/plaf/windows/WindowsListUI.java,Java,,5,6,6,17
/jdk1.4.2_19/com/sun/java/swing/plaf/windows/WindowsLookAndFeel.java,Java,,1320,154,237,1711
/jdk1.4.2_19/com/sun/java/swing/plaf/windows/WindowsMenuBarUI.java,Java,,56,11,25,92
/jdk1.4.2_19/com/sun/java/swing/plaf/windows/WindowsMenuItemUI.java,Java,,32,12,28,72
/jdk1.4.2_19/com/sun/java/swing/plaf/windows/WindowsMenuUI.java,Java,,111,25,48,184
/jdk1.4.2_19/com/sun/java/swing/plaf/windows/WindowsOptionPaneUI.java,Java,,8,6,16,30
/jdk1.4.2_19/com/sun/java/swing/plaf/windows/WindowsPasswordFieldUI.java,Java,,13,9,30,52
/jdk1.4.2_19/com/sun/java/swing/plaf/windows/WindowsPopupMenuUI.java,Java,,43,11,27,81
/jdk1.4.2_19/com/sun/java/swing/plaf/windows/WindowsPopupWindow.java,Java,,34,10,34,78
/jdk1.4.2_19/com/sun/java/swing/plaf/windows/WindowsProgressBarUI.java,Java,,129,23,26,178
/jdk1.4.2_19/com/sun/java/swing/plaf/windows/WindowsRadioButtonMenuItemUI.java,Java,,6,5,16,27
/jdk1.4.2_19/com/sun/java/swing/plaf/windows/WindowsRadioButtonUI.java,Java,,51,19,34,104
/jdk1.4.2_19/com/sun/java/swing/plaf/windows/WindowsRootPaneUI.java,Java,,151,22,15,188
/jdk1.4.2_19/com/sun/java/swing/plaf/windows/WindowsScrollBarUI.java,Java,,287,46,48,381
/jdk1.4.2_19/com/sun/java/swing/plaf/windows/WindowsScrollPaneUI.java,Java,,5,6,16,27
/jdk1.4.2_19/com/sun/java/swing/plaf/windows/WindowsSeparatorUI.java,Java,,3,3,12,18
/jdk1.4.2_19/com/sun/java/swing/plaf/windows/WindowsSliderUI.java,Java,,81,18,17,116
/jdk1.4.2_19/com/sun/java/swing/plaf/windows/WindowsSpinnerUI.java,Java,,43,12,6,61
/jdk1.4.2_19/com/sun/java/swing/plaf/windows/WindowsSplitPaneDivider.java,Java,,23,7,25,55
/jdk1.4.2_19/com/sun/java/swing/plaf/windows/WindowsSplitPaneUI.java,Java,,18,10,22,50
/jdk1.4.2_19/com/sun/java/swing/plaf/windows/WindowsTabbedPaneUI.java,Java,,46,13,16,75
/jdk1.4.2_19/com/sun/java/swing/plaf/windows/WindowsTableHeaderUI.java,Java,,69,16,6,91
/jdk1.4.2_19/com/sun/java/swing/plaf/windows/WindowsTableUI.java,Java,,5,6,6,17
/jdk1.4.2_19/com/sun/java/swing/plaf/windows/WindowsTextAreaUI.java,Java,,13,8,30,51
/jdk1.4.2_19/com/sun/java/swing/plaf/windows/WindowsTextFieldUI.java,Java,,82,17,72,171
/jdk1.4.2_19/com/sun/java/swing/plaf/windows/WindowsTextPaneUI.java,Java,,14,6,30,50
/jdk1.4.2_19/com/sun/java/swing/plaf/windows/WindowsTextUI.java,Java,,139,15,65,219
/jdk1.4.2_19/com/sun/java/swing/plaf/windows/WindowsToggleButtonUI.java,Java,,93,27,37,157
/jdk1.4.2_19/com/sun/java/swing/plaf/windows/WindowsToolBarSeparatorUI.java,Java,,73,19,13,105
/jdk1.4.2_19/com/sun/java/swing/plaf/windows/WindowsToolBarUI.java,Java,,50,14,6,70
/jdk1.4.2_19/com/sun/java/swing/plaf/windows/WindowsTreeUI.java,Java,,137,28,56,221
/jdk1.4.2_19/com/sun/java/swing/plaf/windows/WindowsUtils.java,Java,,9,4,16,29
/jdk1.4.2_19/com/sun/java/swing/plaf/windows/XPStyle.java,Java,,564,74,159,797
/jdk1.4.2_19/com/sun/java/swing/SwingUtilities2.java,Java,,189,25,108,322
/jdk1.4.2_19/com/sun/naming/internal/FactoryEnumeration.java,Java,,50,10,33,93
/jdk1.4.2_19/com/sun/naming/internal/NamedWeakReference.java,Java,,11,8,12,31
/jdk1.4.2_19/com/sun/naming/internal/ResourceManager.java,Java,,263,53,228,544
/jdk1.4.2_19/com/sun/naming/internal/VersionHelper.java,Java,,65,21,52,138
/jdk1.4.2_19/com/sun/naming/internal/VersionHelper12.java,Java,,174,29,32,235
/jdk1.4.2_19/com/sun/security/auth/callback/DialogCallbackHandler.java,Java,,195,43,59,297
/jdk1.4.2_19/com/sun/security/auth/callback/TextCallbackHandler.java,Java,,220,38,36,294
/jdk1.4.2_19/com/sun/security/auth/login/ConfigFile.java,Java,,407,69,106,582
/jdk1.4.2_19/com/sun/security/auth/module/Crypt.java,Java,,259,55,67,381
/jdk1.4.2_19/com/sun/security/auth/module/JndiLoginModule.java,Java,,375,75,295,745
/jdk1.4.2_19/com/sun/security/auth/module/KeyStoreLoginModule.java,Java,,467,61,167,695
/jdk1.4.2_19/com/sun/security/auth/module/Krb5LoginModule.java,Java,defUsername,544,62,428,1034
/jdk1.4.2_19/com/sun/security/auth/module/NTLoginModule.java,Java,,227,32,119,378
/jdk1.4.2_19/com/sun/security/auth/module/NTSystem.java,Java,,43,15,69,127
/jdk1.4.2_19/com/sun/security/auth/module/SolarisLoginModule.java,Java,,148,25,122,295
/jdk1.4.2_19/com/sun/security/auth/module/SolarisSystem.java,Java,,26,10,44,80
/jdk1.4.2_19/com/sun/security/auth/module/UnixLoginModule.java,Java,,147,25,117,289
/jdk1.4.2_19/com/sun/security/auth/module/UnixSystem.java,Java,,26,10,44,80
/jdk1.4.2_19/com/sun/security/auth/NTDomainPrincipal.java,Java,,43,13,75,131
/jdk1.4.2_19/com/sun/security/auth/NTNumericCredential.java,Java,,33,12,57,102
/jdk1.4.2_19/com/sun/security/auth/NTSid.java,Java,,49,12,78,139
/jdk1.4.2_19/com/sun/security/auth/NTSidDomainPrincipal.java,Java,,23,8,58,89
/jdk1.4.2_19/com/sun/security/auth/NTSidGroupPrincipal.java,Java,,23,9,53,85
/jdk1.4.2_19/com/sun/security/auth/NTSidPrimaryGroupPrincipal.java,Java,,23,9,56,88
/jdk1.4.2_19/com/sun/security/auth/NTSidUserPrincipal.java,Java,,23,8,52,83
/jdk1.4.2_19/com/sun/security/auth/NTUserPrincipal.java,Java,,43,13,69,125
/jdk1.4.2_19/com/sun/security/auth/PolicyFile.java,Java,,758,137,555,1450
/jdk1.4.2_19/com/sun/security/auth/PolicyParser.java,Java,,609,106,229,944
/jdk1.4.2_19/com/sun/security/auth/PrincipalComparator.java,Java,,4,2,41,47
/jdk1.4.2_19/com/sun/security/auth/SolarisNumericGroupPrincipal.java,Java,,58,18,120,196
/jdk1.4.2_19/com/sun/security/auth/SolarisNumericUserPrincipal.java,Java,,47,17,98,162
/jdk1.4.2_19/com/sun/security/auth/SolarisPrincipal.java,Java,,39,15,72,126
/jdk1.4.2_19/com/sun/security/auth/SubjectCodeSource.java,Java,,190,43,150,383
/jdk1.4.2_19/com/sun/security/auth/UnixNumericGroupPrincipal.java,Java,,66,17,116,199
/jdk1.4.2_19/com/sun/security/auth/UnixNumericUserPrincipal.java,Java,,50,14,95,159
/jdk1.4.2_19/com/sun/security/auth/UnixPrincipal.java,Java,,42,13,69,124
/jdk1.4.2_19/com/sun/security/auth/X500Principal.java,Java,,59,20,86,165
/jdk1.4.2_19/com/sun/security/jgss/GSSUtil.java,Java,,11,5,38,54
/jdk1.4.2_19/java/applet/Applet.java,Java,,142,37,363,542
/jdk1.4.2_19/java/applet/AppletContext.java,Java,,21,12,142,175
/jdk1.4.2_19/java/applet/AppletStub.java,Java,,10,8,76,94
/jdk1.4.2_19/java/applet/AudioClip.java,Java,,6,4,26,36
/jdk1.4.2_19/java/awt/ActiveEvent.java,Java,,4,3,35,42
/jdk1.4.2_19/java/awt/Adjustable.java,Java,,22,23,91,136
/jdk1.4.2_19/java/awt/AlphaComposite.java,Java,,109,45,324,478
/jdk1.4.2_19/java/awt/AttributeValue.java,Java,,21,5,8,34
/jdk1.4.2_19/java/awt/AWTError.java,Java,,7,4,21,32
/jdk1.4.2_19/java/awt/AWTEvent.java,Java,,267,59,202,528
/jdk1.4.2_19/java/awt/AWTEventMulticaster.java,Java,,362,87,504,953
/jdk1.4.2_19/java/awt/AWTException.java,Java,,7,4,23,34
/jdk1.4.2_19/java/awt/AWTKeyStroke.java,Java,,332,55,340,727
/jdk1.4.2_19/java/awt/AWTPermission.java,Java,,13,9,137,159
/jdk1.4.2_19/java/awt/BasicStroke.java,Java,,257,56,256,569
/jdk1.4.2_19/java/awt/BorderLayout.java,Java,,262,50,428,740
/jdk1.4.2_19/java/awt/BufferCapabilities.java,Java,,60,21,117,198
/jdk1.4.2_19/java/awt/Button.java,Java,[PENDING:  WDW -- need to provide a localized string,203,53,385,641
/jdk1.4.2_19/java/awt/Canvas.java,Java,,58,19,141,218
/jdk1.4.2_19/java/awt/CardLayout.java,Java,,317,48,232,597
/jdk1.4.2_19/java/awt/Checkbox.java,Java,,279,70,485,834
/jdk1.4.2_19/java/awt/CheckboxGroup.java,Java,,32,9,90,131
/jdk1.4.2_19/java/awt/CheckboxMenuItem.java,Java,,182,50,373,605
/jdk1.4.2_19/java/awt/Choice.java,Java,,270,68,468,806
/jdk1.4.2_19/java/awt/color/CMMException.java,Java,,6,7,29,42
/jdk1.4.2_19/java/awt/color/ColorSpace.java,Java,,136,77,324,537
/jdk1.4.2_19/java/awt/color/ICC_ColorSpace.java,Java,,200,36,355,591
/jdk1.4.2_19/java/awt/color/ICC_Profile.java,Java,,809,343,777,1929
/jdk1.4.2_19/java/awt/color/ICC_ProfileGray.java,Java,,25,18,88,131
/jdk1.4.2_19/java/awt/color/ICC_ProfileRGB.java,Java,,73,34,156,263
/jdk1.4.2_19/java/awt/color/ProfileDataException.java,Java,,6,4,14,24
/jdk1.4.2_19/java/awt/Color.java,Java,,467,81,647,1195
/jdk1.4.2_19/java/awt/ColorPaintContext.java,Java,,31,11,6,48
/jdk1.4.2_19/java/awt/Component.java,Java,,3337,560,3962,7859
/jdk1.4.2_19/java/awt/ComponentOrientation.java,Java,,52,15,111,178
/jdk1.4.2_19/java/awt/Composite.java,Java,,7,5,57,69
/jdk1.4.2_19/java/awt/CompositeContext.java,Java,,9,8,35,52
/jdk1.4.2_19/java/awt/Conditional.java,Java,,4,2,14,20
/jdk1.4.2_19/java/awt/Container.java,Java,,1828,268,1452,3548
/jdk1.4.2_19/java/awt/ContainerOrderFocusTraversalPolicy.java,Java,,218,31,141,390
/jdk1.4.2_19/java/awt/Cursor.java,Java,,226,68,138,432
/jdk1.4.2_19/java/awt/datatransfer/Clipboard.java,Java,,24,15,55,94
/jdk1.4.2_19/java/awt/datatransfer/ClipboardOwner.java,Java,,4,5,30,39
/jdk1.4.2_19/java/awt/datatransfer/DataFlavor.java,Java,,494,138,699,1331
/jdk1.4.2_19/java/awt/datatransfer/FlavorMap.java,Java,,6,6,46,58
/jdk1.4.2_19/java/awt/datatransfer/FlavorTable.java,Java,,6,6,53,65
/jdk1.4.2_19/java/awt/datatransfer/MimeType.java,Java,,171,40,164,375
/jdk1.4.2_19/java/awt/datatransfer/MimeTypeParameterList.java,Java,,244,56,89,389
/jdk1.4.2_19/java/awt/datatransfer/MimeTypeParseException.java,Java,,10,6,20,36
/jdk1.4.2_19/java/awt/datatransfer/StringSelection.java,Java,,38,11,72,121
/jdk1.4.2_19/java/awt/datatransfer/SystemFlavorMap.java,Java,,657,108,426,1191
/jdk1.4.2_19/java/awt/datatransfer/Transferable.java,Java,,7,8,36,51
/jdk1.4.2_19/java/awt/datatransfer/UnsupportedFlavorException.java,Java,,7,4,22,33
/jdk1.4.2_19/java/awt/DefaultFocusTraversalPolicy.java,Java,,32,7,61,100
/jdk1.4.2_19/java/awt/DefaultKeyboardFocusManager.java,Java,,739,108,294,1141
/jdk1.4.2_19/java/awt/Dialog.java,Java,,309,65,435,809
/jdk1.4.2_19/java/awt/Dimension.java,Java,,58,20,139,217
/jdk1.4.2_19/java/awt/DisplayMode.java,Java,,35,11,59,105
/jdk1.4.2_19/java/awt/dnd/Autoscroll.java,Java,,7,9,47,63
/jdk1.4.2_19/java/awt/dnd/DnDConstants.java,Java,,10,14,44,68
/jdk1.4.2_19/java/awt/dnd/DnDEventMulticaster.java,Java,,82,19,116,217
/jdk1.4.2_19/java/awt/dnd/DragGestureEvent.java,Java,,86,55,197,338
/jdk1.4.2_19/java/awt/dnd/DragGestureListener.java,Java,,5,8,28,41
/jdk1.4.2_19/java/awt/dnd/DragGestureRecognizer.java,Java,,94,57,295,446
/jdk1.4.2_19/java/awt/dnd/DragSource.java,Java,,245,74,544,863
/jdk1.4.2_19/java/awt/dnd/DragSourceAdapter.java,Java,,10,8,101,119
/jdk1.4.2_19/java/awt/dnd/DragSourceContext.java,Java,,214,81,301,596
/jdk1.4.2_19/java/awt/dnd/DragSourceDragEvent.java,Java,,81,25,153,259
/jdk1.4.2_19/java/awt/dnd/DragSourceDropEvent.java,Java,,23,19,92,134
/jdk1.4.2_19/java/awt/dnd/DragSourceEvent.java,Java,,37,18,107,162
/jdk1.4.2_19/java/awt/dnd/DragSourceListener.java,Java,,9,15,82,106
/jdk1.4.2_19/java/awt/dnd/DragSourceMotionListener.java,Java,,5,5,34,44
/jdk1.4.2_19/java/awt/dnd/DropTarget.java,Java,,299,146,361,806
/jdk1.4.2_19/java/awt/dnd/DropTargetAdapter.java,Java,,7,6,69,82
/jdk1.4.2_19/java/awt/dnd/DropTargetContext.java,Java,,131,65,207,403
/jdk1.4.2_19/java/awt/dnd/DropTargetDragEvent.java,Java,,43,30,138,211
/jdk1.4.2_19/java/awt/dnd/DropTargetDropEvent.java,Java,,59,43,181,283
/jdk1.4.2_19/java/awt/dnd/DropTargetEvent.java,Java,,18,14,36,68
/jdk1.4.2_19/java/awt/dnd/DropTargetListener.java,Java,,12,22,99,133
/jdk1.4.2_19/java/awt/dnd/InvalidDnDOperationException.java,Java,,6,12,23,41
/jdk1.4.2_19/java/awt/dnd/MouseDragGestureRecognizer.java,Java,,35,35,110,180
/jdk1.4.2_19/java/awt/dnd/peer/DragSourceContextPeer.java,Java,,19,15,29,63
/jdk1.4.2_19/java/awt/dnd/peer/DropTargetContextPeer.java,Java,,23,30,49,102
/jdk1.4.2_19/java/awt/dnd/peer/DropTargetPeer.java,Java,,6,8,28,42
/jdk1.4.2_19/java/awt/dnd/SerializationTester.java,Java,,33,6,17,56
/jdk1.4.2_19/java/awt/event/ActionEvent.java,Java,,50,22,148,220
/jdk1.4.2_19/java/awt/event/ActionListener.java,Java,,5,5,26,36
/jdk1.4.2_19/java/awt/event/AdjustmentEvent.java,Java,,75,26,131,232
/jdk1.4.2_19/java/awt/event/AdjustmentListener.java,Java,,5,5,16,26
/jdk1.4.2_19/java/awt/event/AWTEventListener.java,Java,,6,5,34,45
/jdk1.4.2_19/java/awt/event/AWTEventListenerProxy.java,Java,,19,7,36,62
/jdk1.4.2_19/java/awt/event/ComponentAdapter.java,Java,,7,5,44,56
/jdk1.4.2_19/java/awt/event/ComponentEvent.java,Java,,45,14,81,140
/jdk1.4.2_19/java/awt/event/ComponentListener.java,Java,,8,6,44,58
/jdk1.4.2_19/java/awt/event/ContainerAdapter.java,Java,,5,3,38,46
/jdk1.4.2_19/java/awt/event/ContainerEvent.java,Java,,36,13,82,131
/jdk1.4.2_19/java/awt/event/ContainerListener.java,Java,,6,5,39,50
/jdk1.4.2_19/java/awt/event/FocusAdapter.java,Java,,5,3,38,46
/jdk1.4.2_19/java/awt/event/FocusEvent.java,Java,,53,19,137,209
/jdk1.4.2_19/java/awt/event/FocusListener.java,Java,,6,5,34,45
/jdk1.4.2_19/java/awt/event/HierarchyBoundsAdapter.java,Java,,6,3,35,44
/jdk1.4.2_19/java/awt/event/HierarchyBoundsListener.java,Java,,6,4,35,45
/jdk1.4.2_19/java/awt/event/HierarchyEvent.java,Java,,85,19,177,281
/jdk1.4.2_19/java/awt/event/HierarchyListener.java,Java,,5,3,32,40
/jdk1.4.2_19/java/awt/event/InputEvent.java,Java,,126,43,203,372
/jdk1.4.2_19/java/awt/event/InputMethodEvent.java,Java,,129,32,224,385
/jdk1.4.2_19/java/awt/event/InputMethodListener.java,Java,,6,7,26,39
/jdk1.4.2_19/java/awt/event/InvocationEvent.java,Java,,73,22,156,251
/jdk1.4.2_19/java/awt/event/ItemEvent.java,Java,,51,18,99,168
/jdk1.4.2_19/java/awt/event/ItemListener.java,Java,,5,5,30,40
/jdk1.4.2_19/java/awt/event/KeyAdapter.java,Java,,6,4,43,53
/jdk1.4.2_19/java/awt/event/KeyEvent.java,Java,,661,153,665,1479
/jdk1.4.2_19/java/awt/event/KeyListener.java,Java,,7,6,44,57
/jdk1.4.2_19/java/awt/event/MouseAdapter.java,Java,,8,6,53,67
/jdk1.4.2_19/java/awt/event/MouseEvent.java,Java,,271,47,384,702
/jdk1.4.2_19/java/awt/event/MouseListener.java,Java,,9,8,51,68
/jdk1.4.2_19/java/awt/event/MouseMotionAdapter.java,Java,,5,3,47,55
/jdk1.4.2_19/java/awt/event/MouseMotionListener.java,Java,,6,6,47,59
/jdk1.4.2_19/java/awt/event/MouseWheelEvent.java,Java,,49,23,215,287
/jdk1.4.2_19/java/awt/event/MouseWheelListener.java,Java,,5,4,29,38
/jdk1.4.2_19/java/awt/event/NativeLibLoader.java,Java,,7,3,31,41
/jdk1.4.2_19/java/awt/event/PaintEvent.java,Java,,36,13,63,112
/jdk1.4.2_19/java/awt/event/TextEvent.java,Java,,23,13,55,91
/jdk1.4.2_19/java/awt/event/TextListener.java,Java,,5,5,30,40
/jdk1.4.2_19/java/awt/event/WindowAdapter.java,Java,,15,11,75,101
/jdk1.4.2_19/java/awt/event/WindowEvent.java,Java,,98,31,240,369
/jdk1.4.2_19/java/awt/event/WindowFocusListener.java,Java,,6,5,42,53
/jdk1.4.2_19/java/awt/event/WindowListener.java,Java,,11,9,69,89
/jdk1.4.2_19/java/awt/event/WindowStateListener.java,Java,,5,3,29,37
/jdk1.4.2_19/java/awt/Event.java,Java,,230,106,526,862
/jdk1.4.2_19/java/awt/EventDispatchThread.java,Java,,178,38,112,328
/jdk1.4.2_19/java/awt/EventQueue.java,Java,,481,73,357,911
/jdk1.4.2_19/java/awt/FileDialog.java,Java,,112,30,227,369
/jdk1.4.2_19/java/awt/FlowLayout.java,Java,,189,40,282,511
/jdk1.4.2_19/java/awt/FocusTraversalPolicy.java,Java,,17,7,113,137
/jdk1.4.2_19/java/awt/font/CharArrayIterator.java,Java,,84,26,58,168
/jdk1.4.2_19/java/awt/font/FontRenderContext.java,Java,,56,15,98,169
/jdk1.4.2_19/java/awt/font/GlyphJustificationInfo.java,Java,,60,23,111,194
/jdk1.4.2_19/java/awt/font/GlyphMetrics.java,Java,,69,30,205,304
/jdk1.4.2_19/java/awt/font/GlyphVector.java,Java,,82,41,469,592
/jdk1.4.2_19/java/awt/font/GraphicAttribute.java,Java,,43,21,111,175
/jdk1.4.2_19/java/awt/font/ImageGraphicAttribute.java,Java,,68,36,108,212
/jdk1.4.2_19/java/awt/font/LineBreakMeasurer.java,Java,,113,36,367,516
/jdk1.4.2_19/java/awt/font/LineMetrics.java,Java,,14,16,98,128
/jdk1.4.2_19/java/awt/font/MultipleMaster.java,Java,,15,10,64,89
/jdk1.4.2_19/java/awt/font/NumericShaper.java,Java,,643,79,202,924
/jdk1.4.2_19/java/awt/font/OpenType.java,Java,,61,64,291,416
/jdk1.4.2_19/java/awt/font/ShapeGraphicAttribute.java,Java,,82,35,108,225
/jdk1.4.2_19/java/awt/font/StyledParagraph.java,Java,,280,64,131,475
/jdk1.4.2_19/java/awt/font/TextAttribute.java,Java,,79,65,760,904
/jdk1.4.2_19/java/awt/font/TextHitInfo.java,Java,,54,18,157,229
/jdk1.4.2_19/java/awt/font/TextJustifier.java,Java,,146,26,50,222
/jdk1.4.2_19/java/awt/font/TextLayout.java,Java,,1300,365,1057,2722
/jdk1.4.2_19/java/awt/font/TextLine.java,Java,,791,246,113,1150
/jdk1.4.2_19/java/awt/font/TextMeasurer.java,Java,,405,118,223,746
/jdk1.4.2_19/java/awt/font/TransformAttribute.java,Java,,31,12,48,91
/jdk1.4.2_19/java/awt/Font.java,Java,,896,168,1009,2073
/jdk1.4.2_19/java/awt/FontFormatException.java,Java,,7,2,20,29
/jdk1.4.2_19/java/awt/FontMetrics.java,Java,,135,36,398,569
/jdk1.4.2_19/java/awt/Frame.java,Java,,415,99,658,1172
/jdk1.4.2_19/java/awt/geom/AffineTransform.java,Java,,1769,136,1211,3116
/jdk1.4.2_19/java/awt/geom/Arc2D.java,Java,,582,111,692,1385
/jdk1.4.2_19/java/awt/geom/ArcIterator.java,Java,,151,10,64,225
/jdk1.4.2_19/java/awt/geom/Area.java,Java,,307,37,250,594
/jdk1.4.2_19/java/awt/geom/CubicCurve2D.java,Java,,674,112,855,1641
/jdk1.4.2_19/java/awt/geom/CubicIterator.java,Java,,66,9,64,139
/jdk1.4.2_19/java/awt/geom/Dimension2D.java,Java,,18,7,65,90
/jdk1.4.2_19/java/awt/geom/Ellipse2D.java,Java,,136,33,238,407
/jdk1.4.2_19/java/awt/geom/EllipseIterator.java,Java,,100,12,64,176
/jdk1.4.2_19/java/awt/geom/FlatteningPathIterator.java,Java,,184,36,158,378
/jdk1.4.2_19/java/awt/geom/GeneralPath.java,Java,,285,40,312,637
/jdk1.4.2_19/java/awt/geom/GeneralPathIterator.java,Java,,51,10,80,141
/jdk1.4.2_19/java/awt/geom/IllegalPathStateException.java,Java,,8,4,27,39
/jdk1.4.2_19/java/awt/geom/Line2D.java,Java,,297,72,635,1004
/jdk1.4.2_19/java/awt/geom/LineIterator.java,Java,,58,9,64,131
/jdk1.4.2_19/java/awt/geom/NoninvertibleTransformException.java,Java,,6,3,20,29
/jdk1.4.2_19/java/awt/geom/PathIterator.java,Java,,15,13,170,198
/jdk1.4.2_19/java/awt/geom/Point2D.java,Java,,112,32,226,370
/jdk1.4.2_19/java/awt/geom/QuadCurve2D.java,Java,,499,98,685,1282
/jdk1.4.2_19/java/awt/geom/QuadIterator.java,Java,,62,9,64,135
/jdk1.4.2_19/java/awt/geom/Rectangle2D.java,Java,,314,65,624,1003
/jdk1.4.2_19/java/awt/geom/RectangularShape.java,Java,,101,28,230,359
/jdk1.4.2_19/java/awt/geom/RectIterator.java,Java,,66,9,64,139
/jdk1.4.2_19/java/awt/geom/RoundRectangle2D.java,Java,,213,49,353,615
/jdk1.4.2_19/java/awt/geom/RoundRectIterator.java,Java,,92,11,69,172
/jdk1.4.2_19/java/awt/GradientPaint.java,Java,,85,19,141,245
/jdk1.4.2_19/java/awt/GradientPaintContext.java,Java,,209,23,44,276
/jdk1.4.2_19/java/awt/Graphics.java,Java,,163,57,985,1205
/jdk1.4.2_19/java/awt/Graphics2D.java,Java,,99,47,1070,1216
/jdk1.4.2_19/java/awt/GraphicsCallback.java,Java,,109,13,6,128
/jdk1.4.2_19/java/awt/GraphicsConfigTemplate.java,Java,,14,11,67,92
/jdk1.4.2_19/java/awt/GraphicsConfiguration.java,Java,,44,22,240,306
/jdk1.4.2_19/java/awt/GraphicsDevice.java,Java,,62,22,223,307
/jdk1.4.2_19/java/awt/GraphicsEnvironment.java,Java,,78,23,194,295
/jdk1.4.2_19/java/awt/GridBagConstraints.java,Java,,83,42,375,500
/jdk1.4.2_19/java/awt/GridBagLayout.java,Java,,640,135,757,1532
/jdk1.4.2_19/java/awt/GridLayout.java,Java,,154,23,273,450
/jdk1.4.2_19/java/awt/HeadlessException.java,Java,,7,2,14,23
/jdk1.4.2_19/java/awt/IllegalComponentStateException.java,Java,,10,4,26,40
/jdk1.4.2_19/java/awt/im/InputContext.java,Java,,39,18,256,313
/jdk1.4.2_19/java/awt/im/InputMethodHighlight.java,Java,,45,21,109,175
/jdk1.4.2_19/java/awt/im/InputMethodRequests.java,Java,,15,11,165,191
/jdk1.4.2_19/java/awt/im/InputSubset.java,Java,,24,15,58,97
/jdk1.4.2_19/java/awt/im/spi/InputMethod.java,Java,,23,22,313,358
/jdk1.4.2_19/java/awt/im/spi/InputMethodContext.java,Java,,15,8,94,117
/jdk1.4.2_19/java/awt/im/spi/InputMethodDescriptor.java,Java,,11,10,85,106
/jdk1.4.2_19/java/awt/image/AffineTransformOp.java,Java,,275,37,229,541
/jdk1.4.2_19/java/awt/image/AreaAveragingScaleFilter.java,Java,,164,11,89,264
/jdk1.4.2_19/java/awt/image/BandCombineOp.java,Java,,124,15,120,259
/jdk1.4.2_19/java/awt/image/BandedSampleModel.java,Java,,387,92,328,807
/jdk1.4.2_19/java/awt/image/BufferedImage.java,Java,,704,131,651,1486
/jdk1.4.2_19/java/awt/image/BufferedImageFilter.java,Java,,263,15,122,400
/jdk1.4.2_19/java/awt/image/BufferedImageOp.java,Java,,12,7,100,119
/jdk1.4.2_19/java/awt/image/BufferStrategy.java,Java,,11,9,136,156
/jdk1.4.2_19/java/awt/image/ByteLookupTable.java,Java,,79,13,101,193
/jdk1.4.2_19/java/awt/image/ColorConvertOp.java,Java,,712,80,270,1062
/jdk1.4.2_19/java/awt/image/ColorModel.java,Java,,702,89,1144,1935
/jdk1.4.2_19/java/awt/image/ComponentColorModel.java,Java,,1822,79,1028,2929
/jdk1.4.2_19/java/awt/image/ComponentSampleModel.java,Java,,596,112,460,1168
/jdk1.4.2_19/java/awt/image/ConvolveOp.java,Java,,134,31,149,314
/jdk1.4.2_19/java/awt/image/CropImageFilter.java,Java,,77,8,76,161
/jdk1.4.2_19/java/awt/image/DataBuffer.java,Java,,127,40,240,407
/jdk1.4.2_19/java/awt/image/DataBufferByte.java,Java,,63,18,130,211
/jdk1.4.2_19/java/awt/image/DataBufferDouble.java,Java,,86,26,210,322
/jdk1.4.2_19/java/awt/image/DataBufferFloat.java,Java,,86,26,213,325
/jdk1.4.2_19/java/awt/image/DataBufferInt.java,Java,,63,19,128,210
/jdk1.4.2_19/java/awt/image/DataBufferShort.java,Java,,63,19,127,209
/jdk1.4.2_19/java/awt/image/DataBufferUShort.java,Java,,94,21,129,244
/jdk1.4.2_19/java/awt/image/DirectColorModel.java,Java,,715,56,629,1400
/jdk1.4.2_19/java/awt/image/FilteredImageSource.java,Java,,60,10,64,134
/jdk1.4.2_19/java/awt/image/ImageConsumer.java,Java,,22,18,165,205
/jdk1.4.2_19/java/awt/image/ImageFilter.java,Java,,52,13,148,213
/jdk1.4.2_19/java/awt/image/ImageObserver.java,Java,,14,11,128,153
/jdk1.4.2_19/java/awt/image/ImageProducer.java,Java,,8,6,81,95
/jdk1.4.2_19/java/awt/image/ImagingOpException.java,Java,,6,4,18,28
/jdk1.4.2_19/java/awt/image/IndexColorModel.java,Java,,650,72,660,1382
/jdk1.4.2_19/java/awt/image/Kernel.java,Java,,59,19,64,142
/jdk1.4.2_19/java/awt/image/LookupOp.java,Java,,331,52,169,552
/jdk1.4.2_19/java/awt/image/LookupTable.java,Java,,25,10,57,92
/jdk1.4.2_19/java/awt/image/MemoryImageSource.java,Java,,215,24,308,547
/jdk1.4.2_19/java/awt/image/MultiPixelPackedSampleModel.java,Java,,291,60,323,674
/jdk1.4.2_19/java/awt/image/PackedColorModel.java,Java,,208,35,221,464
/jdk1.4.2_19/java/awt/image/PixelGrabber.java,Java,,308,28,315,651
/jdk1.4.2_19/java/awt/image/PixelInterleavedSampleModel.java,Java,,67,6,80,153
/jdk1.4.2_19/java/awt/image/Raster.java,Java,,636,137,965,1738
/jdk1.4.2_19/java/awt/image/RasterFormatException.java,Java,,6,4,17,27
/jdk1.4.2_19/java/awt/image/RasterOp.java,Java,,11,7,72,90
/jdk1.4.2_19/java/awt/image/renderable/ContextualRenderedImageFactory.java,Java,,15,9,101,125
/jdk1.4.2_19/java/awt/image/renderable/ParameterBlock.java,Java,,189,50,466,705
/jdk1.4.2_19/java/awt/image/renderable/RenderableImage.java,Java,,18,15,147,180
/jdk1.4.2_19/java/awt/image/renderable/RenderableImageOp.java,Java,,121,29,182,332
/jdk1.4.2_19/java/awt/image/renderable/RenderableImageProducer.java,Java,,93,19,89,201
/jdk1.4.2_19/java/awt/image/renderable/RenderContext.java,Java,,61,22,167,250
/jdk1.4.2_19/java/awt/image/renderable/RenderedImageFactory.java,Java,,7,4,49,60
/jdk1.4.2_19/java/awt/image/RenderedImage.java,Java,,27,25,147,199
/jdk1.4.2_19/java/awt/image/ReplicateScaleFilter.java,Java,,115,16,105,236
/jdk1.4.2_19/java/awt/image/RescaleOp.java,Java,,348,63,238,649
/jdk1.4.2_19/java/awt/image/RGBImageFilter.java,Java,,101,13,156,270
/jdk1.4.2_19/java/awt/image/SampleModel.java,Java,,464,152,750,1366
/jdk1.4.2_19/java/awt/image/ShortLookupTable.java,Java,,79,13,95,187
/jdk1.4.2_19/java/awt/image/SinglePixelPackedSampleModel.java,Java,,380,75,331,786
/jdk1.4.2_19/java/awt/image/TileObserver.java,Java,,6,4,27,37
/jdk1.4.2_19/java/awt/image/VolatileImage.java,Java,,30,23,257,310
/jdk1.4.2_19/java/awt/image/WritableRaster.java,Java,,223,37,463,723
/jdk1.4.2_19/java/awt/image/WritableRenderedImage.java,Java,,13,13,107,133
/jdk1.4.2_19/java/awt/Image.java,Java,,32,14,144,190
/jdk1.4.2_19/java/awt/ImageCapabilities.java,Java,,20,8,35,63
/jdk1.4.2_19/java/awt/Insets.java,Java,,47,14,94,155
/jdk1.4.2_19/java/awt/ItemSelectable.java,Java,,7,7,34,48
/jdk1.4.2_19/java/awt/JobAttributes.java,Java,,443,68,531,1042
/jdk1.4.2_19/java/awt/KeyboardFocusManager.java,Java,,1315,228,1268,2811
/jdk1.4.2_19/java/awt/KeyEventDispatcher.java,Java,,5,4,64,73
/jdk1.4.2_19/java/awt/KeyEventPostProcessor.java,Java,,5,4,67,76
/jdk1.4.2_19/java/awt/Label.java,Java,,121,33,182,336
/jdk1.4.2_19/java/awt/LayoutManager.java,Java,,8,5,46,59
/jdk1.4.2_19/java/awt/LayoutManager2.java,Java,,8,7,55,70
/jdk1.4.2_19/java/awt/List.java,Java,[FIXME,606,155,1107,1868
/jdk1.4.2_19/java/awt/MediaTracker.java,Java,,390,56,467,913
/jdk1.4.2_19/java/awt/Menu.java,Java,,238,58,294,590
/jdk1.4.2_19/java/awt/MenuBar.java,Java,,200,41,223,464
/jdk1.4.2_19/java/awt/MenuComponent.java,Java,,302,92,575,969
/jdk1.4.2_19/java/awt/MenuContainer.java,Java,,6,3,16,25
/jdk1.4.2_19/java/awt/MenuItem.java,Java,[PENDING:  WDW -- need to provide a localized string,279,70,506,855
/jdk1.4.2_19/java/awt/MenuShortcut.java,Java,,52,13,110,175
/jdk1.4.2_19/java/awt/PageAttributes.java,Java,,521,52,782,1355
/jdk1.4.2_19/java/awt/Paint.java,Java,,12,6,59,77
/jdk1.4.2_19/java/awt/PaintContext.java,Java,,12,7,46,65
/jdk1.4.2_19/java/awt/Panel.java,Java,,37,13,63,113
/jdk1.4.2_19/java/awt/peer/ButtonPeer.java,Java,,5,3,13,21
/jdk1.4.2_19/java/awt/peer/CanvasPeer.java,Java,,4,2,13,19
/jdk1.4.2_19/java/awt/peer/CheckboxMenuItemPeer.java,Java,,4,1,13,18
/jdk1.4.2_19/java/awt/peer/CheckboxPeer.java,Java,,7,2,13,22
/jdk1.4.2_19/java/awt/peer/ChoicePeer.java,Java,,9,3,16,28
/jdk1.4.2_19/java/awt/peer/ComponentPeer.java,Java,,57,13,34,104
/jdk1.4.2_19/java/awt/peer/ContainerPeer.java,Java,,11,3,16,30
/jdk1.4.2_19/java/awt/peer/DialogPeer.java,Java,,6,5,13,24
/jdk1.4.2_19/java/awt/peer/FileDialogPeer.java,Java,,8,3,13,24
/jdk1.4.2_19/java/awt/peer/FontPeer.java,Java,,3,2,13,18
/jdk1.4.2_19/java/awt/peer/FramePeer.java,Java,,11,3,13,27
/jdk1.4.2_19/java/awt/peer/LabelPeer.java,Java,,7,2,13,22
/jdk1.4.2_19/java/awt/peer/LightweightPeer.java,Java,,3,3,21,27
/jdk1.4.2_19/java/awt/peer/ListPeer.java,Java,,19,7,28,54
/jdk1.4.2_19/java/awt/peer/MenuBarPeer.java,Java,,7,2,13,22
/jdk1.4.2_19/java/awt/peer/MenuComponentPeer.java,Java,,4,1,13,18
/jdk1.4.2_19/java/awt/peer/MenuItemPeer.java,Java,,7,4,19,30
/jdk1.4.2_19/java/awt/peer/MenuPeer.java,Java,,7,2,13,22
/jdk1.4.2_19/java/awt/peer/PanelPeer.java,Java,,4,2,13,19
/jdk1.4.2_19/java/awt/peer/PopupMenuPeer.java,Java,,5,2,13,20
/jdk1.4.2_19/java/awt/peer/RobotPeer.java,Java,,13,6,17,36
/jdk1.4.2_19/java/awt/peer/ScrollbarPeer.java,Java,,6,1,13,20
/jdk1.4.2_19/java/awt/peer/ScrollPanePeer.java,Java,,11,2,13,26
/jdk1.4.2_19/java/awt/peer/TextAreaPeer.java,Java,,12,6,25,43
/jdk1.4.2_19/java/awt/peer/TextComponentPeer.java,Java,,16,2,13,31
/jdk1.4.2_19/java/awt/peer/TextFieldPeer.java,Java,,10,5,22,37
/jdk1.4.2_19/java/awt/peer/WindowPeer.java,Java,,7,4,13,24
/jdk1.4.2_19/java/awt/Point.java,Java,,54,18,140,212
/jdk1.4.2_19/java/awt/Polygon.java,Java,,261,52,361,674
/jdk1.4.2_19/java/awt/PopupMenu.java,Java,,76,18,94,188
/jdk1.4.2_19/java/awt/print/Book.java,Java,,66,27,110,203
/jdk1.4.2_19/java/awt/print/Pageable.java,Java,,9,7,50,66
/jdk1.4.2_19/java/awt/print/PageFormat.java,Java,,141,58,146,345
/jdk1.4.2_19/java/awt/print/Paper.java,Java,,53,25,111,189
/jdk1.4.2_19/java/awt/print/Printable.java,Java,,8,7,53,68
/jdk1.4.2_19/java/awt/print/PrinterAbortException.java,Java,,9,6,22,37
/jdk1.4.2_19/java/awt/print/PrinterException.java,Java,,8,6,21,35
/jdk1.4.2_19/java/awt/print/PrinterGraphics.java,Java,,4,5,20,29
/jdk1.4.2_19/java/awt/print/PrinterIOException.java,Java,,16,6,48,70
/jdk1.4.2_19/java/awt/print/PrinterJob.java,Java,,91,37,357,485
/jdk1.4.2_19/java/awt/PrintGraphics.java,Java,,4,4,16,24
/jdk1.4.2_19/java/awt/PrintJob.java,Java,,11,9,43,63
/jdk1.4.2_19/java/awt/Rectangle.java,Java,,287,54,557,898
/jdk1.4.2_19/java/awt/RenderingHints.java,Java,,210,71,425,706
/jdk1.4.2_19/java/awt/Robot.java,Java,,188,42,207,437
/jdk1.4.2_19/java/awt/Scrollbar.java,Java,,334,82,786,1202
/jdk1.4.2_19/java/awt/ScrollPane.java,Java,,344,79,383,806
/jdk1.4.2_19/java/awt/ScrollPaneAdjustable.java,Java,,137,43,230,410
/jdk1.4.2_19/java/awt/SentEvent.java,Java,,50,6,15,71
/jdk1.4.2_19/java/awt/SequencedEvent.java,Java,,111,17,62,190
/jdk1.4.2_19/java/awt/Shape.java,Java,,17,12,288,317
/jdk1.4.2_19/java/awt/Stroke.java,Java,,4,6,45,55
/jdk1.4.2_19/java/awt/SystemColor.java,Java,,111,65,296,472
/jdk1.4.2_19/java/awt/TextArea.java,Java,,236,60,387,683
/jdk1.4.2_19/java/awt/TextComponent.java,Java,,450,89,596,1135
/jdk1.4.2_19/java/awt/TextField.java,Java,,220,55,435,710
/jdk1.4.2_19/java/awt/TexturePaint.java,Java,,47,13,63,123
/jdk1.4.2_19/java/awt/TexturePaintContext.java,Java,,702,47,57,806
/jdk1.4.2_19/java/awt/Toolkit.java,Java,,720,142,1295,2157
/jdk1.4.2_19/java/awt/Transparency.java,Java,,7,6,29,42
/jdk1.4.2_19/java/awt/Window.java,Java,,858,147,1105,2110
/jdk1.4.2_19/java/beans/AppletInitializer.java,Java,,7,10,57,74
/jdk1.4.2_19/java/beans/beancontext/BeanContext.java,Java,,16,13,87,116
/jdk1.4.2_19/java/beans/beancontext/BeanContextChild.java,Java,,13,12,96,121
/jdk1.4.2_19/java/beans/beancontext/BeanContextChildComponentProxy.java,Java,,5,6,26,37
/jdk1.4.2_19/java/beans/beancontext/BeanContextChildSupport.java,Java,,100,57,171,328
/jdk1.4.2_19/java/beans/beancontext/BeanContextContainerProxy.java,Java,,5,5,25,35
/jdk1.4.2_19/java/beans/beancontext/BeanContextEvent.java,Java,,19,19,55,93
/jdk1.4.2_19/java/beans/beancontext/BeanContextMembershipEvent.java,Java,,28,24,66,118
/jdk1.4.2_19/java/beans/beancontext/BeanContextMembershipListener.java,Java,,7,7,30,44
/jdk1.4.2_19/java/beans/beancontext/BeanContextProxy.java,Java,,4,4,60,68
/jdk1.4.2_19/java/beans/beancontext/BeanContextServiceAvailableEvent.java,Java,,19,17,35,71
/jdk1.4.2_19/java/beans/beancontext/BeanContextServiceProvider.java,Java,,7,9,72,88
/jdk1.4.2_19/java/beans/beancontext/BeanContextServiceProviderBeanInfo.java,Java,,5,5,19,29
/jdk1.4.2_19/java/beans/beancontext/BeanContextServiceRevokedEvent.java,Java,,20,18,48,86
/jdk1.4.2_19/java/beans/beancontext/BeanContextServiceRevokedListener.java,Java,,6,7,18,31
/jdk1.4.2_19/java/beans/beancontext/BeanContextServices.java,Java,,17,17,107,141
/jdk1.4.2_19/java/beans/beancontext/BeanContextServicesListener.java,Java,,7,4,17,28
/jdk1.4.2_19/java/beans/beancontext/BeanContextServicesSupport.java,Java,,615,313,282,1210
/jdk1.4.2_19/java/beans/beancontext/BeanContextSupport.java,Java,,589,256,528,1373
/jdk1.4.2_19/java/beans/BeanDescriptor.java,Java,,28,10,42,80
/jdk1.4.2_19/java/beans/BeanInfo.java,Java,,15,15,123,153
/jdk1.4.2_19/java/beans/Beans.java,Java,,310,92,248,650
/jdk1.4.2_19/java/beans/Customizer.java,Java,,6,8,34,48
/jdk1.4.2_19/java/beans/DefaultPersistenceDelegate.java,Java,,176,26,196,398
/jdk1.4.2_19/java/beans/DesignMode.java,Java,,6,9,57,72
/jdk1.4.2_19/java/beans/Encoder.java,Java,,106,66,150,322
/jdk1.4.2_19/java/beans/EventHandler.java,Java,,145,24,369,538
/jdk1.4.2_19/java/beans/EventSetDescriptor.java,Java,,200,34,204,438
/jdk1.4.2_19/java/beans/ExceptionListener.java,Java,,4,48,21,73
/jdk1.4.2_19/java/beans/Expression.java,Java,,28,58,90,176
/jdk1.4.2_19/java/beans/FeatureDescriptor.java,Java,,146,32,138,316
/jdk1.4.2_19/java/beans/IdentityHashtable.java,Java,,25,58,11,94
/jdk1.4.2_19/java/beans/IndexedPropertyDescriptor.java,Java,,269,47,138,454
/jdk1.4.2_19/java/beans/IntrospectionException.java,Java,,7,4,20,31
/jdk1.4.2_19/java/beans/Introspector.java,Java,,1020,161,403,1584
/jdk1.4.2_19/java/beans/MetaData.java,Java,,684,119,192,995
/jdk1.4.2_19/java/beans/MethodDescriptor.java,Java,,41,14,48,103
/jdk1.4.2_19/java/beans/NameGenerator.java,Java,,49,12,36,97
/jdk1.4.2_19/java/beans/ParameterDescriptor.java,Java,,8,6,21,35
/jdk1.4.2_19/java/beans/PersistenceDelegate.java,Java,,24,54,162,240
/jdk1.4.2_19/java/beans/PropertyChangeEvent.java,Java,,29,13,82,124
/jdk1.4.2_19/java/beans/PropertyChangeListener.java,Java,,4,6,16,26
/jdk1.4.2_19/java/beans/PropertyChangeListenerProxy.java,Java,,16,6,39,61
/jdk1.4.2_19/java/beans/PropertyChangeSupport.java,Java,,217,44,167,428
/jdk1.4.2_19/java/beans/PropertyDescriptor.java,Java,,337,60,191,588
/jdk1.4.2_19/java/beans/PropertyEditor.java,Java,,15,25,146,186
/jdk1.4.2_19/java/beans/PropertyEditorManager.java,Java,,90,19,80,189
/jdk1.4.2_19/java/beans/PropertyEditorSupport.java,Java,,81,33,129,243
/jdk1.4.2_19/java/beans/PropertyVetoException.java,Java,,12,8,26,46
/jdk1.4.2_19/java/beans/ReflectionUtils.java,Java,,212,25,5,242
/jdk1.4.2_19/java/beans/SimpleBeanInfo.java,Java,,54,14,60,128
/jdk1.4.2_19/java/beans/Statement.java,Java,,137,19,117,273
/jdk1.4.2_19/java/beans/VetoableChangeListener.java,Java,,5,2,19,26
/jdk1.4.2_19/java/beans/VetoableChangeListenerProxy.java,Java,,18,7,39,64
/jdk1.4.2_19/java/beans/VetoableChangeSupport.java,Java,,217,43,155,415
/jdk1.4.2_19/java/beans/Visibility.java,Java,,7,8,34,49
/jdk1.4.2_19/java/beans/XMLDecoder.java,Java,,341,53,109,503
/jdk1.4.2_19/java/beans/XMLEncoder.java,Java,,300,46,259,605
/jdk1.4.2_19/java/io/Bits.java,Java,,93,18,18,129
/jdk1.4.2_19/java/io/BufferedInputStream.java,Java,,133,25,244,402
/jdk1.4.2_19/java/io/BufferedOutputStream.java,Java,,44,9,74,127
/jdk1.4.2_19/java/io/BufferedReader.java,Java,,263,37,208,508
/jdk1.4.2_19/java/io/BufferedWriter.java,Java,,105,24,121,250
/jdk1.4.2_19/java/io/ByteArrayInputStream.java,Java,,66,17,175,258
/jdk1.4.2_19/java/io/ByteArrayOutputStream.java,Java,,66,19,128,213
/jdk1.4.2_19/java/io/CharArrayReader.java,Java,,96,17,84,197
/jdk1.4.2_19/java/io/CharArrayWriter.java,Java,,83,16,76,175
/jdk1.4.2_19/java/io/CharConversionException.java,Java,,10,1,21,32
/jdk1.4.2_19/java/io/DataInput.java,Java,,19,16,454,489
/jdk1.4.2_19/java/io/DataInputStream.java,Java,,184,32,464,680
/jdk1.4.2_19/java/io/DataOutput.java,Java,,18,15,301,334
/jdk1.4.2_19/java/io/DataOutputStream.java,Java,,131,25,219,375
/jdk1.4.2_19/java/io/EOFException.java,Java,,10,3,33,46
/jdk1.4.2_19/java/io/ExpiringCache.java,Java,,79,15,9,103
/jdk1.4.2_19/java/io/Externalizable.java,Java,,7,4,69,80
/jdk1.4.2_19/java/io/File.java,Java,,422,86,1061,1569
/jdk1.4.2_19/java/io/FileDescriptor.java,Java,,21,12,82,115
/jdk1.4.2_19/java/io/FileFilter.java,Java,,4,5,23,32
/jdk1.4.2_19/java/io/FileInputStream.java,Java,,73,23,202,298
/jdk1.4.2_19/java/io/FilenameFilter.java,Java,,5,2,29,36
/jdk1.4.2_19/java/io/FileNotFoundException.java,Java,,14,8,42,64
/jdk1.4.2_19/java/io/FileOutputStream.java,Java,,90,25,233,348
/jdk1.4.2_19/java/io/FilePermission.java,Java,,332,98,375,805
/jdk1.4.2_19/java/io/FileReader.java,Java,,12,8,49,69
/jdk1.4.2_19/java/io/FileSystem.java,Java,,51,46,130,227
/jdk1.4.2_19/java/io/FileWriter.java,Java,,18,10,74,102
/jdk1.4.2_19/java/io/FilterInputStream.java,Java,,35,12,176,223
/jdk1.4.2_19/java/io/FilterOutputStream.java,Java,,31,9,105,145
/jdk1.4.2_19/java/io/FilterReader.java,Java,,32,15,65,112
/jdk1.4.2_19/java/io/FilterWriter.java,Java,,23,12,60,95
/jdk1.4.2_19/java/io/InputStream.java,Java,,68,20,262,350
/jdk1.4.2_19/java/io/InputStreamReader.java,Java,,50,16,124,190
/jdk1.4.2_19/java/io/InterruptedIOException.java,Java,,11,4,40,55
/jdk1.4.2_19/java/io/InvalidClassException.java,Java,,17,5,39,61
/jdk1.4.2_19/java/io/InvalidObjectException.java,Java,,6,2,23,31
/jdk1.4.2_19/java/io/IOException.java,Java,,10,3,29,42
/jdk1.4.2_19/java/io/LineNumberInputStream.java,Java,,96,19,159,274
/jdk1.4.2_19/java/io/LineNumberReader.java,Java,,100,23,115,238
/jdk1.4.2_19/java/io/NotActiveException.java,Java,,9,3,21,33
/jdk1.4.2_19/java/io/NotSerializableException.java,Java,,9,3,23,35
/jdk1.4.2_19/java/io/ObjectInput.java,Java,,11,8,71,90
/jdk1.4.2_19/java/io/ObjectInputStream.java,Java,,1825,294,1255,3374
/jdk1.4.2_19/java/io/ObjectInputValidation.java,Java,,4,2,22,28
/jdk1.4.2_19/java/io/ObjectOutput.java,Java,,10,7,56,73
/jdk1.4.2_19/java/io/ObjectOutputStream.java,Java,,1109,173,915,2197
/jdk1.4.2_19/java/io/ObjectStreamClass.java,Java,,1340,181,536,2057
/jdk1.4.2_19/java/io/ObjectStreamConstants.java,Java,,32,34,140,206
/jdk1.4.2_19/java/io/ObjectStreamException.java,Java,,9,3,21,33
/jdk1.4.2_19/java/io/ObjectStreamField.java,Java,,95,21,134,250
/jdk1.4.2_19/java/io/OptionalDataException.java,Java,,13,4,46,63
/jdk1.4.2_19/java/io/OutputStream.java,Java,,24,7,100,131
/jdk1.4.2_19/java/io/OutputStreamWriter.java,Java,,56,20,149,225
/jdk1.4.2_19/java/io/PipedInputStream.java,Java,,134,20,171,325
/jdk1.4.2_19/java/io/PipedOutputStream.java,Java,,53,11,95,159
/jdk1.4.2_19/java/io/PipedReader.java,Java,,144,23,138,305
/jdk1.4.2_19/java/io/PipedWriter.java,Java,,53,14,92,159
/jdk1.4.2_19/java/io/PrintStream.java,Java,,248,50,306,604
/jdk1.4.2_19/java/io/PrintWriter.java,Java,,211,48,275,534
/jdk1.4.2_19/java/io/PushbackInputStream.java,Java,,106,19,183,308
/jdk1.4.2_19/java/io/PushbackReader.java,Java,,120,21,119,260
/jdk1.4.2_19/java/io/RandomAccessFile.java,Java,,269,64,719,1052
/jdk1.4.2_19/java/io/Reader.java,Java,,56,19,146,221
/jdk1.4.2_19/java/io/SequenceInputStream.java,Java,,79,14,108,201
/jdk1.4.2_19/java/io/Serializable.java,Java,,3,2,100,105
/jdk1.4.2_19/java/io/SerializablePermission.java,Java,,16,11,82,109
/jdk1.4.2_19/java/io/StreamCorruptedException.java,Java,,9,3,22,34
/jdk1.4.2_19/java/io/StreamTokenizer.java,Java,,367,52,395,814
/jdk1.4.2_19/java/io/StringBufferInputStream.java,Java,,53,11,90,154
/jdk1.4.2_19/java/io/StringReader.java,Java,,77,16,76,169
/jdk1.4.2_19/java/io/StringWriter.java,Java,,43,16,64,123
/jdk1.4.2_19/java/io/SyncFailedException.java,Java,,6,2,21,29
/jdk1.4.2_19/java/io/UnsupportedEncodingException.java,Java,,11,2,20,33
/jdk1.4.2_19/java/io/UTFDataFormatException.java,Java,,10,3,32,45
/jdk1.4.2_19/java/io/Win32FileSystem.java,Java,,378,56,103,537
/jdk1.4.2_19/java/io/WinNTFileSystem.java,Java,,26,9,16,51
/jdk1.4.2_19/java/io/WriteAbortedException.java,Java,,19,6,51,76
/jdk1.4.2_19/java/io/Writer.java,Java,,48,17,109,174
/jdk1.4.2_19/java/lang/AbstractMethodError.java,Java,,10,3,26,39
/jdk1.4.2_19/java/lang/ArithmeticException.java,Java,,10,3,25,38
/jdk1.4.2_19/java/lang/ArrayIndexOutOfBoundsException.java,Java,,13,4,31,48
/jdk1.4.2_19/java/lang/ArrayStoreException.java,Java,,10,4,28,42
/jdk1.4.2_19/java/lang/AssertionError.java,Java,,31,10,92,133
/jdk1.4.2_19/java/lang/AssertionStatusDirectives.java,Java,,8,6,62,76
/jdk1.4.2_19/java/lang/Boolean.java,Java,,51,17,147,215
/jdk1.4.2_19/java/lang/Byte.java,Java,,102,31,296,429
/jdk1.4.2_19/java/lang/Character.java,Java,,758,118,1145,2021
/jdk1.4.2_19/java/lang/CharacterData.java,Java,,839,42,84,965
/jdk1.4.2_19/java/lang/CharacterDataLatin1.java,Java,,201,41,52,294
/jdk1.4.2_19/java/lang/CharSequence.java,Java,,7,9,70,86
/jdk1.4.2_19/java/lang/Class.java,Java,,755,160,1209,2124
/jdk1.4.2_19/java/lang/ClassCastException.java,Java,,10,3,28,41
/jdk1.4.2_19/java/lang/ClassCircularityError.java,Java,,9,3,22,34
/jdk1.4.2_19/java/lang/ClassFormatError.java,Java,,10,3,24,37
/jdk1.4.2_19/java/lang/ClassLoader.java,Java,,769,129,959,1857
/jdk1.4.2_19/java/lang/ClassNotFoundException.java,Java,,21,8,79,108
/jdk1.4.2_19/java/lang/Cloneable.java,Java,,3,2,32,37
/jdk1.4.2_19/java/lang/CloneNotSupportedException.java,Java,,10,4,32,46
/jdk1.4.2_19/java/lang/Comparable.java,Java,,4,3,115,122
/jdk1.4.2_19/java/lang/Compiler.java,Java,,40,10,67,117
/jdk1.4.2_19/java/lang/Double.java,Java,,88,35,556,679
/jdk1.4.2_19/java/lang/Error.java,Java,,16,6,64,86
/jdk1.4.2_19/java/lang/Exception.java,Java,,16,6,57,79
/jdk1.4.2_19/java/lang/ExceptionInInitializerError.java,Java,,22,8,79,109
/jdk1.4.2_19/java/lang/Float.java,Java,,89,36,544,669
/jdk1.4.2_19/java/lang/FloatingDecimal.java,Java,,1463,110,719,2292
/jdk1.4.2_19/java/lang/IllegalAccessError.java,Java,,9,3,27,39
/jdk1.4.2_19/java/lang/IllegalAccessException.java,Java,,9,3,47,59
/jdk1.4.2_19/java/lang/IllegalArgumentException.java,Java,,10,3,25,38
/jdk1.4.2_19/java/lang/IllegalMonitorStateException.java,Java,,10,3,30,43
/jdk1.4.2_19/java/lang/IllegalStateException.java,Java,,10,3,27,40
/jdk1.4.2_19/java/lang/IllegalThreadStateException.java,Java,,9,3,28,40
/jdk1.4.2_19/java/lang/IncompatibleClassChangeError.java,Java,,10,3,25,38
/jdk1.4.2_19/java/lang/IndexOutOfBoundsException.java,Java,,10,3,26,39
/jdk1.4.2_19/java/lang/InheritableThreadLocal.java,Java,,13,5,49,67
/jdk1.4.2_19/java/lang/InstantiationError.java,Java,,10,5,27,42
/jdk1.4.2_19/java/lang/InstantiationException.java,Java,,10,3,26,39
/jdk1.4.2_19/java/lang/Integer.java,Java,,333,60,567,960
/jdk1.4.2_19/java/lang/InternalError.java,Java,,10,3,23,36
/jdk1.4.2_19/java/lang/InterruptedException.java,Java,,10,3,30,43
/jdk1.4.2_19/java/lang/LinkageError.java,Java,,10,3,25,38
/jdk1.4.2_19/java/lang/Long.java,Java,,281,51,574,906
/jdk1.4.2_19/java/lang/Math.java,Java,,131,43,694,868
/jdk1.4.2_19/java/lang/NegativeArraySizeException.java,Java,,10,3,23,36
/jdk1.4.2_19/java/lang/NoClassDefFoundError.java,Java,,10,3,29,42
/jdk1.4.2_19/java/lang/NoSuchFieldError.java,Java,,10,3,27,40
/jdk1.4.2_19/java/lang/NoSuchFieldException.java,Java,,9,3,21,33
/jdk1.4.2_19/java/lang/NoSuchMethodError.java,Java,,10,3,28,41
/jdk1.4.2_19/java/lang/NoSuchMethodException.java,Java,,10,3,21,34
/jdk1.4.2_19/java/lang/NullPointerException.java,Java,,10,3,35,48
/jdk1.4.2_19/java/lang/Number.java,Java,,14,8,73,95
/jdk1.4.2_19/java/lang/NumberFormatException.java,Java,,14,5,31,50
/jdk1.4.2_19/java/lang/Object.java,Java,,36,17,427,480
/jdk1.4.2_19/java/lang/OutOfMemoryError.java,Java,,10,3,24,37
/jdk1.4.2_19/java/lang/Package.java,Java,,264,35,231,530
/jdk1.4.2_19/java/lang/Process.java,Java,,11,8,107,126
/jdk1.4.2_19/java/lang/ref/Finalizer.java,Java,,129,19,31,179
/jdk1.4.2_19/java/lang/ref/FinalReference.java,Java,,6,6,7,19
/jdk1.4.2_19/java/lang/ref/PhantomReference.java,Java,,9,7,46,62
/jdk1.4.2_19/java/lang/ref/Reference.java,Java,,77,31,113,221
/jdk1.4.2_19/java/lang/ref/ReferenceQueue.java,Java,,64,14,52,130
/jdk1.4.2_19/java/lang/ref/SoftReference.java,Java,,18,10,71,99
/jdk1.4.2_19/java/lang/ref/WeakReference.java,Java,,9,7,41,57
/jdk1.4.2_19/java/lang/reflect/AccessibleObject.java,Java,,42,13,112,167
/jdk1.4.2_19/java/lang/reflect/Array.java,Java,,56,29,384,469
/jdk1.4.2_19/java/lang/reflect/Constructor.java,Java,,135,19,161,315
/jdk1.4.2_19/java/lang/reflect/Field.java,Java,,216,39,587,842
/jdk1.4.2_19/java/lang/reflect/InvocationHandler.java,Java,,5,3,70,78
/jdk1.4.2_19/java/lang/reflect/InvocationTargetException.java,Java,,22,8,63,93
/jdk1.4.2_19/java/lang/reflect/Member.java,Java,,9,8,49,66
/jdk1.4.2_19/java/lang/reflect/Method.java,Java,,158,21,194,373
/jdk1.4.2_19/java/lang/reflect/Modifier.java,Java,,81,34,212,327
/jdk1.4.2_19/java/lang/reflect/Proxy.java,Java,,168,38,426,632
/jdk1.4.2_19/java/lang/reflect/ReflectAccess.java,Java,,71,14,13,98
/jdk1.4.2_19/java/lang/reflect/ReflectPermission.java,Java,,10,5,59,74
/jdk1.4.2_19/java/lang/reflect/UndeclaredThrowableException.java,Java,,21,7,74,102
/jdk1.4.2_19/java/lang/Runnable.java,Java,,5,2,44,51
/jdk1.4.2_19/java/lang/Runtime.java,Java,,151,39,653,843
/jdk1.4.2_19/java/lang/RuntimeException.java,Java,,16,6,57,79
/jdk1.4.2_19/java/lang/RuntimePermission.java,Java,,15,8,262,285
/jdk1.4.2_19/java/lang/SecurityException.java,Java,,9,2,23,34
/jdk1.4.2_19/java/lang/SecurityManager.java,Java,,359,65,1269,1693
/jdk1.4.2_19/java/lang/Short.java,Java,,104,30,296,430
/jdk1.4.2_19/java/lang/Shutdown.java,Java,,136,34,66,236
/jdk1.4.2_19/java/lang/StackOverflowError.java,Java,,10,3,23,36
/jdk1.4.2_19/java/lang/StackTraceElement.java,Java,,49,13,123,185
/jdk1.4.2_19/java/lang/StrictMath.java,Java,,101,44,634,779
/jdk1.4.2_19/java/lang/String.java,Java,,711,109,1487,2307
/jdk1.4.2_19/java/lang/StringBuffer.java,Java,,360,63,853,1276
/jdk1.4.2_19/java/lang/StringCoding.java,Java,,306,50,49,405
/jdk1.4.2_19/java/lang/StringIndexOutOfBoundsException.java,Java,,13,4,35,52
/jdk1.4.2_19/java/lang/System.java,Java,,180,45,684,909
/jdk1.4.2_19/java/lang/Terminator.java,Java,,22,10,23,55
/jdk1.4.2_19/java/lang/Thread.java,Java,,298,82,861,1241
/jdk1.4.2_19/java/lang/ThreadDeath.java,Java,,2,3,30,35
/jdk1.4.2_19/java/lang/ThreadGroup.java,Java,,439,43,461,943
/jdk1.4.2_19/java/lang/ThreadLocal.java,Java,,242,62,316,620
/jdk1.4.2_19/java/lang/Throwable.java,Java,,138,36,476,650
/jdk1.4.2_19/java/lang/UnknownError.java,Java,,10,3,23,36
/jdk1.4.2_19/java/lang/UnsatisfiedLinkError.java,Java,,10,3,24,37
/jdk1.4.2_19/java/lang/UnsupportedClassVersionError.java,Java,,10,3,23,36
/jdk1.4.2_19/java/lang/UnsupportedOperationException.java,Java,,8,3,26,37
/jdk1.4.2_19/java/lang/VerifyError.java,Java,,10,3,23,36
/jdk1.4.2_19/java/lang/VirtualMachineError.java,Java,,10,3,24,37
/jdk1.4.2_19/java/lang/Void.java,Java,,6,4,21,31
/jdk1.4.2_19/java/lang/Win32Process.java,Java,,86,14,8,108
/jdk1.4.2_19/java/math/BigDecimal.java,Java,,317,87,687,1091
/jdk1.4.2_19/java/math/BigInteger.java,Java,,1563,374,1169,3106
/jdk1.4.2_19/java/math/BitSieve.java,Java,,86,21,92,199
/jdk1.4.2_19/java/math/MutableBigInteger.java,Java,,838,183,336,1357
/jdk1.4.2_19/java/math/SignedMutableBigInteger.java,Java,,44,19,59,122
/jdk1.4.2_19/java/net/Authenticator.java,Java,,105,29,161,295
/jdk1.4.2_19/java/net/BindException.java,Java,,7,5,23,35
/jdk1.4.2_19/java/net/ConnectException.java,Java,,7,3,24,34
/jdk1.4.2_19/java/net/ContentHandler.java,Java,,14,6,72,92
/jdk1.4.2_19/java/net/ContentHandlerFactory.java,Java,,4,2,31,37
/jdk1.4.2_19/java/net/DatagramPacket.java,Java,,103,26,238,367
/jdk1.4.2_19/java/net/DatagramSocket.java,Java,,441,59,669,1169
/jdk1.4.2_19/java/net/DatagramSocketImpl.java,Java,,35,24,163,222
/jdk1.4.2_19/java/net/DatagramSocketImplFactory.java,Java,,5,2,22,29
/jdk1.4.2_19/java/net/FileNameMap.java,Java,,4,3,20,27
/jdk1.4.2_19/java/net/HttpURLConnection.java,Java,,157,77,363,597
/jdk1.4.2_19/java/net/Inet4Address.java,Java,,149,34,225,408
/jdk1.4.2_19/java/net/Inet4AddressImpl.java,Java,,23,5,11,39
/jdk1.4.2_19/java/net/Inet6Address.java,Java,,258,44,264,566
/jdk1.4.2_19/java/net/Inet6AddressImpl.java,Java,,33,6,16,55
/jdk1.4.2_19/java/net/InetAddress.java,Java,,539,122,652,1313
/jdk1.4.2_19/java/net/InetAddressImpl.java,Java,,9,5,15,29
/jdk1.4.2_19/java/net/InetSocketAddress.java,Java,,93,16,130,239
/jdk1.4.2_19/java/net/JarURLConnection.java,Java,,55,25,224,304
/jdk1.4.2_19/java/net/MalformedURLException.java,Java,,9,4,24,37
/jdk1.4.2_19/java/net/MulticastSocket.java,Java,,210,47,395,652
/jdk1.4.2_19/java/net/NetPermission.java,Java,,16,8,91,115
/jdk1.4.2_19/java/net/NetworkInterface.java,Java,,174,34,124,332
/jdk1.4.2_19/java/net/NoRouteToHostException.java,Java,,7,3,24,34
/jdk1.4.2_19/java/net/PasswordAuthentication.java,Java,,15,9,41,65
/jdk1.4.2_19/java/net/PlainDatagramSocketImpl.java,Java,,174,39,106,319
/jdk1.4.2_19/java/net/PlainSocketImpl.java,Java,,423,58,167,648
/jdk1.4.2_19/java/net/PortUnreachableException.java,Java,,7,5,21,33
/jdk1.4.2_19/java/net/ProtocolException.java,Java,,10,4,23,37
/jdk1.4.2_19/java/net/ServerSocket.java,Java,,263,37,463,763
/jdk1.4.2_19/java/net/Socket.java,Java,,529,81,856,1466
/jdk1.4.2_19/java/net/SocketAddress.java,Java,,3,2,19,24
/jdk1.4.2_19/java/net/SocketException.java,Java,,10,4,23,37
/jdk1.4.2_19/java/net/SocketImpl.java,Java,,68,32,194,294
/jdk1.4.2_19/java/net/SocketImplFactory.java,Java,,5,2,24,31
/jdk1.4.2_19/java/net/SocketInputStream.java,Java,,129,25,97,251
/jdk1.4.2_19/java/net/SocketOptions.java,Java,,20,34,264,318
/jdk1.4.2_19/java/net/SocketOutputStream.java,Java,,72,17,77,166
/jdk1.4.2_19/java/net/SocketPermission.java,Java,,691,176,505,1372
/jdk1.4.2_19/java/net/SocketTimeoutException.java,Java,,7,5,19,31
/jdk1.4.2_19/java/net/SocksConsts.java,Java,,25,6,9,40
/jdk1.4.2_19/java/net/SocksSocketImpl.java,Java,,636,28,147,811
/jdk1.4.2_19/java/net/SocksSocketImplFactory.java,Java,,102,8,46,156
/jdk1.4.2_19/java/net/UnknownHostException.java,Java,,10,4,23,37
/jdk1.4.2_19/java/net/UnknownServiceException.java,Java,,9,4,26,39
/jdk1.4.2_19/java/net/URI.java,Java,,1462,279,1689,3430
/jdk1.4.2_19/java/net/URISyntaxException.java,Java,,39,11,65,115
/jdk1.4.2_19/java/net/URL.java,Java,,421,102,666,1189
/jdk1.4.2_19/java/net/URLClassLoader.java,Java,,330,36,210,576
/jdk1.4.2_19/java/net/URLConnection.java,Java,,515,130,933,1578
/jdk1.4.2_19/java/net/URLDecoder.java,Java,,61,20,102,183
/jdk1.4.2_19/java/net/URLEncoder.java,Java,,109,19,147,275
/jdk1.4.2_19/java/net/URLStreamHandler.java,Java,,293,41,193,527
/jdk1.4.2_19/java/net/URLStreamHandlerFactory.java,Java,,4,2,28,34
/jdk1.4.2_19/java/nio/Bits.java,Java,,520,137,33,690
/jdk1.4.2_19/java/nio/Buffer.java,Java,,120,31,306,457
/jdk1.4.2_19/java/nio/BufferOverflowException.java,Java,,6,7,19,32
/jdk1.4.2_19/java/nio/BufferUnderflowException.java,Java,,6,7,19,32
/jdk1.4.2_19/java/nio/ByteBuffer.java,Java,,197,349,1312,1858
/jdk1.4.2_19/java/nio/ByteBufferAsCharBufferB.java,Java,,118,68,9,195
/jdk1.4.2_19/java/nio/ByteBufferAsCharBufferL.java,Java,,118,68,9,195
/jdk1.4.2_19/java/nio/ByteBufferAsCharBufferRB.java,Java,,78,109,8,195
/jdk1.4.2_19/java/nio/ByteBufferAsCharBufferRL.java,Java,,78,109,8,195
/jdk1.4.2_19/java/nio/ByteBufferAsDoubleBufferB.java,Java,,91,96,8,195
/jdk1.4.2_19/java/nio/ByteBufferAsDoubleBufferL.java,Java,,91,96,8,195
/jdk1.4.2_19/java/nio/ByteBufferAsDoubleBufferRB.java,Java,,51,137,7,195
/jdk1.4.2_19/java/nio/ByteBufferAsDoubleBufferRL.java,Java,,51,137,7,195
/jdk1.4.2_19/java/nio/ByteBufferAsFloatBufferB.java,Java,,91,96,8,195
/jdk1.4.2_19/java/nio/ByteBufferAsFloatBufferL.java,Java,,91,96,8,195
/jdk1.4.2_19/java/nio/ByteBufferAsFloatBufferRB.java,Java,,51,137,7,195
/jdk1.4.2_19/java/nio/ByteBufferAsFloatBufferRL.java,Java,,51,137,7,195
/jdk1.4.2_19/java/nio/ByteBufferAsIntBufferB.java,Java,,91,96,8,195
/jdk1.4.2_19/java/nio/ByteBufferAsIntBufferL.java,Java,,91,96,8,195
/jdk1.4.2_19/java/nio/ByteBufferAsIntBufferRB.java,Java,,51,137,7,195
/jdk1.4.2_19/java/nio/ByteBufferAsIntBufferRL.java,Java,,51,137,7,195
/jdk1.4.2_19/java/nio/ByteBufferAsLongBufferB.java,Java,,91,96,8,195
/jdk1.4.2_19/java/nio/ByteBufferAsLongBufferL.java,Java,,91,96,8,195
/jdk1.4.2_19/java/nio/ByteBufferAsLongBufferRB.java,Java,,51,137,7,195
/jdk1.4.2_19/java/nio/ByteBufferAsLongBufferRL.java,Java,,51,137,7,195
/jdk1.4.2_19/java/nio/ByteBufferAsShortBufferB.java,Java,,91,96,8,195
/jdk1.4.2_19/java/nio/ByteBufferAsShortBufferL.java,Java,,91,96,8,195
/jdk1.4.2_19/java/nio/ByteBufferAsShortBufferRB.java,Java,,51,137,7,195
/jdk1.4.2_19/java/nio/ByteBufferAsShortBufferRL.java,Java,,51,137,7,195
/jdk1.4.2_19/java/nio/ByteOrder.java,Java,,17,11,44,72
/jdk1.4.2_19/java/nio/channels/AlreadyConnectedException.java,Java,,6,7,19,32
/jdk1.4.2_19/java/nio/channels/AsynchronousCloseException.java,Java,,6,7,20,33
/jdk1.4.2_19/java/nio/channels/ByteChannel.java,Java,,6,6,16,28
/jdk1.4.2_19/java/nio/channels/CancelledKeyException.java,Java,,6,7,19,32
/jdk1.4.2_19/java/nio/channels/Channel.java,Java,,6,8,52,66
/jdk1.4.2_19/java/nio/channels/Channels.java,Java,,206,40,196,442
/jdk1.4.2_19/java/nio/channels/ClosedByInterruptException.java,Java,,6,7,21,34
/jdk1.4.2_19/java/nio/channels/ClosedChannelException.java,Java,,6,7,22,35
/jdk1.4.2_19/java/nio/channels/ClosedSelectorException.java,Java,,6,7,19,32
/jdk1.4.2_19/java/nio/channels/ConnectionPendingException.java,Java,,6,7,20,33
/jdk1.4.2_19/java/nio/channels/DatagramChannel.java,Java,,41,25,355,421
/jdk1.4.2_19/java/nio/channels/FileChannel.java,Java,,64,43,863,970
/jdk1.4.2_19/java/nio/channels/FileLock.java,Java,,51,16,177,244
/jdk1.4.2_19/java/nio/channels/FileLockInterruptionException.java,Java,,6,7,20,33
/jdk1.4.2_19/java/nio/channels/GatheringByteChannel.java,Java,,10,9,130,149
/jdk1.4.2_19/java/nio/channels/IllegalBlockingModeException.java,Java,,6,7,19,32
/jdk1.4.2_19/java/nio/channels/IllegalSelectorException.java,Java,,6,7,20,33
/jdk1.4.2_19/java/nio/channels/InterruptibleChannel.java,Java,,7,8,49,64
/jdk1.4.2_19/java/nio/channels/NoConnectionPendingException.java,Java,,6,7,20,33
/jdk1.4.2_19/java/nio/channels/NonReadableChannelException.java,Java,,6,7,19,32
/jdk1.4.2_19/java/nio/channels/NonWritableChannelException.java,Java,,6,7,19,32
/jdk1.4.2_19/java/nio/channels/NotYetBoundException.java,Java,,6,7,19,32
/jdk1.4.2_19/java/nio/channels/NotYetConnectedException.java,Java,,6,7,19,32
/jdk1.4.2_19/java/nio/channels/OverlappingFileLockException.java,Java,,6,7,21,34
/jdk1.4.2_19/java/nio/channels/Pipe.java,Java,,33,16,87,136
/jdk1.4.2_19/java/nio/channels/ReadableByteChannel.java,Java,,6,7,78,91
/jdk1.4.2_19/java/nio/channels/ScatteringByteChannel.java,Java,,10,8,127,145
/jdk1.4.2_19/java/nio/channels/SelectableChannel.java,Java,,25,17,277,319
/jdk1.4.2_19/java/nio/channels/SelectionKey.java,Java,,37,33,310,380
/jdk1.4.2_19/java/nio/channels/Selector.java,Java,,20,17,341,378
/jdk1.4.2_19/java/nio/channels/ServerSocketChannel.java,Java,,20,13,121,154
/jdk1.4.2_19/java/nio/channels/SocketChannel.java,Java,,46,25,292,363
/jdk1.4.2_19/java/nio/channels/spi/AbstractInterruptibleChannel.java,Java,,105,25,115,245
/jdk1.4.2_19/java/nio/channels/spi/AbstractSelectableChannel.java,Java,,138,34,105,277
/jdk1.4.2_19/java/nio/channels/spi/AbstractSelectionKey.java,Java,,17,9,25,51
/jdk1.4.2_19/java/nio/channels/spi/AbstractSelector.java,Java,,60,23,131,214
/jdk1.4.2_19/java/nio/channels/spi/SelectorProvider.java,Java,,84,16,103,203
/jdk1.4.2_19/java/nio/channels/UnresolvedAddressException.java,Java,,6,7,19,32
/jdk1.4.2_19/java/nio/channels/UnsupportedAddressTypeException.java,Java,,6,7,19,32
/jdk1.4.2_19/java/nio/channels/WritableByteChannel.java,Java,,8,7,73,88
/jdk1.4.2_19/java/nio/CharBuffer.java,Java,,168,171,932,1271
/jdk1.4.2_19/java/nio/charset/CharacterCodingException.java,Java,,6,7,19,32
/jdk1.4.2_19/java/nio/charset/Charset.java,Java,,270,57,510,837
/jdk1.4.2_19/java/nio/charset/CharsetDecoder.java,Java,,208,186,545,939
/jdk1.4.2_19/java/nio/charset/CharsetEncoder.java,Java,,253,138,548,939
/jdk1.4.2_19/java/nio/charset/CoderMalfunctionError.java,Java,,8,6,21,35
/jdk1.4.2_19/java/nio/charset/CoderResult.java,Java,,97,29,141,267
/jdk1.4.2_19/java/nio/charset/CodingErrorAction.java,Java,,16,11,40,67
/jdk1.4.2_19/java/nio/charset/IllegalCharsetNameException.java,Java,,13,9,27,49
/jdk1.4.2_19/java/nio/charset/MalformedInputException.java,Java,,15,9,13,37
/jdk1.4.2_19/java/nio/charset/spi/CharsetProvider.java,Java,,12,9,72,93
/jdk1.4.2_19/java/nio/charset/UnmappableCharacterException.java,Java,,15,9,13,37
/jdk1.4.2_19/java/nio/charset/UnsupportedCharsetException.java,Java,,13,9,27,49
/jdk1.4.2_19/java/nio/DirectByteBuffer.java,Java,,613,332,24,969
/jdk1.4.2_19/java/nio/DirectByteBufferR.java,Java,,338,618,13,969
/jdk1.4.2_19/java/nio/DirectCharBufferRS.java,Java,,87,333,10,430
/jdk1.4.2_19/java/nio/DirectCharBufferRU.java,Java,,87,333,10,430
/jdk1.4.2_19/java/nio/DirectCharBufferS.java,Java,,190,223,17,430
/jdk1.4.2_19/java/nio/DirectCharBufferU.java,Java,,190,223,17,430
/jdk1.4.2_19/java/nio/DirectDoubleBufferRS.java,Java,,60,361,9,430
/jdk1.4.2_19/java/nio/DirectDoubleBufferRU.java,Java,,60,361,9,430
/jdk1.4.2_19/java/nio/DirectDoubleBufferS.java,Java,,163,251,16,430
/jdk1.4.2_19/java/nio/DirectDoubleBufferU.java,Java,,163,251,16,430
/jdk1.4.2_19/java/nio/DirectFloatBufferRS.java,Java,,60,361,9,430
/jdk1.4.2_19/java/nio/DirectFloatBufferRU.java,Java,,60,361,9,430
/jdk1.4.2_19/java/nio/DirectFloatBufferS.java,Java,,163,251,16,430
/jdk1.4.2_19/java/nio/DirectFloatBufferU.java,Java,,163,251,16,430
/jdk1.4.2_19/java/nio/DirectIntBufferRS.java,Java,,60,361,9,430
/jdk1.4.2_19/java/nio/DirectIntBufferRU.java,Java,,60,361,9,430
/jdk1.4.2_19/java/nio/DirectIntBufferS.java,Java,,163,251,16,430
/jdk1.4.2_19/java/nio/DirectIntBufferU.java,Java,,163,251,16,430
/jdk1.4.2_19/java/nio/DirectLongBufferRS.java,Java,,60,361,9,430
/jdk1.4.2_19/java/nio/DirectLongBufferRU.java,Java,,60,361,9,430
/jdk1.4.2_19/java/nio/DirectLongBufferS.java,Java,,163,251,16,430
/jdk1.4.2_19/java/nio/DirectLongBufferU.java,Java,,163,251,16,430
/jdk1.4.2_19/java/nio/DirectShortBufferRS.java,Java,,60,361,9,430
/jdk1.4.2_19/java/nio/DirectShortBufferRU.java,Java,,60,361,9,430
/jdk1.4.2_19/java/nio/DirectShortBufferS.java,Java,,163,251,16,430
/jdk1.4.2_19/java/nio/DirectShortBufferU.java,Java,,163,251,16,430
/jdk1.4.2_19/java/nio/DoubleBuffer.java,Java,,150,362,759,1271
/jdk1.4.2_19/java/nio/FloatBuffer.java,Java,,150,362,759,1271
/jdk1.4.2_19/java/nio/HeapByteBuffer.java,Java,,301,229,43,573
/jdk1.4.2_19/java/nio/HeapByteBufferR.java,Java,,201,341,31,573
/jdk1.4.2_19/java/nio/HeapCharBuffer.java,Java,,129,406,38,573
/jdk1.4.2_19/java/nio/HeapCharBufferR.java,Java,,77,470,26,573
/jdk1.4.2_19/java/nio/HeapDoubleBuffer.java,Java,,112,424,37,573
/jdk1.4.2_19/java/nio/HeapDoubleBufferR.java,Java,,60,488,25,573
/jdk1.4.2_19/java/nio/HeapFloatBuffer.java,Java,,112,424,37,573
/jdk1.4.2_19/java/nio/HeapFloatBufferR.java,Java,,60,488,25,573
/jdk1.4.2_19/java/nio/HeapIntBuffer.java,Java,,112,424,37,573
/jdk1.4.2_19/java/nio/HeapIntBufferR.java,Java,,60,488,25,573
/jdk1.4.2_19/java/nio/HeapLongBuffer.java,Java,,112,424,37,573
/jdk1.4.2_19/java/nio/HeapLongBufferR.java,Java,,60,488,25,573
/jdk1.4.2_19/java/nio/HeapShortBuffer.java,Java,,112,424,37,573
/jdk1.4.2_19/java/nio/HeapShortBufferR.java,Java,,60,488,25,573
/jdk1.4.2_19/java/nio/IntBuffer.java,Java,,150,362,759,1271
/jdk1.4.2_19/java/nio/InvalidMarkException.java,Java,,6,7,19,32
/jdk1.4.2_19/java/nio/LongBuffer.java,Java,,150,362,759,1271
/jdk1.4.2_19/java/nio/MappedByteBuffer.java,Java,,37,14,95,146
/jdk1.4.2_19/java/nio/ReadOnlyBufferException.java,Java,,6,7,19,32
/jdk1.4.2_19/java/nio/ShortBuffer.java,Java,,150,362,759,1271
/jdk1.4.2_19/java/nio/StringCharBuffer.java,Java,,66,22,8,96
/jdk1.4.2_19/java/rmi/AccessException.java,Java,,10,5,38,53
/jdk1.4.2_19/java/rmi/activation/Activatable.java,Java,,162,27,320,509
/jdk1.4.2_19/java/rmi/activation/ActivateFailedException.java,Java,,10,5,30,45
/jdk1.4.2_19/java/rmi/activation/ActivationDesc.java,Java,,99,22,202,323
/jdk1.4.2_19/java/rmi/activation/ActivationException.java,Java,,28,9,62,99
/jdk1.4.2_19/java/rmi/activation/ActivationGroup.java,Java,,181,37,316,534
/jdk1.4.2_19/java/rmi/activation/ActivationGroupDesc.java,Java,,121,31,189,341
/jdk1.4.2_19/java/rmi/activation/ActivationGroupID.java,Java,,26,9,63,98
/jdk1.4.2_19/java/rmi/activation/ActivationID.java,Java,,74,18,163,255
/jdk1.4.2_19/java/rmi/activation/ActivationInstantiator.java,Java,,8,5,46,59
/jdk1.4.2_19/java/rmi/activation/ActivationMonitor.java,Java,,15,9,68,92
/jdk1.4.2_19/java/rmi/activation/ActivationSystem.java,Java,,32,14,163,209
/jdk1.4.2_19/java/rmi/activation/Activator.java,Java,,9,4,83,96
/jdk1.4.2_19/java/rmi/activation/UnknownGroupException.java,Java,,7,4,32,43
/jdk1.4.2_19/java/rmi/activation/UnknownObjectException.java,Java,,7,4,34,45
/jdk1.4.2_19/java/rmi/AlreadyBoundException.java,Java,,10,4,31,45
/jdk1.4.2_19/java/rmi/ConnectException.java,Java,,10,5,30,45
/jdk1.4.2_19/java/rmi/ConnectIOException.java,Java,,10,6,31,47
/jdk1.4.2_19/java/rmi/dgc/DGC.java,Java,,9,4,84,97
/jdk1.4.2_19/java/rmi/dgc/Lease.java,Java,,19,6,34,59
/jdk1.4.2_19/java/rmi/dgc/VMID.java,Java,,83,18,58,159
/jdk1.4.2_19/java/rmi/MarshalException.java,Java,,10,5,39,54
/jdk1.4.2_19/java/rmi/MarshalledObject.java,Java,,107,28,157,292
/jdk1.4.2_19/java/rmi/Naming.java,Java,,129,22,137,288
/jdk1.4.2_19/java/rmi/NoSuchObjectException.java,Java,,7,4,34,45
/jdk1.4.2_19/java/rmi/NotBoundException.java,Java,,10,4,33,47
/jdk1.4.2_19/java/rmi/registry/LocateRegistry.java,Java,,64,15,114,193
/jdk1.4.2_19/java/rmi/registry/Registry.java,Java,,18,8,149,175
/jdk1.4.2_19/java/rmi/registry/RegistryHandler.java,Java,,8,5,40,53
/jdk1.4.2_19/java/rmi/Remote.java,Java,,2,2,29,33
/jdk1.4.2_19/java/rmi/RemoteException.java,Java,,28,9,63,100
/jdk1.4.2_19/java/rmi/RMISecurityException.java,Java,,10,4,33,47
/jdk1.4.2_19/java/rmi/RMISecurityManager.java,Java,,6,4,31,41
/jdk1.4.2_19/java/rmi/server/ExportException.java,Java,,10,6,35,51
/jdk1.4.2_19/java/rmi/server/LoaderHandler.java,Java,,11,7,56,74
/jdk1.4.2_19/java/rmi/server/LogStream.java,Java,,107,25,105,237
/jdk1.4.2_19/java/rmi/server/ObjID.java,Java,,77,23,152,252
/jdk1.4.2_19/java/rmi/server/Operation.java,Java,,13,5,34,52
/jdk1.4.2_19/java/rmi/server/RemoteCall.java,Java,,16,10,81,107
/jdk1.4.2_19/java/rmi/server/RemoteObject.java,Java,,81,14,334,429
/jdk1.4.2_19/java/rmi/server/RemoteRef.java,Java,,19,14,154,187
/jdk1.4.2_19/java/rmi/server/RemoteServer.java,Java,,27,8,63,98
/jdk1.4.2_19/java/rmi/server/RemoteStub.java,Java,,13,5,38,56
/jdk1.4.2_19/java/rmi/server/RMIClassLoader.java,Java,,127,27,559,713
/jdk1.4.2_19/java/rmi/server/RMIClassLoaderSpi.java,Java,,14,7,156,177
/jdk1.4.2_19/java/rmi/server/RMIClientSocketFactory.java,Java,,7,4,46,57
/jdk1.4.2_19/java/rmi/server/RMIFailureHandler.java,Java,,4,5,35,44
/jdk1.4.2_19/java/rmi/server/RMIServerSocketFactory.java,Java,,7,4,46,57
/jdk1.4.2_19/java/rmi/server/RMISocketFactory.java,Java,,52,12,107,171
/jdk1.4.2_19/java/rmi/server/ServerCloneException.java,Java,,25,8,60,93
/jdk1.4.2_19/java/rmi/server/ServerNotActiveException.java,Java,,9,5,30,44
/jdk1.4.2_19/java/rmi/server/ServerRef.java,Java,,8,6,35,49
/jdk1.4.2_19/java/rmi/server/Skeleton.java,Java,,7,3,40,50
/jdk1.4.2_19/java/rmi/server/SkeletonMismatchException.java,Java,,8,6,29,43
/jdk1.4.2_19/java/rmi/server/SkeletonNotFoundException.java,Java,,11,6,35,52
/jdk1.4.2_19/java/rmi/server/SocketSecurityException.java,Java,,10,6,37,53
/jdk1.4.2_19/java/rmi/server/UID.java,Java,,84,18,149,251
/jdk1.4.2_19/java/rmi/server/UnicastRemoteObject.java,Java,,113,26,139,278
/jdk1.4.2_19/java/rmi/server/Unreferenced.java,Java,,4,2,22,28
/jdk1.4.2_19/java/rmi/ServerError.java,Java,,7,4,28,39
/jdk1.4.2_19/java/rmi/ServerException.java,Java,,10,5,35,50
/jdk1.4.2_19/java/rmi/ServerRuntimeException.java,Java,,7,4,35,46
/jdk1.4.2_19/java/rmi/StubNotFoundException.java,Java,,10,5,35,50
/jdk1.4.2_19/java/rmi/UnexpectedException.java,Java,,10,5,32,47
/jdk1.4.2_19/java/rmi/UnknownHostException.java,Java,,10,5,30,45
/jdk1.4.2_19/java/rmi/UnmarshalException.java,Java,,10,5,44,59
/jdk1.4.2_19/java/security/AccessControlContext.java,Java,,240,65,183,488
/jdk1.4.2_19/java/security/AccessControlException.java,Java,,14,8,42,64
/jdk1.4.2_19/java/security/AccessController.java,Java,,43,23,338,404
/jdk1.4.2_19/java/security/acl/Acl.java,Java,,16,28,196,240
/jdk1.4.2_19/java/security/acl/AclEntry.java,Java,,15,15,108,138
/jdk1.4.2_19/java/security/acl/AclNotFoundException.java,Java,,5,4,15,24
/jdk1.4.2_19/java/security/acl/Group.java,Java,,9,9,51,69
/jdk1.4.2_19/java/security/acl/LastOwnerException.java,Java,,5,3,17,25
/jdk1.4.2_19/java/security/acl/NotOwnerException.java,Java,,5,3,16,24
/jdk1.4.2_19/java/security/acl/Owner.java,Java,,9,7,61,77
/jdk1.4.2_19/java/security/acl/Permission.java,Java,,5,6,25,36
/jdk1.4.2_19/java/security/AlgorithmParameterGenerator.java,Java,,78,18,184,280
/jdk1.4.2_19/java/security/AlgorithmParameterGeneratorSpi.java,Java,,9,7,53,69
/jdk1.4.2_19/java/security/AlgorithmParameters.java,Java,,107,21,229,357
/jdk1.4.2_19/java/security/AlgorithmParametersSpi.java,Java,,19,11,103,133
/jdk1.4.2_19/java/security/AllPermission.java,Java,,68,31,121,220
/jdk1.4.2_19/java/security/BasicPermission.java,Java,,186,71,264,521
/jdk1.4.2_19/java/security/cert/Certificate.java,Java,,88,21,141,250
/jdk1.4.2_19/java/security/cert/CertificateEncodingException.java,Java,,9,4,25,38
/jdk1.4.2_19/java/security/cert/CertificateException.java,Java,,10,5,24,39
/jdk1.4.2_19/java/security/cert/CertificateExpiredException.java,Java,,9,4,27,40
/jdk1.4.2_19/java/security/cert/CertificateFactory.java,Java,,205,27,355,587
/jdk1.4.2_19/java/security/cert/CertificateFactorySpi.java,Java,,36,12,242,290
/jdk1.4.2_19/java/security/cert/CertificateNotYetValidException.java,Java,,9,4,27,40
/jdk1.4.2_19/java/security/cert/CertificateParsingException.java,Java,,9,4,26,39
/jdk1.4.2_19/java/security/cert/CertPath.java,Java,,89,22,195,306
/jdk1.4.2_19/java/security/cert/CertPathBuilder.java,Java,,200,19,158,377
/jdk1.4.2_19/java/security/cert/CertPathBuilderException.java,Java,,43,13,98,154
/jdk1.4.2_19/java/security/cert/CertPathBuilderResult.java,Java,,5,4,42,51
/jdk1.4.2_19/java/security/cert/CertPathBuilderSpi.java,Java,,7,5,46,58
/jdk1.4.2_19/java/security/cert/CertPathHelperImpl.java,Java,,37,17,20,74
/jdk1.4.2_19/java/security/cert/CertPathParameters.java,Java,,4,3,25,32
/jdk1.4.2_19/java/security/cert/CertPathValidator.java,Java,,202,19,168,389
/jdk1.4.2_19/java/security/cert/CertPathValidatorException.java,Java,,63,18,145,226
/jdk1.4.2_19/java/security/cert/CertPathValidatorResult.java,Java,,4,3,26,33
/jdk1.4.2_19/java/security/cert/CertPathValidatorSpi.java,Java,,8,5,55,68
/jdk1.4.2_19/java/security/cert/CertSelector.java,Java,,5,4,41,50
/jdk1.4.2_19/java/security/cert/CertStore.java,Java,,220,20,242,482
/jdk1.4.2_19/java/security/cert/CertStoreException.java,Java,,43,13,96,152
/jdk1.4.2_19/java/security/cert/CertStoreParameters.java,Java,,4,3,56,63
/jdk1.4.2_19/java/security/cert/CertStoreSpi.java,Java,,11,6,91,108
/jdk1.4.2_19/java/security/cert/CollectionCertStoreParameters.java,Java,,33,9,82,124
/jdk1.4.2_19/java/security/cert/CRL.java,Java,,12,8,51,71
/jdk1.4.2_19/java/security/cert/CRLException.java,Java,,10,5,24,39
/jdk1.4.2_19/java/security/cert/CRLSelector.java,Java,,5,4,40,49
/jdk1.4.2_19/java/security/cert/LDAPCertStoreParameters.java,Java,,39,13,80,132
/jdk1.4.2_19/java/security/cert/PKIXBuilderParameters.java,Java,,40,9,133,182
/jdk1.4.2_19/java/security/cert/PKIXCertPathBuilderResult.java,Java,,28,7,67,102
/jdk1.4.2_19/java/security/cert/PKIXCertPathChecker.java,Java,,19,9,135,163
/jdk1.4.2_19/java/security/cert/PKIXCertPathValidatorResult.java,Java,,43,10,89,142
/jdk1.4.2_19/java/security/cert/PKIXParameters.java,Java,,240,39,424,703
/jdk1.4.2_19/java/security/cert/PolicyNode.java,Java,,12,10,94,116
/jdk1.4.2_19/java/security/cert/PolicyQualifierInfo.java,Java,,46,12,98,156
/jdk1.4.2_19/java/security/cert/TrustAnchor.java,Java,,96,16,166,278
/jdk1.4.2_19/java/security/cert/X509Certificate.java,Java,,59,29,526,614
/jdk1.4.2_19/java/security/cert/X509CertSelector.java,Java,,1260,106,1171,2537
/jdk1.4.2_19/java/security/cert/X509CRL.java,Java,,74,26,287,387
/jdk1.4.2_19/java/security/cert/X509CRLEntry.java,Java,,40,13,85,138
/jdk1.4.2_19/java/security/cert/X509CRLSelector.java,Java,,243,34,318,595
/jdk1.4.2_19/java/security/cert/X509Extension.java,Java,,8,8,153,169
/jdk1.4.2_19/java/security/Certificate.java,Java,,14,11,113,138
/jdk1.4.2_19/java/security/CodeSource.java,Java,,216,42,220,478
/jdk1.4.2_19/java/security/DigestException.java,Java,,9,4,24,37
/jdk1.4.2_19/java/security/DigestInputStream.java,Java,,41,18,116,175
/jdk1.4.2_19/java/security/DigestOutputStream.java,Java,,39,16,103,158
/jdk1.4.2_19/java/security/DomainCombiner.java,Java,,5,3,86,94
/jdk1.4.2_19/java/security/GeneralSecurityException.java,Java,,9,5,25,39
/jdk1.4.2_19/java/security/Guard.java,Java,,4,4,31,39
/jdk1.4.2_19/java/security/GuardedObject.java,Java,,24,10,49,83
/jdk1.4.2_19/java/security/Identity.java,Java,,178,42,259,479
/jdk1.4.2_19/java/security/IdentityScope.java,Java,,67,26,144,237
/jdk1.4.2_19/java/security/interfaces/DSAKey.java,Java,,4,3,26,33
/jdk1.4.2_19/java/security/interfaces/DSAKeyPairGenerator.java,Java,,8,5,79,92
/jdk1.4.2_19/java/security/interfaces/DSAParams.java,Java,,7,6,34,47
/jdk1.4.2_19/java/security/interfaces/DSAPrivateKey.java,Java,,6,8,29,43
/jdk1.4.2_19/java/security/interfaces/DSAPublicKey.java,Java,,6,8,29,43
/jdk1.4.2_19/java/security/interfaces/RSAKey.java,Java,,5,5,22,32
/jdk1.4.2_19/java/security/interfaces/RSAMultiPrimePrivateCrtKey.java,Java,,12,11,58,81
/jdk1.4.2_19/java/security/interfaces/RSAPrivateCrtKey.java,Java,,10,10,46,66
/jdk1.4.2_19/java/security/interfaces/RSAPrivateKey.java,Java,,6,4,20,30
/jdk1.4.2_19/java/security/interfaces/RSAPublicKey.java,Java,,6,4,18,28
/jdk1.4.2_19/java/security/InvalidAlgorithmParameterException.java,Java,,10,5,32,47
/jdk1.4.2_19/java/security/InvalidKeyException.java,Java,,9,6,25,40
/jdk1.4.2_19/java/security/InvalidParameterException.java,Java,,9,5,26,40
/jdk1.4.2_19/java/security/Key.java,Java,,7,8,113,128
/jdk1.4.2_19/java/security/KeyException.java,Java,,9,5,27,41
/jdk1.4.2_19/java/security/KeyFactory.java,Java,,65,17,197,279
/jdk1.4.2_19/java/security/KeyFactorySpi.java,Java,,13,9,100,122
/jdk1.4.2_19/java/security/KeyManagementException.java,Java,,9,5,36,50
/jdk1.4.2_19/java/security/KeyPair.java,Java,,16,8,38,62
/jdk1.4.2_19/java/security/KeyPairGenerator.java,Java,,110,26,342,478
/jdk1.4.2_19/java/security/KeyPairGeneratorSpi.java,Java,,11,7,71,89
/jdk1.4.2_19/java/security/KeyStore.java,Java,,209,32,448,689
/jdk1.4.2_19/java/security/KeyStoreException.java,Java,,9,5,27,41
/jdk1.4.2_19/java/security/KeyStoreSpi.java,Java,,34,20,215,269
/jdk1.4.2_19/java/security/MessageDigest.java,Java,,206,39,274,519
/jdk1.4.2_19/java/security/MessageDigestSpi.java,Java,,35,12,107,154
/jdk1.4.2_19/java/security/NoSuchAlgorithmException.java,Java,,9,5,26,40
/jdk1.4.2_19/java/security/NoSuchProviderException.java,Java,,9,5,25,39
/jdk1.4.2_19/java/security/Permission.java,Java,,30,22,161,213
/jdk1.4.2_19/java/security/PermissionCollection.java,Java,,30,12,134,176
/jdk1.4.2_19/java/security/Permissions.java,Java,,232,79,267,578
/jdk1.4.2_19/java/security/Policy.java,Java,,174,42,201,417
/jdk1.4.2_19/java/security/Principal.java,Java,,7,6,42,55
/jdk1.4.2_19/java/security/PrivateKey.java,Java,,4,3,32,39
/jdk1.4.2_19/java/security/PrivilegedAction.java,Java,,4,4,30,38
/jdk1.4.2_19/java/security/PrivilegedActionException.java,Java,,19,7,61,87
/jdk1.4.2_19/java/security/PrivilegedExceptionAction.java,Java,,4,5,35,44
/jdk1.4.2_19/java/security/ProtectionDomain.java,Java,,157,36,139,332
/jdk1.4.2_19/java/security/Provider.java,Java,,130,33,229,392
/jdk1.4.2_19/java/security/ProviderException.java,Java,,9,5,25,39
/jdk1.4.2_19/java/security/PublicKey.java,Java,,4,3,29,36
/jdk1.4.2_19/java/security/SecureClassLoader.java,Java,,64,14,100,178
/jdk1.4.2_19/java/security/SecureRandom.java,Java,,136,30,349,515
/jdk1.4.2_19/java/security/SecureRandomSpi.java,Java,,6,6,38,50
/jdk1.4.2_19/java/security/Security.java,Java,,940,165,617,1722
/jdk1.4.2_19/java/security/SecurityPermission.java,Java,,15,8,260,283
/jdk1.4.2_19/java/security/Signature.java,Java,,283,68,484,835
/jdk1.4.2_19/java/security/SignatureException.java,Java,,9,6,24,39
/jdk1.4.2_19/java/security/SignatureSpi.java,Java,,62,27,240,329
/jdk1.4.2_19/java/security/SignedObject.java,Java,,57,15,168,240
/jdk1.4.2_19/java/security/Signer.java,Java,,58,17,88,163
/jdk1.4.2_19/java/security/spec/AlgorithmParameterSpec.java,Java,,2,3,22,27
/jdk1.4.2_19/java/security/spec/DSAParameterSpec.java,Java,,22,9,41,72
/jdk1.4.2_19/java/security/spec/DSAPrivateKeySpec.java,Java,,27,10,52,89
/jdk1.4.2_19/java/security/spec/DSAPublicKeySpec.java,Java,,27,10,52,89
/jdk1.4.2_19/java/security/spec/EncodedKeySpec.java,Java,,11,7,46,64
/jdk1.4.2_19/java/security/spec/InvalidKeySpecException.java,Java,,10,6,29,45
/jdk1.4.2_19/java/security/spec/InvalidParameterSpecException.java,Java,,10,6,31,47
/jdk1.4.2_19/java/security/spec/KeySpec.java,Java,,2,3,40,45
/jdk1.4.2_19/java/security/spec/PKCS8EncodedKeySpec.java,Java,,12,6,57,75
/jdk1.4.2_19/java/security/spec/PSSParameterSpec.java,Java,,14,7,33,54
/jdk1.4.2_19/java/security/spec/RSAKeyGenParameterSpec.java,Java,,19,10,40,69
/jdk1.4.2_19/java/security/spec/RSAMultiPrimePrivateCrtKeySpec.java,Java,,92,13,90,195
/jdk1.4.2_19/java/security/spec/RSAOtherPrimeInfo.java,Java,,35,10,58,103
/jdk1.4.2_19/java/security/spec/RSAPrivateCrtKeySpec.java,Java,,46,14,68,128
/jdk1.4.2_19/java/security/spec/RSAPrivateKeySpec.java,Java,,16,8,36,60
/jdk1.4.2_19/java/security/spec/RSAPublicKeySpec.java,Java,,16,8,36,60
/jdk1.4.2_19/java/security/spec/X509EncodedKeySpec.java,Java,,12,6,47,65
/jdk1.4.2_19/java/security/UnrecoverableKeyException.java,Java,,9,5,23,37
/jdk1.4.2_19/java/security/UnresolvedPermission.java,Java,,282,41,196,519
/jdk1.4.2_19/java/security/UnresolvedPermissionCollection.java,Java,,74,31,90,195
/jdk1.4.2_19/java/sql/Array.java,Java,,15,16,257,288
/jdk1.4.2_19/java/sql/BatchUpdateException.java,Java,,29,10,114,153
/jdk1.4.2_19/java/sql/Blob.java,Java,,12,16,160,188
/jdk1.4.2_19/java/sql/CallableStatement.java,Java,,111,97,1208,1416
/jdk1.4.2_19/java/sql/Clob.java,Java,,14,17,184,215
/jdk1.4.2_19/java/sql/Connection.java,Java,,57,51,768,876
/jdk1.4.2_19/java/sql/DatabaseMetaData.java,Java,,247,227,2571,3045
/jdk1.4.2_19/java/sql/DataTruncation.java,Java,,38,15,75,128
/jdk1.4.2_19/java/sql/Date.java,Java,,64,22,137,223
/jdk1.4.2_19/java/sql/Driver.java,Java,,11,12,113,136
/jdk1.4.2_19/java/sql/DriverManager.java,Java,,251,71,250,572
/jdk1.4.2_19/java/sql/DriverPropertyInfo.java,Java,,12,9,43,64
/jdk1.4.2_19/java/sql/ParameterMetaData.java,Java,,19,20,123,162
/jdk1.4.2_19/java/sql/PreparedStatement.java,Java,,56,45,545,646
/jdk1.4.2_19/java/sql/Ref.java,Java,,7,10,83,100
/jdk1.4.2_19/java/sql/ResultSet.java,Java,,174,177,2022,2373
/jdk1.4.2_19/java/sql/ResultSetMetaData.java,Java,,27,28,195,250
/jdk1.4.2_19/java/sql/Savepoint.java,Java,,5,7,32,44
/jdk1.4.2_19/java/sql/SQLData.java,Java,,6,6,101,113
/jdk1.4.2_19/java/sql/SQLException.java,Java,,65,14,89,168
/jdk1.4.2_19/java/sql/SQLInput.java,Java,,26,31,219,276
/jdk1.4.2_19/java/sql/SQLOutput.java,Java,,26,31,229,286
/jdk1.4.2_19/java/sql/SQLPermission.java,Java,,11,11,83,105
/jdk1.4.2_19/java/sql/SQLWarning.java,Java,,32,11,67,110
/jdk1.4.2_19/java/sql/Statement.java,Java,,47,53,703,803
/jdk1.4.2_19/java/sql/Struct.java,Java,,6,8,62,76
/jdk1.4.2_19/java/sql/Time.java,Java,,78,23,124,225
/jdk1.4.2_19/java/sql/Timestamp.java,Java,,253,40,210,503
/jdk1.4.2_19/java/sql/Types.java,Java,,34,40,174,248
/jdk1.4.2_19/java/text/Annotation.java,Java,,13,8,45,66
/jdk1.4.2_19/java/text/AttributedCharacterIterator.java,Java,,54,29,139,222
/jdk1.4.2_19/java/text/AttributedString.java,Java,,712,132,237,1081
/jdk1.4.2_19/java/text/Bidi.java,Java,,369,72,200,641
/jdk1.4.2_19/java/text/BreakDictionary.java,Java,,121,35,150,306
/jdk1.4.2_19/java/text/BreakIterator.java,Java,,176,43,354,573
/jdk1.4.2_19/java/text/CharacterBreakData.java,Java,,163,23,138,324
/jdk1.4.2_19/java/text/CharacterIterator.java,Java,,15,17,143,175
/jdk1.4.2_19/java/text/CharacterIteratorFieldDelegate.java,Java,,60,11,36,107
/jdk1.4.2_19/java/text/CharSet.java,Java,,697,91,287,1075
/jdk1.4.2_19/java/text/ChoiceFormat.java,Java,,262,39,299,600
/jdk1.4.2_19/java/text/CollationElementIterator.java,Java,,390,57,285,732
/jdk1.4.2_19/java/text/CollationKey.java,Java,,45,17,129,191
/jdk1.4.2_19/java/text/CollationRules.java,Java,,204,11,42,257
/jdk1.4.2_19/java/text/Collator.java,Java,,115,30,338,483
/jdk1.4.2_19/java/text/DateFormat.java,Java,,261,66,572,899
/jdk1.4.2_19/java/text/DateFormatSymbols.java,Java,,225,49,288,562
/jdk1.4.2_19/java/text/DecimalFormat.java,Java,,1312,195,1259,2766
/jdk1.4.2_19/java/text/DecimalFormatSymbols.java,Java,,251,72,340,663
/jdk1.4.2_19/java/text/DictionaryBasedBreakIterator.java,Java,,236,57,265,558
/jdk1.4.2_19/java/text/DigitList.java,Java,,262,48,222,532
/jdk1.4.2_19/java/text/DontCareFieldPosition.java,Java,,18,5,12,35
/jdk1.4.2_19/java/text/EntryPair.java,Java,,15,4,23,42
/jdk1.4.2_19/java/text/FieldPosition.java,Java,,96,27,163,286
/jdk1.4.2_19/java/text/Format.java,Java,,65,25,288,378
/jdk1.4.2_19/java/text/LineBreakData.java,Java,,296,15,197,508
/jdk1.4.2_19/java/text/MergeCollation.java,Java,,187,32,107,326
/jdk1.4.2_19/java/text/MessageFormat.java,Java,,620,68,797,1485
/jdk1.4.2_19/java/text/NumberFormat.java,Java,,273,84,670,1027
/jdk1.4.2_19/java/text/ParseException.java,Java,,12,6,43,61
/jdk1.4.2_19/java/text/ParsePosition.java,Java,,38,12,72,122
/jdk1.4.2_19/java/text/PatternEntry.java,Java,,206,29,54,289
/jdk1.4.2_19/java/text/RBCollationTables.java,Java,,129,31,121,281
/jdk1.4.2_19/java/text/RBTableBuilder.java,Java,,279,55,165,499
/jdk1.4.2_19/java/text/RuleBasedBreakIterator.java,Java,,1200,276,1167,2643
/jdk1.4.2_19/java/text/RuleBasedCollator.java,Java,,260,43,469,772
/jdk1.4.2_19/java/text/SentenceBreakData.java,Java,,219,33,189,441
/jdk1.4.2_19/java/text/SimpleDateFormat.java,Java,,983,120,800,1903
/jdk1.4.2_19/java/text/SimpleTextBoundary.java,Java,,199,33,110,342
/jdk1.4.2_19/java/text/SpecialMapping.java,Java,,17,6,45,68
/jdk1.4.2_19/java/text/StringCharacterIterator.java,Java,,129,26,106,261
/jdk1.4.2_19/java/text/TextBoundaryData.java,Java,,259,10,28,297
/jdk1.4.2_19/java/text/UnicodeClassMapping.java,Java,,43,8,42,93
/jdk1.4.2_19/java/text/WordBreakData.java,Java,,293,40,180,513
/jdk1.4.2_19/java/text/WordBreakTable.java,Java,,31,9,53,93
/jdk1.4.2_19/java/util/AbstractCollection.java,Java,,124,29,311,464
/jdk1.4.2_19/java/util/AbstractList.java,Java,,335,75,456,866
/jdk1.4.2_19/java/util/AbstractMap.java,Java,,256,56,355,667
/jdk1.4.2_19/java/util/AbstractSequentialList.java,Java,,52,14,196,262
/jdk1.4.2_19/java/util/AbstractSet.java,Java,,46,11,98,155
/jdk1.4.2_19/java/util/ArrayList.java,Java,,201,53,302,556
/jdk1.4.2_19/java/util/Arrays.java,Java,,1017,214,1150,2381
/jdk1.4.2_19/java/util/BitSet.java,Java,,486,121,439,1046
/jdk1.4.2_19/java/util/Calendar.java,Java,,562,119,1108,1789
/jdk1.4.2_19/java/util/Collection.java,Java,,18,24,370,412
/jdk1.4.2_19/java/util/Collections.java,Java,,1236,256,1020,2512
/jdk1.4.2_19/java/util/Comparator.java,Java,,5,4,129,138
/jdk1.4.2_19/java/util/ConcurrentModificationException.java,Java,,8,3,58,69
/jdk1.4.2_19/java/util/Currency.java,Java,,166,30,168,364
/jdk1.4.2_19/java/util/CurrencyData.java,Java,,36,11,0,47
/jdk1.4.2_19/java/util/Date.java,Java,,408,48,733,1189
/jdk1.4.2_19/java/util/Dictionary.java,Java,,13,9,116,138
/jdk1.4.2_19/java/util/EmptyStackException.java,Java,,6,2,19,27
/jdk1.4.2_19/java/util/Enumeration.java,Java,,5,3,56,64
/jdk1.4.2_19/java/util/EventListener.java,Java,,3,2,10,15
/jdk1.4.2_19/java/util/EventListenerProxy.java,Java,,10,4,39,53
/jdk1.4.2_19/java/util/EventObject.java,Java,,15,7,34,56
/jdk1.4.2_19/java/util/GregorianCalendar.java,Java,,991,202,1038,2231
/jdk1.4.2_19/java/util/HashMap.java,Java,,508,104,411,1023
/jdk1.4.2_19/java/util/HashSet.java,Java,,77,26,177,280
/jdk1.4.2_19/java/util/Hashtable.java,Java,,526,111,423,1060
/jdk1.4.2_19/java/util/IdentityHashMap.java,Java,,555,94,518,1167
/jdk1.4.2_19/java/util/Iterator.java,Java,,6,4,56,66
/jdk1.4.2_19/java/util/jar/Attributes.java,Java,,251,62,319,632
/jdk1.4.2_19/java/util/jar/JarEntry.java,Java,,26,8,54,88
/jdk1.4.2_19/java/util/jar/JarException.java,Java,,9,3,21,33
/jdk1.4.2_19/java/util/jar/JarFile.java,Java,,289,37,160,486
/jdk1.4.2_19/java/util/jar/JarInputStream.java,Java,,88,16,79,183
/jdk1.4.2_19/java/util/jar/JarOutputStream.java,Java,,58,10,62,130
/jdk1.4.2_19/java/util/jar/JarVerifier.java,Java,,252,61,87,400
/jdk1.4.2_19/java/util/jar/JavaUtilJarAccessImpl.java,Java,,8,3,6,17
/jdk1.4.2_19/java/util/jar/Manifest.java,Java,,261,34,118,413
/jdk1.4.2_19/java/util/LinkedHashMap.java,Java,,146,36,276,458
/jdk1.4.2_19/java/util/LinkedHashSet.java,Java,,17,6,124,147
/jdk1.4.2_19/java/util/LinkedList.java,Java,,317,69,322,708
/jdk1.4.2_19/java/util/List.java,Java,,28,41,494,563
/jdk1.4.2_19/java/util/ListIterator.java,Java,,12,13,159,184
/jdk1.4.2_19/java/util/ListResourceBundle.java,Java,,39,11,106,156
/jdk1.4.2_19/java/util/Locale.java,Java,,468,116,576,1160
/jdk1.4.2_19/java/util/logging/ConsoleHandler.java,Java,,33,10,57,100
/jdk1.4.2_19/java/util/logging/ErrorManager.java,Java,,24,7,50,81
/jdk1.4.2_19/java/util/logging/FileHandler.java,Java,,316,37,243,596
/jdk1.4.2_19/java/util/logging/Filter.java,Java,,4,6,23,33
/jdk1.4.2_19/java/util/logging/Formatter.java,Java,,35,15,87,137
/jdk1.4.2_19/java/util/logging/Handler.java,Java,,87,22,170,279
/jdk1.4.2_19/java/util/logging/Level.java,Java,,102,30,210,342
/jdk1.4.2_19/java/util/logging/Logger.java,Java,,525,104,808,1437
/jdk1.4.2_19/java/util/logging/LoggingPermission.java,Java,,13,6,37,56
/jdk1.4.2_19/java/util/logging/LogManager.java,Java,,509,76,337,922
/jdk1.4.2_19/java/util/logging/LogRecord.java,Java,,186,45,275,506
/jdk1.4.2_19/java/util/logging/MemoryHandler.java,Java,,103,16,133,252
/jdk1.4.2_19/java/util/logging/SimpleFormatter.java,Java,,50,9,21,80
/jdk1.4.2_19/java/util/logging/SocketHandler.java,Java,,74,15,83,172
/jdk1.4.2_19/java/util/logging/StreamHandler.java,Java,,123,18,129,270
/jdk1.4.2_19/java/util/logging/XMLFormatter.java,Java,,158,24,51,233
/jdk1.4.2_19/java/util/Map.java,Java,,24,27,370,421
/jdk1.4.2_19/java/util/MissingResourceException.java,Java,,17,9,54,80
/jdk1.4.2_19/java/util/NoSuchElementException.java,Java,,10,3,28,41
/jdk1.4.2_19/java/util/Observable.java,Java,,47,15,134,196
/jdk1.4.2_19/java/util/Observer.java,Java,,4,1,25,30
/jdk1.4.2_19/java/util/prefs/AbstractPreferences.java,Java,,528,106,957,1591
/jdk1.4.2_19/java/util/prefs/BackingStoreException.java,Java,,18,7,38,63
/jdk1.4.2_19/java/util/prefs/Base64.java,Java,,145,20,79,244
/jdk1.4.2_19/java/util/prefs/InvalidPreferencesFormatException.java,Java,,21,9,53,83
/jdk1.4.2_19/java/util/prefs/NodeChangeEvent.java,Java,,23,10,51,84
/jdk1.4.2_19/java/util/prefs/NodeChangeListener.java,Java,,5,4,28,37
/jdk1.4.2_19/java/util/prefs/PreferenceChangeEvent.java,Java,,29,11,64,104
/jdk1.4.2_19/java/util/prefs/PreferenceChangeListener.java,Java,,4,2,23,29
/jdk1.4.2_19/java/util/prefs/Preferences.java,Java,,128,55,990,1173
/jdk1.4.2_19/java/util/prefs/PreferencesFactory.java,Java,,6,3,31,40
/jdk1.4.2_19/java/util/prefs/WindowsPreferences.java,Java,,700,67,327,1094
/jdk1.4.2_19/java/util/prefs/WindowsPreferencesFactory.java,Java,,9,3,22,34
/jdk1.4.2_19/java/util/prefs/XmlSupport.java,Java,,219,30,115,364
/jdk1.4.2_19/java/util/Properties.java,Java,,259,40,378,677
/jdk1.4.2_19/java/util/PropertyPermission.java,Java,,255,95,286,636
/jdk1.4.2_19/java/util/PropertyResourceBundle.java,Java,,22,8,90,120
/jdk1.4.2_19/java/util/Random.java,Java,,112,33,359,504
/jdk1.4.2_19/java/util/RandomAccess.java,Java,,3,2,44,49
/jdk1.4.2_19/java/util/regex/ASCII.java,Java,,205,40,11,256
/jdk1.4.2_19/java/util/regex/Matcher.java,Java,,220,51,510,781
/jdk1.4.2_19/java/util/regex/Pattern.java,Java,,3293,259,1458,5010
/jdk1.4.2_19/java/util/regex/PatternSyntaxException.java,Java,,45,14,51,110
/jdk1.4.2_19/java/util/ResourceBundle.java,Java,,437,68,622,1127
/jdk1.4.2_19/java/util/ResourceBundleEnumeration.java,Java,,36,7,16,59
/jdk1.4.2_19/java/util/Set.java,Java,,18,26,287,331
/jdk1.4.2_19/java/util/SimpleTimeZone.java,Java,,644,111,973,1728
/jdk1.4.2_19/java/util/SortedMap.java,Java,,9,8,207,224
/jdk1.4.2_19/java/util/SortedSet.java,Java,,9,8,206,223
/jdk1.4.2_19/java/util/Stack.java,Java,,34,13,71,118
/jdk1.4.2_19/java/util/StringTokenizer.java,Java,,108,23,209,340
/jdk1.4.2_19/java/util/Timer.java,Java,,190,36,337,563
/jdk1.4.2_19/java/util/TimerTask.java,Java,,27,14,100,141
/jdk1.4.2_19/java/util/TimeZone.java,Java,,260,47,406,713
/jdk1.4.2_19/java/util/TooManyListenersException.java,Java,,9,8,37,54
/jdk1.4.2_19/java/util/TreeMap.java,Java,,851,166,619,1636
/jdk1.4.2_19/java/util/TreeSet.java,Java,,108,36,344,488
/jdk1.4.2_19/java/util/Vector.java,Java,,325,71,623,1019
/jdk1.4.2_19/java/util/WeakHashMap.java,Java,,493,103,355,951
/jdk1.4.2_19/java/util/zip/Adler32.java,Java,,35,11,38,84
/jdk1.4.2_19/java/util/zip/CheckedInputStream.java,Java,,42,8,44,94
/jdk1.4.2_19/java/util/zip/CheckedOutputStream.java,Java,,23,7,37,67
/jdk1.4.2_19/java/util/zip/Checksum.java,Java,,8,5,30,43
/jdk1.4.2_19/java/util/zip/CRC32.java,Java,,34,11,36,81
/jdk1.4.2_19/java/util/zip/DataFormatException.java,Java,,10,3,20,33
/jdk1.4.2_19/java/util/zip/Deflater.java,Java,,149,32,200,381
/jdk1.4.2_19/java/util/zip/DeflaterOutputStream.java,Java,,76,15,73,164
/jdk1.4.2_19/java/util/zip/GZIPInputStream.java,Java,,116,20,86,222
/jdk1.4.2_19/java/util/zip/GZIPOutputStream.java,Java,,70,15,67,152
/jdk1.4.2_19/java/util/zip/Inflater.java,Java,,119,22,176,317
/jdk1.4.2_19/java/util/zip/InflaterInputStream.java,Java,,111,20,88,219
/jdk1.4.2_19/java/util/zip/ZipConstants.java,Java,,43,7,31,81
/jdk1.4.2_19/java/util/zip/ZipEntry.java,Java,,147,33,151,331
/jdk1.4.2_19/java/util/zip/ZipException.java,Java,,11,6,24,41
/jdk1.4.2_19/java/util/zip/ZipFile.java,Java,,299,47,150,496
/jdk1.4.2_19/java/util/zip/ZipInputStream.java,Java,,284,22,111,417
/jdk1.4.2_19/java/util/zip/ZipOutputStream.java,Java,,349,25,125,499
/jdk1.4.2_19/javax/accessibility/Accessible.java,Java,,4,3,26,33
/jdk1.4.2_19/javax/accessibility/AccessibleAction.java,Java,,6,5,48,59
/jdk1.4.2_19/javax/accessibility/AccessibleBundle.java,Java,,56,19,63,138
/jdk1.4.2_19/javax/accessibility/AccessibleComponent.java,Java,,32,30,236,298
/jdk1.4.2_19/javax/accessibility/AccessibleContext.java,Java,,123,52,489,664
/jdk1.4.2_19/javax/accessibility/AccessibleEditableText.java,Java,,15,14,86,115
/jdk1.4.2_19/javax/accessibility/AccessibleExtendedComponent.java,Java,,6,5,45,56
/jdk1.4.2_19/javax/accessibility/AccessibleExtendedTable.java,Java,,6,5,46,57
/jdk1.4.2_19/javax/accessibility/AccessibleHyperlink.java,Java,,14,13,96,123
/jdk1.4.2_19/javax/accessibility/AccessibleHypertext.java,Java,,9,8,46,63
/jdk1.4.2_19/javax/accessibility/AccessibleIcon.java,Java,,7,7,50,64
/jdk1.4.2_19/javax/accessibility/AccessibleKeyBinding.java,Java,,5,4,55,64
/jdk1.4.2_19/javax/accessibility/AccessibleRelation.java,Java,,51,21,152,224
/jdk1.4.2_19/javax/accessibility/AccessibleRelationSet.java,Java,,115,16,94,225
/jdk1.4.2_19/javax/accessibility/AccessibleResourceBundle.java,Java,,89,5,43,137
/jdk1.4.2_19/javax/accessibility/AccessibleRole.java,Java,,121,77,379,577
/jdk1.4.2_19/javax/accessibility/AccessibleSelection.java,Java,,10,9,78,97
/jdk1.4.2_19/javax/accessibility/AccessibleState.java,Java,,62,32,228,322
/jdk1.4.2_19/javax/accessibility/AccessibleStateSet.java,Java,,86,14,82,182
/jdk1.4.2_19/javax/accessibility/AccessibleTable.java,Java,,25,26,151,202
/jdk1.4.2_19/javax/accessibility/AccessibleTableModelChange.java,Java,,11,10,62,83
/jdk1.4.2_19/javax/accessibility/AccessibleText.java,Java,,20,19,125,164
/jdk1.4.2_19/javax/accessibility/AccessibleValue.java,Java,,7,7,61,75
/jdk1.4.2_19/javax/imageio/event/IIOReadProgressListener.java,Java,,16,12,126,154
/jdk1.4.2_19/javax/imageio/event/IIOReadUpdateListener.java,Java,,34,9,189,232
/jdk1.4.2_19/javax/imageio/event/IIOReadWarningListener.java,Java,,6,4,31,41
/jdk1.4.2_19/javax/imageio/event/IIOWriteProgressListener.java,Java,,14,10,99,123
/jdk1.4.2_19/javax/imageio/event/IIOWriteWarningListener.java,Java,,8,4,33,45
/jdk1.4.2_19/javax/imageio/IIOException.java,Java,,11,5,40,56
/jdk1.4.2_19/javax/imageio/IIOImage.java,Java,,88,20,197,305
/jdk1.4.2_19/javax/imageio/IIOParam.java,Java,,152,38,469,659
/jdk1.4.2_19/javax/imageio/IIOParamController.java,Java,,4,3,94,101
/jdk1.4.2_19/javax/imageio/ImageIO.java,Java,,772,137,603,1512
/jdk1.4.2_19/javax/imageio/ImageReader.java,Java,,824,146,1871,2841
/jdk1.4.2_19/javax/imageio/ImageReadParam.java,Java,,98,24,364,486
/jdk1.4.2_19/javax/imageio/ImageTranscoder.java,Java,,9,5,121,135
/jdk1.4.2_19/javax/imageio/ImageTypeSpecifier.java,Java,,677,95,378,1150
/jdk1.4.2_19/javax/imageio/ImageWriteParam.java,Java,,398,59,991,1448
/jdk1.4.2_19/javax/imageio/ImageWriter.java,Java,,405,90,1451,1946
/jdk1.4.2_19/javax/imageio/metadata/IIOInvalidTreeException.java,Java,,18,7,55,80
/jdk1.4.2_19/javax/imageio/metadata/IIOMetadata.java,Java,,196,41,609,846
/jdk1.4.2_19/javax/imageio/metadata/IIOMetadataController.java,Java,,4,3,62,69
/jdk1.4.2_19/javax/imageio/metadata/IIOMetadataFormat.java,Java,,59,57,702,818
/jdk1.4.2_19/javax/imageio/metadata/IIOMetadataFormatImpl.java,Java,,601,115,506,1222
/jdk1.4.2_19/javax/imageio/metadata/IIOMetadataNode.java,Java,,420,127,303,850
/jdk1.4.2_19/javax/imageio/plugins/jpeg/JPEGHuffmanTable.java,Java,,156,27,102,285
/jdk1.4.2_19/javax/imageio/plugins/jpeg/JPEGImageReadParam.java,Java,,48,11,123,182
/jdk1.4.2_19/javax/imageio/plugins/jpeg/JPEGImageWriteParam.java,Java,,104,17,181,302
/jdk1.4.2_19/javax/imageio/plugins/jpeg/JPEGQTable.java,Java,,81,19,105,205
/jdk1.4.2_19/javax/imageio/spi/DigraphNode.java,Java,,62,20,62,144
/jdk1.4.2_19/javax/imageio/spi/IIORegistry.java,Java,,70,11,98,179
/jdk1.4.2_19/javax/imageio/spi/IIOServiceProvider.java,Java,,32,12,111,155
/jdk1.4.2_19/javax/imageio/spi/ImageInputStreamSpi.java,Java,,32,11,141,184
/jdk1.4.2_19/javax/imageio/spi/ImageOutputStreamSpi.java,Java,,33,11,139,183
/jdk1.4.2_19/javax/imageio/spi/ImageReaderSpi.java,Java,,76,16,297,389
/jdk1.4.2_19/javax/imageio/spi/ImageReaderWriterSpi.java,Java,,181,35,368,584
/jdk1.4.2_19/javax/imageio/spi/ImageTranscoderSpi.java,Java,,13,8,57,78
/jdk1.4.2_19/javax/imageio/spi/ImageWriterSpi.java,Java,,84,18,314,416
/jdk1.4.2_19/javax/imageio/spi/PartiallyOrderedSet.java,Java,,97,31,69,197
/jdk1.4.2_19/javax/imageio/spi/RegisterableService.java,Java,,5,4,38,47
/jdk1.4.2_19/javax/imageio/spi/ServiceRegistry.java,Java,,320,59,435,814
/jdk1.4.2_19/javax/imageio/stream/FileCacheImageInputStream.java,Java,,103,25,83,211
/jdk1.4.2_19/javax/imageio/stream/FileCacheImageOutputStream.java,Java,,110,23,84,217
/jdk1.4.2_19/javax/imageio/stream/FileImageInputStream.java,Java,,61,11,52,124
/jdk1.4.2_19/javax/imageio/stream/FileImageOutputStream.java,Java,,70,13,48,131
/jdk1.4.2_19/javax/imageio/stream/IIOByteBuffer.java,Java,,29,12,85,126
/jdk1.4.2_19/javax/imageio/stream/ImageInputStream.java,Java,,51,48,869,968
/jdk1.4.2_19/javax/imageio/stream/ImageInputStreamImpl.java,Java,,547,109,200,856
/jdk1.4.2_19/javax/imageio/stream/ImageOutputStream.java,Java,,28,26,585,639
/jdk1.4.2_19/javax/imageio/stream/ImageOutputStreamImpl.java,Java,,382,53,51,486
/jdk1.4.2_19/javax/imageio/stream/MemoryCache.java,Java,,182,36,122,340
/jdk1.4.2_19/javax/imageio/stream/MemoryCacheImageInputStream.java,Java,,64,20,61,145
/jdk1.4.2_19/javax/imageio/stream/MemoryCacheImageOutputStream.java,Java,,81,24,70,175
/jdk1.4.2_19/javax/naming/AuthenticationException.java,Java,,10,5,43,58
/jdk1.4.2_19/javax/naming/AuthenticationNotSupportedException.java,Java,,10,5,48,63
/jdk1.4.2_19/javax/naming/BinaryRefAddr.java,Java,,50,13,103,166
/jdk1.4.2_19/javax/naming/Binding.java,Java,,40,15,128,183
/jdk1.4.2_19/javax/naming/CannotProceedException.java,Java,,42,21,206,269
/jdk1.4.2_19/javax/naming/CommunicationException.java,Java,,10,4,35,49
/jdk1.4.2_19/javax/naming/CompositeName.java,Java,,119,32,456,607
/jdk1.4.2_19/javax/naming/CompoundName.java,Java,,127,30,451,608
/jdk1.4.2_19/javax/naming/ConfigurationException.java,Java,,10,4,41,55
/jdk1.4.2_19/javax/naming/Context.java,Java,,51,49,982,1082
/jdk1.4.2_19/javax/naming/ContextNotEmptyException.java,Java,,10,4,41,55
/jdk1.4.2_19/javax/naming/directory/Attribute.java,Java,,26,22,275,323
/jdk1.4.2_19/javax/naming/directory/AttributeInUseException.java,Java,,11,5,34,50
/jdk1.4.2_19/javax/naming/directory/AttributeModificationException.java,Java,,26,12,85,123
/jdk1.4.2_19/javax/naming/directory/Attributes.java,Java,,16,15,135,166
/jdk1.4.2_19/javax/naming/directory/BasicAttribute.java,Java,,269,51,219,539
/jdk1.4.2_19/javax/naming/directory/BasicAttributes.java,Java,,169,45,145,359
/jdk1.4.2_19/javax/naming/directory/DirContext.java,Java,,71,35,910,1016
/jdk1.4.2_19/javax/naming/directory/InitialDirContext.java,Java,,165,38,62,265
/jdk1.4.2_19/javax/naming/directory/InvalidAttributeIdentifierException.java,Java,,11,6,32,49
/jdk1.4.2_19/javax/naming/directory/InvalidAttributesException.java,Java,,11,6,38,55
/jdk1.4.2_19/javax/naming/directory/InvalidAttributeValueException.java,Java,,11,6,36,53
/jdk1.4.2_19/javax/naming/directory/InvalidSearchControlsException.java,Java,,11,6,33,50
/jdk1.4.2_19/javax/naming/directory/InvalidSearchFilterException.java,Java,,11,6,33,50
/jdk1.4.2_19/javax/naming/directory/ModificationItem.java,Java,,37,14,66,117
/jdk1.4.2_19/javax/naming/directory/NoSuchAttributeException.java,Java,,11,7,31,49
/jdk1.4.2_19/javax/naming/directory/SchemaViolationException.java,Java,,11,6,43,60
/jdk1.4.2_19/javax/naming/directory/SearchControls.java,Java,,70,26,223,319
/jdk1.4.2_19/javax/naming/directory/SearchResult.java,Java,,34,14,124,172
/jdk1.4.2_19/javax/naming/event/EventContext.java,Java,,15,12,205,232
/jdk1.4.2_19/javax/naming/event/EventDirContext.java,Java,,15,6,121,142
/jdk1.4.2_19/javax/naming/event/NamespaceChangeListener.java,Java,,6,5,63,74
/jdk1.4.2_19/javax/naming/event/NamingEvent.java,Java,,52,20,211,283
/jdk1.4.2_19/javax/naming/event/NamingExceptionEvent.java,Java,,19,9,49,77
/jdk1.4.2_19/javax/naming/event/NamingListener.java,Java,,4,2,42,48
/jdk1.4.2_19/javax/naming/event/ObjectChangeListener.java,Java,,4,3,49,56
/jdk1.4.2_19/javax/naming/InitialContext.java,Java,,175,48,264,487
/jdk1.4.2_19/javax/naming/InsufficientResourcesException.java,Java,,10,5,40,55
/jdk1.4.2_19/javax/naming/InterruptedNamingException.java,Java,,10,5,44,59
/jdk1.4.2_19/javax/naming/InvalidNameException.java,Java,,10,5,40,55
/jdk1.4.2_19/javax/naming/ldap/Control.java,Java,,8,7,64,79
/jdk1.4.2_19/javax/naming/ldap/ControlFactory.java,Java,,27,13,100,140
/jdk1.4.2_19/javax/naming/ldap/ExtendedRequest.java,Java,,8,7,116,131
/jdk1.4.2_19/javax/naming/ldap/ExtendedResponse.java,Java,,5,6,71,82
/jdk1.4.2_19/javax/naming/ldap/HasControls.java,Java,,5,5,43,53
/jdk1.4.2_19/javax/naming/ldap/InitialLdapContext.java,Java,,61,20,110,191
/jdk1.4.2_19/javax/naming/ldap/LdapContext.java,Java,,17,11,306,334
/jdk1.4.2_19/javax/naming/ldap/LdapReferralException.java,Java,,18,9,114,141
/jdk1.4.2_19/javax/naming/ldap/StartTlsRequest.java,Java,,74,29,128,231
/jdk1.4.2_19/javax/naming/ldap/StartTlsResponse.java,Java,,23,19,146,188
/jdk1.4.2_19/javax/naming/ldap/UnsolicitedNotification.java,Java,,6,5,36,47
/jdk1.4.2_19/javax/naming/ldap/UnsolicitedNotificationEvent.java,Java,,16,8,43,67
/jdk1.4.2_19/javax/naming/ldap/UnsolicitedNotificationListener.java,Java,,5,4,42,51
/jdk1.4.2_19/javax/naming/LimitExceededException.java,Java,,11,7,39,57
/jdk1.4.2_19/javax/naming/LinkException.java,Java,,63,23,201,287
/jdk1.4.2_19/javax/naming/LinkLoopException.java,Java,,10,5,35,50
/jdk1.4.2_19/javax/naming/LinkRef.java,Java,,21,7,71,99
/jdk1.4.2_19/javax/naming/MalformedLinkException.java,Java,,10,6,34,50
/jdk1.4.2_19/javax/naming/Name.java,Java,,19,19,213,251
/jdk1.4.2_19/javax/naming/NameAlreadyBoundException.java,Java,,10,5,41,56
/jdk1.4.2_19/javax/naming/NameClassPair.java,Java,,38,16,163,217
/jdk1.4.2_19/javax/naming/NameImpl.java,Java,,530,81,103,714
/jdk1.4.2_19/javax/naming/NameNotFoundException.java,Java,,10,5,33,48
/jdk1.4.2_19/javax/naming/NameParser.java,Java,,4,3,33,40
/jdk1.4.2_19/javax/naming/NamingEnumeration.java,Java,,7,5,118,130
/jdk1.4.2_19/javax/naming/NamingException.java,Java,,104,24,242,370
/jdk1.4.2_19/javax/naming/NamingSecurityException.java,Java,,10,5,39,54
/jdk1.4.2_19/javax/naming/NoInitialContextException.java,Java,,10,4,44,58
/jdk1.4.2_19/javax/naming/NoPermissionException.java,Java,,10,4,33,47
/jdk1.4.2_19/javax/naming/NotContextException.java,Java,,10,5,41,56
/jdk1.4.2_19/javax/naming/OperationNotSupportedException.java,Java,,10,5,35,50
/jdk1.4.2_19/javax/naming/PartialResultException.java,Java,,10,5,34,49
/jdk1.4.2_19/javax/naming/RefAddr.java,Java,,36,12,86,134
/jdk1.4.2_19/javax/naming/Reference.java,Java,,109,29,240,378
/jdk1.4.2_19/javax/naming/Referenceable.java,Java,,4,2,35,41
/jdk1.4.2_19/javax/naming/ReferralException.java,Java,,16,11,158,185
/jdk1.4.2_19/javax/naming/ServiceUnavailableException.java,Java,,10,5,36,51
/jdk1.4.2_19/javax/naming/SizeLimitExceededException.java,Java,,11,6,35,52
/jdk1.4.2_19/javax/naming/spi/ContinuationContext.java,Java,,173,34,14,221
/jdk1.4.2_19/javax/naming/spi/ContinuationDirContext.java,Java,,244,52,20,316
/jdk1.4.2_19/javax/naming/spi/DirectoryManager.java,Java,,120,30,169,319
/jdk1.4.2_19/javax/naming/spi/DirObjectFactory.java,Java,,9,4,101,114
/jdk1.4.2_19/javax/naming/spi/DirStateFactory.java,Java,,19,10,141,170
/jdk1.4.2_19/javax/naming/spi/InitialContextFactory.java,Java,,7,4,44,55
/jdk1.4.2_19/javax/naming/spi/InitialContextFactoryBuilder.java,Java,,7,3,43,53
/jdk1.4.2_19/javax/naming/spi/NamingManager.java,Java,,294,83,472,849
/jdk1.4.2_19/javax/naming/spi/ObjectFactory.java,Java,,7,5,144,156
/jdk1.4.2_19/javax/naming/spi/ObjectFactoryBuilder.java,Java,,7,3,47,57
/jdk1.4.2_19/javax/naming/spi/Resolver.java,Java,,9,7,60,76
/jdk1.4.2_19/javax/naming/spi/ResolveResult.java,Java,,63,13,108,184
/jdk1.4.2_19/javax/naming/spi/StateFactory.java,Java,,8,2,111,121
/jdk1.4.2_19/javax/naming/StringRefAddr.java,Java,,12,5,52,69
/jdk1.4.2_19/javax/naming/TimeLimitExceededException.java,Java,,11,6,35,52
/jdk1.4.2_19/javax/print/attribute/Attribute.java,Java,,6,6,33,45
/jdk1.4.2_19/javax/print/attribute/AttributeSet.java,Java,,16,19,257,292
/jdk1.4.2_19/javax/print/attribute/AttributeSetUtilities.java,Java,,259,73,228,560
/jdk1.4.2_19/javax/print/attribute/DateTimeSyntax.java,Java,,26,16,84,126
/jdk1.4.2_19/javax/print/attribute/DocAttribute.java,Java,,3,4,23,30
/jdk1.4.2_19/javax/print/attribute/DocAttributeSet.java,Java,,5,6,82,93
/jdk1.4.2_19/javax/print/attribute/EnumSyntax.java,Java,,59,22,180,261
/jdk1.4.2_19/javax/print/attribute/HashAttributeSet.java,Java,,162,36,310,508
/jdk1.4.2_19/javax/print/attribute/HashDocAttributeSet.java,Java,,17,9,56,82
/jdk1.4.2_19/javax/print/attribute/HashPrintJobAttributeSet.java,Java,,17,8,55,80
/jdk1.4.2_19/javax/print/attribute/HashPrintRequestAttributeSet.java,Java,,18,12,55,85
/jdk1.4.2_19/javax/print/attribute/HashPrintServiceAttributeSet.java,Java,,18,9,55,82
/jdk1.4.2_19/javax/print/attribute/IntegerSyntax.java,Java,,29,11,74,114
/jdk1.4.2_19/javax/print/attribute/PrintJobAttribute.java,Java,,3,2,22,27
/jdk1.4.2_19/javax/print/attribute/PrintJobAttributeSet.java,Java,,5,5,81,91
/jdk1.4.2_19/javax/print/attribute/PrintRequestAttribute.java,Java,,3,4,26,33
/jdk1.4.2_19/javax/print/attribute/PrintRequestAttributeSet.java,Java,,5,6,82,93
/jdk1.4.2_19/javax/print/attribute/PrintServiceAttribute.java,Java,,3,2,18,23
/jdk1.4.2_19/javax/print/attribute/PrintServiceAttributeSet.java,Java,,5,7,84,96
/jdk1.4.2_19/javax/print/attribute/ResolutionSyntax.java,Java,,81,28,229,338
/jdk1.4.2_19/javax/print/attribute/SetOfIntegerSyntax.java,Java,,264,40,234,538
/jdk1.4.2_19/javax/print/attribute/Size2DSyntax.java,Java,,84,22,220,326
/jdk1.4.2_19/javax/print/attribute/standard/Chromaticity.java,Java,,29,14,95,138
/jdk1.4.2_19/javax/print/attribute/standard/ColorSupported.java,Java,,27,12,70,109
/jdk1.4.2_19/javax/print/attribute/standard/Compression.java,Java,,32,15,66,113
/jdk1.4.2_19/javax/print/attribute/standard/Copies.java,Java,,19,7,89,115
/jdk1.4.2_19/javax/print/attribute/standard/CopiesSupported.java,Java,,29,9,82,120
/jdk1.4.2_19/javax/print/attribute/standard/DateTimeAtCompleted.java,Java,,20,8,76,104
/jdk1.4.2_19/javax/print/attribute/standard/DateTimeAtCreation.java,Java,,20,7,75,102
/jdk1.4.2_19/javax/print/attribute/standard/DateTimeAtProcessing.java,Java,,20,7,76,103
/jdk1.4.2_19/javax/print/attribute/standard/Destination.java,Java,,21,8,73,102
/jdk1.4.2_19/javax/print/attribute/standard/DocumentName.java,Java,,18,8,74,100
/jdk1.4.2_19/javax/print/attribute/standard/Fidelity.java,Java,,33,12,63,108
/jdk1.4.2_19/javax/print/attribute/standard/Finishings.java,Java,,120,29,307,456
/jdk1.4.2_19/javax/print/attribute/standard/JobHoldUntil.java,Java,,20,8,103,131
/jdk1.4.2_19/javax/print/attribute/standard/JobImpressions.java,Java,,19,7,96,122
/jdk1.4.2_19/javax/print/attribute/standard/JobImpressionsCompleted.java,Java,,19,7,81,107
/jdk1.4.2_19/javax/print/attribute/standard/JobImpressionsSupported.java,Java,,25,8,75,108
/jdk1.4.2_19/javax/print/attribute/standard/JobKOctets.java,Java,,19,7,147,173
/jdk1.4.2_19/javax/print/attribute/standard/JobKOctetsProcessed.java,Java,,19,7,93,119
/jdk1.4.2_19/javax/print/attribute/standard/JobKOctetsSupported.java,Java,,25,7,75,107
/jdk1.4.2_19/javax/print/attribute/standard/JobMediaSheets.java,Java,,19,7,90,116
/jdk1.4.2_19/javax/print/attribute/standard/JobMediaSheetsCompleted.java,Java,,19,6,81,106
/jdk1.4.2_19/javax/print/attribute/standard/JobMediaSheetsSupported.java,Java,,25,7,75,107
/jdk1.4.2_19/javax/print/attribute/standard/JobMessageFromOperator.java,Java,,20,8,80,108
/jdk1.4.2_19/javax/print/attribute/standard/JobName.java,Java,,20,8,76,104
/jdk1.4.2_19/javax/print/attribute/standard/JobOriginatingUserName.java,Java,,20,8,80,108
/jdk1.4.2_19/javax/print/attribute/standard/JobPriority.java,Java,,19,7,80,106
/jdk1.4.2_19/javax/print/attribute/standard/JobPrioritySupported.java,Java,,19,9,74,102
/jdk1.4.2_19/javax/print/attribute/standard/JobSheets.java,Java,,33,13,67,113
/jdk1.4.2_19/javax/print/attribute/standard/JobState.java,Java,,50,21,145,216
/jdk1.4.2_19/javax/print/attribute/standard/JobStateReason.java,Java,,137,40,264,441
/jdk1.4.2_19/javax/print/attribute/standard/JobStateReasons.java,Java,,30,11,117,158
/jdk1.4.2_19/javax/print/attribute/standard/Media.java,Java,,23,7,73,103
/jdk1.4.2_19/javax/print/attribute/standard/MediaName.java,Java,,32,14,47,93
/jdk1.4.2_19/javax/print/attribute/standard/MediaPrintableArea.java,Java,,83,23,208,314
/jdk1.4.2_19/javax/print/attribute/standard/MediaSize.java,Java,,311,33,479,823
/jdk1.4.2_19/javax/print/attribute/standard/MediaSizeName.java,Java,,259,33,252,544
/jdk1.4.2_19/javax/print/attribute/standard/MediaTray.java,Java,,44,19,57,120
/jdk1.4.2_19/javax/print/attribute/standard/MultipleDocumentHandling.java,Java,,42,16,189,247
/jdk1.4.2_19/javax/print/attribute/standard/NumberOfDocuments.java,Java,,19,7,66,92
/jdk1.4.2_19/javax/print/attribute/standard/NumberOfInterveningJobs.java,Java,,19,7,66,92
/jdk1.4.2_19/javax/print/attribute/standard/NumberUp.java,Java,,20,7,143,170
/jdk1.4.2_19/javax/print/attribute/standard/NumberUpSupported.java,Java,,49,9,99,157
/jdk1.4.2_19/javax/print/attribute/standard/OrientationRequested.java,Java,,46,15,106,167
/jdk1.4.2_19/javax/print/attribute/standard/OutputDeviceAssigned.java,Java,,20,10,77,107
/jdk1.4.2_19/javax/print/attribute/standard/PageRanges.java,Java,,58,12,174,244
/jdk1.4.2_19/javax/print/attribute/standard/PagesPerMinute.java,Java,,19,7,67,93
/jdk1.4.2_19/javax/print/attribute/standard/PagesPerMinuteColor.java,Java,,19,7,79,105
/jdk1.4.2_19/javax/print/attribute/standard/PDLOverrideSupported.java,Java,,33,13,61,107
/jdk1.4.2_19/javax/print/attribute/standard/PresentationDirection.java,Java,,58,18,89,165
/jdk1.4.2_19/javax/print/attribute/standard/PrinterInfo.java,Java,,19,8,73,100
/jdk1.4.2_19/javax/print/attribute/standard/PrinterIsAcceptingJobs.java,Java,,33,12,62,107
/jdk1.4.2_19/javax/print/attribute/standard/PrinterLocation.java,Java,,19,8,71,98
/jdk1.4.2_19/javax/print/attribute/standard/PrinterMakeAndModel.java,Java,,20,7,70,97
/jdk1.4.2_19/javax/print/attribute/standard/PrinterMessageFromOperator.java,Java,,20,8,85,113
/jdk1.4.2_19/javax/print/attribute/standard/PrinterMoreInfo.java,Java,,20,8,74,102
/jdk1.4.2_19/javax/print/attribute/standard/PrinterMoreInfoManufacturer.java,Java,,20,8,78,106
/jdk1.4.2_19/javax/print/attribute/standard/PrinterName.java,Java,,19,8,73,100
/jdk1.4.2_19/javax/print/attribute/standard/PrinterResolution.java,Java,,22,7,101,130
/jdk1.4.2_19/javax/print/attribute/standard/PrinterState.java,Java,,41,14,66,121
/jdk1.4.2_19/javax/print/attribute/standard/PrinterStateReason.java,Java,,155,44,225,424
/jdk1.4.2_19/javax/print/attribute/standard/PrinterStateReasons.java,Java,,105,22,159,286
/jdk1.4.2_19/javax/print/attribute/standard/PrinterURI.java,Java,,20,9,66,95
/jdk1.4.2_19/javax/print/attribute/standard/PrintQuality.java,Java,,39,14,62,115
/jdk1.4.2_19/javax/print/attribute/standard/QueuedJobCount.java,Java,,19,7,64,90
/jdk1.4.2_19/javax/print/attribute/standard/ReferenceUriSchemesSupported.java,Java,,50,18,95,163
/jdk1.4.2_19/javax/print/attribute/standard/RequestingUserName.java,Java,,20,8,81,109
/jdk1.4.2_19/javax/print/attribute/standard/Severity.java,Java,,33,14,91,138
/jdk1.4.2_19/javax/print/attribute/standard/SheetCollate.java,Java,,33,12,168,213
/jdk1.4.2_19/javax/print/attribute/standard/Sides.java,Java,,38,16,147,201
/jdk1.4.2_19/javax/print/attribute/SupportedValuesAttribute.java,Java,,3,3,20,26
/jdk1.4.2_19/javax/print/attribute/TextSyntax.java,Java,,41,16,76,133
/jdk1.4.2_19/javax/print/attribute/UnmodifiableSetException.java,Java,,8,3,22,33
/jdk1.4.2_19/javax/print/attribute/URISyntax.java,Java,,30,12,60,102
/jdk1.4.2_19/javax/print/AttributeException.java,Java,,6,8,34,48
/jdk1.4.2_19/javax/print/CancelablePrintJob.java,Java,,4,5,50,59
/jdk1.4.2_19/javax/print/Doc.java,Java,,14,11,165,190
/jdk1.4.2_19/javax/print/DocFlavor.java,Java,,219,116,1067,1402
/jdk1.4.2_19/javax/print/DocPrintJob.java,Java,,20,12,127,159
/jdk1.4.2_19/javax/print/event/PrintEvent.java,Java,,9,6,17,32
/jdk1.4.2_19/javax/print/event/PrintJobAdapter.java,Java,,15,13,59,87
/jdk1.4.2_19/javax/print/event/PrintJobAttributeEvent.java,Java,,18,15,27,60
/jdk1.4.2_19/javax/print/event/PrintJobAttributeListener.java,Java,,4,4,20,28
/jdk1.4.2_19/javax/print/event/PrintJobEvent.java,Java,,21,19,63,103
/jdk1.4.2_19/javax/print/event/PrintJobListener.java,Java,,9,15,53,77
/jdk1.4.2_19/javax/print/event/PrintServiceAttributeEvent.java,Java,,19,14,30,63
/jdk1.4.2_19/javax/print/event/PrintServiceAttributeListener.java,Java,,4,5,21,30
/jdk1.4.2_19/javax/print/FlavorException.java,Java,,5,5,19,29
/jdk1.4.2_19/javax/print/MimeType.java,Java,,388,42,197,627
/jdk1.4.2_19/javax/print/MultiDoc.java,Java,,6,8,104,118
/jdk1.4.2_19/javax/print/MultiDocPrintJob.java,Java,,6,6,37,49
/jdk1.4.2_19/javax/print/MultiDocPrintService.java,Java,,7,7,15,29
/jdk1.4.2_19/javax/print/PrintException.java,Java,,15,8,32,55
/jdk1.4.2_19/javax/print/PrintService.java,Java,,33,25,407,465
/jdk1.4.2_19/javax/print/PrintServiceLookup.java,Java,,250,42,174,466
/jdk1.4.2_19/javax/print/ServiceUI.java,Java,,122,28,149,299
/jdk1.4.2_19/javax/print/ServiceUIFactory.java,Java,,13,15,96,124
/jdk1.4.2_19/javax/print/SimpleDoc.java,Java,,76,22,135,233
/jdk1.4.2_19/javax/print/StreamPrintService.java,Java,,21,12,63,96
/jdk1.4.2_19/javax/print/StreamPrintServiceFactory.java,Java,,98,26,87,211
/jdk1.4.2_19/javax/print/URIException.java,Java,,9,10,36,55
/jdk1.4.2_19/javax/rmi/CORBA/ClassDesc.java,Java,,5,4,23,32
/jdk1.4.2_19/javax/rmi/CORBA/GetORBPropertiesFileAction.java,Java,,54,18,18,90
/jdk1.4.2_19/javax/rmi/CORBA/PortableRemoteObjectDelegate.java,Java,,17,9,42,68
/jdk1.4.2_19/javax/rmi/CORBA/Stub.java,Java,,115,45,67,227
/jdk1.4.2_19/javax/rmi/CORBA/StubDelegate.java,Java,,17,10,50,77
/jdk1.4.2_19/javax/rmi/CORBA/Tie.java,Java,,18,9,42,69
/jdk1.4.2_19/javax/rmi/CORBA/Util.java,Java,,150,52,157,359
/jdk1.4.2_19/javax/rmi/CORBA/UtilDelegate.java,Java,,28,20,72,120
/jdk1.4.2_19/javax/rmi/CORBA/ValueHandler.java,Java,,14,9,57,80
/jdk1.4.2_19/javax/rmi/PortableRemoteObject.java,Java,,132,43,84,259
/jdk1.4.2_19/javax/security/auth/AuthPermission.java,Java,,12,4,125,141
/jdk1.4.2_19/javax/security/auth/callback/Callback.java,Java,,2,3,30,35
/jdk1.4.2_19/javax/security/auth/callback/CallbackHandler.java,Java,,5,3,127,135
/jdk1.4.2_19/javax/security/auth/callback/ChoiceCallback.java,Java,,47,14,131,192
/jdk1.4.2_19/javax/security/auth/callback/ConfirmationCallback.java,Java,,121,36,325,482
/jdk1.4.2_19/javax/security/auth/callback/LanguageCallback.java,Java,,12,7,41,60
/jdk1.4.2_19/javax/security/auth/callback/NameCallback.java,Java,,30,10,85,125
/jdk1.4.2_19/javax/security/auth/callback/PasswordCallback.java,Java,,32,10,83,125
/jdk1.4.2_19/javax/security/auth/callback/TextInputCallback.java,Java,,30,10,86,126
/jdk1.4.2_19/javax/security/auth/callback/TextOutputCallback.java,Java,,22,8,58,88
/jdk1.4.2_19/javax/security/auth/callback/UnsupportedCallbackException.java,Java,,15,6,41,62
/jdk1.4.2_19/javax/security/auth/Destroyable.java,Java,,5,4,36,45
/jdk1.4.2_19/javax/security/auth/DestroyFailedException.java,Java,,9,4,28,41
/jdk1.4.2_19/javax/security/auth/kerberos/DelegationPermission.java,Java,,124,47,187,358
/jdk1.4.2_19/javax/security/auth/kerberos/KerberosKey.java,Java,,69,24,123,216
/jdk1.4.2_19/javax/security/auth/kerberos/KerberosPrincipal.java,Java,,102,42,143,287
/jdk1.4.2_19/javax/security/auth/kerberos/KerberosTicket.java,Java,,271,72,280,623
/jdk1.4.2_19/javax/security/auth/kerberos/KeyImpl.java,Java,,104,23,49,176
/jdk1.4.2_19/javax/security/auth/kerberos/ServicePermission.java,Java,,212,91,268,571
/jdk1.4.2_19/javax/security/auth/login/AccountExpiredException.java,Java,,9,4,31,44
/jdk1.4.2_19/javax/security/auth/login/AppConfigurationEntry.java,Java,,49,17,85,151
/jdk1.4.2_19/javax/security/auth/login/Configuration.java,Java,,79,14,203,296
/jdk1.4.2_19/javax/security/auth/login/CredentialExpiredException.java,Java,,9,4,33,46
/jdk1.4.2_19/javax/security/auth/login/FailedLoginException.java,Java,,9,4,28,41
/jdk1.4.2_19/javax/security/auth/login/LoginContext.java,Java,,348,71,420,839
/jdk1.4.2_19/javax/security/auth/login/LoginException.java,Java,,9,5,25,39
/jdk1.4.2_19/javax/security/auth/Policy.java,Java,,69,14,213,296
/jdk1.4.2_19/javax/security/auth/PrivateCredentialPermission.java,Java,,242,79,247,568
/jdk1.4.2_19/javax/security/auth/Refreshable.java,Java,,5,4,36,45
/jdk1.4.2_19/javax/security/auth/RefreshFailedException.java,Java,,9,4,28,41
/jdk1.4.2_19/javax/security/auth/spi/LoginModule.java,Java,,14,8,200,222
/jdk1.4.2_19/javax/security/auth/Subject.java,Java,,666,144,585,1395
/jdk1.4.2_19/javax/security/auth/SubjectDomainCombiner.java,Java,,356,62,150,568
/jdk1.4.2_19/javax/security/auth/x500/X500Principal.java,Java,,115,22,252,389
/jdk1.4.2_19/javax/security/auth/x500/X500PrivateCredential.java,Java,,41,14,62,117
/jdk1.4.2_19/javax/sound/midi/ControllerEventListener.java,Java,,5,5,37,47
/jdk1.4.2_19/javax/sound/midi/Instrument.java,Java,,12,15,46,73
/jdk1.4.2_19/javax/sound/midi/InvalidMidiDataException.java,Java,,9,8,29,46
/jdk1.4.2_19/javax/sound/midi/MetaEventListener.java,Java,,5,5,23,33
/jdk1.4.2_19/javax/sound/midi/MetaMessage.java,Java,,74,39,193,306
/jdk1.4.2_19/javax/sound/midi/MidiChannel.java,Java,,29,30,362,421
/jdk1.4.2_19/javax/sound/midi/MidiDevice.java,Java,,45,66,243,354
/jdk1.4.2_19/javax/sound/midi/MidiEvent.java,Java,,18,15,46,79
/jdk1.4.2_19/javax/sound/midi/MidiFileFormat.java,Java,,33,25,95,153
/jdk1.4.2_19/javax/sound/midi/MidiMessage.java,Java,,36,20,115,171
/jdk1.4.2_19/javax/sound/midi/MidiSystem.java,Java,,442,198,477,1117
/jdk1.4.2_19/javax/sound/midi/MidiUnavailableException.java,Java,,9,8,29,46
/jdk1.4.2_19/javax/sound/midi/Patch.java,Java,,15,18,62,95
/jdk1.4.2_19/javax/sound/midi/Receiver.java,Java,,5,6,34,45
/jdk1.4.2_19/javax/sound/midi/Sequence.java,Java,,133,68,202,403
/jdk1.4.2_19/javax/sound/midi/Sequencer.java,Java,,61,125,567,753
/jdk1.4.2_19/javax/sound/midi/ShortMessage.java,Java,,129,57,210,396
/jdk1.4.2_19/javax/sound/midi/Soundbank.java,Java,,11,38,227,276
/jdk1.4.2_19/javax/sound/midi/SoundbankResource.java,Java,,21,27,114,162
/jdk1.4.2_19/javax/sound/midi/spi/MidiDeviceProvider.java,Java,,16,11,35,62
/jdk1.4.2_19/javax/sound/midi/spi/MidiFileReader.java,Java,,16,15,94,125
/jdk1.4.2_19/javax/sound/midi/spi/MidiFileWriter.java,Java,,30,18,70,118
/jdk1.4.2_19/javax/sound/midi/spi/SoundbankReader.java,Java,,12,17,54,83
/jdk1.4.2_19/javax/sound/midi/Synthesizer.java,Java,,19,48,298,365
/jdk1.4.2_19/javax/sound/midi/SysexMessage.java,Java,,47,26,113,186
/jdk1.4.2_19/javax/sound/midi/Track.java,Java,,67,34,99,200
/jdk1.4.2_19/javax/sound/midi/Transmitter.java,Java,,6,9,32,47
/jdk1.4.2_19/javax/sound/midi/VoiceStatus.java,Java,,9,16,118,143
/jdk1.4.2_19/javax/sound/sampled/AudioFileFormat.java,Java,,72,52,134,258
/jdk1.4.2_19/javax/sound/sampled/AudioFormat.java,Java,,91,66,308,465
/jdk1.4.2_19/javax/sound/sampled/AudioInputStream.java,Java,,177,91,222,490
/jdk1.4.2_19/javax/sound/sampled/AudioPermission.java,Java,,10,11,208,229
/jdk1.4.2_19/javax/sound/sampled/AudioSystem.java,Java,,569,220,409,1198
/jdk1.4.2_19/javax/sound/sampled/BooleanControl.java,Java,,34,41,101,176
/jdk1.4.2_19/javax/sound/sampled/Clip.java,Java,,14,13,176,203
/jdk1.4.2_19/javax/sound/sampled/CompoundControl.java,Java,,33,38,53,124
/jdk1.4.2_19/javax/sound/sampled/Control.java,Java,,28,29,72,129
/jdk1.4.2_19/javax/sound/sampled/DataLine.java,Java,,106,53,286,445
/jdk1.4.2_19/javax/sound/sampled/EnumControl.java,Java,,43,51,104,198
/jdk1.4.2_19/javax/sound/sampled/FloatControl.java,Java,,87,91,300,478
/jdk1.4.2_19/javax/sound/sampled/Line.java,Java,,46,47,246,339
/jdk1.4.2_19/javax/sound/sampled/LineEvent.java,Java,,41,45,164,250
/jdk1.4.2_19/javax/sound/sampled/LineListener.java,Java,,4,6,42,52
/jdk1.4.2_19/javax/sound/sampled/LineUnavailableException.java,Java,,9,9,35,53
/jdk1.4.2_19/javax/sound/sampled/Mixer.java,Java,,49,41,257,347
/jdk1.4.2_19/javax/sound/sampled/Port.java,Java,,45,45,102,192
/jdk1.4.2_19/javax/sound/sampled/ReverbType.java,Java,,45,30,197,272
/jdk1.4.2_19/javax/sound/sampled/SourceDataLine.java,Java,,6,10,161,177
/jdk1.4.2_19/javax/sound/sampled/spi/AudioFileReader.java,Java,,16,10,94,120
/jdk1.4.2_19/javax/sound/sampled/spi/AudioFileWriter.java,Java,,31,24,115,170
/jdk1.4.2_19/javax/sound/sampled/spi/FormatConversionProvider.java,Java,,48,43,166,257
/jdk1.4.2_19/javax/sound/sampled/spi/MixerProvider.java,Java,,15,11,35,61
/jdk1.4.2_19/javax/sound/sampled/TargetDataLine.java,Java,,6,9,153,168
/jdk1.4.2_19/javax/sound/sampled/UnsupportedAudioFileException.java,Java,,9,9,33,51
/jdk1.4.2_19/javax/sql/ConnectionEvent.java,Java,,14,15,51,80
/jdk1.4.2_19/javax/sql/ConnectionEventListener.java,Java,,5,11,47,63
/jdk1.4.2_19/javax/sql/ConnectionPoolDataSource.java,Java,,11,17,97,125
/jdk1.4.2_19/javax/sql/DataSource.java,Java,,12,15,127,154
/jdk1.4.2_19/javax/sql/PooledConnection.java,Java,,9,9,96,114
/jdk1.4.2_19/javax/sql/RowSet.java,Java,,76,79,786,941
/jdk1.4.2_19/javax/sql/RowSetEvent.java,Java,,6,9,32,47
/jdk1.4.2_19/javax/sql/RowSetInternal.java,Java,,9,15,66,90
/jdk1.4.2_19/javax/sql/RowSetListener.java,Java,,6,6,47,59
/jdk1.4.2_19/javax/sql/RowSetMetaData.java,Java,,21,27,174,222
/jdk1.4.2_19/javax/sql/RowSetReader.java,Java,,5,6,44,55
/jdk1.4.2_19/javax/sql/RowSetWriter.java,Java,,5,6,35,46
/jdk1.4.2_19/javax/sql/XAConnection.java,Java,,5,13,27,45
/jdk1.4.2_19/javax/sql/XADataSource.java,Java,,11,16,88,115
/jdk1.4.2_19/javax/swing/AbstractAction.java,Java,,323,48,199,570
/jdk1.4.2_19/javax/swing/AbstractActionPropertyChangeListener.java,Java,,46,10,27,83
/jdk1.4.2_19/javax/swing/AbstractButton.java,Java,,1283,205,1295,2783
/jdk1.4.2_19/javax/swing/AbstractCellEditor.java,Java,,51,15,84,150
/jdk1.4.2_19/javax/swing/AbstractListModel.java,Java,,60,19,124,203
/jdk1.4.2_19/javax/swing/AbstractSpinnerModel.java,Java,,33,18,73,124
/jdk1.4.2_19/javax/swing/Action.java,Java,,20,9,162,191
/jdk1.4.2_19/javax/swing/ActionMap.java,Java,,107,22,76,205
/jdk1.4.2_19/javax/swing/AncestorNotifier.java,Java,,145,31,43,219
/jdk1.4.2_19/javax/swing/Autoscroller.java,Java,,73,17,10,100
/jdk1.4.2_19/javax/swing/border/AbstractBorder.java,Java,,36,10,75,121
/jdk1.4.2_19/javax/swing/border/BevelBorder.java,Java,,123,38,118,279
/jdk1.4.2_19/javax/swing/border/Border.java,Java,,11,4,58,73
/jdk1.4.2_19/javax/swing/border/CompoundBorder.java,Java,,66,16,75,157
/jdk1.4.2_19/javax/swing/border/EmptyBorder.java,Java,,38,10,52,100
/jdk1.4.2_19/javax/swing/border/EtchedBorder.java,Java,,65,22,103,190
/jdk1.4.2_19/javax/swing/border/LineBorder.java,Java,,68,17,76,161
/jdk1.4.2_19/javax/swing/border/MatteBorder.java,Java,,126,26,89,241
/jdk1.4.2_19/javax/swing/border/SoftBevelBorder.java,Java,,68,20,67,155
/jdk1.4.2_19/javax/swing/border/TitledBorder.java,Java,,383,65,193,641
/jdk1.4.2_19/javax/swing/BorderFactory.java,Java,,127,30,344,501
/jdk1.4.2_19/javax/swing/BoundedRangeModel.java,Java,,18,30,201,249
/jdk1.4.2_19/javax/swing/Box.java,Java,,94,32,287,413
/jdk1.4.2_19/javax/swing/BoxLayout.java,Java,,183,41,261,485
/jdk1.4.2_19/javax/swing/ButtonGroup.java,Java,,60,15,90,165
/jdk1.4.2_19/javax/swing/ButtonModel.java,Java,,27,25,156,208
/jdk1.4.2_19/javax/swing/CellEditor.java,Java,,12,10,95,117
/jdk1.4.2_19/javax/swing/CellRendererPane.java,Java,,83,32,97,212
/jdk1.4.2_19/javax/swing/colorchooser/AbstractColorChooserPanel.java,Java,,70,22,130,222
/jdk1.4.2_19/javax/swing/colorchooser/CenterLayout.java,Java,,41,9,12,62
/jdk1.4.2_19/javax/swing/colorchooser/ColorChooserComponentFactory.java,Java,,14,10,23,47
/jdk1.4.2_19/javax/swing/colorchooser/ColorSelectionModel.java,Java,,10,6,40,56
/jdk1.4.2_19/javax/swing/colorchooser/DefaultColorSelectionModel.java,Java,,47,16,75,138
/jdk1.4.2_19/javax/swing/colorchooser/DefaultHSBChooserPanel.java,Java,,537,125,99,761
/jdk1.4.2_19/javax/swing/colorchooser/DefaultPreviewPanel.java,Java,,147,46,22,215
/jdk1.4.2_19/javax/swing/colorchooser/DefaultRGBChooserPanel.java,Java,,145,41,79,265
/jdk1.4.2_19/javax/swing/colorchooser/DefaultSwatchChooserPanel.java,Java,,481,67,68,616
/jdk1.4.2_19/javax/swing/colorchooser/SmartGridLayout.java,Java,,108,49,16,173
/jdk1.4.2_19/javax/swing/colorchooser/SyntheticImage.java,Java,,104,10,33,147
/jdk1.4.2_19/javax/swing/ComboBoxEditor.java,Java,,11,8,20,39
/jdk1.4.2_19/javax/swing/ComboBoxModel.java,Java,,5,4,30,39
/jdk1.4.2_19/javax/swing/ComponentInputMap.java,Java,,43,7,50,100
/jdk1.4.2_19/javax/swing/DebugGraphics.java,Java,,1036,177,236,1449
/jdk1.4.2_19/javax/swing/DebugGraphicsFilter.java,Java,,13,5,11,29
/jdk1.4.2_19/javax/swing/DebugGraphicsInfo.java,Java,,32,9,12,53
/jdk1.4.2_19/javax/swing/DebugGraphicsObserver.java,Java,,19,6,11,36
/jdk1.4.2_19/javax/swing/DefaultBoundedRangeModel.java,Java,,141,49,216,406
/jdk1.4.2_19/javax/swing/DefaultButtonModel.java,Java,,195,58,299,552
/jdk1.4.2_19/javax/swing/DefaultCellEditor.java,Java,,148,42,169,359
/jdk1.4.2_19/javax/swing/DefaultComboBoxModel.java,Java,,98,25,51,174
/jdk1.4.2_19/javax/swing/DefaultDesktopManager.java,Java,,437,113,163,713
/jdk1.4.2_19/javax/swing/DefaultFocusManager.java,Java,,99,26,27,152
/jdk1.4.2_19/javax/swing/DefaultListCellRenderer.java,Java,,76,27,123,226
/jdk1.4.2_19/javax/swing/DefaultListModel.java,Java,,141,42,340,523
/jdk1.4.2_19/javax/swing/DefaultListSelectionModel.java,Java,,320,81,269,670
/jdk1.4.2_19/javax/swing/DefaultSingleSelectionModel.java,Java,,52,15,94,161
/jdk1.4.2_19/javax/swing/DelegatingDefaultFocusManager.java,Java,,106,9,26,141
/jdk1.4.2_19/javax/swing/DesktopManager.java,Java,,19,11,72,102
/jdk1.4.2_19/javax/swing/event/AncestorEvent.java,Java,,25,7,54,86
/jdk1.4.2_19/javax/swing/event/AncestorListener.java,Java,,10,8,36,54
/jdk1.4.2_19/javax/swing/event/CaretEvent.java,Java,,9,7,39,55
/jdk1.4.2_19/javax/swing/event/CaretListener.java,Java,,5,5,18,28
/jdk1.4.2_19/javax/swing/event/CellEditorListener.java,Java,,7,7,15,29
/jdk1.4.2_19/javax/swing/event/ChangeEvent.java,Java,,7,4,28,39
/jdk1.4.2_19/javax/swing/event/ChangeListener.java,Java,,5,5,17,27
/jdk1.4.2_19/javax/swing/event/DocumentEvent.java,Java,,28,20,118,166
/jdk1.4.2_19/javax/swing/event/DocumentListener.java,Java,,7,5,49,61
/jdk1.4.2_19/javax/swing/event/EventListenerList.java,Java,,115,18,140,273
/jdk1.4.2_19/javax/swing/event/HyperlinkEvent.java,Java,,48,20,103,171
/jdk1.4.2_19/javax/swing/event/HyperlinkListener.java,Java,,5,5,17,27
/jdk1.4.2_19/javax/swing/event/InternalFrameAdapter.java,Java,,10,8,45,63
/jdk1.4.2_19/javax/swing/event/InternalFrameEvent.java,Java,,49,18,108,175
/jdk1.4.2_19/javax/swing/event/InternalFrameListener.java,Java,,11,9,50,70
/jdk1.4.2_19/javax/swing/event/ListDataEvent.java,Java,,26,12,66,104
/jdk1.4.2_19/javax/swing/event/ListDataListener.java,Java,,7,9,37,53
/jdk1.4.2_19/javax/swing/event/ListSelectionEvent.java,Java,,29,10,59,98
/jdk1.4.2_19/javax/swing/event/ListSelectionListener.java,Java,,6,8,19,33
/jdk1.4.2_19/javax/swing/event/MenuDragMouseEvent.java,Java,,24,7,54,85
/jdk1.4.2_19/javax/swing/event/MenuDragMouseListener.java,Java,,8,5,36,49
/jdk1.4.2_19/javax/swing/event/MenuEvent.java,Java,,7,4,30,41
/jdk1.4.2_19/javax/swing/event/MenuKeyEvent.java,Java,,23,7,50,80
/jdk1.4.2_19/javax/swing/event/MenuKeyListener.java,Java,,7,7,22,36
/jdk1.4.2_19/javax/swing/event/MenuListener.java,Java,,7,5,27,39
/jdk1.4.2_19/javax/swing/event/MouseInputAdapter.java,Java,,11,7,24,42
/jdk1.4.2_19/javax/swing/event/MouseInputListener.java,Java,,5,5,13,23
/jdk1.4.2_19/javax/swing/event/PopupMenuEvent.java,Java,,7,2,28,37
/jdk1.4.2_19/javax/swing/event/PopupMenuListener.java,Java,,7,6,22,35
/jdk1.4.2_19/javax/swing/event/SwingPropertyChangeSupport.java,Java,,176,35,119,330
/jdk1.4.2_19/javax/swing/event/TableColumnModelEvent.java,Java,,15,10,45,70
/jdk1.4.2_19/javax/swing/event/TableColumnModelListener.java,Java,,12,9,22,43
/jdk1.4.2_19/javax/swing/event/TableModelEvent.java,Java,,38,18,105,161
/jdk1.4.2_19/javax/swing/event/TableModelListener.java,Java,,6,5,18,29
/jdk1.4.2_19/javax/swing/event/TreeExpansionEvent.java,Java,,12,5,41,58
/jdk1.4.2_19/javax/swing/event/TreeExpansionListener.java,Java,,7,5,22,34
/jdk1.4.2_19/javax/swing/event/TreeModelEvent.java,Java,,75,16,206,297
/jdk1.4.2_19/javax/swing/event/TreeModelListener.java,Java,,8,8,65,81
/jdk1.4.2_19/javax/swing/event/TreeSelectionEvent.java,Java,,71,14,86,171
/jdk1.4.2_19/javax/swing/event/TreeSelectionListener.java,Java,,6,3,24,33
/jdk1.4.2_19/javax/swing/event/TreeWillExpandListener.java,Java,,7,5,22,34
/jdk1.4.2_19/javax/swing/event/UndoableEditEvent.java,Java,,12,5,33,50
/jdk1.4.2_19/javax/swing/event/UndoableEditListener.java,Java,,5,5,16,26
/jdk1.4.2_19/javax/swing/filechooser/FileFilter.java,Java,,6,4,30,40
/jdk1.4.2_19/javax/swing/filechooser/FileSystemView.java,Java,,408,93,241,742
/jdk1.4.2_19/javax/swing/filechooser/FileView.java,Java,,20,8,64,92
/jdk1.4.2_19/javax/swing/FocusManager.java,Java,,36,10,81,127
/jdk1.4.2_19/javax/swing/GraphicsWrapper.java,Java,,10,8,12,30
/jdk1.4.2_19/javax/swing/GrayFilter.java,Java,,31,9,37,77
/jdk1.4.2_19/javax/swing/Icon.java,Java,,9,6,26,41
/jdk1.4.2_19/javax/swing/ImageIcon.java,Java,,230,61,318,609
/jdk1.4.2_19/javax/swing/InputMap.java,Java,,116,25,73,214
/jdk1.4.2_19/javax/swing/InputVerifier.java,Java,,8,11,98,117
/jdk1.4.2_19/javax/swing/InternalFrameFocusTraversalPolicy.java,Java,,10,4,37,51
/jdk1.4.2_19/javax/swing/JApplet.java,Java,,138,45,261,444
/jdk1.4.2_19/javax/swing/JButton.java,Java,,96,33,196,325
/jdk1.4.2_19/javax/swing/JCheckBox.java,Java,,124,38,218,380
/jdk1.4.2_19/javax/swing/JCheckBoxMenuItem.java,Java,,80,24,167,271
/jdk1.4.2_19/javax/swing/JColorChooser.java,Java,,283,89,340,712
/jdk1.4.2_19/javax/swing/JComboBox.java,Java,,747,170,1245,2162
/jdk1.4.2_19/javax/swing/JComponent.java,Java,,2296,432,2441,5169
/jdk1.4.2_19/javax/swing/JDesktopPane.java,Java,,140,44,220,404
/jdk1.4.2_19/javax/swing/JDialog.java,Java,,251,64,588,903
/jdk1.4.2_19/javax/swing/JEditorPane.java,Java,,1106,159,991,2256
/jdk1.4.2_19/javax/swing/JFileChooser.java,Java,,675,171,1025,1871
/jdk1.4.2_19/javax/swing/JFormattedTextField.java,Java,,398,88,661,1147
/jdk1.4.2_19/javax/swing/JFrame.java,Java,,244,60,525,829
/jdk1.4.2_19/javax/swing/JInternalFrame.java,Java,,864,183,1321,2368
/jdk1.4.2_19/javax/swing/JLabel.java,Java,,709,130,760,1599
/jdk1.4.2_19/javax/swing/JLayeredPane.java,Java,,295,66,372,733
/jdk1.4.2_19/javax/swing/JList.java,Java,,1321,293,1475,3089
/jdk1.4.2_19/javax/swing/JMenu.java,Java,,789,149,755,1693
/jdk1.4.2_19/javax/swing/JMenuBar.java,Java,,315,74,347,736
/jdk1.4.2_19/javax/swing/JMenuItem.java,Java,,418,75,432,925
/jdk1.4.2_19/javax/swing/JOptionPane.java,Java,,806,152,1443,2401
/jdk1.4.2_19/javax/swing/JPanel.java,Java,,63,23,141,227
/jdk1.4.2_19/javax/swing/JPasswordField.java,Java,,91,30,228,349
/jdk1.4.2_19/javax/swing/JPopupMenu.java,Java,,633,135,580,1348
/jdk1.4.2_19/javax/swing/JProgressBar.java,Java,,306,91,669,1066
/jdk1.4.2_19/javax/swing/JRadioButton.java,Java,,102,33,196,331
/jdk1.4.2_19/javax/swing/JRadioButtonMenuItem.java,Java,,69,21,155,245
/jdk1.4.2_19/javax/swing/JRootPane.java,Java,,309,78,604,991
/jdk1.4.2_19/javax/swing/JScrollBar.java,Java,,297,110,467,874
/jdk1.4.2_19/javax/swing/JScrollPane.java,Java,,468,140,809,1417
/jdk1.4.2_19/javax/swing/JSeparator.java,Java,,86,25,161,272
/jdk1.4.2_19/javax/swing/JSlider.java,Java,,466,164,581,1211
/jdk1.4.2_19/javax/swing/JSpinner.java,Java,,460,147,667,1274
/jdk1.4.2_19/javax/swing/JSplitPane.java,Java,,385,165,661,1211
/jdk1.4.2_19/javax/swing/JTabbedPane.java,Java,,830,196,994,2020
/jdk1.4.2_19/javax/swing/JTable.java,Java,,2700,539,2863,6102
/jdk1.4.2_19/javax/swing/JTextArea.java,Java,,295,53,456,804
/jdk1.4.2_19/javax/swing/JTextField.java,Java,,319,65,527,911
/jdk1.4.2_19/javax/swing/JTextPane.java,Java,,166,34,310,510
/jdk1.4.2_19/javax/swing/JToggleButton.java,Java,,144,48,198,390
/jdk1.4.2_19/javax/swing/JToolBar.java,Java,[WDW - need to add orientation from BoxLayout,390,83,421,894
/jdk1.4.2_19/javax/swing/JToolTip.java,Java,,77,29,155,261
/jdk1.4.2_19/javax/swing/JTree.java,Java,,2314,436,2090,4840
/jdk1.4.2_19/javax/swing/JViewport.java,Java,,833,187,776,1796
/jdk1.4.2_19/javax/swing/JWindow.java,Java,,133,42,376,551
/jdk1.4.2_19/javax/swing/KeyboardManager.java,Java,,201,47,84,332
/jdk1.4.2_19/javax/swing/KeyStroke.java,Java,,60,11,185,256
/jdk1.4.2_19/javax/swing/LayoutComparator.java,Java,,91,24,27,142
/jdk1.4.2_19/javax/swing/LayoutFocusTraversalPolicy.java,Java,,106,12,134,252
/jdk1.4.2_19/javax/swing/LegacyGlueFocusTraversalPolicy.java,Java,,147,15,21,183
/jdk1.4.2_19/javax/swing/ListCellRenderer.java,Java,,11,4,55,70
/jdk1.4.2_19/javax/swing/ListModel.java,Java,,9,7,37,53
/jdk1.4.2_19/javax/swing/ListSelectionModel.java,Java,,28,36,191,255
/jdk1.4.2_19/javax/swing/LookAndFeel.java,Java,,166,44,230,440
/jdk1.4.2_19/javax/swing/MenuElement.java,Java,,10,10,43,63
/jdk1.4.2_19/javax/swing/MenuSelectionManager.java,Java,,302,50,103,455
/jdk1.4.2_19/javax/swing/MultiUIDefaults.java,Java,,130,34,11,175
/jdk1.4.2_19/javax/swing/MutableComboBoxModel.java,Java,,7,8,41,56
/jdk1.4.2_19/javax/swing/OverlayLayout.java,Java,,116,26,116,258
/jdk1.4.2_19/javax/swing/plaf/ActionMapUIResource.java,Java,,6,4,13,23
/jdk1.4.2_19/javax/swing/plaf/basic/BasicArrowButton.java,Java,,155,32,26,213
/jdk1.4.2_19/javax/swing/plaf/basic/BasicBorders.java,Java,,457,86,65,608
/jdk1.4.2_19/javax/swing/plaf/basic/BasicButtonListener.java,Java,,229,45,41,315
/jdk1.4.2_19/javax/swing/plaf/basic/BasicButtonUI.java,Java,,242,67,96,405
/jdk1.4.2_19/javax/swing/plaf/basic/BasicCheckBoxMenuItemUI.java,Java,,32,15,14,61
/jdk1.4.2_19/javax/swing/plaf/basic/BasicCheckBoxUI.java,Java,,16,10,24,50
/jdk1.4.2_19/javax/swing/plaf/basic/BasicColorChooserUI.java,Java,,206,59,18,283
/jdk1.4.2_19/javax/swing/plaf/basic/BasicComboBoxEditor.java,Java,,71,21,42,134
/jdk1.4.2_19/javax/swing/plaf/basic/BasicComboBoxRenderer.java,Java,,62,20,43,125
/jdk1.4.2_19/javax/swing/plaf/basic/BasicComboBoxUI.java,Java,,918,201,470,1589
/jdk1.4.2_19/javax/swing/plaf/basic/BasicComboPopup.java,Java,,548,122,462,1132
/jdk1.4.2_19/javax/swing/plaf/basic/BasicDesktopIconUI.java,Java,,175,44,27,246
/jdk1.4.2_19/javax/swing/plaf/basic/BasicDesktopPaneUI.java,Java,,466,51,97,614
/jdk1.4.2_19/javax/swing/plaf/basic/BasicDirectoryModel.java,Java,,272,46,42,360
/jdk1.4.2_19/javax/swing/plaf/basic/BasicDragGestureRecognizer.java,Java,,83,24,31,138
/jdk1.4.2_19/javax/swing/plaf/basic/BasicDropTargetListener.java,Java,,147,35,110,292
/jdk1.4.2_19/javax/swing/plaf/basic/BasicEditorPaneUI.java,Java,,81,14,58,153
/jdk1.4.2_19/javax/swing/plaf/basic/BasicFileChooserUI.java,Java,,879,173,145,1197
/jdk1.4.2_19/javax/swing/plaf/basic/BasicFormattedTextFieldUI.java,Java,,11,3,26,40
/jdk1.4.2_19/javax/swing/plaf/basic/BasicGraphicsUtils.java,Java,,189,57,59,305
/jdk1.4.2_19/javax/swing/plaf/basic/BasicHTML.java,Java,,228,49,269,546
/jdk1.4.2_19/javax/swing/plaf/basic/BasicIconFactory.java,Java,,151,33,22,206
/jdk1.4.2_19/javax/swing/plaf/basic/BasicInternalFrameTitlePane.java,Java,,494,98,95,687
/jdk1.4.2_19/javax/swing/plaf/basic/BasicInternalFrameUI.java,Java,,1077,186,199,1462
/jdk1.4.2_19/javax/swing/plaf/basic/BasicLabelUI.java,Java,,290,54,108,452
/jdk1.4.2_19/javax/swing/plaf/basic/BasicListUI.java,Java,,1336,268,707,2311
/jdk1.4.2_19/javax/swing/plaf/basic/BasicLookAndFeel.java,Java,,1368,151,236,1755
/jdk1.4.2_19/javax/swing/plaf/basic/BasicMenuBarUI.java,Java,,186,40,23,249
/jdk1.4.2_19/javax/swing/plaf/basic/BasicMenuItemUI.java,Java,,814,137,187,1138
/jdk1.4.2_19/javax/swing/plaf/basic/BasicMenuUI.java,Java,,450,80,91,621
/jdk1.4.2_19/javax/swing/plaf/basic/BasicOptionPaneUI.java,Java,,913,166,271,1350
/jdk1.4.2_19/javax/swing/plaf/basic/BasicPanelUI.java,Java,,34,11,13,58
/jdk1.4.2_19/javax/swing/plaf/basic/BasicPasswordFieldUI.java,Java,,17,12,35,64
/jdk1.4.2_19/javax/swing/plaf/basic/BasicPopupMenuSeparatorUI.java,Java,,27,9,13,49
/jdk1.4.2_19/javax/swing/plaf/basic/BasicPopupMenuUI.java,Java,,820,141,112,1073
/jdk1.4.2_19/javax/swing/plaf/basic/BasicProgressBarUI.java,Java,,766,151,422,1339
/jdk1.4.2_19/javax/swing/plaf/basic/BasicRadioButtonMenuItemUI.java,Java,,33,13,13,59
/jdk1.4.2_19/javax/swing/plaf/basic/BasicRadioButtonUI.java,Java,,151,41,46,238
/jdk1.4.2_19/javax/swing/plaf/basic/BasicRootPaneUI.java,Java,,121,25,24,170
/jdk1.4.2_19/javax/swing/plaf/basic/BasicScrollBarUI.java,Java,,884,186,226,1296
/jdk1.4.2_19/javax/swing/plaf/basic/BasicScrollPaneUI.java,Java,,641,111,157,909
/jdk1.4.2_19/javax/swing/plaf/basic/BasicSeparatorUI.java,Java,,68,22,14,104
/jdk1.4.2_19/javax/swing/plaf/basic/BasicSliderUI.java,Java,,1294,248,135,1677
/jdk1.4.2_19/javax/swing/plaf/basic/BasicSpinnerUI.java,Java,,507,112,276,895
/jdk1.4.2_19/javax/swing/plaf/basic/BasicSplitPaneDivider.java,Java,,578,141,269,988
/jdk1.4.2_19/javax/swing/plaf/basic/BasicSplitPaneUI.java,Java,,1245,278,649,2172
/jdk1.4.2_19/javax/swing/plaf/basic/BasicTabbedPaneUI.java,Java,,2398,360,428,3186
/jdk1.4.2_19/javax/swing/plaf/basic/BasicTableHeaderUI.java,Java,,331,75,98,504
/jdk1.4.2_19/javax/swing/plaf/basic/BasicTableUI.java,Java,,936,192,241,1369
/jdk1.4.2_19/javax/swing/plaf/basic/BasicTextAreaUI.java,Java,,164,30,102,296
/jdk1.4.2_19/javax/swing/plaf/basic/BasicTextFieldUI.java,Java,,182,29,168,379
/jdk1.4.2_19/javax/swing/plaf/basic/BasicTextPaneUI.java,Java,,67,17,60,144
/jdk1.4.2_19/javax/swing/plaf/basic/BasicTextUI.java,Java,,1217,211,1023,2451
/jdk1.4.2_19/javax/swing/plaf/basic/BasicToggleButtonUI.java,Java,,98,31,28,157
/jdk1.4.2_19/javax/swing/plaf/basic/BasicToolBarSeparatorUI.java,Java,,55,16,14,85
/jdk1.4.2_19/javax/swing/plaf/basic/BasicToolBarUI.java,Java,,928,178,204,1310
/jdk1.4.2_19/javax/swing/plaf/basic/BasicToolTipUI.java,Java,,169,31,37,237
/jdk1.4.2_19/javax/swing/plaf/basic/BasicTransferable.java,Java,,154,31,80,265
/jdk1.4.2_19/javax/swing/plaf/basic/BasicTreeUI.java,Java,,2608,505,743,3856
/jdk1.4.2_19/javax/swing/plaf/basic/BasicViewportUI.java,Java,,31,11,13,55
/jdk1.4.2_19/javax/swing/plaf/basic/CenterLayout.java,Java,,41,9,12,62
/jdk1.4.2_19/javax/swing/plaf/basic/ComboPopup.java,Java,,15,11,58,84
/jdk1.4.2_19/javax/swing/plaf/basic/DefaultMenuLayout.java,Java,,19,6,15,40
/jdk1.4.2_19/javax/swing/plaf/BorderUIResource.java,Java,,152,43,33,228
/jdk1.4.2_19/javax/swing/plaf/ButtonUI.java,Java,,5,3,12,20
/jdk1.4.2_19/javax/swing/plaf/ColorChooserUI.java,Java,,6,6,13,25
/jdk1.4.2_19/javax/swing/plaf/ColorUIResource.java,Java,,18,7,24,49
/jdk1.4.2_19/javax/swing/plaf/ComboBoxUI.java,Java,,7,6,22,35
/jdk1.4.2_19/javax/swing/plaf/ComponentInputMapUIResource.java,Java,,8,4,13,25
/jdk1.4.2_19/javax/swing/plaf/ComponentUI.java,Java,,46,17,223,286
/jdk1.4.2_19/javax/swing/plaf/DesktopIconUI.java,Java,,3,4,12,19
/jdk1.4.2_19/javax/swing/plaf/DesktopPaneUI.java,Java,,3,4,12,19
/jdk1.4.2_19/javax/swing/plaf/DimensionUIResource.java,Java,,9,4,26,39
/jdk1.4.2_19/javax/swing/plaf/FileChooserUI.java,Java,,14,7,12,33
/jdk1.4.2_19/javax/swing/plaf/FontUIResource.java,Java,,12,5,25,42
/jdk1.4.2_19/javax/swing/plaf/IconUIResource.java,Java,,25,8,33,66
/jdk1.4.2_19/javax/swing/plaf/InputMapUIResource.java,Java,,6,4,13,23
/jdk1.4.2_19/javax/swing/plaf/InsetsUIResource.java,Java,,9,4,25,38
/jdk1.4.2_19/javax/swing/plaf/InternalFrameUI.java,Java,,3,3,12,18
/jdk1.4.2_19/javax/swing/plaf/LabelUI.java,Java,,3,2,12,17
/jdk1.4.2_19/javax/swing/plaf/ListUI.java,Java,,10,9,38,57
/jdk1.4.2_19/javax/swing/plaf/MenuBarUI.java,Java,,5,5,13,23
/jdk1.4.2_19/javax/swing/plaf/MenuItemUI.java,Java,,5,3,14,22
/jdk1.4.2_19/javax/swing/plaf/metal/DefaultMetalTheme.java,Java,,149,33,71,253
/jdk1.4.2_19/javax/swing/plaf/metal/MetalBorders.java,Java,,636,167,87,890
/jdk1.4.2_19/javax/swing/plaf/metal/MetalBumps.java,Java,,164,35,24,223
/jdk1.4.2_19/javax/swing/plaf/metal/MetalButtonUI.java,Java,,97,30,43,170
/jdk1.4.2_19/javax/swing/plaf/metal/MetalCheckBoxIcon.java,Java,,55,14,21,90
/jdk1.4.2_19/javax/swing/plaf/metal/MetalCheckBoxUI.java,Java,,29,14,31,74
/jdk1.4.2_19/javax/swing/plaf/metal/MetalComboBoxButton.java,Java,,136,29,28,193
/jdk1.4.2_19/javax/swing/plaf/metal/MetalComboBoxEditor.java,Java,,49,14,39,102
/jdk1.4.2_19/javax/swing/plaf/metal/MetalComboBoxIcon.java,Java,,24,11,22,57
/jdk1.4.2_19/javax/swing/plaf/metal/MetalComboBoxUI.java,Java,,132,34,68,234
/jdk1.4.2_19/javax/swing/plaf/metal/MetalDesktopIconUI.java,Java,,88,21,19,128
/jdk1.4.2_19/javax/swing/plaf/metal/MetalFileChooserUI.java,Java,,1561,279,176,2016
/jdk1.4.2_19/javax/swing/plaf/metal/MetalFontDesktopProperty.java,Java,,35,8,39,82
/jdk1.4.2_19/javax/swing/plaf/metal/MetalHighContrastTheme.java,Java,,121,33,18,172
/jdk1.4.2_19/javax/swing/plaf/metal/MetalIconFactory.java,Java,,1537,327,290,2154
/jdk1.4.2_19/javax/swing/plaf/metal/MetalInternalFrameTitlePane.java,Java,,382,68,61,511
/jdk1.4.2_19/javax/swing/plaf/metal/MetalInternalFrameUI.java,Java,,143,32,17,192
/jdk1.4.2_19/javax/swing/plaf/metal/MetalLabelUI.java,Java,,24,10,21,55
/jdk1.4.2_19/javax/swing/plaf/metal/MetalLookAndFeel.java,Java,,1100,136,184,1420
/jdk1.4.2_19/javax/swing/plaf/metal/MetalPopupMenuSeparatorUI.java,Java,,29,13,13,55
/jdk1.4.2_19/javax/swing/plaf/metal/MetalProgressBarUI.java,Java,,96,25,50,171
/jdk1.4.2_19/javax/swing/plaf/metal/MetalRadioButtonUI.java,Java,,128,33,40,201
/jdk1.4.2_19/javax/swing/plaf/metal/MetalRootPaneUI.java,Java,,591,95,285,971
/jdk1.4.2_19/javax/swing/plaf/metal/MetalScrollBarUI.java,Java,,281,134,35,450
/jdk1.4.2_19/javax/swing/plaf/metal/MetalScrollButton.java,Java,,236,57,45,338
/jdk1.4.2_19/javax/swing/plaf/metal/MetalScrollPaneUI.java,Java,,73,21,27,121
/jdk1.4.2_19/javax/swing/plaf/metal/MetalSeparatorUI.java,Java,,45,15,22,82
/jdk1.4.2_19/javax/swing/plaf/metal/MetalSliderUI.java,Java,,256,58,40,354
/jdk1.4.2_19/javax/swing/plaf/metal/MetalSplitPaneDivider.java,Java,,257,38,83,378
/jdk1.4.2_19/javax/swing/plaf/metal/MetalSplitPaneUI.java,Java,,13,6,27,46
/jdk1.4.2_19/javax/swing/plaf/metal/MetalTabbedPaneUI.java,Java,,651,157,169,977
/jdk1.4.2_19/javax/swing/plaf/metal/MetalTextFieldUI.java,Java,,15,7,29,51
/jdk1.4.2_19/javax/swing/plaf/metal/MetalTheme.java,Java,,68,21,27,116
/jdk1.4.2_19/javax/swing/plaf/metal/MetalTitlePane.java,Java,,644,135,217,996
/jdk1.4.2_19/javax/swing/plaf/metal/MetalToggleButtonUI.java,Java,,89,24,38,151
/jdk1.4.2_19/javax/swing/plaf/metal/MetalToolBarUI.java,Java,,139,31,46,216
/jdk1.4.2_19/javax/swing/plaf/metal/MetalToolTipUI.java,Java,,105,25,30,160
/jdk1.4.2_19/javax/swing/plaf/metal/MetalTreeUI.java,Java,,127,40,54,221
/jdk1.4.2_19/javax/swing/plaf/metal/MetalUtils.java,Java,,103,23,37,163
/jdk1.4.2_19/javax/swing/plaf/multi/MultiButtonUI.java,Java,,88,18,87,193
/jdk1.4.2_19/javax/swing/plaf/multi/MultiColorChooserUI.java,Java,,88,18,87,193
/jdk1.4.2_19/javax/swing/plaf/multi/MultiComboBoxUI.java,Java,,110,21,102,233
/jdk1.4.2_19/javax/swing/plaf/multi/MultiDesktopIconUI.java,Java,,88,18,87,193
/jdk1.4.2_19/javax/swing/plaf/multi/MultiDesktopPaneUI.java,Java,,88,18,87,193
/jdk1.4.2_19/javax/swing/plaf/multi/MultiFileChooserUI.java,Java,,135,24,117,276
/jdk1.4.2_19/javax/swing/plaf/multi/MultiInternalFrameUI.java,Java,,88,18,87,193
/jdk1.4.2_19/javax/swing/plaf/multi/MultiLabelUI.java,Java,,88,18,87,193
/jdk1.4.2_19/javax/swing/plaf/multi/MultiListUI.java,Java,,115,21,105,241
/jdk1.4.2_19/javax/swing/plaf/multi/MultiLookAndFeel.java,Java,,120,16,147,283
/jdk1.4.2_19/javax/swing/plaf/multi/MultiMenuBarUI.java,Java,,88,18,87,193
/jdk1.4.2_19/javax/swing/plaf/multi/MultiMenuItemUI.java,Java,,89,19,90,198
/jdk1.4.2_19/javax/swing/plaf/multi/MultiOptionPaneUI.java,Java,,102,20,96,218
/jdk1.4.2_19/javax/swing/plaf/multi/MultiPanelUI.java,Java,,88,18,87,193
/jdk1.4.2_19/javax/swing/plaf/multi/MultiPopupMenuUI.java,Java,,107,20,99,226
/jdk1.4.2_19/javax/swing/plaf/multi/MultiProgressBarUI.java,Java,,88,18,87,193
/jdk1.4.2_19/javax/swing/plaf/multi/MultiRootPaneUI.java,Java,,88,18,87,193
/jdk1.4.2_19/javax/swing/plaf/multi/MultiScrollBarUI.java,Java,,88,18,87,193
/jdk1.4.2_19/javax/swing/plaf/multi/MultiScrollPaneUI.java,Java,,88,18,87,193
/jdk1.4.2_19/javax/swing/plaf/multi/MultiSeparatorUI.java,Java,,88,18,87,193
/jdk1.4.2_19/javax/swing/plaf/multi/MultiSliderUI.java,Java,,88,18,87,193
/jdk1.4.2_19/javax/swing/plaf/multi/MultiSpinnerUI.java,Java,,88,18,87,193
/jdk1.4.2_19/javax/swing/plaf/multi/MultiSplitPaneUI.java,Java,,128,24,114,266
/jdk1.4.2_19/javax/swing/plaf/multi/MultiTabbedPaneUI.java,Java,,114,21,105,240
/jdk1.4.2_19/javax/swing/plaf/multi/MultiTableHeaderUI.java,Java,,88,18,87,193
/jdk1.4.2_19/javax/swing/plaf/multi/MultiTableUI.java,Java,,88,18,87,193
/jdk1.4.2_19/javax/swing/plaf/multi/MultiTextUI.java,Java,,173,28,141,342
/jdk1.4.2_19/javax/swing/plaf/multi/MultiToolBarUI.java,Java,,88,18,87,193
/jdk1.4.2_19/javax/swing/plaf/multi/MultiToolTipUI.java,Java,,88,18,87,193
/jdk1.4.2_19/javax/swing/plaf/multi/MultiTreeUI.java,Java,,165,28,141,334
/jdk1.4.2_19/javax/swing/plaf/multi/MultiViewportUI.java,Java,,88,18,87,193
/jdk1.4.2_19/javax/swing/plaf/OptionPaneUI.java,Java,,7,5,20,32
/jdk1.4.2_19/javax/swing/plaf/PanelUI.java,Java,,3,4,12,19
/jdk1.4.2_19/javax/swing/plaf/PopupMenuUI.java,Java,,14,7,26,47
/jdk1.4.2_19/javax/swing/plaf/ProgressBarUI.java,Java,,3,3,12,18
/jdk1.4.2_19/javax/swing/plaf/RootPaneUI.java,Java,,3,2,12,17
/jdk1.4.2_19/javax/swing/plaf/ScrollBarUI.java,Java,,3,2,12,17
/jdk1.4.2_19/javax/swing/plaf/ScrollPaneUI.java,Java,,3,4,12,19
/jdk1.4.2_19/javax/swing/plaf/SeparatorUI.java,Java,,3,4,13,20
/jdk1.4.2_19/javax/swing/plaf/SliderUI.java,Java,,3,3,12,18
/jdk1.4.2_19/javax/swing/plaf/SpinnerUI.java,Java,,3,4,13,20
/jdk1.4.2_19/javax/swing/plaf/SplitPaneUI.java,Java,,12,8,32,52
/jdk1.4.2_19/javax/swing/plaf/TabbedPaneUI.java,Java,,8,3,13,24
/jdk1.4.2_19/javax/swing/plaf/TableHeaderUI.java,Java,,3,2,12,17
/jdk1.4.2_19/javax/swing/plaf/TableUI.java,Java,,3,2,12,17
/jdk1.4.2_19/javax/swing/plaf/TextUI.java,Java,,28,11,107,146
/jdk1.4.2_19/javax/swing/plaf/ToolBarUI.java,Java,,5,5,12,22
/jdk1.4.2_19/javax/swing/plaf/ToolTipUI.java,Java,,3,2,12,17
/jdk1.4.2_19/javax/swing/plaf/TreeUI.java,Java,,18,12,58,88
/jdk1.4.2_19/javax/swing/plaf/UIResource.java,Java,,3,4,43,50
/jdk1.4.2_19/javax/swing/plaf/ViewportUI.java,Java,,3,4,12,19
/jdk1.4.2_19/javax/swing/Popup.java,Java,,92,28,105,225
/jdk1.4.2_19/javax/swing/PopupFactory.java,Java,,538,113,233,884
/jdk1.4.2_19/javax/swing/ProgressMonitor.java,Java,,199,51,144,394
/jdk1.4.2_19/javax/swing/ProgressMonitorInputStream.java,Java,,73,25,73,171
/jdk1.4.2_19/javax/swing/Renderer.java,Java,,6,3,25,34
/jdk1.4.2_19/javax/swing/RepaintManager.java,Java,,382,97,223,702
/jdk1.4.2_19/javax/swing/RootPaneContainer.java,Java,,13,18,108,139
/jdk1.4.2_19/javax/swing/Scrollable.java,Java,,11,11,89,111
/jdk1.4.2_19/javax/swing/ScrollPaneConstants.java,Java,,25,8,68,101
/jdk1.4.2_19/javax/swing/ScrollPaneLayout.java,Java,,517,138,412,1067
/jdk1.4.2_19/javax/swing/SingleSelectionModel.java,Java,,10,8,42,60
/jdk1.4.2_19/javax/swing/SizeRequirements.java,Java,,175,27,267,469
/jdk1.4.2_19/javax/swing/SizeSequence.java,Java,,126,22,221,369
/jdk1.4.2_19/javax/swing/SortingFocusTraversalPolicy.java,Java,,218,59,196,473
/jdk1.4.2_19/javax/swing/SpinnerDateModel.java,Java,,110,33,297,440
/jdk1.4.2_19/javax/swing/SpinnerListModel.java,Java,,73,28,130,231
/jdk1.4.2_19/javax/swing/SpinnerModel.java,Java,,12,14,96,122
/jdk1.4.2_19/javax/swing/SpinnerNumberModel.java,Java,,118,39,277,434
/jdk1.4.2_19/javax/swing/Spring.java,Java,,202,62,218,482
/jdk1.4.2_19/javax/swing/SpringLayout.java,Java,,399,83,530,1012
/jdk1.4.2_19/javax/swing/SwingConstants.java,Java,,22,8,91,121
/jdk1.4.2_19/javax/swing/SwingGraphics.java,Java,,449,87,48,584
/jdk1.4.2_19/javax/swing/SwingUtilities.java,Java,,1011,165,604,1780
/jdk1.4.2_19/javax/swing/SystemEventQueueUtilities.java,Java,,450,88,275,813
/jdk1.4.2_19/javax/swing/table/AbstractTableModel.java,Java,,74,24,226,324
/jdk1.4.2_19/javax/swing/table/DefaultTableCellRenderer.java,Java,,94,33,159,286
/jdk1.4.2_19/javax/swing/table/DefaultTableColumnModel.java,Java,,270,74,383,727
/jdk1.4.2_19/javax/swing/table/DefaultTableModel.java,Java,,214,55,407,676
/jdk1.4.2_19/javax/swing/table/JTableHeader.java,Java,,790,155,510,1455
/jdk1.4.2_19/javax/swing/table/TableCellEditor.java,Java,,9,7,40,56
/jdk1.4.2_19/javax/swing/table/TableCellRenderer.java,Java,,8,5,38,51
/jdk1.4.2_19/javax/swing/table/TableColumn.java,Java,,224,76,479,779
/jdk1.4.2_19/javax/swing/table/TableColumnModel.java,Java,,27,26,171,224
/jdk1.4.2_19/javax/swing/table/TableModel.java,Java,,15,13,99,127
/jdk1.4.2_19/javax/swing/text/AbstractDocument.java,Java,,1257,294,1511,3062
/jdk1.4.2_19/javax/swing/text/AbstractWriter.java,Java,,331,53,316,700
/jdk1.4.2_19/javax/swing/text/AsyncBoxView.java,Java,,649,109,642,1400
/jdk1.4.2_19/javax/swing/text/AttributeSet.java,Java,,23,18,121,162
/jdk1.4.2_19/javax/swing/text/BadLocationException.java,Java,,12,3,33,48
/jdk1.4.2_19/javax/swing/text/BoxView.java,Java,,565,82,519,1166
/jdk1.4.2_19/javax/swing/text/Caret.java,Java,,24,21,140,185
/jdk1.4.2_19/javax/swing/text/ChangedCharSetException.java,Java,,16,7,13,36
/jdk1.4.2_19/javax/swing/text/ComponentView.java,Java,,224,36,200,460
/jdk1.4.2_19/javax/swing/text/CompositeView.java,Java,,321,47,408,776
/jdk1.4.2_19/javax/swing/text/DateFormatter.java,Java,,64,17,62,143
/jdk1.4.2_19/javax/swing/text/DefaultCaret.java,Java,,841,131,636,1608
/jdk1.4.2_19/javax/swing/text/DefaultEditorKit.java,Java,,1053,211,898,2162
/jdk1.4.2_19/javax/swing/text/DefaultFormatter.java,Java,,371,77,294,742
/jdk1.4.2_19/javax/swing/text/DefaultFormatterFactory.java,Java,,87,22,190,299
/jdk1.4.2_19/javax/swing/text/DefaultHighlighter.java,Java,,317,44,162,523
/jdk1.4.2_19/javax/swing/text/DefaultStyledDocument.java,Java,,1476,202,809,2487
/jdk1.4.2_19/javax/swing/text/DefaultTextUI.java,Java,,4,5,15,24
/jdk1.4.2_19/javax/swing/text/Document.java,Java,,23,23,413,459
/jdk1.4.2_19/javax/swing/text/DocumentFilter.java,Java,,26,8,123,157
/jdk1.4.2_19/javax/swing/text/EditorKit.java,Java,,34,16,141,191
/jdk1.4.2_19/javax/swing/text/Element.java,Java,,13,14,96,123
/jdk1.4.2_19/javax/swing/text/ElementIterator.java,Java,,167,42,155,364
/jdk1.4.2_19/javax/swing/text/FieldView.java,Java,,147,19,126,292
/jdk1.4.2_19/javax/swing/text/FlowView.java,Java,,370,62,381,813
/jdk1.4.2_19/javax/swing/text/GapContent.java,Java,,537,94,294,925
/jdk1.4.2_19/javax/swing/text/GapVector.java,Java,,117,32,125,274
/jdk1.4.2_19/javax/swing/text/GlyphPainter1.java,Java,,105,20,86,211
/jdk1.4.2_19/javax/swing/text/GlyphPainter2.java,Java,,211,28,125,364
/jdk1.4.2_19/javax/swing/text/GlyphView.java,Java,,529,82,529,1140
/jdk1.4.2_19/javax/swing/text/Highlighter.java,Java,,22,20,94,136
/jdk1.4.2_19/javax/swing/text/html/AccessibleHTML.java,Java,,1527,290,1190,3007
/jdk1.4.2_19/javax/swing/text/html/BlockView.java,Java,,204,32,189,425
/jdk1.4.2_19/javax/swing/text/html/BRView.java,Java,,17,5,22,44
/jdk1.4.2_19/javax/swing/text/html/CommentView.java,Java,,87,13,19,119
/jdk1.4.2_19/javax/swing/text/html/CSS.java,Java,,2045,310,779,3134
/jdk1.4.2_19/javax/swing/text/html/CSSParser.java,Java,,583,77,177,837
/jdk1.4.2_19/javax/swing/text/html/EditableView.java,Java,,63,11,30,104
/jdk1.4.2_19/javax/swing/text/html/FormView.java,Java,,578,86,327,991
/jdk1.4.2_19/javax/swing/text/html/FrameSetView.java,Java,,170,33,94,297
/jdk1.4.2_19/javax/swing/text/html/FrameView.java,Java,,230,43,116,389
/jdk1.4.2_19/javax/swing/text/html/HiddenTagView.java,Java,,252,39,51,342
/jdk1.4.2_19/javax/swing/text/html/HRuleView.java,Java,,179,25,94,298
/jdk1.4.2_19/javax/swing/text/html/HTML.java,Java,,397,46,214,657
/jdk1.4.2_19/javax/swing/text/html/HTMLDocument.java,Java,,2015,286,1383,3684
/jdk1.4.2_19/javax/swing/text/html/HTMLEditorKit.java,Java,,1251,156,752,2159
/jdk1.4.2_19/javax/swing/text/html/HTMLFrameHyperlinkEvent.java,Java,,30,11,55,96
/jdk1.4.2_19/javax/swing/text/html/HTMLWriter.java,Java,,793,102,326,1221
/jdk1.4.2_19/javax/swing/text/html/ImageView.java,Java,,668,102,291,1061
/jdk1.4.2_19/javax/swing/text/html/InlineView.java,Java,,157,18,82,257
/jdk1.4.2_19/javax/swing/text/html/IsindexView.java,Java,,51,15,31,97
/jdk1.4.2_19/javax/swing/text/html/LineView.java,Java,,62,11,95,168
/jdk1.4.2_19/javax/swing/text/html/ListView.java,Java,,53,8,44,105
/jdk1.4.2_19/javax/swing/text/html/Map.java,Java,,348,48,92,488
/jdk1.4.2_19/javax/swing/text/html/MinimalHTMLWriter.java,Java,,348,82,279,709
/jdk1.4.2_19/javax/swing/text/html/MuxingAttributeSet.java,Java,,148,28,118,294
/jdk1.4.2_19/javax/swing/text/html/NoFramesView.java,Java,,57,15,84,156
/jdk1.4.2_19/javax/swing/text/html/ObjectView.java,Java,,75,11,82,168
/jdk1.4.2_19/javax/swing/text/html/Option.java,Java,,38,12,46,96
/jdk1.4.2_19/javax/swing/text/html/OptionComboBoxModel.java,Java,,13,7,26,46
/jdk1.4.2_19/javax/swing/text/html/OptionListModel.java,Java,,305,74,177,556
/jdk1.4.2_19/javax/swing/text/html/ParagraphView.java,Java,,148,21,113,282
/jdk1.4.2_19/javax/swing/text/html/parser/AttributeList.java,Java,,83,19,53,155
/jdk1.4.2_19/javax/swing/text/html/parser/ContentModel.java,Java,,144,26,68,238
/jdk1.4.2_19/javax/swing/text/html/parser/ContentModelState.java,Java,,173,27,78,278
/jdk1.4.2_19/javax/swing/text/html/parser/DocumentParser.java,Java,,141,20,93,254
/jdk1.4.2_19/javax/swing/text/html/parser/DTD.java,Java,,251,33,151,435
/jdk1.4.2_19/javax/swing/text/html/parser/DTDConstants.java,Java,,39,6,20,65
/jdk1.4.2_19/javax/swing/text/html/parser/Element.java,Java,,79,22,57,158
/jdk1.4.2_19/javax/swing/text/html/parser/Entity.java,Java,,53,15,55,123
/jdk1.4.2_19/javax/swing/text/html/parser/Parser.java,Java,,1430,232,470,2132
/jdk1.4.2_19/javax/swing/text/html/parser/ParserDelegator.java,Java,,67,15,28,110
/jdk1.4.2_19/javax/swing/text/html/parser/ResourceLoader.java,Java,,16,7,20,43
/jdk1.4.2_19/javax/swing/text/html/parser/TagElement.java,Java,,33,15,13,61
/jdk1.4.2_19/javax/swing/text/html/parser/TagStack.java,Java,,123,29,53,205
/jdk1.4.2_19/javax/swing/text/html/ResourceLoader.java,Java,,16,7,20,43
/jdk1.4.2_19/javax/swing/text/html/StyleSheet.java,Java,,1960,211,981,3152
/jdk1.4.2_19/javax/swing/text/html/TableView.java,Java,,995,163,592,1750
/jdk1.4.2_19/javax/swing/text/html/TextAreaDocument.java,Java,,20,12,23,55
/jdk1.4.2_19/javax/swing/text/IconView.java,Java,,56,12,84,152
/jdk1.4.2_19/javax/swing/text/InternationalFormatter.java,Java,,567,95,421,1083
/jdk1.4.2_19/javax/swing/text/JTextComponent.java,Java,,1833,320,1609,3762
/jdk1.4.2_19/javax/swing/text/Keymap.java,Java,,18,16,94,128
/jdk1.4.2_19/javax/swing/text/LabelView.java,Java,,90,24,161,275
/jdk1.4.2_19/javax/swing/text/LayeredHighlighter.java,Java,,14,4,28,46
/jdk1.4.2_19/javax/swing/text/LayoutQueue.java,Java,,54,15,35,104
/jdk1.4.2_19/javax/swing/text/MaskFormatter.java,Java,,465,86,438,989
/jdk1.4.2_19/javax/swing/text/MutableAttributeSet.java,Java,,10,20,51,81
/jdk1.4.2_19/javax/swing/text/NavigationFilter.java,Java,,22,8,99,129
/jdk1.4.2_19/javax/swing/text/NumberFormatter.java,Java,,282,45,158,485
/jdk1.4.2_19/javax/swing/text/ParagraphView.java,Java,,433,52,407,892
/jdk1.4.2_19/javax/swing/text/PasswordView.java,Java,,110,12,94,216
/jdk1.4.2_19/javax/swing/text/PlainDocument.java,Java,,168,16,119,303
/jdk1.4.2_19/javax/swing/text/PlainView.java,Java,,369,45,268,682
/jdk1.4.2_19/javax/swing/text/Position.java,Java,,15,8,39,62
/jdk1.4.2_19/javax/swing/text/rtf/AbstractFilter.java,Java,,108,27,78,213
/jdk1.4.2_19/javax/swing/text/rtf/Constants.java,Java,,28,10,22,60
/jdk1.4.2_19/javax/swing/text/rtf/MockAttributeSet.java,Java,,78,22,8,108
/jdk1.4.2_19/javax/swing/text/rtf/RTFAttribute.java,Java,,26,7,16,49
/jdk1.4.2_19/javax/swing/text/rtf/RTFAttributes.java,Java,,324,64,16,404
/jdk1.4.2_19/javax/swing/text/rtf/RTFEditorKit.java,Java,,43,13,82,138
/jdk1.4.2_19/javax/swing/text/rtf/RTFGenerator.java,Java,,764,130,97,991
/jdk1.4.2_19/javax/swing/text/rtf/RTFParser.java,Java,,228,35,53,316
/jdk1.4.2_19/javax/swing/text/rtf/RTFReader.java,Java,,1124,227,282,1633
/jdk1.4.2_19/javax/swing/text/Segment.java,Java,,96,27,126,249
/jdk1.4.2_19/javax/swing/text/SegmentCache.java,Java,,39,15,56,110
/jdk1.4.2_19/javax/swing/text/SimpleAttributeSet.java,Java,,200,35,153,388
/jdk1.4.2_19/javax/swing/text/StateInvariantError.java,Java,,7,2,19,28
/jdk1.4.2_19/javax/swing/text/StringContent.java,Java,,264,40,177,481
/jdk1.4.2_19/javax/swing/text/Style.java,Java,,11,10,37,58
/jdk1.4.2_19/javax/swing/text/StyleConstants.java,Java,,308,131,552,991
/jdk1.4.2_19/javax/swing/text/StyleContext.java,Java,,698,146,744,1588
/jdk1.4.2_19/javax/swing/text/StyledDocument.java,Java,,17,16,127,160
/jdk1.4.2_19/javax/swing/text/StyledEditorKit.java,Java,,393,76,405,874
/jdk1.4.2_19/javax/swing/text/TabableView.java,Java,,5,4,44,53
/jdk1.4.2_19/javax/swing/text/TabExpander.java,Java,,4,4,22,30
/jdk1.4.2_19/javax/swing/text/TableView.java,Java,,425,75,394,894
/jdk1.4.2_19/javax/swing/text/TabSet.java,Java,,66,15,54,135
/jdk1.4.2_19/javax/swing/text/TabStop.java,Java,,76,15,70,161
/jdk1.4.2_19/javax/swing/text/TextAction.java,Java,,45,6,68,119
/jdk1.4.2_19/javax/swing/text/TextLayoutStrategy.java,Java,,301,52,192,545
/jdk1.4.2_19/javax/swing/text/Utilities.java,Java,,496,48,268,812
/jdk1.4.2_19/javax/swing/text/View.java,Java,,376,66,914,1356
/jdk1.4.2_19/javax/swing/text/ViewFactory.java,Java,,5,4,22,31
/jdk1.4.2_19/javax/swing/text/WrappedPlainView.java,Java,,384,57,311,752
/jdk1.4.2_19/javax/swing/text/ZoneView.java,Java,,247,49,338,634
/jdk1.4.2_19/javax/swing/Timer.java,Java,,139,65,337,541
/jdk1.4.2_19/javax/swing/TimerQueue.java,Java,,172,60,40,272
/jdk1.4.2_19/javax/swing/ToolTipManager.java,Java,,520,78,224,822
/jdk1.4.2_19/javax/swing/TransferHandler.java,Java,,442,94,315,851
/jdk1.4.2_19/javax/swing/tree/AbstractLayoutCache.java,Java,,140,56,318,514
/jdk1.4.2_19/javax/swing/tree/DefaultMutableTreeNode.java,Java,,646,227,617,1490
/jdk1.4.2_19/javax/swing/tree/DefaultTreeCellEditor.java,Java,,344,88,287,719
/jdk1.4.2_19/javax/swing/tree/DefaultTreeCellRenderer.java,Java,,223,66,227,516
/jdk1.4.2_19/javax/swing/tree/DefaultTreeModel.java,Java,,263,57,341,661
/jdk1.4.2_19/javax/swing/tree/DefaultTreeSelectionModel.java,Java,,702,118,391,1211
/jdk1.4.2_19/javax/swing/tree/ExpandVetoException.java,Java,,12,6,28,46
/jdk1.4.2_19/javax/swing/tree/FixedHeightLayoutCache.java,Java,,962,185,435,1582
/jdk1.4.2_19/javax/swing/tree/MutableTreeNode.java,Java,,10,8,38,56
/jdk1.4.2_19/javax/swing/tree/RowMapper.java,Java,,6,3,20,29
/jdk1.4.2_19/javax/swing/tree/TreeCellEditor.java,Java,,10,4,34,48
/jdk1.4.2_19/javax/swing/tree/TreeCellRenderer.java,Java,,8,4,31,43
/jdk1.4.2_19/javax/swing/tree/TreeModel.java,Java,,13,15,106,134
/jdk1.4.2_19/javax/swing/tree/TreeNode.java,Java,,12,10,46,68
/jdk1.4.2_19/javax/swing/tree/TreePath.java,Java,,138,33,147,318
/jdk1.4.2_19/javax/swing/tree/TreeSelectionModel.java,Java,,36,33,225,294
/jdk1.4.2_19/javax/swing/tree/VariableHeightLayoutCache.java,Java,,1046,191,513,1750
/jdk1.4.2_19/javax/swing/UIDefaults.java,Java,,443,102,619,1164
/jdk1.4.2_19/javax/swing/UIManager.java,Java,,528,138,555,1221
/jdk1.4.2_19/javax/swing/undo/AbstractUndoableEdit.java,Java,,73,24,165,262
/jdk1.4.2_19/javax/swing/undo/CannotRedoException.java,Java,,3,2,21,26
/jdk1.4.2_19/javax/swing/undo/CannotUndoException.java,Java,,3,3,21,27
/jdk1.4.2_19/javax/swing/undo/CompoundEdit.java,Java,,110,21,114,245
/jdk1.4.2_19/javax/swing/undo/StateEdit.java,Java,,59,27,90,176
/jdk1.4.2_19/javax/swing/undo/StateEditable.java,Java,,7,8,21,36
/jdk1.4.2_19/javax/swing/undo/UndoableEdit.java,Java,,15,14,90,119
/jdk1.4.2_19/javax/swing/undo/UndoableEditSupport.java,Java,,70,17,75,162
/jdk1.4.2_19/javax/swing/undo/UndoManager.java,Java,,210,44,209,463
/jdk1.4.2_19/javax/swing/UnsupportedLookAndFeelException.java,Java,,7,1,26,34
/jdk1.4.2_19/javax/swing/ViewportLayout.java,Java,,81,19,83,183
/jdk1.4.2_19/javax/swing/WindowConstants.java,Java,,8,7,52,67
/jdk1.4.2_19/javax/xml/parsers/DocumentBuilder.java,Java,,63,34,139,236
/jdk1.4.2_19/javax/xml/parsers/DocumentBuilderFactory.java,Java,,72,39,185,296
/jdk1.4.2_19/javax/xml/parsers/FactoryConfigurationError.java,Java,,30,27,56,113
/jdk1.4.2_19/javax/xml/parsers/FactoryFinder.java,Java,,139,22,60,221
/jdk1.4.2_19/javax/xml/parsers/ParserConfigurationException.java,Java,,9,9,22,40
/jdk1.4.2_19/javax/xml/parsers/SAXParser.java,Java,,136,49,242,427
/jdk1.4.2_19/javax/xml/parsers/SAXParserFactory.java,Java,,45,21,140,206
/jdk1.4.2_19/javax/xml/transform/dom/DOMLocator.java,Java,,6,7,20,33
/jdk1.4.2_19/javax/xml/transform/dom/DOMResult.java,Java,,32,18,82,132
/jdk1.4.2_19/javax/xml/transform/dom/DOMSource.java,Java,,32,18,71,121
/jdk1.4.2_19/javax/xml/transform/ErrorListener.java,Java,,9,5,77,91
/jdk1.4.2_19/javax/xml/transform/FactoryFinder.java,Java,,139,22,60,221
/jdk1.4.2_19/javax/xml/transform/OutputKeys.java,Java,,15,13,141,169
/jdk1.4.2_19/javax/xml/transform/Result.java,Java,,12,9,52,73
/jdk1.4.2_19/javax/xml/transform/sax/SAXResult.java,Java,,37,20,74,131
/jdk1.4.2_19/javax/xml/transform/sax/SAXSource.java,Java,,62,26,94,182
/jdk1.4.2_19/javax/xml/transform/sax/SAXTransformerFactory.java,Java,,27,14,98,139
/jdk1.4.2_19/javax/xml/transform/sax/TemplatesHandler.java,Java,,9,8,36,53
/jdk1.4.2_19/javax/xml/transform/sax/TransformerHandler.java,Java,,16,10,34,60
/jdk1.4.2_19/javax/xml/transform/Source.java,Java,,8,7,27,42
/jdk1.4.2_19/javax/xml/transform/SourceLocator.java,Java,,7,6,66,79
/jdk1.4.2_19/javax/xml/transform/stream/StreamResult.java,Java,,54,23,109,186
/jdk1.4.2_19/javax/xml/transform/stream/StreamSource.java,Java,,68,27,164,259
/jdk1.4.2_19/javax/xml/transform/Templates.java,Java,,7,7,52,66
/jdk1.4.2_19/javax/xml/transform/Transformer.java,Java,,22,17,197,236
/jdk1.4.2_19/javax/xml/transform/TransformerConfigurationException.java,Java,,24,7,53,84
/jdk1.4.2_19/javax/xml/transform/TransformerException.java,Java,,166,60,128,354
/jdk1.4.2_19/javax/xml/transform/TransformerFactory.java,Java,,45,18,186,249
/jdk1.4.2_19/javax/xml/transform/TransformerFactoryConfigurationError.java,Java,,30,19,51,100
/jdk1.4.2_19/javax/xml/transform/URIResolver.java,Java,,5,3,25,33
/jdk1.4.2_19/launcher/java.c,C/C++/ObjC,,1125,150,359,1634
/jdk1.4.2_19/launcher/java.h,h,,35,17,32,84
/jdk1.4.2_19/launcher/java_md.c,C/C++/ObjC,,405,67,150,622
/jdk1.4.2_19/launcher/java_md.h,h,,28,9,18,55
/jdk1.4.2_19/org/apache/crimson/jaxp/DefaultValidationErrorHandler.java,Java,,28,5,58,91
/jdk1.4.2_19/org/apache/crimson/jaxp/DocumentBuilderFactoryImpl.java,Java,,24,9,72,105
/jdk1.4.2_19/org/apache/crimson/jaxp/DocumentBuilderImpl.java,Java,,97,33,76,206
/jdk1.4.2_19/org/apache/crimson/jaxp/SAXParserFactoryImpl.java,Java,,63,11,89,163
/jdk1.4.2_19/org/apache/crimson/jaxp/SAXParserImpl.java,Java,,76,22,104,202
/jdk1.4.2_19/org/apache/crimson/parser/AttributeDecl.java,Java,,26,13,64,103
/jdk1.4.2_19/org/apache/crimson/parser/AttributesEx.java,Java,,8,6,90,104
/jdk1.4.2_19/org/apache/crimson/parser/AttributesExImpl.java,Java,,48,14,84,146
/jdk1.4.2_19/org/apache/crimson/parser/ContentModel.java,Java,,104,27,158,289
/jdk1.4.2_19/org/apache/crimson/parser/ContentModelState.java,Java,,104,17,96,217
/jdk1.4.2_19/org/apache/crimson/parser/ElementDecl.java,Java,,13,13,90,116
/jdk1.4.2_19/org/apache/crimson/parser/ElementValidator.java,Java,,12,7,71,90
/jdk1.4.2_19/org/apache/crimson/parser/EndOfInputException.java,Java,,3,6,60,69
/jdk1.4.2_19/org/apache/crimson/parser/EntityDecl.java,Java,,6,5,63,74
/jdk1.4.2_19/org/apache/crimson/parser/ExternalEntity.java,Java,,25,9,61,95
/jdk1.4.2_19/org/apache/crimson/parser/InputEntity.java,Java,,666,133,310,1109
/jdk1.4.2_19/org/apache/crimson/parser/InternalEntity.java,Java,,10,5,60,75
/jdk1.4.2_19/org/apache/crimson/parser/Parser2.java,Java,,2203,470,855,3528
/jdk1.4.2_19/org/apache/crimson/parser/Resolver.java,Java,,207,46,253,506
/jdk1.4.2_19/org/apache/crimson/parser/SimpleHashtable.java,Java,,132,35,155,322
/jdk1.4.2_19/org/apache/crimson/parser/ValidatingParser.java,Java,,201,49,122,372
/jdk1.4.2_19/org/apache/crimson/parser/XmlReader.java,Java,,464,97,303,864
/jdk1.4.2_19/org/apache/crimson/parser/XMLReaderImpl.java,Java,,216,39,225,480
/jdk1.4.2_19/org/apache/crimson/tree/AttributeNode.java,Java,,143,37,144,324
/jdk1.4.2_19/org/apache/crimson/tree/AttributeNode1.java,Java,,22,5,76,103
/jdk1.4.2_19/org/apache/crimson/tree/AttributeSet.java,Java,,344,67,141,552
/jdk1.4.2_19/org/apache/crimson/tree/CDataNode.java,Java,,42,15,87,144
/jdk1.4.2_19/org/apache/crimson/tree/CommentNode.java,Java,,46,14,74,134
/jdk1.4.2_19/org/apache/crimson/tree/DataNode.java,Java,,121,38,121,280
/jdk1.4.2_19/org/apache/crimson/tree/Doctype.java,Java,,295,70,129,494
/jdk1.4.2_19/org/apache/crimson/tree/DocumentEx.java,Java,,15,19,147,181
/jdk1.4.2_19/org/apache/crimson/tree/DomEx.java,Java,,51,7,74,132
/jdk1.4.2_19/org/apache/crimson/tree/DOMImplementationImpl.java,Java,,52,12,83,147
/jdk1.4.2_19/org/apache/crimson/tree/ElementEx.java,Java,,9,7,96,112
/jdk1.4.2_19/org/apache/crimson/tree/ElementFactory.java,Java,,7,5,85,97
/jdk1.4.2_19/org/apache/crimson/tree/ElementNode.java,Java,,30,7,97,134
/jdk1.4.2_19/org/apache/crimson/tree/ElementNode2.java,Java,,348,66,209,623
/jdk1.4.2_19/org/apache/crimson/tree/NamespacedNode.java,Java,,58,15,101,174
/jdk1.4.2_19/org/apache/crimson/tree/NodeBase.java,Java,,147,54,230,431
/jdk1.4.2_19/org/apache/crimson/tree/NodeEx.java,Java,,10,8,106,124
/jdk1.4.2_19/org/apache/crimson/tree/ParentNode.java,Java,,464,110,227,801
/jdk1.4.2_19/org/apache/crimson/tree/ParseContext.java,Java,,9,6,84,99
/jdk1.4.2_19/org/apache/crimson/tree/PINode.java,Java,,50,21,87,158
/jdk1.4.2_19/org/apache/crimson/tree/SimpleElementFactory.java,Java,,145,34,201,380
/jdk1.4.2_19/org/apache/crimson/tree/TextNode.java,Java,,84,27,120,231
/jdk1.4.2_19/org/apache/crimson/tree/TreeWalker.java,Java,,115,23,144,282
/jdk1.4.2_19/org/apache/crimson/tree/XmlDocument.java,Java,,684,164,607,1455
/jdk1.4.2_19/org/apache/crimson/tree/XmlDocumentBuilder.java,Java,,329,99,368,796
/jdk1.4.2_19/org/apache/crimson/tree/XmlDocumentBuilderNS.java,Java,,85,17,100,202
/jdk1.4.2_19/org/apache/crimson/tree/XmlWritable.java,Java,,9,5,73,87
/jdk1.4.2_19/org/apache/crimson/tree/XmlWriteContext.java,Java,,51,16,114,181
/jdk1.4.2_19/org/apache/crimson/util/MessageCatalog.java,Java,,218,54,301,573
/jdk1.4.2_19/org/apache/crimson/util/XmlChars.java,Java,,177,38,212,427
/jdk1.4.2_19/org/apache/crimson/util/XmlNames.java,Java,,72,23,135,230
/jdk1.4.2_19/org/apache/xalan/extensions/ExpressionContext.java,Java,,17,10,101,128
/jdk1.4.2_19/org/apache/xalan/extensions/ExpressionVisitor.java,Java,,23,4,79,106
/jdk1.4.2_19/org/apache/xalan/extensions/ExtensionHandler.java,Java,,77,25,132,234
/jdk1.4.2_19/org/apache/xalan/extensions/ExtensionHandlerExsltFunction.java,Java,,116,17,104,237
/jdk1.4.2_19/org/apache/xalan/extensions/ExtensionHandlerGeneral.java,Java,,223,64,155,442
/jdk1.4.2_19/org/apache/xalan/extensions/ExtensionHandlerJava.java,Java,,23,11,102,136
/jdk1.4.2_19/org/apache/xalan/extensions/ExtensionHandlerJavaClass.java,Java,,249,45,164,458
/jdk1.4.2_19/org/apache/xalan/extensions/ExtensionHandlerJavaPackage.java,Java,,298,41,168,507
/jdk1.4.2_19/org/apache/xalan/extensions/ExtensionNamespacesManager.java,Java,,146,32,139,317
/jdk1.4.2_19/org/apache/xalan/extensions/ExtensionNamespaceSupport.java,Java,,66,6,13,85
/jdk1.4.2_19/org/apache/xalan/extensions/ExtensionsTable.java,Java,,104,17,126,247
/jdk1.4.2_19/org/apache/xalan/extensions/MethodResolver.java,Java,,669,72,293,1034
/jdk1.4.2_19/org/apache/xalan/extensions/XSLProcessorContext.java,Java,,181,40,135,356
/jdk1.4.2_19/org/apache/xalan/lib/ExsltBase.java,Java,,43,3,73,119
/jdk1.4.2_19/org/apache/xalan/lib/ExsltCommon.java,Java,,53,10,107,170
/jdk1.4.2_19/org/apache/xalan/lib/ExsltDatetime.java,Java,,439,70,449,958
/jdk1.4.2_19/org/apache/xalan/lib/ExsltDynamic.java,Java,,288,72,284,644
/jdk1.4.2_19/org/apache/xalan/lib/ExsltMath.java,Java,,157,35,232,424
/jdk1.4.2_19/org/apache/xalan/lib/ExsltSets.java,Java,,104,27,144,275
/jdk1.4.2_19/org/apache/xalan/lib/ExsltStrings.java,Java,,143,27,192,362
/jdk1.4.2_19/org/apache/xalan/lib/Extensions.java,Java,,178,41,222,441
/jdk1.4.2_19/org/apache/xalan/lib/NodeInfo.java,Java,,105,24,155,284
/jdk1.4.2_19/org/apache/xalan/lib/PipeDocument.java,Java,,132,19,128,279
/jdk1.4.2_19/org/apache/xalan/lib/Redirect.java,Java,,254,31,188,473
/jdk1.4.2_19/org/apache/xalan/lib/sql/ConnectionPool.java,Java,,23,22,150,195
/jdk1.4.2_19/org/apache/xalan/lib/sql/ConnectionPoolManager.java,Java,,41,19,108,168
/jdk1.4.2_19/org/apache/xalan/lib/sql/DefaultConnectionPool.java,Java,,285,99,236,620
/jdk1.4.2_19/org/apache/xalan/lib/sql/DTMDocument.java,Java,,870,173,586,1629
/jdk1.4.2_19/org/apache/xalan/lib/sql/ObjectArray.java,Java,,104,30,73,207
/jdk1.4.2_19/org/apache/xalan/lib/sql/PooledConnection.java,Java,,32,8,88,128
/jdk1.4.2_19/org/apache/xalan/lib/sql/QueryParameter.java,Java,,23,8,86,117
/jdk1.4.2_19/org/apache/xalan/lib/sql/SQLDocument.java,Java,,474,97,299,870
/jdk1.4.2_19/org/apache/xalan/lib/sql/SQLErrorDocument.java,Java,,57,23,123,203
/jdk1.4.2_19/org/apache/xalan/lib/sql/XConnection.java,Java,,760,182,455,1397
/jdk1.4.2_19/org/apache/xalan/processor/ProcessorAttributeSet.java,Java,,35,10,94,139
/jdk1.4.2_19/org/apache/xalan/processor/ProcessorCharacters.java,Java,,74,25,120,219
/jdk1.4.2_19/org/apache/xalan/processor/ProcessorDecimalFormat.java,Java,,16,7,86,109
/jdk1.4.2_19/org/apache/xalan/processor/ProcessorExsltFuncResult.java,Java,,44,7,65,116
/jdk1.4.2_19/org/apache/xalan/processor/ProcessorExsltFunction.java,Java,,137,14,85,236
/jdk1.4.2_19/org/apache/xalan/processor/ProcessorGlobalParamDecl.java,Java,,23,8,84,115
/jdk1.4.2_19/org/apache/xalan/processor/ProcessorGlobalVariableDecl.java,Java,,23,8,84,115
/jdk1.4.2_19/org/apache/xalan/processor/ProcessorImport.java,Java,,27,10,71,108
/jdk1.4.2_19/org/apache/xalan/processor/ProcessorInclude.java,Java,,177,42,122,341
/jdk1.4.2_19/org/apache/xalan/processor/ProcessorKey.java,Java,,76,20,97,193
/jdk1.4.2_19/org/apache/xalan/processor/ProcessorLRE.java,Java,,230,52,107,389
/jdk1.4.2_19/org/apache/xalan/processor/ProcessorNamespaceAlias.java,Java,,32,6,86,124
/jdk1.4.2_19/org/apache/xalan/processor/ProcessorOutputElem.java,Java,,94,27,143,264
/jdk1.4.2_19/org/apache/xalan/processor/ProcessorPreserveSpace.java,Java,,27,7,79,113
/jdk1.4.2_19/org/apache/xalan/processor/ProcessorStripSpace.java,Java,,26,8,79,113
/jdk1.4.2_19/org/apache/xalan/processor/ProcessorStylesheetDoc.java,Java,,4,1,61,66
/jdk1.4.2_19/org/apache/xalan/processor/ProcessorStylesheetElement.java,Java,,66,14,88,168
/jdk1.4.2_19/org/apache/xalan/processor/ProcessorTemplate.java,Java,,16,5,70,91
/jdk1.4.2_19/org/apache/xalan/processor/ProcessorTemplateElem.java,Java,,65,13,95,173
/jdk1.4.2_19/org/apache/xalan/processor/ProcessorText.java,Java,,26,12,84,122
/jdk1.4.2_19/org/apache/xalan/processor/ProcessorUnknown.java,Java,,20,5,86,111
/jdk1.4.2_19/org/apache/xalan/processor/StopParseException.java,Java,,8,2,66,76
/jdk1.4.2_19/org/apache/xalan/processor/StylesheetHandler.java,Java,,695,222,804,1721
/jdk1.4.2_19/org/apache/xalan/processor/StylesheetPIHandler.java,Java,,200,30,132,362
/jdk1.4.2_19/org/apache/xalan/processor/TransformerFactoryImpl.java,Java,,553,114,405,1072
/jdk1.4.2_19/org/apache/xalan/processor/WhitespaceInfoPaths.java,Java,,25,10,25,60
/jdk1.4.2_19/org/apache/xalan/processor/XSLProcessorVersion.java,Java,,18,10,124,152
/jdk1.4.2_19/org/apache/xalan/processor/XSLTAttributeDef.java,Java,,840,183,630,1653
/jdk1.4.2_19/org/apache/xalan/processor/XSLTElementDef.java,Java,,368,88,414,870
/jdk1.4.2_19/org/apache/xalan/processor/XSLTElementProcessor.java,Java,,162,43,216,421
/jdk1.4.2_19/org/apache/xalan/processor/XSLTSchema.java,Java,,721,65,147,933
/jdk1.4.2_19/org/apache/xalan/res/XSLMessages.java,Java,,178,62,176,416
/jdk1.4.2_19/org/apache/xalan/res/XSLTErrorResources.java,Java,,1131,660,816,2607
/jdk1.4.2_19/org/apache/xalan/res/XSLTErrorResources_de.java,Java,,957,610,738,2305
/jdk1.4.2_19/org/apache/xalan/res/XSLTErrorResources_en.java,Java,,4,2,61,67
/jdk1.4.2_19/org/apache/xalan/res/XSLTErrorResources_es.java,Java,,964,620,739,2323
/jdk1.4.2_19/org/apache/xalan/res/XSLTErrorResources_fr.java,Java,,964,609,739,2312
/jdk1.4.2_19/org/apache/xalan/res/XSLTErrorResources_it.java,Java,,964,1178,745,2887
/jdk1.4.2_19/org/apache/xalan/res/XSLTErrorResources_ja.java,Java,,965,1172,1023,3160
/jdk1.4.2_19/org/apache/xalan/res/XSLTErrorResources_ko.java,Java,,1396,1187,748,3331
/jdk1.4.2_19/org/apache/xalan/res/XSLTErrorResources_sv.java,Java,,955,1175,738,2868
/jdk1.4.2_19/org/apache/xalan/res/XSLTErrorResources_zh_CN.java,Java,,966,1174,737,2877
/jdk1.4.2_19/org/apache/xalan/res/XSLTErrorResources_zh_TW.java,Java,,966,1172,736,2874
/jdk1.4.2_19/org/apache/xalan/serialize/CharInfo.java,Java,,121,42,148,311
/jdk1.4.2_19/org/apache/xalan/serialize/DOMSerializer.java,Java,,7,3,84,94
/jdk1.4.2_19/org/apache/xalan/serialize/ElemDesc.java,Java,,49,35,120,204
/jdk1.4.2_19/org/apache/xalan/serialize/EncodingInfo.java,Java,,13,6,76,95
/jdk1.4.2_19/org/apache/xalan/serialize/Encodings.java,Java,,215,42,162,419
/jdk1.4.2_19/org/apache/xalan/serialize/Method.java,Java,,8,5,78,91
/jdk1.4.2_19/org/apache/xalan/serialize/Serializer.java,Java,,18,12,134,164
/jdk1.4.2_19/org/apache/xalan/serialize/SerializerFactory.java,Java,,46,20,81,147
/jdk1.4.2_19/org/apache/xalan/serialize/SerializerToHTML.java,Java,,762,203,411,1376
/jdk1.4.2_19/org/apache/xalan/serialize/SerializerToText.java,Java,,158,47,349,554
/jdk1.4.2_19/org/apache/xalan/serialize/SerializerToXML.java,Java,,1355,337,906,2598
/jdk1.4.2_19/org/apache/xalan/serialize/WriterToASCI.java,Java,,43,13,120,176
/jdk1.4.2_19/org/apache/xalan/serialize/WriterToUTF8.java,Java,,83,17,126,226
/jdk1.4.2_19/org/apache/xalan/serialize/WriterToUTF8Buffered.java,Java,,184,49,180,413
/jdk1.4.2_19/org/apache/xalan/templates/AbsPathChecker.java,Java,,30,6,81,117
/jdk1.4.2_19/org/apache/xalan/templates/AVT.java,Java,,344,101,197,642
/jdk1.4.2_19/org/apache/xalan/templates/AVTPart.java,Java,,19,11,103,133
/jdk1.4.2_19/org/apache/xalan/templates/AVTPartSimple.java,Java,,27,10,101,138
/jdk1.4.2_19/org/apache/xalan/templates/AVTPartXPath.java,Java,,51,13,126,190
/jdk1.4.2_19/org/apache/xalan/templates/Constants.java,Java,,307,44,168,519
/jdk1.4.2_19/org/apache/xalan/templates/DecimalFormatProperties.java,Java,,122,39,269,430
/jdk1.4.2_19/org/apache/xalan/templates/ElemApplyImport.java,Java,,48,14,97,159
/jdk1.4.2_19/org/apache/xalan/templates/ElemApplyTemplates.java,Java,,251,55,178,484
/jdk1.4.2_19/org/apache/xalan/templates/ElemAttribute.java,Java,,115,26,171,312
/jdk1.4.2_19/org/apache/xalan/templates/ElemAttributeSet.java,Java,,68,25,124,217
/jdk1.4.2_19/org/apache/xalan/templates/ElemCallTemplate.java,Java,,171,39,189,399
/jdk1.4.2_19/org/apache/xalan/templates/ElemChoose.java,Java,,93,38,111,242
/jdk1.4.2_19/org/apache/xalan/templates/ElemComment.java,Java,,67,16,111,194
/jdk1.4.2_19/org/apache/xalan/templates/ElemCopy.java,Java,,73,18,102,193
/jdk1.4.2_19/org/apache/xalan/templates/ElemCopyOf.java,Java,,127,33,133,293
/jdk1.4.2_19/org/apache/xalan/templates/ElemElement.java,Java,,197,61,201,459
/jdk1.4.2_19/org/apache/xalan/templates/ElemEmpty.java,Java,,9,5,65,79
/jdk1.4.2_19/org/apache/xalan/templates/ElemExsltFuncResult.java,Java,,51,10,32,93
/jdk1.4.2_19/org/apache/xalan/templates/ElemExsltFunction.java,Java,,86,26,130,242
/jdk1.4.2_19/org/apache/xalan/templates/ElemExtensionCall.java,Java,,178,50,155,383
/jdk1.4.2_19/org/apache/xalan/templates/ElemExtensionDecl.java,Java,,141,30,245,416
/jdk1.4.2_19/org/apache/xalan/templates/ElemExtensionScript.java,Java,,29,10,99,138
/jdk1.4.2_19/org/apache/xalan/templates/ElemFallback.java,Java,,42,14,104,160
/jdk1.4.2_19/org/apache/xalan/templates/ElemForEach.java,Java,,239,73,243,555
/jdk1.4.2_19/org/apache/xalan/templates/ElemIf.java,Java,,67,26,133,226
/jdk1.4.2_19/org/apache/xalan/templates/ElemLiteralResult.java,Java,,315,100,357,772
/jdk1.4.2_19/org/apache/xalan/templates/ElemMessage.java,Java,,41,16,116,173
/jdk1.4.2_19/org/apache/xalan/templates/ElemNumber.java,Java,,1141,317,765,2223
/jdk1.4.2_19/org/apache/xalan/templates/ElemOtherwise.java,Java,,17,6,76,99
/jdk1.4.2_19/org/apache/xalan/templates/ElemParam.java,Java,,47,17,107,171
/jdk1.4.2_19/org/apache/xalan/templates/ElemPI.java,Java,,98,30,144,272
/jdk1.4.2_19/org/apache/xalan/templates/ElemSort.java,Java,,89,26,271,386
/jdk1.4.2_19/org/apache/xalan/templates/ElemTemplate.java,Java,,127,46,289,462
/jdk1.4.2_19/org/apache/xalan/templates/ElemTemplateElement.java,Java,,732,226,746,1704
/jdk1.4.2_19/org/apache/xalan/templates/ElemText.java,Java,,41,16,136,193
/jdk1.4.2_19/org/apache/xalan/templates/ElemTextLiteral.java,Java,,82,24,166,272
/jdk1.4.2_19/org/apache/xalan/templates/ElemUnknown.java,Java,,23,9,69,101
/jdk1.4.2_19/org/apache/xalan/templates/ElemUse.java,Java,,73,24,152,249
/jdk1.4.2_19/org/apache/xalan/templates/ElemValueOf.java,Java,,148,41,191,380
/jdk1.4.2_19/org/apache/xalan/templates/ElemVariable.java,Java,,214,69,277,560
/jdk1.4.2_19/org/apache/xalan/templates/ElemVariablePsuedo.java,Java,,17,8,23,48
/jdk1.4.2_19/org/apache/xalan/templates/ElemWhen.java,Java,,41,13,113,167
/jdk1.4.2_19/org/apache/xalan/templates/ElemWithParam.java,Java,,100,31,151,282
/jdk1.4.2_19/org/apache/xalan/templates/FuncDocument.java,Java,,257,63,186,506
/jdk1.4.2_19/org/apache/xalan/templates/FuncFormatNumb.java,Java,,97,31,102,230
/jdk1.4.2_19/org/apache/xalan/templates/FuncKey.java,Java,,89,24,81,194
/jdk1.4.2_19/org/apache/xalan/templates/KeyDeclaration.java,Java,,52,15,144,211
/jdk1.4.2_19/org/apache/xalan/templates/NamespaceAlias.java,Java,,49,16,129,194
/jdk1.4.2_19/org/apache/xalan/templates/OutputProperties.java,Java,,510,128,484,1122
/jdk1.4.2_19/org/apache/xalan/templates/RedundentExprEliminator.java,Java,,910,129,435,1474
/jdk1.4.2_19/org/apache/xalan/templates/Stylesheet.java,Java,,581,213,753,1547
/jdk1.4.2_19/org/apache/xalan/templates/StylesheetComposed.java,Java,,149,57,192,398
/jdk1.4.2_19/org/apache/xalan/templates/StylesheetRoot.java,Java,,547,186,602,1335
/jdk1.4.2_19/org/apache/xalan/templates/TemplateList.java,Java,,560,108,289,957
/jdk1.4.2_19/org/apache/xalan/templates/TemplateSubPatternAssociation.java,Java,,87,32,167,286
/jdk1.4.2_19/org/apache/xalan/templates/VarNameCollector.java,Java,,27,9,24,60
/jdk1.4.2_19/org/apache/xalan/templates/WhiteSpaceInfo.java,Java,,24,12,91,127
/jdk1.4.2_19/org/apache/xalan/templates/XMLNSDecl.java,Java,,26,9,87,122
/jdk1.4.2_19/org/apache/xalan/templates/XSLTVisitable.java,Java,,5,2,13,20
/jdk1.4.2_19/org/apache/xalan/templates/XSLTVisitor.java,Java,,38,14,113,165
/jdk1.4.2_19/org/apache/xalan/templates/XUnresolvedVariable.java,Java,,74,23,133,230
/jdk1.4.2_19/org/apache/xalan/templates/XUnresolvedVariableSimple.java,Java,,27,10,27,64
/jdk1.4.2_19/org/apache/xalan/trace/EndSelectionEvent.java,Java,,15,5,17,37
/jdk1.4.2_19/org/apache/xalan/trace/GenerateEvent.java,Java,,62,32,163,257
/jdk1.4.2_19/org/apache/xalan/trace/PrintTraceListener.java,Java,,202,44,138,384
/jdk1.4.2_19/org/apache/xalan/trace/SelectionEvent.java,Java,,26,11,90,127
/jdk1.4.2_19/org/apache/xalan/trace/TraceListener.java,Java,,8,5,82,95
/jdk1.4.2_19/org/apache/xalan/trace/TraceListenerEx.java,Java,,5,3,68,76
/jdk1.4.2_19/org/apache/xalan/trace/TraceListenerEx2.java,Java,,5,1,66,72
/jdk1.4.2_19/org/apache/xalan/trace/TraceManager.java,Java,,153,47,151,351
/jdk1.4.2_19/org/apache/xalan/trace/TracerEvent.java,Java,,74,25,103,202
/jdk1.4.2_19/org/apache/xalan/transformer/ClonerToResultTree.java,Java,,83,12,176,271
/jdk1.4.2_19/org/apache/xalan/transformer/Counter.java,Java,,46,26,127,199
/jdk1.4.2_19/org/apache/xalan/transformer/CountersTable.java,Java,,85,38,123,246
/jdk1.4.2_19/org/apache/xalan/transformer/DecimalToRoman.java,Java,,16,7,75,98
/jdk1.4.2_19/org/apache/xalan/transformer/KeyIterator.java,Java,,64,21,107,192
/jdk1.4.2_19/org/apache/xalan/transformer/KeyManager.java,Java,,61,17,78,156
/jdk1.4.2_19/org/apache/xalan/transformer/KeyRefIterator.java,Java,,90,23,92,205
/jdk1.4.2_19/org/apache/xalan/transformer/KeyTable.java,Java,,139,28,130,297
/jdk1.4.2_19/org/apache/xalan/transformer/MsgMgr.java,Java,,92,30,236,358
/jdk1.4.2_19/org/apache/xalan/transformer/NodeSorter.java,Java,,250,86,282,618
/jdk1.4.2_19/org/apache/xalan/transformer/NodeSortKey.java,Java,,49,22,96,167
/jdk1.4.2_19/org/apache/xalan/transformer/NumeratorFormatter.java,Java,,147,51,178,376
/jdk1.4.2_19/org/apache/xalan/transformer/QueuedEvents.java,Java,,56,30,125,211
/jdk1.4.2_19/org/apache/xalan/transformer/ResultNameSpace.java,Java,,12,5,72,89
/jdk1.4.2_19/org/apache/xalan/transformer/ResultTreeHandler.java,Java,,891,279,758,1928
/jdk1.4.2_19/org/apache/xalan/transformer/SerializerSwitcher.java,Java,,97,33,113,243
/jdk1.4.2_19/org/apache/xalan/transformer/StackGuard.java,Java,,75,20,131,226
/jdk1.4.2_19/org/apache/xalan/transformer/TransformerClient.java,Java,,5,2,72,79
/jdk1.4.2_19/org/apache/xalan/transformer/TransformerHandlerImpl.java,Java,,476,138,491,1105
/jdk1.4.2_19/org/apache/xalan/transformer/TransformerIdentityImpl.java,Java,,586,148,690,1424
/jdk1.4.2_19/org/apache/xalan/transformer/TransformerImpl.java,Java,,1626,456,1416,3498
/jdk1.4.2_19/org/apache/xalan/transformer/TransformSnapshot.java,Java,,4,2,4,10
/jdk1.4.2_19/org/apache/xalan/transformer/TransformSnapshotImpl.java,Java,,119,50,134,303
/jdk1.4.2_19/org/apache/xalan/transformer/TransformState.java,Java,,16,11,128,155
/jdk1.4.2_19/org/apache/xalan/transformer/TrAXFilter.java,Java,,121,25,72,218
/jdk1.4.2_19/org/apache/xalan/transformer/TreeWalker2Result.java,Java,,84,22,96,202
/jdk1.4.2_19/org/apache/xalan/transformer/XalanProperties.java,Java,,6,2,62,70
/jdk1.4.2_19/org/apache/xalan/transformer/XSLInfiniteLoopException.java,Java,,12,3,70,85
/jdk1.4.2_19/org/apache/xalan/Version.java,Java,,39,10,139,188
/jdk1.4.2_19/org/apache/xalan/xslt/EnvironmentCheck.java,Java,,759,160,456,1375
/jdk1.4.2_19/org/apache/xalan/xslt/Process.java,Java,,891,123,170,1184
/jdk1.4.2_19/org/apache/xml/dtm/Axis.java,Java,,49,25,149,223
/jdk1.4.2_19/org/apache/xml/dtm/DTM.java,Java,,93,93,818,1004
/jdk1.4.2_19/org/apache/xml/dtm/DTMAxisIterator.java,Java,,15,12,105,132
/jdk1.4.2_19/org/apache/xml/dtm/DTMAxisTraverser.java,Java,,14,5,133,152
/jdk1.4.2_19/org/apache/xml/dtm/DTMConfigurationException.java,Java,,25,8,47,80
/jdk1.4.2_19/org/apache/xml/dtm/DTMDOMException.java,Java,,12,2,75,89
/jdk1.4.2_19/org/apache/xml/dtm/DTMException.java,Java,,167,64,120,351
/jdk1.4.2_19/org/apache/xml/dtm/DTMFilter.java,Java,,21,20,183,224
/jdk1.4.2_19/org/apache/xml/dtm/DTMIterator.java,Java,,32,33,315,380
/jdk1.4.2_19/org/apache/xml/dtm/DTMManager.java,Java,,198,69,317,584
/jdk1.4.2_19/org/apache/xml/dtm/DTMWSFilter.java,Java,,8,5,23,36
/jdk1.4.2_19/org/apache/xml/dtm/ref/ChunkedIntArray.java,Java,,148,23,174,345
/jdk1.4.2_19/org/apache/xml/dtm/ref/CoroutineManager.java,Java,,92,23,266,381
/jdk1.4.2_19/org/apache/xml/dtm/ref/CoroutineParser.java,Java,,17,14,149,180
/jdk1.4.2_19/org/apache/xml/dtm/ref/CustomStringPool.java,Java,,33,6,86,125
/jdk1.4.2_19/org/apache/xml/dtm/ref/dom2dtm/DOM2DTM.java,Java,,879,193,697,1769
/jdk1.4.2_19/org/apache/xml/dtm/ref/dom2dtm/DOM2DTMdefaultNamespaceDeclarationNode.java,Java,,54,7,78,139
/jdk1.4.2_19/org/apache/xml/dtm/ref/DTMAxisIteratorBase.java,Java,,83,38,170,291
/jdk1.4.2_19/org/apache/xml/dtm/ref/DTMDefaultBase.java,Java,,893,268,990,2151
/jdk1.4.2_19/org/apache/xml/dtm/ref/DTMDefaultBaseIterators.java,Java,,884,311,735,1930
/jdk1.4.2_19/org/apache/xml/dtm/ref/DTMDefaultBaseTraversers.java,Java,,725,212,802,1739
/jdk1.4.2_19/org/apache/xml/dtm/ref/DTMDocumentImpl.java,Java,,724,240,1485,2449
/jdk1.4.2_19/org/apache/xml/dtm/ref/DTMManagerDefault.java,Java,,419,115,408,942
/jdk1.4.2_19/org/apache/xml/dtm/ref/DTMNamedNodeMap.java,Java,,84,27,213,324
/jdk1.4.2_19/org/apache/xml/dtm/ref/DTMNodeIterator.java,Java,,62,18,136,216
/jdk1.4.2_19/org/apache/xml/dtm/ref/DTMNodeList.java,Java,,64,9,122,195
/jdk1.4.2_19/org/apache/xml/dtm/ref/DTMNodeProxy.java,Java,,469,130,781,1380
/jdk1.4.2_19/org/apache/xml/dtm/ref/DTMSafeStringPool.java,Java,,61,13,72,146
/jdk1.4.2_19/org/apache/xml/dtm/ref/DTMStringPool.java,Java,,96,23,99,218
/jdk1.4.2_19/org/apache/xml/dtm/ref/DTMTreeWalker.java,Java,,238,57,149,444
/jdk1.4.2_19/org/apache/xml/dtm/ref/ExpandedNameTable.java,Java,,144,34,184,362
/jdk1.4.2_19/org/apache/xml/dtm/ref/IncrementalSAXSource.java,Java,,14,11,102,127
/jdk1.4.2_19/org/apache/xml/dtm/ref/IncrementalSAXSource_Filter.java,Java,,427,62,351,840
/jdk1.4.2_19/org/apache/xml/dtm/ref/NodeLocator.java,Java,,39,9,97,145
/jdk1.4.2_19/org/apache/xml/dtm/ref/sax2dtm/SAX2DTM.java,Java,,998,326,1028,2352
/jdk1.4.2_19/org/apache/xml/dtm/ref/sax2dtm/SAX2RTFDTM.java,Java,,126,35,201,362
/jdk1.4.2_19/org/apache/xml/utils/AttList.java,Java,,86,24,182,292
/jdk1.4.2_19/org/apache/xml/utils/BoolStack.java,Java,,69,28,133,230
/jdk1.4.2_19/org/apache/xml/utils/CharKey.java,Java,,24,9,33,66
/jdk1.4.2_19/org/apache/xml/utils/DefaultErrorHandler.java,Java,,123,30,196,349
/jdk1.4.2_19/org/apache/xml/utils/DOMBuilder.java,Java,,224,78,450,752
/jdk1.4.2_19/org/apache/xml/utils/ElemDesc.java,Java,,56,36,133,225
/jdk1.4.2_19/org/apache/xml/utils/FastStringBuffer.java,Java,,570,196,610,1376
/jdk1.4.2_19/org/apache/xml/utils/Hashtree2Node.java,Java,,70,12,96,178
/jdk1.4.2_19/org/apache/xml/utils/IntStack.java,Java,,86,25,136,247
/jdk1.4.2_19/org/apache/xml/utils/IntVector.java,Java,,177,70,208,455
/jdk1.4.2_19/org/apache/xml/utils/ListingErrorHandler.java,Java,,237,63,302,602
/jdk1.4.2_19/org/apache/xml/utils/MutableAttrListImpl.java,Java,,51,20,106,177
/jdk1.4.2_19/org/apache/xml/utils/NameSpace.java,Java,,13,6,75,94
/jdk1.4.2_19/org/apache/xml/utils/NamespaceSupport2.java,Java,,276,85,424,785
/jdk1.4.2_19/org/apache/xml/utils/NodeConsumer.java,Java,,6,3,67,76
/jdk1.4.2_19/org/apache/xml/utils/NodeVector.java,Java,,337,133,308,778
/jdk1.4.2_19/org/apache/xml/utils/NSInfo.java,Java,,33,15,98,146
/jdk1.4.2_19/org/apache/xml/utils/ObjectPool.java,Java,,69,26,118,213
/jdk1.4.2_19/org/apache/xml/utils/ObjectStack.java,Java,,88,27,136,251
/jdk1.4.2_19/org/apache/xml/utils/ObjectVector.java,Java,,183,74,210,467
/jdk1.4.2_19/org/apache/xml/utils/PrefixResolver.java,Java,,8,5,95,108
/jdk1.4.2_19/org/apache/xml/utils/PrefixResolverDefault.java,Java,,65,18,106,189
/jdk1.4.2_19/org/apache/xml/utils/QName.java,Java,,332,95,310,737
/jdk1.4.2_19/org/apache/xml/utils/RawCharacterHandler.java,Java,,6,2,70,78
/jdk1.4.2_19/org/apache/xml/utils/res/XResourceBundle.java,Java,,74,18,93,185
/jdk1.4.2_19/org/apache/xml/utils/res/XResourceBundleBase.java,Java,,7,4,75,86
/jdk1.4.2_19/org/apache/xml/utils/res/XResources_cy.java,Java,,45,13,78,136
/jdk1.4.2_19/org/apache/xml/utils/res/XResources_de.java,Java,,29,9,87,125
/jdk1.4.2_19/org/apache/xml/utils/res/XResources_el.java,Java,,45,13,83,141
/jdk1.4.2_19/org/apache/xml/utils/res/XResources_en.java,Java,,29,9,86,124
/jdk1.4.2_19/org/apache/xml/utils/res/XResources_es.java,Java,,29,9,87,125
/jdk1.4.2_19/org/apache/xml/utils/res/XResources_fr.java,Java,,29,9,87,125
/jdk1.4.2_19/org/apache/xml/utils/res/XResources_he.java,Java,,37,11,82,130
/jdk1.4.2_19/org/apache/xml/utils/res/XResources_hy.java,Java,,46,10,81,137
/jdk1.4.2_19/org/apache/xml/utils/res/XResources_it.java,Java,,29,9,87,125
/jdk1.4.2_19/org/apache/xml/utils/res/XResources_ja_JP_A.java,Java,,43,11,81,135
/jdk1.4.2_19/org/apache/xml/utils/res/XResources_ja_JP_HA.java,Java,,43,11,81,135
/jdk1.4.2_19/org/apache/xml/utils/res/XResources_ja_JP_HI.java,Java,,43,11,82,136
/jdk1.4.2_19/org/apache/xml/utils/res/XResources_ja_JP_I.java,Java,,43,11,82,136
/jdk1.4.2_19/org/apache/xml/utils/res/XResources_ka.java,Java,,46,10,78,134
/jdk1.4.2_19/org/apache/xml/utils/res/XResources_ko.java,Java,,37,11,81,129
/jdk1.4.2_19/org/apache/xml/utils/res/XResources_sv.java,Java,,29,9,88,126
/jdk1.4.2_19/org/apache/xml/utils/res/XResources_zh_CN.java,Java,,39,11,79,129
/jdk1.4.2_19/org/apache/xml/utils/res/XResources_zh_TW.java,Java,,39,11,79,129
/jdk1.4.2_19/org/apache/xml/utils/SAXSourceLocator.java,Java,,51,13,141,205
/jdk1.4.2_19/org/apache/xml/utils/SerializableLocatorImpl.java,Java,,51,33,177,261
/jdk1.4.2_19/org/apache/xml/utils/StringBufferPool.java,Java,,15,4,77,96
/jdk1.4.2_19/org/apache/xml/utils/StringToIntTable.java,Java,,82,35,115,232
/jdk1.4.2_19/org/apache/xml/utils/StringToStringTable.java,Java,,104,40,134,278
/jdk1.4.2_19/org/apache/xml/utils/StringToStringTableVector.java,Java,,80,32,123,235
/jdk1.4.2_19/org/apache/xml/utils/StringVector.java,Java,,91,41,126,258
/jdk1.4.2_19/org/apache/xml/utils/SuballocatedByteVector.java,Java,,267,37,230,534
/jdk1.4.2_19/org/apache/xml/utils/SuballocatedIntVector.java,Java,,271,41,241,553
/jdk1.4.2_19/org/apache/xml/utils/SystemIDResolver.java,Java,,111,28,134,273
/jdk1.4.2_19/org/apache/xml/utils/TreeWalker.java,Java,,300,71,152,523
/jdk1.4.2_19/org/apache/xml/utils/Trie.java,Java,,65,23,93,181
/jdk1.4.2_19/org/apache/xml/utils/UnImplNode.java,Java,,394,209,702,1305
/jdk1.4.2_19/org/apache/xml/utils/URI.java,Java,,903,221,565,1689
/jdk1.4.2_19/org/apache/xml/utils/WrappedRuntimeException.java,Java,,19,9,81,109
/jdk1.4.2_19/org/apache/xml/utils/WrongParserException.java,Java,,8,2,65,75
/jdk1.4.2_19/org/apache/xml/utils/XMLChar.java,Java,,308,76,297,681
/jdk1.4.2_19/org/apache/xml/utils/XMLCharacterRecognizer.java,Java,,41,15,89,145
/jdk1.4.2_19/org/apache/xml/utils/XMLString.java,Java,,47,40,624,711
/jdk1.4.2_19/org/apache/xml/utils/XMLStringFactory.java,Java,,10,5,92,107
/jdk1.4.2_19/org/apache/xpath/Arg.java,Java,,97,27,170,294
/jdk1.4.2_19/org/apache/xpath/axes/AttributeIterator.java,Java,,28,10,80,118
/jdk1.4.2_19/org/apache/xpath/axes/AxesWalker.java,Java,,274,80,273,627
/jdk1.4.2_19/org/apache/xpath/axes/BasicTestIterator.java,Java,,111,28,67,206
/jdk1.4.2_19/org/apache/xpath/axes/ChildIterator.java,Java,,46,16,98,160
/jdk1.4.2_19/org/apache/xpath/axes/ChildTestIterator.java,Java,,49,23,130,202
/jdk1.4.2_19/org/apache/xpath/axes/ContextNodeList.java,Java,,18,14,140,172
/jdk1.4.2_19/org/apache/xpath/axes/DescendantIterator.java,Java,,223,48,148,419
/jdk1.4.2_19/org/apache/xpath/axes/FilterExprIterator.java,Java,,98,27,78,203
/jdk1.4.2_19/org/apache/xpath/axes/FilterExprIteratorSimple.java,Java,,160,40,105,305
/jdk1.4.2_19/org/apache/xpath/axes/FilterExprWalker.java,Java,,157,44,188,389
/jdk1.4.2_19/org/apache/xpath/axes/HasPositionalPredChecker.java,Java,,55,12,37,104
/jdk1.4.2_19/org/apache/xpath/axes/IteratorPool.java,Java,,52,14,35,101
/jdk1.4.2_19/org/apache/xpath/axes/LocPathIterator.java,Java,,368,124,589,1081
/jdk1.4.2_19/org/apache/xpath/axes/MatchPatternIterator.java,Java,,196,43,117,356
/jdk1.4.2_19/org/apache/xpath/axes/NodeSequence.java,Java,,385,69,231,685
/jdk1.4.2_19/org/apache/xpath/axes/OneStepIterator.java,Java,,119,39,90,248
/jdk1.4.2_19/org/apache/xpath/axes/OneStepIteratorForward.java,Java,,48,20,83,151
/jdk1.4.2_19/org/apache/xpath/axes/PathComponent.java,Java,,5,3,64,72
/jdk1.4.2_19/org/apache/xpath/axes/PredicatedNodeTest.java,Java,,336,77,215,628
/jdk1.4.2_19/org/apache/xpath/axes/ReverseAxesWalker.java,Java,,111,40,131,282
/jdk1.4.2_19/org/apache/xpath/axes/RTFIterator.java,Java,,9,4,9,22
/jdk1.4.2_19/org/apache/xpath/axes/SelfIteratorNoPredicate.java,Java,,49,17,53,119
/jdk1.4.2_19/org/apache/xpath/axes/SubContextList.java,Java,,7,5,78,90
/jdk1.4.2_19/org/apache/xpath/axes/UnionChildIterator.java,Java,,62,12,91,165
/jdk1.4.2_19/org/apache/xpath/axes/UnionPathIterator.java,Java,,318,76,231,625
/jdk1.4.2_19/org/apache/xpath/axes/WalkerFactory.java,Java,,1245,196,429,1870
/jdk1.4.2_19/org/apache/xpath/axes/WalkingIterator.java,Java,,167,53,124,344
/jdk1.4.2_19/org/apache/xpath/axes/WalkingIteratorSorted.java,Java,,75,18,159,252
/jdk1.4.2_19/org/apache/xpath/CachedXPathAPI.java,Java,,93,32,247,372
/jdk1.4.2_19/org/apache/xpath/compiler/Compiler.java,Java,,592,142,534,1268
/jdk1.4.2_19/org/apache/xpath/compiler/FuncLoader.java,Java,,52,19,94,165
/jdk1.4.2_19/org/apache/xpath/compiler/FunctionTable.java,Java,,133,60,141,334
/jdk1.4.2_19/org/apache/xpath/compiler/Keywords.java,Java,,218,69,128,415
/jdk1.4.2_19/org/apache/xpath/compiler/Lexer.java,Java,,422,89,182,693
/jdk1.4.2_19/org/apache/xpath/compiler/OpCodes.java,Java,,68,66,534,668
/jdk1.4.2_19/org/apache/xpath/compiler/OpMap.java,Java,,192,57,242,491
/jdk1.4.2_19/org/apache/xpath/compiler/OpMapVector.java,Java,,35,22,94,151
/jdk1.4.2_19/org/apache/xpath/compiler/PsuedoNames.java,Java,,10,7,78,95
/jdk1.4.2_19/org/apache/xpath/compiler/XPathDumper.java,Java,,8,3,60,71
/jdk1.4.2_19/org/apache/xpath/compiler/XPathParser.java,Java,,1254,395,746,2395
/jdk1.4.2_19/org/apache/xpath/DOM2Helper.java,Java,,94,34,228,356
/jdk1.4.2_19/org/apache/xpath/domapi/XPathEvaluatorImpl.java,Java,,62,25,209,296
/jdk1.4.2_19/org/apache/xpath/domapi/XPathExpressionImpl.java,Java,,60,19,139,218
/jdk1.4.2_19/org/apache/xpath/domapi/XPathNamespaceImpl.java,Java,,91,34,175,300
/jdk1.4.2_19/org/apache/xpath/domapi/XPathNSResolverImpl.java,Java,,12,6,79,97
/jdk1.4.2_19/org/apache/xpath/domapi/XPathResultImpl.java,Java,,220,56,236,512
/jdk1.4.2_19/org/apache/xpath/DOMHelper.java,Java,,604,172,568,1344
/jdk1.4.2_19/org/apache/xpath/DOMOrder.java,Java,,5,2,70,77
/jdk1.4.2_19/org/apache/xpath/Expression.java,Java,,198,59,376,633
/jdk1.4.2_19/org/apache/xpath/ExpressionNode.java,Java,,10,6,72,88
/jdk1.4.2_19/org/apache/xpath/ExpressionOwner.java,Java,,6,5,14,25
/jdk1.4.2_19/org/apache/xpath/ExtensionsProvider.java,Java,,12,5,70,87
/jdk1.4.2_19/org/apache/xpath/FoundIndex.java,Java,,5,2,65,72
/jdk1.4.2_19/org/apache/xpath/functions/FuncBoolean.java,Java,,13,6,69,88
/jdk1.4.2_19/org/apache/xpath/functions/FuncCeiling.java,Java,,14,6,69,89
/jdk1.4.2_19/org/apache/xpath/functions/FuncConcat.java,Java,,33,11,84,128
/jdk1.4.2_19/org/apache/xpath/functions/FuncContains.java,Java,,18,9,70,97
/jdk1.4.2_19/org/apache/xpath/functions/FuncCount.java,Java,,20,9,80,109
/jdk1.4.2_19/org/apache/xpath/functions/FuncCurrent.java,Java,,44,13,88,145
/jdk1.4.2_19/org/apache/xpath/functions/FuncDoclocation.java,Java,,29,10,74,113
/jdk1.4.2_19/org/apache/xpath/functions/FuncExtElementAvailable.java,Java,,58,10,70,138
/jdk1.4.2_19/org/apache/xpath/functions/FuncExtFunction.java,Java,,133,44,177,354
/jdk1.4.2_19/org/apache/xpath/functions/FuncExtFunctionAvailable.java,Java,,52,10,72,134
/jdk1.4.2_19/org/apache/xpath/functions/FuncFalse.java,Java,,16,7,73,96
/jdk1.4.2_19/org/apache/xpath/functions/FuncFloor.java,Java,,13,5,69,87
/jdk1.4.2_19/org/apache/xpath/functions/FuncGenerateId.java,Java,,20,7,76,103
/jdk1.4.2_19/org/apache/xpath/functions/FuncId.java,Java,,85,25,85,195
/jdk1.4.2_19/org/apache/xpath/functions/FuncLang.java,Java,,41,12,71,124
/jdk1.4.2_19/org/apache/xpath/functions/FuncLast.java,Java,,45,14,92,151
/jdk1.4.2_19/org/apache/xpath/functions/FuncLocalPart.java,Java,,23,8,70,101
/jdk1.4.2_19/org/apache/xpath/functions/FuncNamespace.java,Java,,38,12,72,122
/jdk1.4.2_19/org/apache/xpath/functions/FuncNormalizeSpace.java,Java,,43,10,81,134
/jdk1.4.2_19/org/apache/xpath/functions/FuncNot.java,Java,,13,5,69,87
/jdk1.4.2_19/org/apache/xpath/functions/FuncNumber.java,Java,,15,6,69,90
/jdk1.4.2_19/org/apache/xpath/functions/FuncPosition.java,Java,,63,16,98,177
/jdk1.4.2_19/org/apache/xpath/functions/FuncQname.java,Java,,29,9,71,109
/jdk1.4.2_19/org/apache/xpath/functions/FuncRound.java,Java,,14,5,69,88
/jdk1.4.2_19/org/apache/xpath/functions/FuncStartsWith.java,Java,,14,5,69,88
/jdk1.4.2_19/org/apache/xpath/functions/FuncString.java,Java,,15,6,69,90
/jdk1.4.2_19/org/apache/xpath/functions/FuncStringLength.java,Java,,15,6,69,90
/jdk1.4.2_19/org/apache/xpath/functions/FuncSubstring.java,Java,,62,16,86,164
/jdk1.4.2_19/org/apache/xpath/functions/FuncSubstringAfter.java,Java,,19,8,69,96
/jdk1.4.2_19/org/apache/xpath/functions/FuncSubstringBefore.java,Java,,17,7,69,93
/jdk1.4.2_19/org/apache/xpath/functions/FuncSum.java,Java,,29,10,68,107
/jdk1.4.2_19/org/apache/xpath/functions/FuncSystemProperty.java,Java,,123,35,92,250
/jdk1.4.2_19/org/apache/xpath/functions/Function.java,Java,,49,15,118,182
/jdk1.4.2_19/org/apache/xpath/functions/Function2Args.java,Java,,79,22,120,221
/jdk1.4.2_19/org/apache/xpath/functions/Function3Args.java,Java,,79,22,119,220
/jdk1.4.2_19/org/apache/xpath/functions/FunctionDef1Arg.java,Java,,69,16,123,208
/jdk1.4.2_19/org/apache/xpath/functions/FunctionMultiArgs.java,Java,,122,30,122,274
/jdk1.4.2_19/org/apache/xpath/functions/FunctionOneArg.java,Java,,71,21,119,211
/jdk1.4.2_19/org/apache/xpath/functions/FuncTranslate.java,Java,,36,13,80,129
/jdk1.4.2_19/org/apache/xpath/functions/FuncTrue.java,Java,,16,7,73,96
/jdk1.4.2_19/org/apache/xpath/functions/FuncUnparsedEntityURI.java,Java,,21,9,69,99
/jdk1.4.2_19/org/apache/xpath/functions/WrongNumberArgsException.java,Java,,8,3,67,78
/jdk1.4.2_19/org/apache/xpath/NodeSet.java,Java,,596,233,580,1409
/jdk1.4.2_19/org/apache/xpath/NodeSetDTM.java,Java,,399,169,727,1295
/jdk1.4.2_19/org/apache/xpath/objects/XBoolean.java,Java,,58,22,125,205
/jdk1.4.2_19/org/apache/xpath/objects/XBooleanStatic.java,Java,,24,8,77,109
/jdk1.4.2_19/org/apache/xpath/objects/XMLStringFactoryImpl.java,Java,,29,8,100,137
/jdk1.4.2_19/org/apache/xpath/objects/XNodeSet.java,Java,,407,102,491,1000
/jdk1.4.2_19/org/apache/xpath/objects/XNodeSetForDOM.java,Java,,55,15,37,107
/jdk1.4.2_19/org/apache/xpath/objects/XNull.java,Java,,40,14,117,171
/jdk1.4.2_19/org/apache/xpath/objects/XNumber.java,Java,,129,42,293,464
/jdk1.4.2_19/org/apache/xpath/objects/XObject.java,Java,,282,106,404,792
/jdk1.4.2_19/org/apache/xpath/objects/XObjectFactory.java,Java,,105,11,23,139
/jdk1.4.2_19/org/apache/xpath/objects/XRTreeFrag.java,Java,,178,37,210,425
/jdk1.4.2_19/org/apache/xpath/objects/XRTreeFragSelectWrapper.java,Java,,63,18,61,142
/jdk1.4.2_19/org/apache/xpath/objects/XString.java,Java,,406,113,692,1211
/jdk1.4.2_19/org/apache/xpath/objects/XStringForChars.java,Java,,73,25,103,201
/jdk1.4.2_19/org/apache/xpath/objects/XStringForFSB.java,Java,,401,126,504,1031
/jdk1.4.2_19/org/apache/xpath/operations/And.java,Java,,26,9,79,114
/jdk1.4.2_19/org/apache/xpath/operations/Bool.java,Java,,21,6,78,105
/jdk1.4.2_19/org/apache/xpath/operations/Div.java,Java,,17,6,79,102
/jdk1.4.2_19/org/apache/xpath/operations/Equals.java,Java,,23,6,81,110
/jdk1.4.2_19/org/apache/xpath/operations/Gt.java,Java,,11,3,70,84
/jdk1.4.2_19/org/apache/xpath/operations/Gte.java,Java,,12,3,70,85
/jdk1.4.2_19/org/apache/xpath/operations/Lt.java,Java,,11,3,70,84
/jdk1.4.2_19/org/apache/xpath/operations/Lte.java,Java,,11,3,70,84
/jdk1.4.2_19/org/apache/xpath/operations/Minus.java,Java,,17,6,80,103
/jdk1.4.2_19/org/apache/xpath/operations/Mod.java,Java,,17,6,79,102
/jdk1.4.2_19/org/apache/xpath/operations/Mult.java,Java,,17,5,79,101
/jdk1.4.2_19/org/apache/xpath/operations/Neg.java,Java,,16,6,78,100
/jdk1.4.2_19/org/apache/xpath/operations/NotEquals.java,Java,,11,3,70,84
/jdk1.4.2_19/org/apache/xpath/operations/Number.java,Java,,19,7,78,104
/jdk1.4.2_19/org/apache/xpath/operations/Operation.java,Java,,93,27,130,250
/jdk1.4.2_19/org/apache/xpath/operations/Or.java,Java,,26,9,79,114
/jdk1.4.2_19/org/apache/xpath/operations/Plus.java,Java,,17,6,79,102
/jdk1.4.2_19/org/apache/xpath/operations/Quo.java,Java,,11,4,72,87
/jdk1.4.2_19/org/apache/xpath/operations/String.java,Java,,10,3,69,82
/jdk1.4.2_19/org/apache/xpath/operations/UnaryOperation.java,Java,,60,22,119,201
/jdk1.4.2_19/org/apache/xpath/operations/Variable.java,Java,,199,57,176,432
/jdk1.4.2_19/org/apache/xpath/operations/VariableSafeAbsRef.java,Java,,26,6,24,56
/jdk1.4.2_19/org/apache/xpath/patterns/ContextMatchStepPattern.java,Java,,94,26,97,217
/jdk1.4.2_19/org/apache/xpath/patterns/FunctionPattern.java,Java,,114,41,135,290
/jdk1.4.2_19/org/apache/xpath/patterns/NodeTest.java,Java,,299,103,329,731
/jdk1.4.2_19/org/apache/xpath/patterns/NodeTestFilter.java,Java,,5,2,68,75
/jdk1.4.2_19/org/apache/xpath/patterns/StepPattern.java,Java,,602,137,352,1091
/jdk1.4.2_19/org/apache/xpath/patterns/UnionPattern.java,Java,,117,30,109,256
/jdk1.4.2_19/org/apache/xpath/res/XPATHErrorResourceBundle.java,Java,,63,6,69,138
/jdk1.4.2_19/org/apache/xpath/res/XPATHErrorResources.java,Java,,552,320,507,1379
/jdk1.4.2_19/org/apache/xpath/res/XPATHErrorResources_de.java,Java,,431,560,397,1388
/jdk1.4.2_19/org/apache/xpath/res/XPATHErrorResources_en.java,Java,,4,2,61,67
/jdk1.4.2_19/org/apache/xpath/res/XPATHErrorResources_es.java,Java,,432,560,398,1390
/jdk1.4.2_19/org/apache/xpath/res/XPATHErrorResources_fr.java,Java,,433,561,397,1391
/jdk1.4.2_19/org/apache/xpath/res/XPATHErrorResources_it.java,Java,,441,568,404,1413
/jdk1.4.2_19/org/apache/xpath/res/XPATHErrorResources_ja.java,Java,,436,561,492,1489
/jdk1.4.2_19/org/apache/xpath/res/XPATHErrorResources_ko.java,Java,,645,571,437,1653
/jdk1.4.2_19/org/apache/xpath/res/XPATHErrorResources_sv.java,Java,,433,562,397,1392
/jdk1.4.2_19/org/apache/xpath/res/XPATHErrorResources_zh_CN.java,Java,,435,562,396,1393
/jdk1.4.2_19/org/apache/xpath/res/XPATHErrorResources_zh_TW.java,Java,,433,559,396,1388
/jdk1.4.2_19/org/apache/xpath/SourceTree.java,Java,,11,5,73,89
/jdk1.4.2_19/org/apache/xpath/SourceTreeManager.java,Java,,204,61,191,456
/jdk1.4.2_19/org/apache/xpath/VariableStack.java,Java,,180,78,293,551
/jdk1.4.2_19/org/apache/xpath/WhitespaceStrippingElementMatcher.java,Java,,9,3,21,33
/jdk1.4.2_19/org/apache/xpath/XPath.java,Java,,265,69,291,625
/jdk1.4.2_19/org/apache/xpath/XPathAPI.java,Java,,81,27,221,329
/jdk1.4.2_19/org/apache/xpath/XPathContext.java,Java,,545,157,629,1331
/jdk1.4.2_19/org/apache/xpath/XPathException.java,Java,,154,54,142,350
/jdk1.4.2_19/org/apache/xpath/XPathFactory.java,Java,,8,5,75,88
/jdk1.4.2_19/org/apache/xpath/XPathProcessorException.java,Java,,12,4,73,89
/jdk1.4.2_19/org/apache/xpath/XPathVisitable.java,Java,,5,2,71,78
/jdk1.4.2_19/org/apache/xpath/XPathVisitor.java,Java,,63,17,159,239
/jdk1.4.2_19/org/ietf/jgss/ChannelBinding.java,Java,,63,23,109,195
/jdk1.4.2_19/org/ietf/jgss/GSSContext.java,Java,,62,45,1223,1330
/jdk1.4.2_19/org/ietf/jgss/GSSCredential.java,Java,,21,24,309,354
/jdk1.4.2_19/org/ietf/jgss/GSSException.java,Java,,107,59,218,384
/jdk1.4.2_19/org/ietf/jgss/GSSManager.java,Java,,38,19,655,712
/jdk1.4.2_19/org/ietf/jgss/GSSName.java,Java,,27,19,231,277
/jdk1.4.2_19/org/ietf/jgss/MessageProp.java,Java,,67,21,130,218
/jdk1.4.2_19/org/ietf/jgss/Oid.java,Java,,83,23,93,199
/jdk1.4.2_19/org/omg/CORBA/Any.java,Java,,79,58,565,702
/jdk1.4.2_19/org/omg/CORBA/AnyHolder.java,Java,,21,9,60,90
/jdk1.4.2_19/org/omg/CORBA/AnySeqHelper.java,Java,,46,10,27,83
/jdk1.4.2_19/org/omg/CORBA/AnySeqHolder.java,Java,,24,9,15,48
/jdk1.4.2_19/org/omg/CORBA/ARG_IN.java,Java,,4,4,29,37
/jdk1.4.2_19/org/omg/CORBA/ARG_INOUT.java,Java,,4,7,30,41
/jdk1.4.2_19/org/omg/CORBA/ARG_OUT.java,Java,,4,6,29,39
/jdk1.4.2_19/org/omg/CORBA/BAD_CONTEXT.java,Java,,15,7,47,69
/jdk1.4.2_19/org/omg/CORBA/BAD_INV_ORDER.java,Java,,15,8,45,68
/jdk1.4.2_19/org/omg/CORBA/BAD_OPERATION.java,Java,,15,7,43,65
/jdk1.4.2_19/org/omg/CORBA/BAD_PARAM.java,Java,,15,7,52,74
/jdk1.4.2_19/org/omg/CORBA/BAD_POLICY.java,Java,,4,2,16,22
/jdk1.4.2_19/org/omg/CORBA/BAD_POLICY_TYPE.java,Java,,4,2,16,22
/jdk1.4.2_19/org/omg/CORBA/BAD_POLICY_VALUE.java,Java,,4,2,18,24
/jdk1.4.2_19/org/omg/CORBA/BAD_TYPECODE.java,Java,,15,7,44,66
/jdk1.4.2_19/org/omg/CORBA/BooleanHolder.java,Java,,21,9,62,92
/jdk1.4.2_19/org/omg/CORBA/BooleanSeqHelper.java,Java,,44,10,27,81
/jdk1.4.2_19/org/omg/CORBA/BooleanSeqHolder.java,Java,,24,9,15,48
/jdk1.4.2_19/org/omg/CORBA/Bounds.java,Java,,9,5,22,36
/jdk1.4.2_19/org/omg/CORBA/ByteHolder.java,Java,,21,10,62,93
/jdk1.4.2_19/org/omg/CORBA/CharHolder.java,Java,,21,10,63,94
/jdk1.4.2_19/org/omg/CORBA/CharSeqHelper.java,Java,,44,10,27,81
/jdk1.4.2_19/org/omg/CORBA/CharSeqHolder.java,Java,,24,9,15,48
/jdk1.4.2_19/org/omg/CORBA/COMM_FAILURE.java,Java,,15,7,51,73
/jdk1.4.2_19/org/omg/CORBA/CompletionStatus.java,Java,,27,13,85,125
/jdk1.4.2_19/org/omg/CORBA/CompletionStatusHelper.java,Java,,37,10,14,61
/jdk1.4.2_19/org/omg/CORBA/Context.java,Java,,11,19,198,228
/jdk1.4.2_19/org/omg/CORBA/ContextList.java,Java,,7,12,70,89
/jdk1.4.2_19/org/omg/CORBA/CTX_RESTRICT_SCOPE.java,Java,,4,4,28,36
/jdk1.4.2_19/org/omg/CORBA/Current.java,Java,,4,3,23,30
/jdk1.4.2_19/org/omg/CORBA/CurrentHelper.java,Java,,43,11,15,69
/jdk1.4.2_19/org/omg/CORBA/CurrentHolder.java,Java,,24,8,15,47
/jdk1.4.2_19/org/omg/CORBA/CurrentOperations.java,Java,,4,3,16,23
/jdk1.4.2_19/org/omg/CORBA/CustomMarshal.java,Java,,7,3,30,40
/jdk1.4.2_19/org/omg/CORBA/DataInputStream.java,Java,,36,34,258,328
/jdk1.4.2_19/org/omg/CORBA/DataOutputStream.java,Java,,36,34,196,266
/jdk1.4.2_19/org/omg/CORBA/DATA_CONVERSION.java,Java,,15,7,46,68
/jdk1.4.2_19/org/omg/CORBA/DefinitionKind.java,Java,,114,113,256,483
/jdk1.4.2_19/org/omg/CORBA/DefinitionKindHelper.java,Java,,37,10,15,62
/jdk1.4.2_19/org/omg/CORBA/DomainManager.java,Java,,5,4,17,26
/jdk1.4.2_19/org/omg/CORBA/DomainManagerOperations.java,Java,,5,4,23,32
/jdk1.4.2_19/org/omg/CORBA/DoubleHolder.java,Java,,21,12,59,92
/jdk1.4.2_19/org/omg/CORBA/DoubleSeqHelper.java,Java,,44,10,27,81
/jdk1.4.2_19/org/omg/CORBA/DoubleSeqHolder.java,Java,,24,9,15,48
/jdk1.4.2_19/org/omg/CORBA/DynamicImplementation.java,Java,,10,7,12,29
/jdk1.4.2_19/org/omg/CORBA/DynAny.java,Java,,89,68,556,713
/jdk1.4.2_19/org/omg/CORBA/DynAnyPackage/Invalid.java,Java,,10,5,18,33
/jdk1.4.2_19/org/omg/CORBA/DynAnyPackage/InvalidSeq.java,Java,,10,5,19,34
/jdk1.4.2_19/org/omg/CORBA/DynAnyPackage/InvalidValue.java,Java,,10,4,22,36
/jdk1.4.2_19/org/omg/CORBA/DynAnyPackage/TypeMismatch.java,Java,,10,5,19,34
/jdk1.4.2_19/org/omg/CORBA/DynArray.java,Java,,7,6,24,37
/jdk1.4.2_19/org/omg/CORBA/DynEnum.java,Java,,8,7,30,45
/jdk1.4.2_19/org/omg/CORBA/DynFixed.java,Java,,7,5,26,38
/jdk1.4.2_19/org/omg/CORBA/DynSequence.java,Java,,9,7,37,53
/jdk1.4.2_19/org/omg/CORBA/DynStruct.java,Java,,9,7,35,51
/jdk1.4.2_19/org/omg/CORBA/DynUnion.java,Java,,12,11,52,75
/jdk1.4.2_19/org/omg/CORBA/DynValue.java,Java,,8,6,39,53
/jdk1.4.2_19/org/omg/CORBA/Environment.java,Java,,6,10,28,44
/jdk1.4.2_19/org/omg/CORBA/ExceptionList.java,Java,,9,11,73,93
/jdk1.4.2_19/org/omg/CORBA/FieldNameHelper.java,Java,,40,10,14,64
/jdk1.4.2_19/org/omg/CORBA/FixedHolder.java,Java,,21,11,49,81
/jdk1.4.2_19/org/omg/CORBA/FloatHolder.java,Java,,21,9,58,88
/jdk1.4.2_19/org/omg/CORBA/FloatSeqHelper.java,Java,,44,10,27,81
/jdk1.4.2_19/org/omg/CORBA/FloatSeqHolder.java,Java,,24,9,15,48
/jdk1.4.2_19/org/omg/CORBA/FREE_MEM.java,Java,,15,6,43,64
/jdk1.4.2_19/org/omg/CORBA/IdentifierHelper.java,Java,,40,10,15,65
/jdk1.4.2_19/org/omg/CORBA/IDLType.java,Java,,4,6,24,34
/jdk1.4.2_19/org/omg/CORBA/IDLTypeHelper.java,Java,,51,11,15,77
/jdk1.4.2_19/org/omg/CORBA/IDLTypeOperations.java,Java,,5,4,31,40
/jdk1.4.2_19/org/omg/CORBA/IMP_LIMIT.java,Java,,15,7,46,68
/jdk1.4.2_19/org/omg/CORBA/INITIALIZE.java,Java,,15,6,49,70
/jdk1.4.2_19/org/omg/CORBA/INTERNAL.java,Java,,15,6,49,70
/jdk1.4.2_19/org/omg/CORBA/INTF_REPOS.java,Java,,15,6,42,63
/jdk1.4.2_19/org/omg/CORBA/IntHolder.java,Java,,21,9,65,95
/jdk1.4.2_19/org/omg/CORBA/INVALID_TRANSACTION.java,Java,,15,6,44,65
/jdk1.4.2_19/org/omg/CORBA/INV_FLAG.java,Java,,15,6,44,65
/jdk1.4.2_19/org/omg/CORBA/INV_IDENT.java,Java,,15,6,45,66
/jdk1.4.2_19/org/omg/CORBA/INV_OBJREF.java,Java,,15,6,51,72
/jdk1.4.2_19/org/omg/CORBA/INV_POLICY.java,Java,,15,6,42,63
/jdk1.4.2_19/org/omg/CORBA/IRObject.java,Java,,5,2,17,24
/jdk1.4.2_19/org/omg/CORBA/IRObjectOperations.java,Java,,6,6,53,65
/jdk1.4.2_19/org/omg/CORBA/LocalObject.java,Java,,89,39,361,489
/jdk1.4.2_19/org/omg/CORBA/LongHolder.java,Java,,21,10,60,91
/jdk1.4.2_19/org/omg/CORBA/LongLongSeqHelper.java,Java,,44,10,27,81
/jdk1.4.2_19/org/omg/CORBA/LongLongSeqHolder.java,Java,,24,9,15,48
/jdk1.4.2_19/org/omg/CORBA/LongSeqHelper.java,Java,,44,10,27,81
/jdk1.4.2_19/org/omg/CORBA/LongSeqHolder.java,Java,,24,9,15,48
/jdk1.4.2_19/org/omg/CORBA/MARSHAL.java,Java,,15,6,49,70
/jdk1.4.2_19/org/omg/CORBA/NamedValue.java,Java,,6,10,92,108
/jdk1.4.2_19/org/omg/CORBA/NameValuePair.java,Java,,10,8,27,45
/jdk1.4.2_19/org/omg/CORBA/NameValuePairHelper.java,Java,,67,10,14,91
/jdk1.4.2_19/org/omg/CORBA/NO_IMPLEMENT.java,Java,,15,6,48,69
/jdk1.4.2_19/org/omg/CORBA/NO_MEMORY.java,Java,,15,7,41,63
/jdk1.4.2_19/org/omg/CORBA/NO_PERMISSION.java,Java,,15,6,41,62
/jdk1.4.2_19/org/omg/CORBA/NO_RESOURCES.java,Java,,15,6,42,63
/jdk1.4.2_19/org/omg/CORBA/NO_RESPONSE.java,Java,,15,6,42,63
/jdk1.4.2_19/org/omg/CORBA/NVList.java,Java,,9,16,136,161
/jdk1.4.2_19/org/omg/CORBA/Object.java,Java,,25,35,204,264
/jdk1.4.2_19/org/omg/CORBA/ObjectHelper.java,Java,,37,11,19,67
/jdk1.4.2_19/org/omg/CORBA/ObjectHolder.java,Java,,21,9,64,94
/jdk1.4.2_19/org/omg/CORBA/OBJECT_NOT_EXIST.java,Java,,15,6,51,72
/jdk1.4.2_19/org/omg/CORBA/OBJ_ADAPTER.java,Java,,15,6,46,67
/jdk1.4.2_19/org/omg/CORBA/OctetSeqHelper.java,Java,,44,10,27,81
/jdk1.4.2_19/org/omg/CORBA/OctetSeqHolder.java,Java,,24,9,15,48
/jdk1.4.2_19/org/omg/CORBA/OMGVMCID.java,Java,,4,5,16,25
/jdk1.4.2_19/org/omg/CORBA/ORB.java,Java,,293,103,909,1305
/jdk1.4.2_19/org/omg/CORBA/ORBPackage/InconsistentTypeCode.java,Java,,10,4,20,34
/jdk1.4.2_19/org/omg/CORBA/ORBPackage/InvalidName.java,Java,,9,4,23,36
/jdk1.4.2_19/org/omg/CORBA/ParameterMode.java,Java,,29,8,14,51
/jdk1.4.2_19/org/omg/CORBA/ParameterModeHelper.java,Java,,37,11,14,62
/jdk1.4.2_19/org/omg/CORBA/ParameterModeHolder.java,Java,,24,9,14,47
/jdk1.4.2_19/org/omg/CORBA/PERSIST_STORE.java,Java,,15,6,41,62
/jdk1.4.2_19/org/omg/CORBA/Policy.java,Java,,4,3,22,29
/jdk1.4.2_19/org/omg/CORBA/PolicyError.java,Java,,15,7,31,53
/jdk1.4.2_19/org/omg/CORBA/PolicyErrorCodeHelper.java,Java,,40,11,11,62
/jdk1.4.2_19/org/omg/CORBA/PolicyErrorHelper.java,Java,,62,11,12,85
/jdk1.4.2_19/org/omg/CORBA/PolicyErrorHolder.java,Java,,24,9,10,43
/jdk1.4.2_19/org/omg/CORBA/PolicyHelper.java,Java,,51,11,15,77
/jdk1.4.2_19/org/omg/CORBA/PolicyHolder.java,Java,,24,8,15,47
/jdk1.4.2_19/org/omg/CORBA/PolicyListHelper.java,Java,,46,10,15,71
/jdk1.4.2_19/org/omg/CORBA/PolicyListHolder.java,Java,,24,9,15,48
/jdk1.4.2_19/org/omg/CORBA/PolicyOperations.java,Java,,7,6,41,54
/jdk1.4.2_19/org/omg/CORBA/PolicyTypeHelper.java,Java,,40,11,16,67
/jdk1.4.2_19/org/omg/CORBA/portable/ApplicationException.java,Java,,16,6,24,46
/jdk1.4.2_19/org/omg/CORBA/portable/BoxedValueHelper.java,Java,,7,2,14,23
/jdk1.4.2_19/org/omg/CORBA/portable/CustomValue.java,Java,,4,5,20,29
/jdk1.4.2_19/org/omg/CORBA/portable/Delegate.java,Java,,84,30,275,389
/jdk1.4.2_19/org/omg/CORBA/portable/IDLEntity.java,Java,,3,3,13,19
/jdk1.4.2_19/org/omg/CORBA/portable/IndirectionException.java,Java,,9,4,39,52
/jdk1.4.2_19/org/omg/CORBA/portable/InputStream.java,Java,,67,12,223,302
/jdk1.4.2_19/org/omg/CORBA/portable/InvokeHandler.java,Java,,6,4,45,55
/jdk1.4.2_19/org/omg/CORBA/portable/ObjectImpl.java,Java,,155,38,324,517
/jdk1.4.2_19/org/omg/CORBA/portable/OutputStream.java,Java,,65,11,193,269
/jdk1.4.2_19/org/omg/CORBA/portable/RemarshalException.java,Java,,6,2,20,28
/jdk1.4.2_19/org/omg/CORBA/portable/ResponseHandler.java,Java,,5,3,28,36
/jdk1.4.2_19/org/omg/CORBA/portable/ServantObject.java,Java,,5,4,22,31
/jdk1.4.2_19/org/omg/CORBA/portable/Streamable.java,Java,,7,4,32,43
/jdk1.4.2_19/org/omg/CORBA/portable/StreamableValue.java,Java,,3,5,17,25
/jdk1.4.2_19/org/omg/CORBA/portable/UnknownException.java,Java,,8,1,33,42
/jdk1.4.2_19/org/omg/CORBA/portable/ValueBase.java,Java,,4,2,29,35
/jdk1.4.2_19/org/omg/CORBA/portable/ValueFactory.java,Java,,5,3,33,41
/jdk1.4.2_19/org/omg/CORBA/Principal.java,Java,,9,5,24,38
/jdk1.4.2_19/org/omg/CORBA/PrincipalHolder.java,Java,,21,11,44,76
/jdk1.4.2_19/org/omg/CORBA/PRIVATE_MEMBER.java,Java,,4,2,23,29
/jdk1.4.2_19/org/omg/CORBA/PUBLIC_MEMBER.java,Java,,4,2,24,30
/jdk1.4.2_19/org/omg/CORBA/RepositoryIdHelper.java,Java,,40,10,16,66
/jdk1.4.2_19/org/omg/CORBA/Request.java,Java,,25,50,209,284
/jdk1.4.2_19/org/omg/CORBA/ServerRequest.java,Java,,35,19,239,293
/jdk1.4.2_19/org/omg/CORBA/ServiceDetail.java,Java,,11,5,35,51
/jdk1.4.2_19/org/omg/CORBA/ServiceDetailHelper.java,Java,,50,6,11,67
/jdk1.4.2_19/org/omg/CORBA/ServiceInformation.java,Java,,13,7,24,44
/jdk1.4.2_19/org/omg/CORBA/ServiceInformationHelper.java,Java,,58,7,11,76
/jdk1.4.2_19/org/omg/CORBA/ServiceInformationHolder.java,Java,,20,10,63,93
/jdk1.4.2_19/org/omg/CORBA/SetOverrideType.java,Java,,25,11,69,105
/jdk1.4.2_19/org/omg/CORBA/SetOverrideTypeHelper.java,Java,,37,10,14,61
/jdk1.4.2_19/org/omg/CORBA/ShortHolder.java,Java,,21,9,63,93
/jdk1.4.2_19/org/omg/CORBA/ShortSeqHelper.java,Java,,44,10,27,81
/jdk1.4.2_19/org/omg/CORBA/ShortSeqHolder.java,Java,,24,9,15,48
/jdk1.4.2_19/org/omg/CORBA/StringHolder.java,Java,,21,9,62,92
/jdk1.4.2_19/org/omg/CORBA/StringSeqHelper.java,Java,,46,11,7,64
/jdk1.4.2_19/org/omg/CORBA/StringSeqHolder.java,Java,,24,10,7,41
/jdk1.4.2_19/org/omg/CORBA/StringValueHelper.java,Java,,73,14,35,122
/jdk1.4.2_19/org/omg/CORBA/StructMember.java,Java,,12,8,51,71
/jdk1.4.2_19/org/omg/CORBA/StructMemberHelper.java,Java,,74,10,15,99
/jdk1.4.2_19/org/omg/CORBA/SystemException.java,Java,,45,11,45,101
/jdk1.4.2_19/org/omg/CORBA/TCKind.java,Java,,148,79,310,537
/jdk1.4.2_19/org/omg/CORBA/TRANSACTION_REQUIRED.java,Java,,15,6,41,62
/jdk1.4.2_19/org/omg/CORBA/TRANSACTION_ROLLEDBACK.java,Java,,15,6,45,66
/jdk1.4.2_19/org/omg/CORBA/TRANSIENT.java,Java,,15,6,44,65
/jdk1.4.2_19/org/omg/CORBA/TypeCode.java,Java,,29,39,449,517
/jdk1.4.2_19/org/omg/CORBA/TypeCodeHolder.java,Java,,21,9,63,93
/jdk1.4.2_19/org/omg/CORBA/TypeCodePackage/BadKind.java,Java,,9,4,25,38
/jdk1.4.2_19/org/omg/CORBA/TypeCodePackage/Bounds.java,Java,,9,5,24,38
/jdk1.4.2_19/org/omg/CORBA/ULongLongSeqHelper.java,Java,,44,10,27,81
/jdk1.4.2_19/org/omg/CORBA/ULongLongSeqHolder.java,Java,,24,9,15,48
/jdk1.4.2_19/org/omg/CORBA/ULongSeqHelper.java,Java,,44,10,27,81
/jdk1.4.2_19/org/omg/CORBA/ULongSeqHolder.java,Java,,24,9,15,48
/jdk1.4.2_19/org/omg/CORBA/UnionMember.java,Java,,14,9,54,77
/jdk1.4.2_19/org/omg/CORBA/UnionMemberHelper.java,Java,,81,10,15,106
/jdk1.4.2_19/org/omg/CORBA/UNKNOWN.java,Java,,15,6,50,71
/jdk1.4.2_19/org/omg/CORBA/UnknownUserException.java,Java,,11,7,31,49
/jdk1.4.2_19/org/omg/CORBA/UnknownUserExceptionHelper.java,Java,,61,10,17,88
/jdk1.4.2_19/org/omg/CORBA/UnknownUserExceptionHolder.java,Java,,24,8,15,47
/jdk1.4.2_19/org/omg/CORBA/UNSUPPORTED_POLICY.java,Java,,4,2,17,23
/jdk1.4.2_19/org/omg/CORBA/UNSUPPORTED_POLICY_VALUE.java,Java,,4,2,18,24
/jdk1.4.2_19/org/omg/CORBA/UserException.java,Java,,9,5,27,41
/jdk1.4.2_19/org/omg/CORBA/UShortSeqHelper.java,Java,,44,10,27,81
/jdk1.4.2_19/org/omg/CORBA/UShortSeqHolder.java,Java,,24,9,15,48
/jdk1.4.2_19/org/omg/CORBA/ValueBaseHelper.java,Java,,37,12,22,71
/jdk1.4.2_19/org/omg/CORBA/ValueBaseHolder.java,Java,,21,10,58,89
/jdk1.4.2_19/org/omg/CORBA/ValueMember.java,Java,,20,12,71,103
/jdk1.4.2_19/org/omg/CORBA/ValueMemberHelper.java,Java,,106,10,15,131
/jdk1.4.2_19/org/omg/CORBA/VersionSpecHelper.java,Java,,40,10,15,65
/jdk1.4.2_19/org/omg/CORBA/VisibilityHelper.java,Java,,40,11,16,67
/jdk1.4.2_19/org/omg/CORBA/VM_ABSTRACT.java,Java,,4,2,16,22
/jdk1.4.2_19/org/omg/CORBA/VM_CUSTOM.java,Java,,4,2,16,22
/jdk1.4.2_19/org/omg/CORBA/VM_NONE.java,Java,,4,4,19,27
/jdk1.4.2_19/org/omg/CORBA/VM_TRUNCATABLE.java,Java,,4,2,18,24
/jdk1.4.2_19/org/omg/CORBA/WCharSeqHelper.java,Java,,44,10,27,81
/jdk1.4.2_19/org/omg/CORBA/WCharSeqHolder.java,Java,,24,9,15,48
/jdk1.4.2_19/org/omg/CORBA/WrongTransaction.java,Java,,9,4,25,38
/jdk1.4.2_19/org/omg/CORBA/WrongTransactionHelper.java,Java,,54,9,17,80
/jdk1.4.2_19/org/omg/CORBA/WrongTransactionHolder.java,Java,,24,8,15,47
/jdk1.4.2_19/org/omg/CORBA/WStringSeqHelper.java,Java,,46,11,7,64
/jdk1.4.2_19/org/omg/CORBA/WStringSeqHolder.java,Java,,24,10,7,41
/jdk1.4.2_19/org/omg/CORBA/WStringValueHelper.java,Java,,73,16,38,127
/jdk1.4.2_19/org/omg/CORBA/_IDLTypeStub.java,Java,,90,13,32,135
/jdk1.4.2_19/org/omg/CORBA/_PolicyStub.java,Java,,89,14,43,146
/jdk1.4.2_19/org/omg/CORBA_2_3/ORB.java,Java,,23,13,40,76
/jdk1.4.2_19/org/omg/CORBA_2_3/portable/Delegate.java,Java,,6,4,29,39
/jdk1.4.2_19/org/omg/CORBA_2_3/portable/InputStream.java,Java,,24,11,61,96
/jdk1.4.2_19/org/omg/CORBA_2_3/portable/ObjectImpl.java,Java,,10,6,28,44
/jdk1.4.2_19/org/omg/CORBA_2_3/portable/OutputStream.java,Java,,18,9,49,76
/jdk1.4.2_19/org/omg/CosNaming/Binding.java,Java,,14,8,10,32
/jdk1.4.2_19/org/omg/CosNaming/BindingHelper.java,Java,,68,11,9,88
/jdk1.4.2_19/org/omg/CosNaming/BindingHolder.java,Java,,24,9,9,42
/jdk1.4.2_19/org/omg/CosNaming/BindingIterator.java,Java,,4,4,14,22
/jdk1.4.2_19/org/omg/CosNaming/BindingIteratorHelper.java,Java,,53,12,14,79
/jdk1.4.2_19/org/omg/CosNaming/BindingIteratorHolder.java,Java,,24,9,14,47
/jdk1.4.2_19/org/omg/CosNaming/BindingIteratorOperations.java,Java,,7,7,30,44
/jdk1.4.2_19/org/omg/CosNaming/BindingIteratorPOA.java,Java,,70,21,32,123
/jdk1.4.2_19/org/omg/CosNaming/BindingListHelper.java,Java,,46,11,9,66
/jdk1.4.2_19/org/omg/CosNaming/BindingListHolder.java,Java,,24,10,9,43
/jdk1.4.2_19/org/omg/CosNaming/BindingType.java,Java,,27,8,10,45
/jdk1.4.2_19/org/omg/CosNaming/BindingTypeHelper.java,Java,,37,11,10,58
/jdk1.4.2_19/org/omg/CosNaming/BindingTypeHolder.java,Java,,24,9,10,43
/jdk1.4.2_19/org/omg/CosNaming/IstringHelper.java,Java,,40,10,6,56
/jdk1.4.2_19/org/omg/CosNaming/NameComponent.java,Java,,14,7,23,44
/jdk1.4.2_19/org/omg/CosNaming/NameComponentHelper.java,Java,,68,11,23,102
/jdk1.4.2_19/org/omg/CosNaming/NameComponentHolder.java,Java,,24,9,23,56
/jdk1.4.2_19/org/omg/CosNaming/NameHelper.java,Java,,46,11,9,66
/jdk1.4.2_19/org/omg/CosNaming/NameHolder.java,Java,,24,10,9,43
/jdk1.4.2_19/org/omg/CosNaming/NamingContext.java,Java,,4,4,15,23
/jdk1.4.2_19/org/omg/CosNaming/NamingContextExt.java,Java,,4,4,19,27
/jdk1.4.2_19/org/omg/CosNaming/NamingContextExtHelper.java,Java,,53,12,19,84
/jdk1.4.2_19/org/omg/CosNaming/NamingContextExtHolder.java,Java,,24,9,19,52
/jdk1.4.2_19/org/omg/CosNaming/NamingContextExtOperations.java,Java,,8,8,67,83
/jdk1.4.2_19/org/omg/CosNaming/NamingContextExtPackage/AddressHelper.java,Java,,40,11,9,60
/jdk1.4.2_19/org/omg/CosNaming/NamingContextExtPackage/InvalidAddress.java,Java,,12,7,6,25
/jdk1.4.2_19/org/omg/CosNaming/NamingContextExtPackage/InvalidAddressHelper.java,Java,,54,10,8,72
/jdk1.4.2_19/org/omg/CosNaming/NamingContextExtPackage/InvalidAddressHolder.java,Java,,24,8,6,38
/jdk1.4.2_19/org/omg/CosNaming/NamingContextExtPackage/StringNameHelper.java,Java,,40,11,10,61
/jdk1.4.2_19/org/omg/CosNaming/NamingContextExtPackage/URLStringHelper.java,Java,,40,11,10,61
/jdk1.4.2_19/org/omg/CosNaming/NamingContextExtPOA.java,Java,,294,43,230,567
/jdk1.4.2_19/org/omg/CosNaming/NamingContextHelper.java,Java,,53,12,15,80
/jdk1.4.2_19/org/omg/CosNaming/NamingContextHolder.java,Java,,24,9,15,48
/jdk1.4.2_19/org/omg/CosNaming/NamingContextOperations.java,Java,,14,14,176,204
/jdk1.4.2_19/org/omg/CosNaming/NamingContextPackage/AlreadyBound.java,Java,,12,7,6,25
/jdk1.4.2_19/org/omg/CosNaming/NamingContextPackage/AlreadyBoundHelper.java,Java,,54,10,8,72
/jdk1.4.2_19/org/omg/CosNaming/NamingContextPackage/AlreadyBoundHolder.java,Java,,24,8,6,38
/jdk1.4.2_19/org/omg/CosNaming/NamingContextPackage/CannotProceed.java,Java,,22,8,6,36
/jdk1.4.2_19/org/omg/CosNaming/NamingContextPackage/CannotProceedHelper.java,Java,,70,10,8,88
/jdk1.4.2_19/org/omg/CosNaming/NamingContextPackage/CannotProceedHolder.java,Java,,24,8,6,38
/jdk1.4.2_19/org/omg/CosNaming/NamingContextPackage/InvalidName.java,Java,,12,7,6,25
/jdk1.4.2_19/org/omg/CosNaming/NamingContextPackage/InvalidNameHelper.java,Java,,54,10,8,72
/jdk1.4.2_19/org/omg/CosNaming/NamingContextPackage/InvalidNameHolder.java,Java,,24,8,6,38
/jdk1.4.2_19/org/omg/CosNaming/NamingContextPackage/NotEmpty.java,Java,,12,7,6,25
/jdk1.4.2_19/org/omg/CosNaming/NamingContextPackage/NotEmptyHelper.java,Java,,54,10,8,72
/jdk1.4.2_19/org/omg/CosNaming/NamingContextPackage/NotEmptyHolder.java,Java,,24,8,6,38
/jdk1.4.2_19/org/omg/CosNaming/NamingContextPackage/NotFound.java,Java,,22,8,6,36
/jdk1.4.2_19/org/omg/CosNaming/NamingContextPackage/NotFoundHelper.java,Java,,70,10,8,88
/jdk1.4.2_19/org/omg/CosNaming/NamingContextPackage/NotFoundHolder.java,Java,,24,8,6,38
/jdk1.4.2_19/org/omg/CosNaming/NamingContextPackage/NotFoundReason.java,Java,,29,8,9,46
/jdk1.4.2_19/org/omg/CosNaming/NamingContextPackage/NotFoundReasonHelper.java,Java,,37,11,9,57
/jdk1.4.2_19/org/omg/CosNaming/NamingContextPackage/NotFoundReasonHolder.java,Java,,24,9,9,42
/jdk1.4.2_19/org/omg/CosNaming/NamingContextPOA.java,Java,,223,35,178,436
/jdk1.4.2_19/org/omg/CosNaming/_BindingIteratorImplBase.java,Java,,71,3,16,90
/jdk1.4.2_19/org/omg/CosNaming/_BindingIteratorStub.java,Java,,82,14,31,127
/jdk1.4.2_19/org/omg/CosNaming/_NamingContextExtStub.java,Java,,367,36,229,632
/jdk1.4.2_19/org/omg/CosNaming/_NamingContextImplBase.java,Java,,370,3,16,389
/jdk1.4.2_19/org/omg/CosNaming/_NamingContextStub.java,Java,,271,28,177,476
/jdk1.4.2_19/org/omg/Dynamic/Parameter.java,Java,,14,7,11,32
/jdk1.4.2_19/org/omg/DynamicAny/AnySeqHelper.java,Java,,46,10,6,62
/jdk1.4.2_19/org/omg/DynamicAny/DynAny.java,Java,,4,4,73,81
/jdk1.4.2_19/org/omg/DynamicAny/DynAnyFactory.java,Java,,4,4,27,35
/jdk1.4.2_19/org/omg/DynamicAny/DynAnyFactoryHelper.java,Java,,53,12,27,92
/jdk1.4.2_19/org/omg/DynamicAny/DynAnyFactoryOperations.java,Java,,6,6,68,80
/jdk1.4.2_19/org/omg/DynamicAny/DynAnyFactoryPackage/InconsistentTypeCode.java,Java,,12,7,6,25
/jdk1.4.2_19/org/omg/DynamicAny/DynAnyFactoryPackage/InconsistentTypeCodeHelper.java,Java,,54,10,8,72
/jdk1.4.2_19/org/omg/DynamicAny/DynAnyHelper.java,Java,,53,12,73,138
/jdk1.4.2_19/org/omg/DynamicAny/DynAnyOperations.java,Java,,54,54,461,569
/jdk1.4.2_19/org/omg/DynamicAny/DynAnyPackage/InvalidValue.java,Java,,12,7,6,25
/jdk1.4.2_19/org/omg/DynamicAny/DynAnyPackage/InvalidValueHelper.java,Java,,54,10,8,72
/jdk1.4.2_19/org/omg/DynamicAny/DynAnyPackage/TypeMismatch.java,Java,,12,7,6,25
/jdk1.4.2_19/org/omg/DynamicAny/DynAnyPackage/TypeMismatchHelper.java,Java,,54,10,8,72
/jdk1.4.2_19/org/omg/DynamicAny/DynAnySeqHelper.java,Java,,46,10,6,62
/jdk1.4.2_19/org/omg/DynamicAny/DynArray.java,Java,,4,4,11,19
/jdk1.4.2_19/org/omg/DynamicAny/DynArrayHelper.java,Java,,53,12,11,76
/jdk1.4.2_19/org/omg/DynamicAny/DynArrayOperations.java,Java,,8,8,29,45
/jdk1.4.2_19/org/omg/DynamicAny/DynEnum.java,Java,,4,4,10,18
/jdk1.4.2_19/org/omg/DynamicAny/DynEnumHelper.java,Java,,53,12,10,75
/jdk1.4.2_19/org/omg/DynamicAny/DynEnumOperations.java,Java,,8,8,30,46
/jdk1.4.2_19/org/omg/DynamicAny/DynFixed.java,Java,,4,4,11,19
/jdk1.4.2_19/org/omg/DynamicAny/DynFixedHelper.java,Java,,53,12,11,76
/jdk1.4.2_19/org/omg/DynamicAny/DynFixedOperations.java,Java,,6,6,26,38
/jdk1.4.2_19/org/omg/DynamicAny/DynSequence.java,Java,,4,4,9,17
/jdk1.4.2_19/org/omg/DynamicAny/DynSequenceHelper.java,Java,,53,12,9,74
/jdk1.4.2_19/org/omg/DynamicAny/DynSequenceOperations.java,Java,,10,10,57,77
/jdk1.4.2_19/org/omg/DynamicAny/DynStruct.java,Java,,4,4,10,18
/jdk1.4.2_19/org/omg/DynamicAny/DynStructHelper.java,Java,,53,12,10,75
/jdk1.4.2_19/org/omg/DynamicAny/DynStructOperations.java,Java,,10,10,66,86
/jdk1.4.2_19/org/omg/DynamicAny/DynUnion.java,Java,,4,4,16,24
/jdk1.4.2_19/org/omg/DynamicAny/DynUnionHelper.java,Java,,53,12,16,81
/jdk1.4.2_19/org/omg/DynamicAny/DynUnionOperations.java,Java,,13,13,75,101
/jdk1.4.2_19/org/omg/DynamicAny/DynValue.java,Java,,4,4,18,26
/jdk1.4.2_19/org/omg/DynamicAny/DynValueBox.java,Java,,4,4,13,21
/jdk1.4.2_19/org/omg/DynamicAny/DynValueBoxOperations.java,Java,,8,8,37,53
/jdk1.4.2_19/org/omg/DynamicAny/DynValueCommon.java,Java,,4,4,9,17
/jdk1.4.2_19/org/omg/DynamicAny/DynValueCommonOperations.java,Java,,7,7,20,34
/jdk1.4.2_19/org/omg/DynamicAny/DynValueHelper.java,Java,,53,12,18,83
/jdk1.4.2_19/org/omg/DynamicAny/DynValueOperations.java,Java,,10,10,80,100
/jdk1.4.2_19/org/omg/DynamicAny/FieldNameHelper.java,Java,,40,10,6,56
/jdk1.4.2_19/org/omg/DynamicAny/NameDynAnyPair.java,Java,,14,9,15,38
/jdk1.4.2_19/org/omg/DynamicAny/NameDynAnyPairHelper.java,Java,,67,11,9,87
/jdk1.4.2_19/org/omg/DynamicAny/NameDynAnyPairSeqHelper.java,Java,,46,10,6,62
/jdk1.4.2_19/org/omg/DynamicAny/NameValuePair.java,Java,,14,9,15,38
/jdk1.4.2_19/org/omg/DynamicAny/NameValuePairHelper.java,Java,,67,11,9,87
/jdk1.4.2_19/org/omg/DynamicAny/NameValuePairSeqHelper.java,Java,,46,10,6,62
/jdk1.4.2_19/org/omg/DynamicAny/_DynAnyFactoryStub.java,Java,,47,15,69,131
/jdk1.4.2_19/org/omg/DynamicAny/_DynAnyStub.java,Java,,527,159,462,1148
/jdk1.4.2_19/org/omg/DynamicAny/_DynArrayStub.java,Java,,568,171,418,1157
/jdk1.4.2_19/org/omg/DynamicAny/_DynEnumStub.java,Java,,568,171,419,1158
/jdk1.4.2_19/org/omg/DynamicAny/_DynFixedStub.java,Java,,548,165,415,1128
/jdk1.4.2_19/org/omg/DynamicAny/_DynSequenceStub.java,Java,,588,177,446,1211
/jdk1.4.2_19/org/omg/DynamicAny/_DynStructStub.java,Java,,588,177,455,1220
/jdk1.4.2_19/org/omg/DynamicAny/_DynUnionStub.java,Java,,618,186,464,1268
/jdk1.4.2_19/org/omg/DynamicAny/_DynValueStub.java,Java,,619,186,480,1285
/jdk1.4.2_19/org/omg/IOP/Codec.java,Java,,4,4,17,25
/jdk1.4.2_19/org/omg/IOP/CodecFactory.java,Java,,4,4,11,19
/jdk1.4.2_19/org/omg/IOP/CodecFactoryHelper.java,Java,,46,12,11,69
/jdk1.4.2_19/org/omg/IOP/CodecFactoryOperations.java,Java,,5,5,19,29
/jdk1.4.2_19/org/omg/IOP/CodecFactoryPackage/UnknownEncoding.java,Java,,12,7,6,25
/jdk1.4.2_19/org/omg/IOP/CodecFactoryPackage/UnknownEncodingHelper.java,Java,,54,10,8,72
/jdk1.4.2_19/org/omg/IOP/CodecOperations.java,Java,,8,8,61,77
/jdk1.4.2_19/org/omg/IOP/CodecPackage/FormatMismatch.java,Java,,12,7,6,25
/jdk1.4.2_19/org/omg/IOP/CodecPackage/FormatMismatchHelper.java,Java,,54,10,8,72
/jdk1.4.2_19/org/omg/IOP/CodecPackage/InvalidTypeForEncoding.java,Java,,12,7,6,25
/jdk1.4.2_19/org/omg/IOP/CodecPackage/InvalidTypeForEncodingHelper.java,Java,,54,10,8,72
/jdk1.4.2_19/org/omg/IOP/CodecPackage/TypeMismatch.java,Java,,12,7,6,25
/jdk1.4.2_19/org/omg/IOP/CodecPackage/TypeMismatchHelper.java,Java,,54,10,8,72
/jdk1.4.2_19/org/omg/IOP/CodeSets.java,Java,,5,4,11,20
/jdk1.4.2_19/org/omg/IOP/ComponentIdHelper.java,Java,,40,11,10,61
/jdk1.4.2_19/org/omg/IOP/Encoding.java,Java,,16,10,32,58
/jdk1.4.2_19/org/omg/IOP/ENCODING_CDR_ENCAPS.java,Java,,5,4,10,19
/jdk1.4.2_19/org/omg/IOP/IOR.java,Java,,14,9,65,88
/jdk1.4.2_19/org/omg/IOP/IORHelper.java,Java,,72,11,60,143
/jdk1.4.2_19/org/omg/IOP/IORHolder.java,Java,,24,9,60,93
/jdk1.4.2_19/org/omg/IOP/MultipleComponentProfileHelper.java,Java,,46,11,7,64
/jdk1.4.2_19/org/omg/IOP/MultipleComponentProfileHolder.java,Java,,24,10,7,41
/jdk1.4.2_19/org/omg/IOP/ProfileIdHelper.java,Java,,40,11,7,58
/jdk1.4.2_19/org/omg/IOP/ServiceContext.java,Java,,14,9,13,36
/jdk1.4.2_19/org/omg/IOP/ServiceContextHelper.java,Java,,71,11,11,93
/jdk1.4.2_19/org/omg/IOP/ServiceContextHolder.java,Java,,24,9,11,44
/jdk1.4.2_19/org/omg/IOP/ServiceContextListHelper.java,Java,,46,11,7,64
/jdk1.4.2_19/org/omg/IOP/ServiceContextListHolder.java,Java,,24,10,7,41
/jdk1.4.2_19/org/omg/IOP/ServiceIdHelper.java,Java,,40,11,7,58
/jdk1.4.2_19/org/omg/IOP/TaggedComponent.java,Java,,14,9,44,67
/jdk1.4.2_19/org/omg/IOP/TaggedComponentHelper.java,Java,,71,11,42,124
/jdk1.4.2_19/org/omg/IOP/TaggedComponentHolder.java,Java,,24,9,42,75
/jdk1.4.2_19/org/omg/IOP/TaggedProfile.java,Java,,14,9,17,40
/jdk1.4.2_19/org/omg/IOP/TaggedProfileHelper.java,Java,,71,11,15,97
/jdk1.4.2_19/org/omg/IOP/TaggedProfileHolder.java,Java,,24,9,15,48
/jdk1.4.2_19/org/omg/IOP/TAG_ALTERNATE_IIOP_ADDRESS.java,Java,,5,4,32,41
/jdk1.4.2_19/org/omg/IOP/TAG_CODE_SETS.java,Java,,5,4,16,25
/jdk1.4.2_19/org/omg/IOP/TAG_INTERNET_IOP.java,Java,,5,4,31,40
/jdk1.4.2_19/org/omg/IOP/TAG_JAVA_CODEBASE.java,Java,,5,4,19,28
/jdk1.4.2_19/org/omg/IOP/TAG_MULTIPLE_COMPONENTS.java,Java,,5,4,17,26
/jdk1.4.2_19/org/omg/IOP/TAG_ORB_TYPE.java,Java,,5,4,24,33
/jdk1.4.2_19/org/omg/IOP/TAG_POLICIES.java,Java,,5,4,10,19
/jdk1.4.2_19/org/omg/IOP/TransactionService.java,Java,,5,4,11,20
/jdk1.4.2_19/org/omg/Messaging/SyncScopeHelper.java,Java,,40,11,7,58
/jdk1.4.2_19/org/omg/Messaging/SYNC_WITH_TRANSPORT.java,Java,,5,4,10,19
/jdk1.4.2_19/org/omg/PortableInterceptor/ClientRequestInfo.java,Java,,4,4,220,228
/jdk1.4.2_19/org/omg/PortableInterceptor/ClientRequestInfoOperations.java,Java,,13,13,319,345
/jdk1.4.2_19/org/omg/PortableInterceptor/ClientRequestInterceptor.java,Java,,4,4,22,30
/jdk1.4.2_19/org/omg/PortableInterceptor/ClientRequestInterceptorOperations.java,Java,,9,9,175,193
/jdk1.4.2_19/org/omg/PortableInterceptor/Current.java,Java,,4,4,23,31
/jdk1.4.2_19/org/omg/PortableInterceptor/CurrentHelper.java,Java,,46,12,23,81
/jdk1.4.2_19/org/omg/PortableInterceptor/CurrentOperations.java,Java,,6,6,52,64
/jdk1.4.2_19/org/omg/PortableInterceptor/ForwardRequest.java,Java,,19,9,9,37
/jdk1.4.2_19/org/omg/PortableInterceptor/ForwardRequestHelper.java,Java,,61,10,8,79
/jdk1.4.2_19/org/omg/PortableInterceptor/Interceptor.java,Java,,4,4,9,17
/jdk1.4.2_19/org/omg/PortableInterceptor/InterceptorOperations.java,Java,,6,6,38,50
/jdk1.4.2_19/org/omg/PortableInterceptor/InvalidSlot.java,Java,,12,7,6,25
/jdk1.4.2_19/org/omg/PortableInterceptor/InvalidSlotHelper.java,Java,,54,10,8,72
/jdk1.4.2_19/org/omg/PortableInterceptor/IORInfo.java,Java,,4,4,14,22
/jdk1.4.2_19/org/omg/PortableInterceptor/IORInfoOperations.java,Java,,7,7,59,73
/jdk1.4.2_19/org/omg/PortableInterceptor/IORInterceptor.java,Java,,4,4,20,28
/jdk1.4.2_19/org/omg/PortableInterceptor/IORInterceptorOperations.java,Java,,5,5,41,51
/jdk1.4.2_19/org/omg/PortableInterceptor/LOCATION_FORWARD.java,Java,,5,4,15,24
/jdk1.4.2_19/org/omg/PortableInterceptor/ORBInitializer.java,Java,,4,4,116,124
/jdk1.4.2_19/org/omg/PortableInterceptor/ORBInitializerOperations.java,Java,,6,6,144,156
/jdk1.4.2_19/org/omg/PortableInterceptor/ORBInitInfo.java,Java,,4,4,19,27
/jdk1.4.2_19/org/omg/PortableInterceptor/ORBInitInfoOperations.java,Java,,14,14,106,134
/jdk1.4.2_19/org/omg/PortableInterceptor/ORBInitInfoPackage/DuplicateName.java,Java,,19,9,9,37
/jdk1.4.2_19/org/omg/PortableInterceptor/ORBInitInfoPackage/DuplicateNameHelper.java,Java,,61,10,8,79
/jdk1.4.2_19/org/omg/PortableInterceptor/ORBInitInfoPackage/InvalidName.java,Java,,12,7,6,25
/jdk1.4.2_19/org/omg/PortableInterceptor/ORBInitInfoPackage/InvalidNameHelper.java,Java,,54,10,8,72
/jdk1.4.2_19/org/omg/PortableInterceptor/ORBInitInfoPackage/ObjectIdHelper.java,Java,,40,11,7,58
/jdk1.4.2_19/org/omg/PortableInterceptor/PolicyFactory.java,Java,,4,4,19,27
/jdk1.4.2_19/org/omg/PortableInterceptor/PolicyFactoryOperations.java,Java,,5,5,40,50
/jdk1.4.2_19/org/omg/PortableInterceptor/RequestInfo.java,Java,,4,4,21,29
/jdk1.4.2_19/org/omg/PortableInterceptor/RequestInfoOperations.java,Java,,18,18,256,292
/jdk1.4.2_19/org/omg/PortableInterceptor/ServerRequestInfo.java,Java,,4,4,228,236
/jdk1.4.2_19/org/omg/PortableInterceptor/ServerRequestInfoOperations.java,Java,,12,12,305,329
/jdk1.4.2_19/org/omg/PortableInterceptor/ServerRequestInterceptor.java,Java,,4,4,22,30
/jdk1.4.2_19/org/omg/PortableInterceptor/ServerRequestInterceptorOperations.java,Java,,9,9,180,198
/jdk1.4.2_19/org/omg/PortableInterceptor/SUCCESSFUL.java,Java,,5,4,15,24
/jdk1.4.2_19/org/omg/PortableInterceptor/SYSTEM_EXCEPTION.java,Java,,5,4,15,24
/jdk1.4.2_19/org/omg/PortableInterceptor/TRANSPORT_RETRY.java,Java,,5,4,15,24
/jdk1.4.2_19/org/omg/PortableInterceptor/USER_EXCEPTION.java,Java,,5,4,15,24
/jdk1.4.2_19/org/omg/PortableServer/AdapterActivator.java,Java,,4,4,13,21
/jdk1.4.2_19/org/omg/PortableServer/AdapterActivatorOperations.java,Java,,5,5,26,36
/jdk1.4.2_19/org/omg/PortableServer/Current.java,Java,,4,4,24,32
/jdk1.4.2_19/org/omg/PortableServer/CurrentHelper.java,Java,,52,13,30,95
/jdk1.4.2_19/org/omg/PortableServer/CurrentOperations.java,Java,,6,6,44,56
/jdk1.4.2_19/org/omg/PortableServer/CurrentPackage/NoContext.java,Java,,12,7,6,25
/jdk1.4.2_19/org/omg/PortableServer/CurrentPackage/NoContextHelper.java,Java,,54,10,8,72
/jdk1.4.2_19/org/omg/PortableServer/DynamicImplementation.java,Java,,4,2,19,25
/jdk1.4.2_19/org/omg/PortableServer/ForwardRequest.java,Java,,19,8,6,33
/jdk1.4.2_19/org/omg/PortableServer/ForwardRequestHelper.java,Java,,61,10,8,79
/jdk1.4.2_19/org/omg/PortableServer/IdAssignmentPolicy.java,Java,,4,4,11,19
/jdk1.4.2_19/org/omg/PortableServer/IdAssignmentPolicyOperations.java,Java,,5,5,14,24
/jdk1.4.2_19/org/omg/PortableServer/IdAssignmentPolicyValue.java,Java,,27,8,15,50
/jdk1.4.2_19/org/omg/PortableServer/IdUniquenessPolicy.java,Java,,4,4,11,19
/jdk1.4.2_19/org/omg/PortableServer/IdUniquenessPolicyOperations.java,Java,,5,5,14,24
/jdk1.4.2_19/org/omg/PortableServer/IdUniquenessPolicyValue.java,Java,,27,8,13,48
/jdk1.4.2_19/org/omg/PortableServer/ID_ASSIGNMENT_POLICY_ID.java,Java,,5,4,9,18
/jdk1.4.2_19/org/omg/PortableServer/ID_UNIQUENESS_POLICY_ID.java,Java,,5,4,9,18
/jdk1.4.2_19/org/omg/PortableServer/ImplicitActivationPolicy.java,Java,,4,4,10,18
/jdk1.4.2_19/org/omg/PortableServer/ImplicitActivationPolicyOperations.java,Java,,5,5,13,23
/jdk1.4.2_19/org/omg/PortableServer/ImplicitActivationPolicyValue.java,Java,,27,8,15,50
/jdk1.4.2_19/org/omg/PortableServer/IMPLICIT_ACTIVATION_POLICY_ID.java,Java,,5,4,9,18
/jdk1.4.2_19/org/omg/PortableServer/LifespanPolicy.java,Java,,4,4,11,19
/jdk1.4.2_19/org/omg/PortableServer/LifespanPolicyOperations.java,Java,,5,5,14,24
/jdk1.4.2_19/org/omg/PortableServer/LifespanPolicyValue.java,Java,,27,8,14,49
/jdk1.4.2_19/org/omg/PortableServer/LIFESPAN_POLICY_ID.java,Java,,5,4,9,18
/jdk1.4.2_19/org/omg/PortableServer/POA.java,Java,,4,4,16,24
/jdk1.4.2_19/org/omg/PortableServer/POAHelper.java,Java,,50,12,22,84
/jdk1.4.2_19/org/omg/PortableServer/POAManager.java,Java,,4,4,12,20
/jdk1.4.2_19/org/omg/PortableServer/POAManagerOperations.java,Java,,9,9,60,78
/jdk1.4.2_19/org/omg/PortableServer/POAManagerPackage/AdapterInactive.java,Java,,12,7,6,25
/jdk1.4.2_19/org/omg/PortableServer/POAManagerPackage/AdapterInactiveHelper.java,Java,,54,10,8,72
/jdk1.4.2_19/org/omg/PortableServer/POAManagerPackage/State.java,Java,,31,8,9,48
/jdk1.4.2_19/org/omg/PortableServer/POAOperations.java,Java,,36,36,395,467
/jdk1.4.2_19/org/omg/PortableServer/POAPackage/AdapterAlreadyExists.java,Java,,12,7,6,25
/jdk1.4.2_19/org/omg/PortableServer/POAPackage/AdapterAlreadyExistsHelper.java,Java,,54,10,8,72
/jdk1.4.2_19/org/omg/PortableServer/POAPackage/AdapterNonExistent.java,Java,,12,7,6,25
/jdk1.4.2_19/org/omg/PortableServer/POAPackage/AdapterNonExistentHelper.java,Java,,54,10,8,72
/jdk1.4.2_19/org/omg/PortableServer/POAPackage/InvalidPolicy.java,Java,,19,8,6,33
/jdk1.4.2_19/org/omg/PortableServer/POAPackage/InvalidPolicyHelper.java,Java,,61,10,8,79
/jdk1.4.2_19/org/omg/PortableServer/POAPackage/NoServant.java,Java,,12,7,6,25
/jdk1.4.2_19/org/omg/PortableServer/POAPackage/NoServantHelper.java,Java,,54,10,8,72
/jdk1.4.2_19/org/omg/PortableServer/POAPackage/ObjectAlreadyActive.java,Java,,12,7,6,25
/jdk1.4.2_19/org/omg/PortableServer/POAPackage/ObjectAlreadyActiveHelper.java,Java,,54,10,8,72
/jdk1.4.2_19/org/omg/PortableServer/POAPackage/ObjectNotActive.java,Java,,12,7,6,25
/jdk1.4.2_19/org/omg/PortableServer/POAPackage/ObjectNotActiveHelper.java,Java,,54,10,8,72
/jdk1.4.2_19/org/omg/PortableServer/POAPackage/ServantAlreadyActive.java,Java,,12,7,6,25
/jdk1.4.2_19/org/omg/PortableServer/POAPackage/ServantAlreadyActiveHelper.java,Java,,54,10,8,72
/jdk1.4.2_19/org/omg/PortableServer/POAPackage/ServantNotActive.java,Java,,12,7,6,25
/jdk1.4.2_19/org/omg/PortableServer/POAPackage/ServantNotActiveHelper.java,Java,,54,10,8,72
/jdk1.4.2_19/org/omg/PortableServer/POAPackage/WrongAdapter.java,Java,,12,7,6,25
/jdk1.4.2_19/org/omg/PortableServer/POAPackage/WrongAdapterHelper.java,Java,,54,10,8,72
/jdk1.4.2_19/org/omg/PortableServer/POAPackage/WrongPolicy.java,Java,,12,7,6,25
/jdk1.4.2_19/org/omg/PortableServer/POAPackage/WrongPolicyHelper.java,Java,,54,10,8,72
/jdk1.4.2_19/org/omg/PortableServer/portable/Delegate.java,Java,,13,11,74,98
/jdk1.4.2_19/org/omg/PortableServer/RequestProcessingPolicy.java,Java,,4,4,11,19
/jdk1.4.2_19/org/omg/PortableServer/RequestProcessingPolicyOperations.java,Java,,5,5,14,24
/jdk1.4.2_19/org/omg/PortableServer/RequestProcessingPolicyValue.java,Java,,29,8,24,61
/jdk1.4.2_19/org/omg/PortableServer/REQUEST_PROCESSING_POLICY_ID.java,Java,,5,4,9,18
/jdk1.4.2_19/org/omg/PortableServer/Servant.java,Java,,80,18,150,248
/jdk1.4.2_19/org/omg/PortableServer/ServantActivator.java,Java,,4,4,10,18
/jdk1.4.2_19/org/omg/PortableServer/ServantActivatorHelper.java,Java,,53,12,10,75
/jdk1.4.2_19/org/omg/PortableServer/ServantActivatorOperations.java,Java,,6,6,48,60
/jdk1.4.2_19/org/omg/PortableServer/ServantActivatorPOA.java,Java,,34,13,12,59
/jdk1.4.2_19/org/omg/PortableServer/ServantLocator.java,Java,,4,4,24,32
/jdk1.4.2_19/org/omg/PortableServer/ServantLocatorHelper.java,Java,,53,12,24,89
/jdk1.4.2_19/org/omg/PortableServer/ServantLocatorOperations.java,Java,,6,6,55,67
/jdk1.4.2_19/org/omg/PortableServer/ServantLocatorPackage/CookieHolder.java,Java,,18,8,13,39
/jdk1.4.2_19/org/omg/PortableServer/ServantLocatorPOA.java,Java,,34,13,26,73
/jdk1.4.2_19/org/omg/PortableServer/ServantManager.java,Java,,4,4,17,25
/jdk1.4.2_19/org/omg/PortableServer/ServantManagerOperations.java,Java,,4,4,17,25
/jdk1.4.2_19/org/omg/PortableServer/ServantRetentionPolicy.java,Java,,4,4,10,18
/jdk1.4.2_19/org/omg/PortableServer/ServantRetentionPolicyOperations.java,Java,,5,5,13,23
/jdk1.4.2_19/org/omg/PortableServer/ServantRetentionPolicyValue.java,Java,,27,8,14,49
/jdk1.4.2_19/org/omg/PortableServer/SERVANT_RETENTION_POLICY_ID.java,Java,,5,4,9,18
/jdk1.4.2_19/org/omg/PortableServer/ThreadPolicy.java,Java,,4,4,11,19
/jdk1.4.2_19/org/omg/PortableServer/ThreadPolicyOperations.java,Java,,5,5,14,24
/jdk1.4.2_19/org/omg/PortableServer/ThreadPolicyValue.java,Java,,27,8,13,48
/jdk1.4.2_19/org/omg/PortableServer/THREAD_POLICY_ID.java,Java,,5,4,9,18
/jdk1.4.2_19/org/omg/PortableServer/_ServantActivatorStub.java,Java,,48,15,49,112
/jdk1.4.2_19/org/omg/PortableServer/_ServantLocatorStub.java,Java,,48,15,56,119
/jdk1.4.2_19/org/omg/SendingContext/RunTime.java,Java,,4,2,22,28
/jdk1.4.2_19/org/omg/SendingContext/RunTimeOperations.java,Java,,4,2,22,28
/jdk1.4.2_19/org/omg/stub/java/rmi/_Remote_Stub.java,Java,,11,6,28,45
/jdk1.4.2_19/org/w3c/dom/Attr.java,Java,,9,6,109,124
/jdk1.4.2_19/org/w3c/dom/CDATASection.java,Java,,3,2,43,48
/jdk1.4.2_19/org/w3c/dom/CharacterData.java,Java,,23,9,127,159
/jdk1.4.2_19/org/w3c/dom/Comment.java,Java,,3,2,19,24
/jdk1.4.2_19/org/w3c/dom/css/Counter.java,Java,,6,5,27,38
/jdk1.4.2_19/org/w3c/dom/css/CSS2Properties.java,Java,,370,125,916,1411
/jdk1.4.2_19/org/w3c/dom/css/CSSCharsetRule.java,Java,,7,4,37,48
/jdk1.4.2_19/org/w3c/dom/css/CSSFontFaceRule.java,Java,,4,3,21,28
/jdk1.4.2_19/org/w3c/dom/css/CSSImportRule.java,Java,,7,6,31,44
/jdk1.4.2_19/org/w3c/dom/css/CSSMediaRule.java,Java,,12,7,57,76
/jdk1.4.2_19/org/w3c/dom/css/CSSPageRule.java,Java,,8,5,28,41
/jdk1.4.2_19/org/w3c/dom/css/CSSPrimitiveValue.java,Java,,47,12,237,296
/jdk1.4.2_19/org/w3c/dom/css/CSSRule.java,Java,,17,8,68,93
/jdk1.4.2_19/org/w3c/dom/css/CSSRuleList.java,Java,,5,4,34,43
/jdk1.4.2_19/org/w3c/dom/css/CSSStyleDeclaration.java,Java,,19,12,121,152
/jdk1.4.2_19/org/w3c/dom/css/CSSStyleRule.java,Java,,8,5,29,42
/jdk1.4.2_19/org/w3c/dom/css/CSSStyleSheet.java,Java,,12,7,66,85
/jdk1.4.2_19/org/w3c/dom/css/CSSUnknownRule.java,Java,,3,2,17,22
/jdk1.4.2_19/org/w3c/dom/css/CSSValue.java,Java,,12,6,50,68
/jdk1.4.2_19/org/w3c/dom/css/CSSValueList.java,Java,,5,4,37,46
/jdk1.4.2_19/org/w3c/dom/css/DocumentCSS.java,Java,,7,4,39,50
/jdk1.4.2_19/org/w3c/dom/css/DOMImplementationCSS.java,Java,,8,4,28,40
/jdk1.4.2_19/org/w3c/dom/css/ElementCSSInlineStyle.java,Java,,4,3,25,32
/jdk1.4.2_19/org/w3c/dom/css/Rect.java,Java,,7,6,31,44
/jdk1.4.2_19/org/w3c/dom/css/RGBColor.java,Java,,6,5,36,47
/jdk1.4.2_19/org/w3c/dom/css/ViewCSS.java,Java,,7,4,32,43
/jdk1.4.2_19/org/w3c/dom/Document.java,Java,,33,19,376,428
/jdk1.4.2_19/org/w3c/dom/DocumentFragment.java,Java,,3,2,47,52
/jdk1.4.2_19/org/w3c/dom/DocumentType.java,Java,,9,8,63,80
/jdk1.4.2_19/org/w3c/dom/DOMException.java,Java,,23,3,90,116
/jdk1.4.2_19/org/w3c/dom/DOMImplementation.java,Java,,13,5,92,110
/jdk1.4.2_19/org/w3c/dom/Element.java,Java,,34,18,270,322
/jdk1.4.2_19/org/w3c/dom/Entity.java,Java,,6,5,57,68
/jdk1.4.2_19/org/w3c/dom/EntityReference.java,Java,,3,2,34,39
/jdk1.4.2_19/org/w3c/dom/events/DocumentEvent.java,Java,,6,4,46,56
/jdk1.4.2_19/org/w3c/dom/events/Event.java,Java,,18,13,110,141
/jdk1.4.2_19/org/w3c/dom/events/EventException.java,Java,,9,3,24,36
/jdk1.4.2_19/org/w3c/dom/events/EventListener.java,Java,,4,3,34,41
/jdk1.4.2_19/org/w3c/dom/events/EventTarget.java,Java,,11,5,86,102
/jdk1.4.2_19/org/w3c/dom/events/MouseEvent.java,Java,,29,14,109,152
/jdk1.4.2_19/org/w3c/dom/events/MutationEvent.java,Java,,20,10,78,108
/jdk1.4.2_19/org/w3c/dom/events/UIEvent.java,Java,,11,6,41,58
/jdk1.4.2_19/org/w3c/dom/html/HTMLAnchorElement.java,Java,,29,17,66,112
/jdk1.4.2_19/org/w3c/dom/html/HTMLAppletElement.java,Java,,25,14,64,103
/jdk1.4.2_19/org/w3c/dom/html/HTMLAreaElement.java,Java,,19,11,49,79
/jdk1.4.2_19/org/w3c/dom/html/HTMLBaseElement.java,Java,,7,5,22,34
/jdk1.4.2_19/org/w3c/dom/html/HTMLBaseFontElement.java,Java,,9,6,28,43
/jdk1.4.2_19/org/w3c/dom/html/HTMLBodyElement.java,Java,,15,9,45,69
/jdk1.4.2_19/org/w3c/dom/html/HTMLBRElement.java,Java,,5,4,19,28
/jdk1.4.2_19/org/w3c/dom/html/HTMLButtonElement.java,Java,,15,10,42,67
/jdk1.4.2_19/org/w3c/dom/html/HTMLCollection.java,Java,,7,7,43,57
/jdk1.4.2_19/org/w3c/dom/html/HTMLDirectoryElement.java,Java,,5,4,20,29
/jdk1.4.2_19/org/w3c/dom/html/HTMLDivElement.java,Java,,5,4,19,28
/jdk1.4.2_19/org/w3c/dom/html/HTMLDListElement.java,Java,,5,4,19,28
/jdk1.4.2_19/org/w3c/dom/html/HTMLDocument.java,Java,,24,20,111,155
/jdk1.4.2_19/org/w3c/dom/html/HTMLDOMImplementation.java,Java,,5,5,26,36
/jdk1.4.2_19/org/w3c/dom/html/HTMLElement.java,Java,,14,9,43,66
/jdk1.4.2_19/org/w3c/dom/html/HTMLFieldSetElement.java,Java,,4,4,20,28
/jdk1.4.2_19/org/w3c/dom/html/HTMLFontElement.java,Java,,9,6,28,43
/jdk1.4.2_19/org/w3c/dom/html/HTMLFormElement.java,Java,,19,13,55,87
/jdk1.4.2_19/org/w3c/dom/html/HTMLFrameElement.java,Java,,21,13,52,86
/jdk1.4.2_19/org/w3c/dom/html/HTMLFrameSetElement.java,Java,,7,5,23,35
/jdk1.4.2_19/org/w3c/dom/html/HTMLHeadElement.java,Java,,5,4,19,28
/jdk1.4.2_19/org/w3c/dom/html/HTMLHeadingElement.java,Java,,5,4,20,29
/jdk1.4.2_19/org/w3c/dom/html/HTMLHRElement.java,Java,,11,7,32,50
/jdk1.4.2_19/org/w3c/dom/html/HTMLHtmlElement.java,Java,,5,4,20,29
/jdk1.4.2_19/org/w3c/dom/html/HTMLIFrameElement.java,Java,,25,15,59,99
/jdk1.4.2_19/org/w3c/dom/html/HTMLImageElement.java,Java,,29,16,65,110
/jdk1.4.2_19/org/w3c/dom/html/HTMLInputElement.java,Java,,41,25,131,197
/jdk1.4.2_19/org/w3c/dom/html/HTMLIsIndexElement.java,Java,,6,5,24,35
/jdk1.4.2_19/org/w3c/dom/html/HTMLLabelElement.java,Java,,8,6,28,42
/jdk1.4.2_19/org/w3c/dom/html/HTMLLegendElement.java,Java,,8,6,29,43
/jdk1.4.2_19/org/w3c/dom/html/HTMLLIElement.java,Java,,7,5,24,36
/jdk1.4.2_19/org/w3c/dom/html/HTMLLinkElement.java,Java,,21,12,51,84
/jdk1.4.2_19/org/w3c/dom/html/HTMLMapElement.java,Java,,6,5,22,33
/jdk1.4.2_19/org/w3c/dom/html/HTMLMenuElement.java,Java,,5,4,20,29
/jdk1.4.2_19/org/w3c/dom/html/HTMLMetaElement.java,Java,,11,7,31,49
/jdk1.4.2_19/org/w3c/dom/html/HTMLModElement.java,Java,,7,5,24,36
/jdk1.4.2_19/org/w3c/dom/html/HTMLObjectElement.java,Java,,40,23,97,160
/jdk1.4.2_19/org/w3c/dom/html/HTMLOListElement.java,Java,,9,6,27,42
/jdk1.4.2_19/org/w3c/dom/html/HTMLOptGroupElement.java,Java,,7,5,24,36
/jdk1.4.2_19/org/w3c/dom/html/HTMLOptionElement.java,Java,,16,11,51,78
/jdk1.4.2_19/org/w3c/dom/html/HTMLParagraphElement.java,Java,,5,4,19,28
/jdk1.4.2_19/org/w3c/dom/html/HTMLParamElement.java,Java,,11,7,33,51
/jdk1.4.2_19/org/w3c/dom/html/HTMLPreElement.java,Java,,5,4,19,28
/jdk1.4.2_19/org/w3c/dom/html/HTMLQuoteElement.java,Java,,5,4,20,29
/jdk1.4.2_19/org/w3c/dom/html/HTMLScriptElement.java,Java,,17,10,40,67
/jdk1.4.2_19/org/w3c/dom/html/HTMLSelectElement.java,Java,,28,19,87,134
/jdk1.4.2_19/org/w3c/dom/html/HTMLStyleElement.java,Java,,9,6,27,42
/jdk1.4.2_19/org/w3c/dom/html/HTMLTableCaptionElement.java,Java,,5,4,19,28
/jdk1.4.2_19/org/w3c/dom/html/HTMLTableCellElement.java,Java,,32,18,76,126
/jdk1.4.2_19/org/w3c/dom/html/HTMLTableColElement.java,Java,,15,9,39,63
/jdk1.4.2_19/org/w3c/dom/html/HTMLTableElement.java,Java,,40,26,123,189
/jdk1.4.2_19/org/w3c/dom/html/HTMLTableRowElement.java,Java,,21,14,68,103
/jdk1.4.2_19/org/w3c/dom/html/HTMLTableSectionElement.java,Java,,17,11,57,85
/jdk1.4.2_19/org/w3c/dom/html/HTMLTextAreaElement.java,Java,,26,17,71,114
/jdk1.4.2_19/org/w3c/dom/html/HTMLTitleElement.java,Java,,5,4,18,27
/jdk1.4.2_19/org/w3c/dom/html/HTMLUListElement.java,Java,,7,5,23,35
/jdk1.4.2_19/org/w3c/dom/NamedNodeMap.java,Java,,17,10,147,174
/jdk1.4.2_19/org/w3c/dom/Node.java,Java,,50,26,450,526
/jdk1.4.2_19/org/w3c/dom/NodeList.java,Java,,5,4,32,41
/jdk1.4.2_19/org/w3c/dom/Notation.java,Java,,5,4,31,40
/jdk1.4.2_19/org/w3c/dom/ProcessingInstruction.java,Java,,7,4,36,47
/jdk1.4.2_19/org/w3c/dom/stylesheets/DocumentStyle.java,Java,,4,3,27,34
/jdk1.4.2_19/org/w3c/dom/stylesheets/LinkStyle.java,Java,,4,3,24,31
/jdk1.4.2_19/org/w3c/dom/stylesheets/MediaList.java,Java,,13,8,60,81
/jdk1.4.2_19/org/w3c/dom/stylesheets/StyleSheet.java,Java,,12,10,73,95
/jdk1.4.2_19/org/w3c/dom/stylesheets/StyleSheetList.java,Java,,5,4,33,42
/jdk1.4.2_19/org/w3c/dom/Text.java,Java,,5,3,48,56
/jdk1.4.2_19/org/w3c/dom/traversal/DocumentTraversal.java,Java,,15,5,72,92
/jdk1.4.2_19/org/w3c/dom/traversal/NodeFilter.java,Java,,21,6,117,144
/jdk1.4.2_19/org/w3c/dom/traversal/NodeIterator.java,Java,,14,10,85,109
/jdk1.4.2_19/org/w3c/dom/traversal/TreeWalker.java,Java,,19,15,148,182
/jdk1.4.2_19/org/w3c/dom/views/AbstractView.java,Java,,4,3,20,27
/jdk1.4.2_19/org/w3c/dom/views/DocumentView.java,Java,,4,3,23,30
/jdk1.4.2_19/org/xml/sax/AttributeList.java,Java,,9,21,161,191
/jdk1.4.2_19/org/xml/sax/Attributes.java,Java,,16,36,191,243
/jdk1.4.2_19/org/xml/sax/ContentHandler.java,Java,,27,26,321,374
/jdk1.4.2_19/org/xml/sax/DocumentHandler.java,Java,,18,20,192,230
/jdk1.4.2_19/org/xml/sax/DTDHandler.java,Java,,12,8,88,108
/jdk1.4.2_19/org/xml/sax/EntityResolver.java,Java,,7,8,95,110
/jdk1.4.2_19/org/xml/sax/ErrorHandler.java,Java,,9,11,103,123
/jdk1.4.2_19/org/xml/sax/ext/DeclHandler.java,Java,,18,13,110,141
/jdk1.4.2_19/org/xml/sax/ext/LexicalHandler.java,Java,,20,18,173,211
/jdk1.4.2_19/org/xml/sax/HandlerBase.java,Java,,61,42,265,368
/jdk1.4.2_19/org/xml/sax/helpers/AttributeListImpl.java,Java,,90,43,177,310
/jdk1.4.2_19/org/xml/sax/helpers/AttributesImpl.java,Java,,250,77,286,613
/jdk1.4.2_19/org/xml/sax/helpers/DefaultHandler.java,Java,,86,52,314,452
/jdk1.4.2_19/org/xml/sax/helpers/LocatorImpl.java,Java,,51,36,125,212
/jdk1.4.2_19/org/xml/sax/helpers/NamespaceSupport.java,Java,,243,89,357,689
/jdk1.4.2_19/org/xml/sax/helpers/NewInstance.java,Java,,34,5,22,61
/jdk1.4.2_19/org/xml/sax/helpers/ParserAdapter.java,Java,,454,138,443,1035
/jdk1.4.2_19/org/xml/sax/helpers/ParserFactory.java,Java,,34,14,84,132
/jdk1.4.2_19/org/xml/sax/helpers/XMLFilterImpl.java,Java,,274,107,388,769
/jdk1.4.2_19/org/xml/sax/helpers/XMLReaderAdapter.java,Java,,178,86,271,535
/jdk1.4.2_19/org/xml/sax/helpers/XMLReaderFactory.java,Java,,51,13,75,139
/jdk1.4.2_19/org/xml/sax/InputSource.java,Java,,65,36,220,321
/jdk1.4.2_19/org/xml/sax/Locator.java,Java,,7,13,106,126
/jdk1.4.2_19/org/xml/sax/Parser.java,Java,,16,19,172,207
/jdk1.4.2_19/org/xml/sax/SAXException.java,Java,,39,24,91,154
/jdk1.4.2_19/org/xml/sax/SAXNotRecognizedException.java,Java,,8,10,35,53
/jdk1.4.2_19/org/xml/sax/SAXNotSupportedException.java,Java,,8,9,36,53
/jdk1.4.2_19/org/xml/sax/SAXParseException.java,Java,,62,35,167,264
/jdk1.4.2_19/org/xml/sax/XMLFilter.java,Java,,6,10,49,65
/jdk1.4.2_19/org/xml/sax/XMLReader.java,Java,,25,42,348,415
/jdk1.4.2_19/sunw/io/Serializable.java,Java,,3,3,30,36
/jdk1.4.2_19/sunw/util/EventListener.java,Java,,3,3,30,36
/jdk1.4.2_19/sunw/util/EventObject.java,Java,,6,5,30,41
