CommandHandler.java,Java,,13,8,28,49
NameServiceStartThread.java,Java,,29,7,27,63
ORBD.java,Java,,244,50,60,354
ProcessMonitorThread.java,Java,,55,11,39,105
RepositoryImpl.java,Java,,348,78,48,474
ServerMain.java,Java,,247,71,65,383
ServerManagerImpl.java,Java,,466,109,70,645
ServerTableEntry.java,Java,,380,91,72,543
ServerTool.java,Java,,729,166,78,973
CopierManagerImpl.java,Java,,38,11,24,73
FallbackObjectCopierImpl.java,Java,,22,5,28,55
JavaStreamObjectCopierImpl.java,Java,,39,13,26,78
ORBStreamObjectCopierImpl.java,Java,,27,10,26,63
ReferenceObjectCopierImpl.java,Java,,9,3,24,36
AnyImpl.java,Java,,832,135,384,1351
AnyImplHelper.java,Java,,37,9,32,78
AsynchInvoke.java,Java,,25,15,52,92
ContextImpl.java,Java,,53,15,30,98
ContextListImpl.java,Java,,43,10,31,84
CORBAObjectImpl.java,Java,,8,2,33,43
EnvironmentImpl.java,Java,,22,9,30,61
ExceptionListImpl.java,Java,,40,13,30,83
NamedValueImpl.java,Java,,38,9,32,79
NVListImpl.java,Java,,65,16,32,113
PrincipalImpl.java,Java,,13,5,30,48
RequestImpl.java,Java,,249,49,76,374
ServerRequestImpl.java,Java,,139,41,77,257
TCUtility.java,Java,,233,55,41,329
TypeCodeFactory.java,Java,,7,5,24,36
TypeCodeImpl.java,Java,,1744,288,381,2413
TypeCodeImplHelper.java,Java,,41,10,30,81
DynAnyBasicImpl.java,Java,,535,58,43,636
DynAnyCollectionImpl.java,Java,,117,25,63,205
DynAnyComplexImpl.java,Java,,278,40,103,421
DynAnyConstructedImpl.java,Java,,790,72,75,937
DynAnyFactoryImpl.java,Java,,36,15,36,87
DynAnyImpl.java,Java,,118,27,55,200
DynAnyUtil.java,Java,,214,17,107,338
DynArrayImpl.java,Java,,65,18,55,138
DynEnumImpl.java,Java,,110,21,59,190
DynFixedImpl.java,Java,,122,11,77,210
DynSequenceImpl.java,Java,,129,25,103,257
DynStructImpl.java,Java,,40,10,37,87
DynUnionImpl.java,Java,,249,32,104,385
DynValueBoxImpl.java,Java,,88,15,30,133
DynValueCommonImpl.java,Java,,79,18,50,147
DynValueImpl.java,Java,,25,7,27,59
BufferManagerFactory.java,Java,,92,14,37,143
BufferManagerRead.java,Java,,15,13,67,95
BufferManagerReadGrow.java,Java,,48,18,33,99
BufferManagerReadStream.java,Java,,237,50,70,357
BufferManagerWrite.java,Java,,29,19,102,150
BufferManagerWriteCollect.java,Java,,128,39,64,231
BufferManagerWriteGrow.java,Java,,38,17,37,92
BufferManagerWriteStream.java,Java,,61,25,48,134
BufferQueue.java,Java,,24,6,30,60
ByteBufferWithInfo.java,Java,,153,36,68,257
CachedCodeBase.java,Java,,108,39,61,208
CDRInputObject.java,Java,,136,46,85,267
CDRInputStream.java,Java,,349,109,86,544
CDRInputStreamBase.java,Java,,111,31,59,201
CDRInputStream_1_0.java,Java,,1456,437,505,2398
CDRInputStream_1_1.java,Java,,75,45,69,189
CDRInputStream_1_2.java,Java,,56,25,63,144
CDROutputObject.java,Java,,195,42,86,323
CDROutputStream.java,Java,,312,67,59,438
CDROutputStreamBase.java,Java,,101,30,45,176
CDROutputStream_1_0.java,Java,,1240,376,313,1929
CDROutputStream_1_1.java,Java,,54,29,66,149
CDROutputStream_1_2.java,Java,,138,69,152,359
CodeSetCache.java,Java,,33,15,61,109
CodeSetComponentInfo.java,Java,,197,59,84,340
CodeSetConversion.java,Java,,314,113,280,707
EncapsInputStream.java,Java,,93,24,67,184
EncapsOutputStream.java,Java,,60,21,64,145
IDLJavaSerializationInputStream.java,Java,,748,161,174,1083
IDLJavaSerializationOutputStream.java,Java,,557,129,112,798
MarkAndResetHandler.java,Java,,7,4,28,39
MarshalInputStream.java,Java,,44,10,48,102
MarshalOutputStream.java,Java,,46,13,30,89
OSFCodeSetRegistry.java,Java,,104,21,105,230
RestorableInputStream.java,Java,,6,2,29,37
TypeCodeInputStream.java,Java,,120,22,53,195
TypeCodeOutputStream.java,Java,,136,27,101,264
TypeCodeReader.java,Java,,44,7,26,77
WrapperInputStream.java,Java,,154,21,36,211
CDREncapsCodec.java,Java,,96,31,93,220
ClientRequestInfoImpl.java,Java,,498,135,345,978
CodecFactoryImpl.java,Java,,51,16,55,122
InterceptorInvoker.java,Java,,335,74,253,662
InterceptorList.java,Java,,130,29,101,260
IORInfoImpl.java,Java,,151,53,114,318
ORBInitInfoImpl.java,Java,,175,50,156,381
PICurrent.java,Java,,69,22,79,170
PIHandlerImpl.java,Java,,566,149,277,992
PINoOpHandlerImpl.java,Java,,121,48,30,199
RequestInfoImpl.java,Java,,397,121,411,929
ServerRequestInfoImpl.java,Java,,452,138,317,907
SlotTable.java,Java,,44,12,51,107
SlotTableStack.java,Java,,78,25,85,188
FVDCodeBaseImpl.java,Java,,103,28,53,184
IIOPInputStream.java,Java,,1873,376,647,2896
IIOPOutputStream.java,Java,,538,126,156,820
InputStreamHook.java,Java,,267,85,117,469
ObjectStreamClass.java,Java,,995,216,569,1780
ObjectStreamClassCorbaExt.java,Java,,51,14,47,112
ObjectStreamField.java,Java,,154,36,81,271
OptionalDataException.java,Java,,13,6,56,75
OutputStreamHook.java,Java,,149,64,105,318
TypeMismatchException.java,Java,,12,3,30,45
ValueHandlerImpl.java,Java,,630,133,163,926
ValueUtility.java,Java,,336,66,81,483
ByteBuffer.java,Java,,80,18,110,208
EncapsulationUtility.java,Java,,74,19,49,142
FreezableList.java,Java,,85,24,33,142
GenericIdentifiable.java,Java,,54,16,28,98
GenericTaggedComponent.java,Java,,23,8,32,63
GenericTaggedProfile.java,Java,,59,17,28,104
IdentifiableFactoryFinderBase.java,Java,,45,14,24,83
AlternateIIOPAddressComponentImpl.java,Java,,43,15,27,85
CodeSetsComponentImpl.java,Java,,57,18,28,103
IIOPAddressBase.java,Java,,42,12,33,87
IIOPAddressClosureImpl.java,Java,,24,8,27,59
IIOPAddressImpl.java,Java,,38,13,27,78
IIOPProfileImpl.java,Java,,230,66,55,351
IIOPProfileTemplateImpl.java,Java,,102,33,37,172
JavaCodebaseComponentImpl.java,Java,,43,16,27,86
JavaSerializationComponent.java,Java,,42,13,33,88
MaxStreamFormatVersionComponentImpl.java,Java,,51,19,28,98
ORBTypeComponentImpl.java,Java,,41,15,27,83
RequestPartitioningComponentImpl.java,Java,,56,17,26,99
IORImpl.java,Java,,204,65,69,338
IORTemplateImpl.java,Java,,81,25,32,138
IORTemplateListImpl.java,Java,,84,17,28,129
JIDLObjectKeyTemplate.java,Java,,37,14,32,83
NewObjectKeyTemplateBase.java,Java,,37,12,25,74
ObjectAdapterIdArray.java,Java,,28,8,26,62
ObjectAdapterIdBase.java,Java,,57,17,24,98
ObjectAdapterIdNumber.java,Java,,15,5,30,50
ObjectIdImpl.java,Java,,35,10,27,72
ObjectKeyFactoryImpl.java,Java,,120,36,84,240
ObjectKeyImpl.java,Java,,55,18,27,100
ObjectKeyTemplateBase.java,Java,,128,38,31,197
ObjectReferenceFactoryImpl.java,Java,,75,25,42,142
ObjectReferenceProducerBase.java,Java,,26,12,24,62
ObjectReferenceTemplateImpl.java,Java,,95,28,42,165
OldJIDLObjectKeyTemplate.java,Java,,52,20,47,119
OldObjectKeyTemplateBase.java,Java,,21,7,28,56
OldPOAObjectKeyTemplate.java,Java,,49,12,32,93
POAObjectKeyTemplate.java,Java,,43,16,32,91
StubIORImpl.java,Java,,172,37,58,267
TaggedComponentFactoryFinderImpl.java,Java,,34,11,28,73
TaggedProfileFactoryFinderImpl.java,Java,,17,7,27,51
TaggedProfileTemplateFactoryFinderImpl.java,Java,,18,8,27,53
WireObjectKeyTemplate.java,Java,,91,27,37,155
StubDelegateImpl.java,Java,,99,32,83,214
Util.java,Java,,468,81,227,776
PortableRemoteObject.java,Java,,181,54,127,362
DefaultSocketFactory.java,Java,,88,16,26,130
EndPointInfoImpl.java,Java,,76,16,25,117
LegacyServerSocketManagerImpl.java,Java,,121,21,44,186
SocketFactoryAcceptorImpl.java,Java,,46,12,36,94
SocketFactoryConnectionImpl.java,Java,,72,13,35,120
SocketFactoryContactInfoImpl.java,Java,,56,16,40,112
SocketFactoryContactInfoListImpl.java,Java,,23,8,33,64
SocketFactoryContactInfoListIteratorImpl.java,Java,,66,15,36,117
USLPort.java,Java,,14,5,25,44
ActivationSystemException.java,Java,,186,66,13,265
InterceptorsSystemException.java,Java,,702,238,25,965
IORSystemException.java,Java,,360,123,16,499
NamingSystemException.java,Java,,523,179,16,718
OMGSystemException.java,Java,,2814,951,64,3829
ORBUtilSystemException.java,Java,,6787,2227,49,9063
POASystemException.java,Java,,1539,521,34,2094
UtilSystemException.java,Java,,686,224,25,935
MonitoredAttributeInfoFactoryImpl.java,Java,,14,3,24,41
MonitoredAttributeInfoImpl.java,Java,,27,8,24,59
MonitoredObjectFactoryImpl.java,Java,,10,4,24,38
MonitoredObjectImpl.java,Java,,91,22,33,146
MonitoringManagerFactoryImpl.java,Java,,21,6,24,51
MonitoringManagerImpl.java,Java,,26,7,24,57
BindingIteratorImpl.java,Java,,57,18,110,185
InternalBindingKey.java,Java,,52,7,42,101
InternalBindingValue.java,Java,,15,5,31,51
InterOperableNamingImpl.java,Java,,297,21,95,413
NamingContextDataStore.java,Java,,25,11,79,115
NamingContextImpl.java,Java,,502,66,460,1028
NamingUtils.java,Java,,52,15,65,132
TransientBindingIterator.java,Java,,57,10,67,134
TransientNameServer.java,Java,,132,32,72,236
TransientNameService.java,Java,,68,19,71,158
TransientNamingContext.java,Java,,178,29,150,357
CorbalocURL.java,Java,,140,18,130,288
CorbanameURL.java,Java,,55,10,56,121
IIOPEndpointInfo.java,Java,,41,13,38,92
INSURL.java,Java,,9,7,35,51
INSURLBase.java,Java,,32,10,34,76
INSURLHandler.java,Java,,25,9,31,65
NamingConstants.java,Java,,7,5,29,41
Utility.java,Java,,48,12,43,103
InternalBindingKey.java,Java,,79,12,44,135
InternalBindingValue.java,Java,,25,8,36,69
NameServer.java,Java,,48,17,38,103
NameService.java,Java,,129,24,81,234
NamingContextImpl.java,Java,,632,118,556,1306
PersistentBindingIterator.java,Java,,66,12,64,142
ServantManagerImpl.java,Java,,180,49,32,261
NullServantImpl.java,Java,,15,6,24,45
ActiveObjectMap.java,Java,,187,43,35,265
AOMEntry.java,Java,,169,36,42,247
BadServerIdHandler.java,Java,,6,3,31,40
DelegateImpl.java,Java,,101,19,27,147
IdAssignmentPolicyImpl.java,Java,,30,10,24,64
IdUniquenessPolicyImpl.java,Java,,29,10,24,63
ImplicitActivationPolicyImpl.java,Java,,31,10,24,65
LifespanPolicyImpl.java,Java,,29,10,24,63
POACurrent.java,Java,,115,25,42,182
POAFactory.java,Java,,169,43,36,248
POAImpl.java,Java,,1055,261,376,1692
POAManagerImpl.java,Java,,364,80,103,547
POAPolicyMediator.java,Java,,30,19,76,125
POAPolicyMediatorBase.java,Java,,92,25,32,149
POAPolicyMediatorBase_R.java,Java,,131,39,32,202
POAPolicyMediatorFactory.java,Java,,23,2,27,52
POAPolicyMediatorImpl_NR_UDS.java,Java,,81,23,31,135
POAPolicyMediatorImpl_NR_USM.java,Java,,109,28,31,168
POAPolicyMediatorImpl_R_AOM.java,Java,,60,14,34,108
POAPolicyMediatorImpl_R_UDS.java,Java,,69,19,30,118
POAPolicyMediatorImpl_R_USM.java,Java,,260,53,67,380
Policies.java,Java,,243,43,66,352
RequestProcessingPolicyImpl.java,Java,,40,11,24,75
ServantRetentionPolicyImpl.java,Java,,29,10,24,63
ThreadPolicyImpl.java,Java,,29,10,24,63
TOA.java,Java,,6,4,35,45
TOAFactory.java,Java,,63,21,29,113
TOAImpl.java,Java,,126,32,70,228
TransientObjectManager.java,Java,,132,36,37,205
AppletDataCollector.java,Java,,23,9,26,58
DataCollectorBase.java,Java,,306,81,86,473
DataCollectorFactory.java,Java,,32,10,24,66
NormalDataCollector.java,Java,,26,9,24,59
NormalParserAction.java,Java,,18,5,28,51
NormalParserData.java,Java,,22,6,24,52
ORBConfiguratorImpl.java,Java,,441,89,98,628
ORBDataParserImpl.java,Java,,298,56,64,418
ORBImpl.java,Java,,1350,280,498,2128
ORBSingleton.java,Java,,557,142,74,773
ORBVersionImpl.java,Java,,51,19,28,98
ParserAction.java,Java,,8,6,34,48
ParserActionBase.java,Java,,51,15,24,90
ParserActionFactory.java,Java,,15,5,24,44
ParserDataBase.java,Java,,25,5,24,54
ParserTable.java,Java,,868,122,120,1110
PrefixParserAction.java,Java,,72,15,35,122
PrefixParserData.java,Java,,32,10,24,66
PropertyOnlyDataCollector.java,Java,,22,9,24,55
CacheTable.java,Java,,124,6,33,163
Constant.java,Java,,13,5,24,42
Future.java,Java,,21,6,24,51
CondVar.java,Java,,112,29,200,341
DebugMutex.java,Java,,68,12,132,212
Mutex.java,Java,,54,10,129,193
ReentrantMutex.java,Java,,180,33,137,350
Sync.java,Java,,13,20,330,363
SyncUtil.java,Java,,17,4,28,49
CorbaResourceUtil.java,Java,,57,14,24,95
DenseIntMapImpl.java,Java,,34,9,35,78
GuardedAction.java,Java,,38,8,24,70
NameBase.java,Java,,43,9,25,77
StateEngineImpl.java,Java,,221,54,53,328
GetPropertyAction.java,Java,,16,6,66,88
Graph.java,Java,,7,4,24,35
GraphImpl.java,Java,,112,29,46,187
Node.java,Java,,6,3,28,37
NodeData.java,Java,,31,8,31,70
HexOutputStream.java,Java,,30,9,41,80
LegacyHookGetFields.java,Java,,73,24,60,157
LegacyHookPutFields.java,Java,,37,13,61,111
LogKeywords.java,Java,,48,8,41,97
ObjectStreamClassUtil_1_3.java,Java,,366,71,121,558
ObjectStreamClass_1_3_1.java,Java,,698,159,405,1262
ObjectStreamField.java,Java,,139,34,97,270
ObjectUtility.java,Java,,46,12,29,87
ObjectWriter.java,Java,,145,36,35,216
ORBConstants.java,Java,,196,95,180,471
ORBUtility.java,Java,,561,94,191,846
RepIdDelegator.java,Java,,117,34,36,187
RepositoryIdFactory.java,Java,,16,6,30,52
RepositoryIdInterface.java,Java,,14,6,28,48
RepositoryIdStrings.java,Java,,16,9,28,53
RepositoryIdUtility.java,Java,,20,6,33,59
StackImpl.java,Java,,35,9,35,79
ThreadPoolImpl.java,Java,,331,81,135,547
ThreadPoolManagerImpl.java,Java,,104,35,98,237
TimeoutException.java,Java,,4,3,25,32
WorkQueueImpl.java,Java,,122,36,41,199
DynamicAccessPermission.java,Java,,12,6,44,62
DynamicMethodMarshallerImpl.java,Java,,361,67,37,465
DynamicStubImpl.java,Java,,106,27,27,160
ExceptionHandler.java,Java,,10,6,41,57
ExceptionHandlerImpl.java,Java,,192,49,54,295
IDLNameTranslatorImpl.java,Java,,490,168,250,908
IDLType.java,Java,,56,21,47,124
IDLTypeException.java,Java,,7,5,28,40
IDLTypesUtil.java,Java,,390,93,115,598
InvocationHandlerFactoryImpl.java,Java,,90,25,53,168
JNDIStateFactoryImpl.java,Java,,72,25,73,170
PresentationManagerImpl.java,Java,,225,59,41,325
ReflectiveTie.java,Java,,117,29,30,176
StubConnectImpl.java,Java,,58,20,38,116
StubFactoryBase.java,Java,,30,10,24,64
StubFactoryDynamicBase.java,Java,,38,9,26,73
StubFactoryFactoryBase.java,Java,,11,4,29,44
StubFactoryFactoryDynamicBase.java,Java,,58,18,25,101
StubFactoryFactoryProxyImpl.java,Java,,19,3,24,46
StubFactoryFactoryStaticImpl.java,Java,,87,23,39,149
StubFactoryProxyImpl.java,Java,,25,6,26,57
StubFactoryStaticImpl.java,Java,,24,6,24,54
StubInvocationHandlerImpl.java,Java,,141,32,40,213
AddressingDispositionException.java,Java,,11,6,39,56
BootstrapServerRequestDispatcher.java,Java,,73,21,55,149
CorbaClientDelegateImpl.java,Java,,295,64,84,443
CorbaClientRequestDispatcherImpl.java,Java,,671,172,210,1053
CorbaInvocationInfo.java,Java,,68,21,29,118
CorbaMessageMediatorImpl.java,Java,,1652,310,408,2370
CorbaServerRequestDispatcherImpl.java,Java,,578,129,178,885
FullServantCacheLocalCRDImpl.java,Java,,39,15,27,81
AddressingDispositionHelper.java,Java,,40,11,30,81
CancelRequestMessage.java,Java,,5,3,29,37
CancelRequestMessage_1_0.java,Java,,28,15,33,76
CancelRequestMessage_1_1.java,Java,,28,15,33,76
CancelRequestMessage_1_2.java,Java,,28,15,33,76
FragmentMessage.java,Java,,5,3,29,37
FragmentMessage_1_1.java,Java,,29,13,37,79
FragmentMessage_1_2.java,Java,,55,16,37,108
IORAddressingInfo.java,Java,,14,7,30,51
IORAddressingInfoHelper.java,Java,,66,11,30,107
KeyAddr.java,Java,,5,4,30,39
LocateReplyMessage.java,Java,,11,5,29,45
LocateReplyMessage_1_0.java,Java,,76,27,37,140
LocateReplyMessage_1_1.java,Java,,77,26,37,140
LocateReplyMessage_1_2.java,Java,,114,33,47,194
LocateReplyOrReplyMessage.java,Java,,10,5,25,40
LocateRequestMessage.java,Java,,6,4,29,39
LocateRequestMessage_1_0.java,Java,,48,18,34,100
LocateRequestMessage_1_1.java,Java,,49,19,34,102
LocateRequestMessage_1_2.java,Java,,46,18,34,98
Message.java,Java,,42,20,35,97
MessageBase.java,Java,,703,108,156,967
MessageHandler.java,Java,,21,9,42,72
Message_1_0.java,Java,,71,24,48,143
Message_1_1.java,Java,,96,32,68,196
Message_1_2.java,Java,,42,10,29,81
ProfileAddr.java,Java,,5,4,30,39
ReferenceAddr.java,Java,,5,4,30,39
ReplyMessage.java,Java,,15,6,31,52
ReplyMessage_1_0.java,Java,,130,32,39,201
ReplyMessage_1_1.java,Java,,131,31,39,201
ReplyMessage_1_2.java,Java,,141,37,54,232
RequestMessage.java,Java,,15,9,30,54
RequestMessage_1_0.java,Java,,97,26,38,161
RequestMessage_1_1.java,Java,,118,23,34,175
RequestMessage_1_2.java,Java,,116,28,56,200
TargetAddress.java,Java,,77,17,30,124
TargetAddressHelper.java,Java,,108,14,33,155
InfoOnlyServantCacheLocalCRDImpl.java,Java,,29,12,27,68
INSServerRequestDispatcher.java,Java,,40,11,48,99
JIDLLocalCRDImpl.java,Java,,41,16,33,90
LocalClientRequestDispatcherBase.java,Java,,66,21,53,140
MinimalServantCacheLocalCRDImpl.java,Java,,27,10,24,61
NotLocalLocalCRDImpl.java,Java,,25,9,33,67
POALocalCRDImpl.java,Java,,91,24,48,163
RequestCanceledException.java,Java,,10,5,27,42
RequestDispatcherRegistryImpl.java,Java,,111,29,43,183
ServantCacheLocalCRDBase.java,Java,,49,18,29,96
SharedCDRClientRequestDispatcherImpl.java,Java,,151,27,59,237
SpecialMethod.java,Java,,119,24,25,168
BootstrapResolverImpl.java,Java,,85,31,49,165
CompositeResolverImpl.java,Java,,27,7,24,58
FileResolverImpl.java,Java,,65,16,29,110
INSURLOperationImpl.java,Java,,211,36,82,329
LocalResolverImpl.java,Java,,21,7,24,52
ORBDefaultInitRefResolverImpl.java,Java,,29,10,30,69
ORBInitRefResolverImpl.java,Java,,31,10,24,65
SplitLocalResolverImpl.java,Java,,27,8,24,59
ByteBufferPoolImpl.java,Java,,93,25,89,207
CorbaConnectionCacheBase.java,Java,,166,36,66,268
CorbaContactInfoBase.java,Java,,189,43,60,292
CorbaContactInfoListImpl.java,Java,,139,30,71,240
CorbaContactInfoListIteratorImpl.java,Java,,147,37,75,259
CorbaInboundConnectionCacheImpl.java,Java,,148,30,44,222
CorbaOutboundConnectionCacheImpl.java,Java,,143,24,43,210
CorbaResponseWaitingRoomImpl.java,Java,,211,53,73,337
CorbaTransportManagerImpl.java,Java,,179,27,49,255
DefaultIORToSocketInfoImpl.java,Java,,47,10,30,87
DefaultSocketFactoryImpl.java,Java,,78,18,27,123
EventHandlerBase.java,Java,,95,19,36,150
ListenerThreadImpl.java,Java,,85,24,38,147
ReaderThreadImpl.java,Java,,90,24,39,153
ReadTCPTimeoutsImpl.java,Java,,23,6,29,58
SelectorImpl.java,Java,,492,54,69,615
SharedCDRContactInfoImpl.java,Java,,110,25,52,187
SocketOrChannelAcceptorImpl.java,Java,,463,81,120,664
SocketOrChannelConnectionImpl.java,Java,,1119,214,354,1687
SocketOrChannelContactInfoImpl.java,Java,,134,30,53,217
IdentityHashtable.java,Java,,156,32,185,373
IdentityHashtableEntry.java,Java,,7,3,33,43
IdentityHashtableEnumerator.java,Java,,37,7,34,78
JDKBridge.java,Java,,91,19,87,197
JDKClassLoader.java,Java,,86,25,81,192
ORBProperties.java,Java,,29,11,32,72
PackagePrefixChecker.java,Java,,35,12,29,76
RepositoryId.java,Java,,677,175,141,993
RepositoryIdCache.java,Java,,41,16,51,108
SUNVMCID.java,Java,,4,4,33,41
Utility.java,Java,,643,118,241,1002
Version.java,Java,,16,5,30,51
ORBSingleton.java,Java,,8,3,29,40
BootstrapServer.java,Java,,59,21,53,133
ORB.java,Java,,9,2,27,38
PIORB.java,Java,,9,3,28,40
POAORB.java,Java,,8,2,27,37
ORB.java,Java,,11,3,43,57
Broker.java,Java,,10,5,28,43
InputObject.java,Java,,9,7,47,63
OutputObject.java,Java,,9,7,49,65
ClientDelegate.java,Java,,8,5,46,59
ClientInvocationInfo.java,Java,,18,14,28,60
ClientRequestDispatcher.java,Java,,20,6,79,105
MessageMediator.java,Java,,21,14,95,130
ProtocolHandler.java,Java,,6,4,43,53
ServerRequestDispatcher.java,Java,,6,4,38,48
Acceptor.java,Java,,28,21,163,212
ByteBufferPool.java,Java,,8,4,28,40
Connection.java,Java,,29,26,172,227
ConnectionCache.java,Java,,11,9,32,52
ContactInfo.java,Java,,33,18,180,231
ContactInfoList.java,Java,,6,4,42,52
ContactInfoListIterator.java,Java,,12,7,64,83
EventHandler.java,Java,,20,13,34,67
InboundConnectionCache.java,Java,,9,6,28,43
ListenerThread.java,Java,,6,3,28,37
OutboundConnectionCache.java,Java,,8,5,28,41
ReaderThread.java,Java,,5,3,28,36
ResponseWaitingRoom.java,Java,,11,8,29,48
Selector.java,Java,,10,3,28,41
TransportManager.java,Java,,20,14,28,62
Activator.java,Java,,4,3,6,13
ActivatorHelper.java,Java,,67,12,6,85
ActivatorHolder.java,Java,,24,8,6,38
ActivatorOperations.java,Java,,16,15,42,73
BadServerDefinition.java,Java,,19,8,6,33
BadServerDefinitionHelper.java,Java,,61,10,8,79
BadServerDefinitionHolder.java,Java,,24,8,6,38
EndPointInfo.java,Java,,14,6,6,26
EndPointInfoHelper.java,Java,,67,10,6,83
EndPointInfoHolder.java,Java,,24,8,6,38
EndpointInfoListHelper.java,Java,,46,11,8,65
EndpointInfoListHolder.java,Java,,24,10,8,42
IIOP_CLEAR_TEXT.java,Java,,5,4,11,20
InitialNameService.java,Java,,4,4,9,17
InitialNameServiceHelper.java,Java,,67,13,9,89
InitialNameServiceHolder.java,Java,,24,9,9,42
InitialNameServiceOperations.java,Java,,5,5,11,21
NameAlreadyBound.java,Java,,12,7,6,25
NameAlreadyBoundHelper.java,Java,,54,10,8,72
NameAlreadyBoundHolder.java,Java,,24,8,6,38
InvalidORBid.java,Java,,12,7,6,25
InvalidORBidHelper.java,Java,,54,10,8,72
InvalidORBidHolder.java,Java,,24,8,6,38
Locator.java,Java,,4,3,6,13
LocatorHelper.java,Java,,67,12,6,85
LocatorHolder.java,Java,,24,8,6,38
LocatorOperations.java,Java,,8,7,19,34
ServerLocationPerORB.java,Java,,14,6,6,26
ServerLocationPerORBHelper.java,Java,,68,10,6,84
ServerLocationPerORBHolder.java,Java,,24,8,6,38
ServerLocationPerType.java,Java,,14,6,6,26
ServerLocationPerTypeHelper.java,Java,,68,10,6,84
ServerLocationPerTypeHolder.java,Java,,24,8,6,38
NoSuchEndPoint.java,Java,,12,7,6,25
NoSuchEndPointHelper.java,Java,,54,10,8,72
NoSuchEndPointHolder.java,Java,,24,8,6,38
ORBAlreadyRegistered.java,Java,,19,8,6,33
ORBAlreadyRegisteredHelper.java,Java,,62,10,8,80
ORBAlreadyRegisteredHolder.java,Java,,24,8,6,38
ORBidListHelper.java,Java,,47,11,8,66
ORBidListHolder.java,Java,,24,10,8,42
ORBPortInfo.java,Java,,14,6,6,26
ORBPortInfoHelper.java,Java,,68,10,6,84
ORBPortInfoHolder.java,Java,,24,8,6,38
ORBPortInfoListHelper.java,Java,,46,11,8,65
ORBPortInfoListHolder.java,Java,,24,10,8,42
ORBProxy.java,Java,,4,4,8,16
ORBProxyHelper.java,Java,,67,13,8,88
ORBProxyHolder.java,Java,,24,9,8,41
ORBProxyOperations.java,Java,,5,5,14,24
Repository.java,Java,,4,3,6,13
RepositoryHelper.java,Java,,67,12,6,85
RepositoryHolder.java,Java,,24,8,6,38
RepositoryOperations.java,Java,,13,12,29,54
AppNamesHelper.java,Java,,46,11,8,65
AppNamesHolder.java,Java,,24,10,8,42
ServerDef.java,Java,,22,11,11,44
ServerDefHelper.java,Java,,94,10,6,110
ServerDefHolder.java,Java,,24,8,6,38
ServerAlreadyActive.java,Java,,19,8,6,33
ServerAlreadyActiveHelper.java,Java,,62,10,8,80
ServerAlreadyActiveHolder.java,Java,,24,8,6,38
ServerAlreadyInstalled.java,Java,,19,8,6,33
ServerAlreadyInstalledHelper.java,Java,,62,10,8,80
ServerAlreadyInstalledHolder.java,Java,,24,8,6,38
ServerAlreadyRegistered.java,Java,,19,8,6,33
ServerAlreadyRegisteredHelper.java,Java,,62,10,8,80
ServerAlreadyRegisteredHolder.java,Java,,24,8,6,38
ServerAlreadyUninstalled.java,Java,,19,8,6,33
ServerAlreadyUninstalledHelper.java,Java,,62,10,8,80
ServerAlreadyUninstalledHolder.java,Java,,24,8,6,38
ServerHeldDown.java,Java,,19,8,6,33
ServerHeldDownHelper.java,Java,,62,10,8,80
ServerHeldDownHolder.java,Java,,24,8,6,38
ServerIdsHelper.java,Java,,47,11,8,66
ServerIdsHolder.java,Java,,24,10,8,42
ServerManager.java,Java,,4,4,10,18
ServerManagerHelper.java,Java,,67,13,10,90
ServerManagerHolder.java,Java,,24,9,10,43
ServerManagerOperations.java,Java,,4,4,10,18
ServerNotActive.java,Java,,19,8,6,33
ServerNotActiveHelper.java,Java,,62,10,8,80
ServerNotActiveHolder.java,Java,,24,8,6,38
ServerNotRegistered.java,Java,,19,8,6,33
ServerNotRegisteredHelper.java,Java,,62,10,8,80
ServerNotRegisteredHolder.java,Java,,24,8,6,38
ServerProxy.java,Java,,4,4,8,16
ServerProxyHelper.java,Java,,67,13,8,88
ServerProxyHolder.java,Java,,24,9,8,41
ServerProxyOperations.java,Java,,7,7,16,30
TCPPortHelper.java,Java,,40,11,11,62
_ActivatorImplBase.java,Java,,208,36,44,288
_ActivatorStub.java,Java,,304,31,43,378
_InitialNameServiceImplBase.java,Java,,48,15,13,76
_InitialNameServiceStub.java,Java,,59,10,12,81
_LocatorImplBase.java,Java,,108,20,21,149
_LocatorStub.java,Java,,135,15,20,170
_ORBProxyImplBase.java,Java,,43,15,16,74
_ORBProxyStub.java,Java,,55,10,15,80
_RepositoryImplBase.java,Java,,159,30,31,220
_RepositoryStub.java,Java,,229,25,30,284
_ServerManagerImplBase.java,Java,,285,45,61,391
_ServerManagerStub.java,Java,,405,40,60,505
_ServerProxyImplBase.java,Java,,54,19,18,91
_ServerProxyStub.java,Java,,87,14,17,118
Activator.java,Java,,4,3,6,13
ActivatorHelper.java,Java,,67,12,6,85
ActivatorHolder.java,Java,,24,8,6,38
ActivatorOperations.java,Java,,12,11,14,37
BadServerDefinition.java,Java,,19,8,6,33
BadServerDefinitionHelper.java,Java,,61,10,8,79
BadServerDefinitionHolder.java,Java,,24,8,6,38
EndPointInfo.java,Java,,14,6,6,26
EndPointInfoHelper.java,Java,,67,10,6,83
EndPointInfoHolder.java,Java,,24,8,6,38
EndpointInfoListHelper.java,Java,,46,10,6,62
EndpointInfoListHolder.java,Java,,24,9,6,39
IIOP_CLEAR_TEXT.java,Java,,5,4,7,16
InitialNameService.java,Java,,4,3,6,13
InitialNameServiceHelper.java,Java,,67,12,6,85
InitialNameServiceHolder.java,Java,,24,8,6,38
InitialNameServiceOperations.java,Java,,5,4,7,16
NameAlreadyBound.java,Java,,12,7,6,25
NameAlreadyBoundHelper.java,Java,,54,10,8,72
NameAlreadyBoundHolder.java,Java,,24,8,6,38
InvalidORBid.java,Java,,12,7,6,25
InvalidORBidHelper.java,Java,,54,10,8,72
InvalidORBidHolder.java,Java,,24,8,6,38
Locator.java,Java,,4,3,6,13
LocatorHelper.java,Java,,67,12,6,85
LocatorHolder.java,Java,,24,8,6,38
LocatorOperations.java,Java,,8,7,10,25
ServerLocation.java,Java,,14,6,6,26
ServerLocationHelper.java,Java,,68,10,6,84
ServerLocationHolder.java,Java,,24,8,6,38
ServerLocationPerORB.java,Java,,14,6,6,26
ServerLocationPerORBHelper.java,Java,,68,10,6,84
ServerLocationPerORBHolder.java,Java,,24,8,6,38
NoSuchEndPoint.java,Java,,12,7,6,25
NoSuchEndPointHelper.java,Java,,54,10,8,72
NoSuchEndPointHolder.java,Java,,24,8,6,38
ORBAlreadyRegistered.java,Java,,19,8,6,33
ORBAlreadyRegisteredHelper.java,Java,,62,10,8,80
ORBAlreadyRegisteredHolder.java,Java,,24,8,6,38
ORBidHelper.java,Java,,40,11,7,58
ORBidListHelper.java,Java,,47,10,6,63
ORBidListHolder.java,Java,,24,9,6,39
ORBPortInfo.java,Java,,14,6,6,26
ORBPortInfoHelper.java,Java,,68,10,6,84
ORBPortInfoHolder.java,Java,,24,8,6,38
ORBPortInfoListHelper.java,Java,,46,10,6,62
ORBPortInfoListHolder.java,Java,,24,9,6,39
POANameHelper.java,Java,,46,10,6,62
POANameHolder.java,Java,,24,9,6,39
Repository.java,Java,,4,3,6,13
RepositoryHelper.java,Java,,67,12,6,85
RepositoryHolder.java,Java,,24,8,6,38
RepositoryOperations.java,Java,,13,12,15,40
ServerDef.java,Java,,20,9,9,38
ServerDefHelper.java,Java,,87,10,6,103
ServerDefHolder.java,Java,,24,8,6,38
StringSeqHelper.java,Java,,46,10,6,62
StringSeqHolder.java,Java,,24,9,6,39
Server.java,Java,,4,4,8,16
ServerAlreadyActive.java,Java,,19,8,6,33
ServerAlreadyActiveHelper.java,Java,,62,10,8,80
ServerAlreadyActiveHolder.java,Java,,24,8,6,38
ServerAlreadyInstalled.java,Java,,19,8,6,33
ServerAlreadyInstalledHelper.java,Java,,62,10,8,80
ServerAlreadyInstalledHolder.java,Java,,24,8,6,38
ServerAlreadyRegistered.java,Java,,19,8,6,33
ServerAlreadyRegisteredHelper.java,Java,,62,10,8,80
ServerAlreadyRegisteredHolder.java,Java,,24,8,6,38
ServerAlreadyUninstalled.java,Java,,19,8,6,33
ServerAlreadyUninstalledHelper.java,Java,,62,10,8,80
ServerAlreadyUninstalledHolder.java,Java,,24,8,6,38
ServerHeldDown.java,Java,,19,8,6,33
ServerHeldDownHelper.java,Java,,62,10,8,80
ServerHeldDownHolder.java,Java,,24,8,6,38
ServerHelper.java,Java,,67,13,8,88
ServerHolder.java,Java,,24,9,8,41
ServerIdHelper.java,Java,,40,10,6,56
ServerIdsHelper.java,Java,,47,10,6,63
ServerIdsHolder.java,Java,,24,9,6,39
ServerManager.java,Java,,4,3,6,13
ServerManagerHelper.java,Java,,67,12,6,85
ServerManagerHolder.java,Java,,24,8,6,38
ServerManagerOperations.java,Java,,4,3,6,13
ServerNotActive.java,Java,,19,8,6,33
ServerNotActiveHelper.java,Java,,62,10,8,80
ServerNotActiveHolder.java,Java,,24,8,6,38
ServerNotRegistered.java,Java,,19,8,6,33
ServerNotRegisteredHelper.java,Java,,62,10,8,80
ServerNotRegisteredHolder.java,Java,,24,8,6,38
ServerOperations.java,Java,,7,7,16,30
TCPPortHelper.java,Java,,40,10,6,56
_ActivatorImplBase.java,Java,,165,28,16,209
_ActivatorStub.java,Java,,223,23,15,261
_InitialNameServiceImplBase.java,Java,,48,14,9,71
_InitialNameServiceStub.java,Java,,59,9,8,76
_LocatorImplBase.java,Java,,108,20,12,140
_LocatorStub.java,Java,,135,15,11,161
_RepositoryImplBase.java,Java,,159,30,17,206
_RepositoryStub.java,Java,,229,25,16,270
_ServerImplBase.java,Java,,54,19,18,91
_ServerManagerImplBase.java,Java,,242,36,20,298
_ServerManagerStub.java,Java,,324,31,19,374
_ServerStub.java,Java,,87,14,17,118
CopierManager.java,Java,,9,6,37,52
CopyobjectDefaults.java,Java,,52,10,38,100
ObjectCopier.java,Java,,4,2,32,38
ObjectCopierFactory.java,Java,,5,3,28,36
ReflectiveCopyException.java,Java,,15,3,24,42
CorbaInputObject.java,Java,,8,3,24,35
CorbaOutputObject.java,Java,,22,7,24,53
CopyObjectPolicy.java,Java,,31,9,27,67
RequestPartitioningPolicy.java,Java,,45,11,28,84
ServantCachingPolicy.java,Java,,73,22,66,161
ZeroPortPolicy.java,Java,,36,11,27,74
EncapsulationFactoryBase.java,Java,,20,8,24,52
Identifiable.java,Java,,5,4,33,42
IdentifiableBase.java,Java,,14,5,34,53
IdentifiableContainerBase.java,Java,,44,11,36,91
IdentifiableFactory.java,Java,,7,5,32,44
IdentifiableFactoryFinder.java,Java,,7,4,38,49
AlternateIIOPAddressComponent.java,Java,,7,3,27,37
CodeSetsComponent.java,Java,,7,4,27,38
GIOPVersion.java,Java,,134,43,42,219
IIOPAddress.java,Java,,7,4,27,38
IIOPFactories.java,Java,,182,30,29,241
IIOPProfile.java,Java,,12,8,40,60
IIOPProfileTemplate.java,Java,,12,7,34,53
JavaCodebaseComponent.java,Java,,6,3,27,36
MaxStreamFormatVersionComponent.java,Java,,6,2,26,34
ORBTypeComponent.java,Java,,6,3,27,36
RequestPartitioningComponent.java,Java,,6,2,24,32
IOR.java,Java,,19,14,53,86
IORFactories.java,Java,,114,31,58,203
IORFactory.java,Java,,6,4,35,45
IORTemplate.java,Java,,7,4,30,41
IORTemplateList.java,Java,,4,3,30,37
MakeImmutable.java,Java,,4,2,24,30
ObjectAdapterId.java,Java,,7,5,35,47
ObjectId.java,Java,,5,2,27,34
ObjectKey.java,Java,,10,7,35,52
ObjectKeyFactory.java,Java,,9,5,32,46
ObjectKeyTemplate.java,Java,,16,12,46,74
TaggedComponent.java,Java,,7,3,30,40
TaggedComponentBase.java,Java,,17,6,28,51
TaggedComponentFactoryFinder.java,Java,,6,2,27,35
TaggedProfile.java,Java,,12,9,45,66
TaggedProfileTemplate.java,Java,,19,10,49,78
TaggedProfileTemplateBase.java,Java,,32,10,24,66
Writeable.java,Java,,6,3,29,38
WriteContents.java,Java,,5,3,24,32
Connection.java,Java,,5,3,27,35
GetEndPointInfoAgainException.java,Java,,15,6,31,52
LegacyServerSocketEndPointInfo.java,Java,,13,10,42,65
LegacyServerSocketManager.java,Java,,12,7,28,47
ORBSocketFactory.java,Java,,20,13,325,358
IORInfoExt.java,Java,,9,5,25,39
ORBInitInfoExt.java,Java,,6,3,32,41
RequestInfoExt.java,Java,,6,4,35,45
UnknownType.java,Java,,14,3,24,41
CORBALogDomains.java,Java,,29,27,105,161
LogWrapperBase.java,Java,,49,12,31,92
LogWrapperFactory.java,Java,,6,4,24,34
LongMonitoredAttributeBase.java,Java,,12,7,51,70
MonitoredAttribute.java,Java,,10,7,96,113
MonitoredAttributeBase.java,Java,,34,12,69,115
MonitoredAttributeInfo.java,Java,,8,5,74,87
MonitoredAttributeInfoFactory.java,Java,,5,2,40,47
MonitoredObject.java,Java,,19,8,164,191
MonitoredObjectFactory.java,Java,,4,1,38,43
MonitoringConstants.java,Java,,72,12,31,115
MonitoringFactories.java,Java,,24,7,80,111
MonitoringManager.java,Java,,9,5,55,69
MonitoringManagerFactory.java,Java,,6,2,37,45
StatisticMonitoredAttribute.java,Java,,31,15,84,130
StatisticsAccumulator.java,Java,,88,29,105,222
StringMonitoredAttributeBase.java,Java,,14,7,52,73
NullServant.java,Java,,6,3,36,45
OADefault.java,Java,,18,4,28,50
OADestroyed.java,Java,,3,1,27,31
OAInvocationInfo.java,Java,,51,18,41,110
ObjectAdapter.java,Java,,25,25,199,249
ObjectAdapterBase.java,Java,,129,38,36,203
ObjectAdapterFactory.java,Java,,10,8,32,50
DataCollector.java,Java,,10,5,50,65
Operation.java,Java,,4,1,29,34
OperationFactory.java,Java,,407,100,60,567
ORB.java,Java,,333,100,136,569
ORBConfigurator.java,Java,,4,1,31,36
ORBData.java,Java,,65,48,45,158
ORBVersion.java,Java,,14,6,24,44
ORBVersionFactory.java,Java,,53,14,46,113
ParserData.java,Java,,11,8,24,43
ParserDataFactory.java,Java,,19,3,24,46
ParserImplBase.java,Java,,80,20,36,136
ParserImplTableBase.java,Java,,113,25,35,173
PropertyParser.java,Java,,46,11,28,85
StringPair.java,Java,,32,9,24,65
Closure.java,Java,,4,2,24,30
ClosureFactory.java,Java,,14,5,24,43
Action.java,Java,,5,3,47,55
ActionBase.java,Java,,5,3,24,32
FSM.java,Java,,6,4,46,56
FSMImpl.java,Java,,44,13,57,114
FSMTest.java,Java,,172,31,24,227
Guard.java,Java,,44,12,46,102
GuardBase.java,Java,,5,3,24,32
Input.java,Java,,4,3,34,41
InputImpl.java,Java,,5,3,24,32
State.java,Java,,6,4,46,56
StateEngine.java,Java,,17,10,82,109
StateEngineFactory.java,Java,,9,4,29,42
StateImpl.java,Java,,54,16,28,98
CompositeInvocationHandler.java,Java,,9,4,29,42
CompositeInvocationHandlerImpl.java,Java,,53,14,27,94
DelegateInvocationHandlerImpl.java,Java,,31,6,28,65
InvocationHandlerFactory.java,Java,,7,4,29,40
LinkedInvocationHandler.java,Java,,8,4,28,40
NoSuchThreadPoolException.java,Java,,4,3,25,32
NoSuchWorkQueueException.java,Java,,4,3,25,32
ThreadPool.java,Java,,17,17,84,118
ThreadPoolChooser.java,Java,,7,5,41,53
ThreadPoolManager.java,Java,,14,12,71,97
Work.java,Java,,8,8,39,55
WorkQueue.java,Java,,11,10,47,68
DynamicMethodMarshaller.java,Java,,20,15,60,95
DynamicStub.java,Java,,15,11,43,69
IDLNameTranslator.java,Java,,9,6,41,56
PresentationDefaults.java,Java,,28,10,24,62
PresentationManager.java,Java,,38,23,109,170
StubAdapter.java,Java,,134,25,50,209
StubWrapper.java,Java,,108,27,27,162
ClientDelegateFactory.java,Java,,6,4,26,36
CorbaClientDelegate.java,Java,,6,3,25,34
CorbaMessageMediator.java,Java,,80,24,42,146
CorbaProtocolHandler.java,Java,,39,11,28,78
CorbaServerRequestDispatcher.java,Java,,9,6,37,52
ForwardException.java,Java,,38,15,31,84
InitialServerRequestDispatcher.java,Java,,7,3,32,42
LocalClientRequestDispatcher.java,Java,,12,8,53,73
LocalClientRequestDispatcherFactory.java,Java,,5,3,24,32
PIHandler.java,Java,,56,41,209,306
RequestDispatcherDefault.java,Java,,74,16,25,115
RequestDispatcherRegistry.java,Java,,19,16,60,95
RetryType.java,Java,,13,6,33,52
LocalResolver.java,Java,,5,3,30,38
Resolver.java,Java,,5,3,36,44
ResolverDefault.java,Java,,52,12,40,104
CodeSetServiceContext.java,Java,,35,9,25,69
MaxStreamFormatVersionServiceContext.java,Java,,41,13,28,82
ORBVersionServiceContext.java,Java,,39,14,30,83
SendingContextServiceContext.java,Java,,35,9,25,69
ServiceContext.java,Java,,40,11,70,121
ServiceContextData.java,Java,,109,21,31,161
ServiceContextRegistry.java,Java,,49,13,35,97
ServiceContexts.java,Java,,210,83,122,415
UEInfoServiceContext.java,Java,,38,10,25,73
UnknownServiceContext.java,Java,,37,10,24,71
CorbaAcceptor.java,Java,,14,6,29,49
CorbaConnection.java,Java,,75,39,58,172
CorbaConnectionCache.java,Java,,5,3,28,36
CorbaContactInfo.java,Java,,15,5,28,48
CorbaContactInfoList.java,Java,,15,9,28,52
CorbaContactInfoListFactory.java,Java,,8,5,37,50
CorbaContactInfoListIterator.java,Java,,11,7,26,44
CorbaResponseWaitingRoom.java,Java,,11,5,28,44
CorbaTransportManager.java,Java,,20,8,30,58
IIOPPrimaryToContactInfo.java,Java,,13,8,63,84
IORToSocketInfo.java,Java,,7,5,33,45
IORTransformer.java,Java,,8,4,28,40
ORBSocketFactory.java,Java,,22,9,28,59
ReadTimeouts.java,Java,,7,3,25,35
ReadTimeoutsFactory.java,Java,,8,3,25,36
SocketInfo.java,Java,,8,7,28,43
SocketOrChannelAcceptor.java,Java,,6,4,28,38
TransportDefault.java,Java,,57,9,29,95
ImageFormatException.java,Java,,10,4,39,53
JPEGCodec.java,Java,,49,13,89,151
JPEGDecodeParam.java,Java,,62,45,264,371
JPEGEncodeParam.java,Java,,27,20,210,257
JPEGHuffmanTable.java,Java,,139,31,72,242
JPEGImageDecoder.java,Java,,23,13,103,139
JPEGImageEncoder.java,Java,,29,18,179,226
JPEGQTable.java,Java,,62,20,69,151
TruncatedFileException.java,Java,,19,8,56,83
BMPCompressionTypes.java,Java,,17,6,24,47
BMPConstants.java,Java,,19,4,27,50
BMPImageReader.java,Java,,1411,267,182,1860
BMPImageReaderSpi.java,Java,,58,12,24,94
BMPImageWriter.java,Java,,1108,182,227,1517
BMPImageWriterSpi.java,Java,,66,16,24,106
BMPMetadata.java,Java,,221,51,35,307
BMPMetadataFormat.java,Java,,156,22,30,208
BMPMetadataFormatResources.java,Java,,34,10,25,69
BitFile.java,Java,,73,10,40,123
BogusColorSpace.java,Java,,61,23,52,136
I18N.java,Java,,7,2,24,33
I18NImpl.java,Java,,17,4,41,62
ImageUtil.java,Java,,838,118,211,1167
InputStreamAdapter.java,Java,,17,8,24,49
LZWCompressor.java,Java,,73,20,53,146
LZWStringTable.java,Java,,110,29,79,218
PaletteBuilder.java,Java,,307,67,112,486
ReaderUtil.java,Java,,98,13,105,216
StandardMetadataFormat.java,Java,,363,61,75,499
StandardMetadataFormatResources.java,Java,,129,55,26,210
SubImageInputStream.java,Java,,42,11,26,79
GIFImageMetadata.java,Java,,313,72,61,446
GIFImageMetadataFormat.java,Java,,122,16,33,171
GIFImageMetadataFormatResources.java,Java,,70,8,26,104
GIFImageReader.java,Java,,787,168,128,1083
GIFImageReaderSpi.java,Java,,58,17,24,99
GIFImageWriter.java,Java,,924,196,197,1317
GIFImageWriterSpi.java,Java,,63,17,24,104
GIFMetadata.java,Java,,234,35,48,317
GIFStreamMetadata.java,Java,,207,56,54,317
GIFStreamMetadataFormat.java,Java,,67,11,28,106
GIFStreamMetadataFormatResources.java,Java,,37,8,26,71
GIFWritableImageMetadata.java,Java,,315,51,36,402
GIFWritableStreamMetadata.java,Java,,203,28,36,267
AdobeMarkerSegment.java,Java,,90,14,32,136
COMMarkerSegment.java,Java,,57,12,64,133
DHTMarkerSegment.java,Java,,177,30,53,260
DQTMarkerSegment.java,Java,,218,25,66,309
DRIMarkerSegment.java,Java,,37,11,35,83
JFIFMarkerSegment.java,Java,,1201,130,233,1564
JPEG.java,Java,,201,49,118,368
JPEGBuffer.java,Java,,134,19,101,254
JPEGImageMetadataFormat.java,Java,,302,37,27,366
JPEGImageMetadataFormatResources.java,Java,,106,7,30,143
JPEGImageReader.java,Java,,1244,209,377,1830
JPEGImageReaderResources.java,Java,,15,7,24,46
JPEGImageReaderSpi.java,Java,,53,9,26,88
JPEGImageWriter.java,Java,,1494,196,249,1939
JPEGImageWriterResources.java,Java,,51,7,24,82
JPEGImageWriterSpi.java,Java,,59,13,26,98
JPEGMetadata.java,Java,,1789,186,442,2417
JPEGMetadataFormat.java,Java,,105,17,35,157
JPEGMetadataFormatResources.java,Java,,30,5,26,61
JPEGStreamMetadataFormat.java,Java,,17,6,24,47
JPEGStreamMetadataFormatResources.java,Java,,14,5,27,46
MarkerSegment.java,Java,,143,21,65,229
SOFMarkerSegment.java,Java,,219,25,40,284
SOSMarkerSegment.java,Java,,179,24,38,241
PNGImageReader.java,Java,,1230,228,171,1629
PNGImageReaderSpi.java,Java,,63,16,24,103
PNGImageWriter.java,Java,,894,179,98,1171
PNGImageWriterSpi.java,Java,,76,19,31,126
PNGMetadata.java,Java,,1607,243,197,2047
PNGMetadataFormat.java,Java,,323,118,59,500
PNGMetadataFormatResources.java,Java,,169,24,26,219
RowFilter.java,Java,,132,33,27,192
WBMPImageReader.java,Java,,214,56,52,322
WBMPImageReaderSpi.java,Java,,78,18,34,130
WBMPImageWriter.java,Java,,222,44,49,315
WBMPImageWriterSpi.java,Java,,57,12,24,93
WBMPMetadata.java,Java,,82,27,25,134
WBMPMetadataFormat.java,Java,,33,12,25,70
FileImageInputStreamSpi.java,Java,,30,9,24,63
FileImageOutputStreamSpi.java,Java,,31,9,24,64
InputStreamImageInputStreamSpi.java,Java,,41,12,24,77
OutputStreamImageOutputStreamSpi.java,Java,,41,11,24,76
RAFImageInputStreamSpi.java,Java,,32,9,24,65
RAFImageOutputStreamSpi.java,Java,,33,9,24,66
CloseableDisposerRecord.java,Java,,20,5,29,54
StreamCloser.java,Java,,76,13,45,134
StreamFinalizer.java,Java,,18,5,49,72
Painter.java,Java,,4,1,29,34
GTKColorChooserPanel.java,Java,,860,148,295,1303
GTKColorType.java,Java,,108,14,45,167
GTKConstants.java,Java,,54,10,54,118
GTKEngine.java,Java,,472,68,95,635
GTKFileChooserUI.java,Java,,1066,214,122,1402
GTKGraphicsUtils.java,Java,,85,11,48,144
GTKIconFactory.java,Java,,254,50,47,351
GTKLookAndFeel.java,Java,,1376,173,190,1739
GTKPainter.java,Java,,1136,154,233,1523
GTKRegion.java,Java,,9,3,30,42
GTKStyle.java,Java,,797,109,235,1141
GTKStyleFactory.java,Java,,116,17,55,188
Metacity.java,Java,,1862,241,56,2159
PangoFonts.java,Java,,91,21,121,233
XColors.java,Java,,788,16,27,831
MotifBorders.java,Java,,505,121,108,734
MotifButtonListener.java,Java,,14,5,30,49
MotifButtonUI.java,Java,,75,22,53,150
MotifCheckBoxMenuItemUI.java,Java,,62,14,31,107
MotifCheckBoxUI.java,Java,,34,14,42,90
MotifComboBoxUI.java,Java,,264,42,55,361
MotifDesktopIconUI.java,Java,,262,54,49,365
MotifDesktopPaneUI.java,Java,,177,31,59,267
MotifEditorPaneUI.java,Java,,13,5,50,68
MotifFileChooserUI.java,Java,,658,122,74,854
MotifGraphicsUtils.java,Java,,317,62,97,476
MotifIconFactory.java,Java,,350,56,54,460
MotifInternalFrameTitlePane.java,Java,,297,50,35,382
MotifInternalFrameUI.java,Java,,137,27,59,223
MotifLabelUI.java,Java,,19,5,37,61
MotifLookAndFeel.java,Java,,1089,127,64,1280
MotifMenuBarUI.java,Java,,23,7,39,69
MotifMenuItemUI.java,Java,,63,15,31,109
MotifMenuMouseListener.java,Java,,17,2,29,48
MotifMenuMouseMotionListener.java,Java,,11,3,29,43
MotifMenuUI.java,Java,,89,18,44,151
MotifOptionPaneUI.java,Java,,49,13,52,114
MotifPasswordFieldUI.java,Java,,13,5,50,68
MotifPopupMenuSeparatorUI.java,Java,,27,9,30,66
MotifPopupMenuUI.java,Java,,63,11,40,114
MotifProgressBarUI.java,Java,,13,6,39,58
MotifRadioButtonMenuItemUI.java,Java,,62,14,37,113
MotifRadioButtonUI.java,Java,,40,16,48,104
MotifScrollBarButton.java,Java,,154,23,34,211
MotifScrollBarUI.java,Java,,53,16,37,106
MotifScrollPaneUI.java,Java,,91,18,38,147
MotifSeparatorUI.java,Java,,16,5,38,59
MotifSliderUI.java,Java,,85,28,49,162
MotifSplitPaneDivider.java,Java,,181,36,78,295
MotifSplitPaneUI.java,Java,,18,6,42,66
MotifTabbedPaneUI.java,Java,,218,33,55,306
MotifTextAreaUI.java,Java,,13,5,52,70
MotifTextFieldUI.java,Java,,13,5,50,68
MotifTextPaneUI.java,Java,,13,5,50,68
MotifTextUI.java,Java,,69,13,93,175
MotifToggleButtonUI.java,Java,,60,17,48,125
MotifTreeCellRenderer.java,Java,,51,16,46,113
MotifTreeUI.java,Java,,78,24,64,166
motif.java,Java,,27,2,0,29
motif_de.java,Java,,27,2,0,29
motif_es.java,Java,,27,2,0,29
motif_fr.java,Java,,27,2,0,29
motif_it.java,Java,,27,2,0,29
motif_ja.java,Java,,27,2,0,29
motif_ko.java,Java,,27,2,0,29
motif_pt_BR.java,Java,,27,2,0,29
motif_sv.java,Java,,27,2,0,29
motif_zh_CN.java,Java,,27,2,0,29
motif_zh_HK.java,Java,,27,2,0,29
motif_zh_TW.java,Java,,27,2,0,29
AbstractRegionPainter.java,Java,,4,1,29,34
NimbusLookAndFeel.java,Java,,4,1,29,34
AnimationController.java,Java,,309,44,78,431
DesktopProperty.java,Java,,129,31,125,285
windows.java,Java,,35,2,0,37
windows_de.java,Java,,35,2,0,37
windows_es.java,Java,,35,2,0,37
windows_fr.java,Java,,35,2,0,37
windows_it.java,Java,,35,2,0,37
windows_ja.java,Java,,35,2,0,37
windows_ko.java,Java,,35,2,0,37
windows_pt_BR.java,Java,,35,2,0,37
windows_sv.java,Java,,35,2,0,37
windows_zh_CN.java,Java,,35,2,0,37
windows_zh_HK.java,Java,,35,2,0,37
windows_zh_TW.java,Java,,35,2,0,37
TMSchema.java,Java,,400,94,71,565
WindowsBorders.java,Java,,230,42,64,336
WindowsButtonListener.java,Java,,9,5,40,54
WindowsButtonUI.java,Java,,204,36,80,320
WindowsCheckBoxMenuItemUI.java,Java,,48,13,43,104
WindowsCheckBoxUI.java,Java,,36,14,45,95
WindowsClassicLookAndFeel.java,Java,,6,2,36,44
WindowsComboBoxUI.java,Java,,391,52,129,572
WindowsDesktopIconUI.java,Java,,42,14,42,98
WindowsDesktopManager.java,Java,,48,8,47,103
WindowsDesktopPaneUI.java,Java,,27,7,37,71
WindowsEditorPaneUI.java,Java,,14,6,48,68
WindowsFileChooserUI.java,Java,,937,209,163,1309
WindowsGraphicsUtils.java,Java,,132,20,62,214
WindowsIconFactory.java,Java,,748,84,81,913
WindowsInternalFrameTitlePane.java,Java,,450,59,60,569
WindowsInternalFrameUI.java,Java,,71,23,40,134
WindowsLabelUI.java,Java,,59,14,39,112
WindowsLookAndFeel.java,Java,,2006,245,388,2639
WindowsMenuBarUI.java,Java,,129,12,45,186
WindowsMenuItemUI.java,Java,,108,21,51,180
WindowsMenuItemUIAccessor.java,Java,,11,5,30,46
WindowsMenuUI.java,Java,,187,39,69,295
WindowsOptionPaneUI.java,Java,,8,5,34,47
WindowsPasswordFieldUI.java,Java,,13,8,48,69
WindowsPopupMenuSeparatorUI.java,Java,,48,12,35,95
WindowsPopupMenuUI.java,Java,,125,18,81,224
WindowsPopupWindow.java,Java,,34,10,51,95
WindowsProgressBarUI.java,Java,,280,49,83,412
WindowsRadioButtonMenuItemUI.java,Java,,47,13,43,103
WindowsRadioButtonUI.java,Java,,63,20,52,135
WindowsRootPaneUI.java,Java,,144,20,41,205
WindowsScrollBarUI.java,Java,,376,48,78,502
WindowsScrollPaneUI.java,Java,,5,5,34,44
WindowsSeparatorUI.java,Java,,3,3,29,35
WindowsSliderUI.java,Java,,159,33,41,233
WindowsSpinnerUI.java,Java,,66,12,28,106
WindowsSplitPaneDivider.java,Java,,23,7,42,72
WindowsSplitPaneUI.java,Java,,18,9,40,67
WindowsTabbedPaneUI.java,Java,,151,25,51,227
WindowsTableHeaderUI.java,Java,,184,16,46,246
WindowsTextAreaUI.java,Java,,13,7,48,68
WindowsTextFieldUI.java,Java,,69,17,89,175
WindowsTextPaneUI.java,Java,,14,5,48,67
WindowsTextUI.java,Java,,139,14,83,236
WindowsToggleButtonUI.java,Java,,103,27,51,181
WindowsToolBarSeparatorUI.java,Java,,75,19,30,124
WindowsToolBarUI.java,Java,,56,15,28,99
WindowsTreeUI.java,Java,,138,31,73,242
XPStyle.java,Java,,467,93,202,762
SwingUtilities3.java,Java,,130,21,71,222
AnnotatedType.java,Java,,5,5,35,45
AnnotationDesc.java,Java,,10,9,66,85
AnnotationTypeDoc.java,Java,,4,4,36,44
AnnotationTypeElementDoc.java,Java,,4,4,36,44
AnnotationValue.java,Java,,5,5,49,59
ClassDoc.java,Java,,30,29,281,340
ConstructorDoc.java,Java,,3,2,30,35
Doc.java,Java,,29,27,209,265
DocErrorReporter.java,Java,,9,8,66,83
Doclet.java,Java,,16,6,89,111
ExecutableMemberDoc.java,Java,,16,15,117,148
FieldDoc.java,Java,,9,8,62,79
LanguageVersion.java,Java,,5,5,37,47
MemberDoc.java,Java,,4,3,40,47
MethodDoc.java,Java,,10,9,80,99
package-info.java,Java,,2,1,145,148
PackageDoc.java,Java,,13,12,104,129
Parameter.java,Java,,8,7,59,74
ParameterizedType.java,Java,,8,8,92,108
ParamTag.java,Java,,6,5,56,67
ProgramElementDoc.java,Java,,15,13,97,125
RootDoc.java,Java,,9,8,92,109
SeeTag.java,Java,,9,8,109,126
SerialFieldTag.java,Java,,8,7,72,87
SourcePosition.java,Java,,8,6,41,55
Tag.java,Java,,13,11,142,166
ThrowsTag.java,Java,,7,6,66,79
Type.java,Java,,16,15,141,172
TypeVariable.java,Java,,6,7,52,65
WildcardType.java,Java,,5,5,51,61
lr_parser.java,Java,,490,203,558,1251
Scanner.java,Java,,4,3,38,45
Symbol.java,Java,,38,20,71,129
virtual_parse_stack.java,Java,,49,33,87,169
JmxProperties.java,Java,,55,33,144,232
ServiceName.java,Java,,14,11,72,97
DefaultMBeanServerInterceptor.java,Java,,1296,259,514,2069
MBeanServerInterceptor.java,Java,,34,11,85,130
ClassLoaderRepositorySupport.java,Java,,189,36,95,320
ConvertingMethod.java,Java,,161,26,42,229
DefaultMXBeanMappingFactory.java,Java,,1159,161,221,1541
DescriptorCache.java,Java,,35,8,24,67
DynamicMBean2.java,Java,,11,6,60,77
GetPropertyAction.java,Java,,11,5,30,46
Introspector.java,Java,,480,62,274,816
JmxMBeanServer.java,Java,,459,121,942,1522
JmxMBeanServerBuilder.java,Java,,15,5,94,114
MBeanAnalyzer.java,Java,,159,26,90,275
MBeanInstantiator.java,Java,,446,82,258,786
MBeanIntrospector.java,Java,,264,43,164,471
MBeanServerDelegateImpl.java,Java,,170,29,122,321
MBeanSupport.java,Java,,129,25,122,276
ModifiableClassLoaderRepository.java,Java,,11,9,50,70
MXBeanIntrospector.java,Java,,262,35,68,365
MXBeanLookup.java,Java,,101,13,74,188
MXBeanMapping.java,Java,,41,12,157,210
MXBeanMappingFactory.java,Java,,12,5,107,124
MXBeanProxy.java,Java,,117,24,34,175
MXBeanSupport.java,Java,,95,14,69,178
NamedObject.java,Java,,37,17,68,122
ObjectInputStreamWithLoader.java,Java,,25,8,36,69
PerInterface.java,Java,,196,25,59,280
Repository.java,Java,,345,80,253,678
SecureClassLoaderRepository.java,Java,,23,3,38,64
StandardMBeanIntrospector.java,Java,,130,24,39,193
StandardMBeanSupport.java,Java,,36,10,49,95
SunJmxMBeanServer.java,Java,,11,10,69,90
Util.java,Java,,122,23,96,241
WeakIdentityHashMap.java,Java,,64,19,54,137
ArrayNotificationBuffer.java,Java,,551,92,209,852
ArrayQueue.java,Java,,67,10,25,102
ClientCommunicatorAdmin.java,Java,,151,45,57,253
ClientListenerInfo.java,Java,,57,19,30,106
ClientNotifForwarder.java,Java,,596,151,174,921
IIOPHelper.java,Java,,93,21,76,190
IIOPProxy.java,Java,,20,17,73,110
NotificationBuffer.java,Java,,13,4,55,72
NotificationBufferFilter.java,Java,,9,3,28,40
ProxyRef.java,Java,,54,16,33,103
RMIExporter.java,Java,,18,5,36,59
ServerCommunicatorAdmin.java,Java,,135,38,59,232
ServerNotifForwarder.java,Java,,368,64,74,506
Unmarshal.java,Java,,7,3,24,34
ClientProvider.java,Java,,19,5,24,48
IIOPProxyImpl.java,Java,,105,22,30,157
ProxyInputStream.java,Java,,165,49,27,241
ServerProvider.java,Java,,21,6,24,51
ClientProvider.java,Java,,19,5,24,48
ServerProvider.java,Java,,21,6,24,51
FileLoginModule.java,Java,,295,64,211,570
JMXPluggableAuthenticator.java,Java,,187,37,122,346
JMXSubjectDomainCombiner.java,Java,,42,9,55,106
MBeanServerAccessController.java,Java,,377,51,237,665
MBeanServerFileAccessController.java,Java,,300,36,208,544
NotificationAccessController.java,Java,,19,6,85,110
SubjectDelegator.java,Java,,66,12,47,125
ClassLoaderWithRepository.java,Java,,33,8,24,65
ClassLogger.java,Java,,171,44,31,246
EnvHelp.java,Java,,388,79,316,783
OrderClassLoaders.java,Java,,21,6,24,51
AcmChecker.java,Java,,109,14,28,151
LongList.java,Java,,111,30,94,235
SnmpEntryOid.java,Java,,12,3,36,51
SnmpErrorHandlerAgent.java,Java,,81,37,96,214
SnmpGenericMetaServer.java,Java,,15,9,108,132
SnmpGenericObjectServer.java,Java,,259,54,259,572
SnmpIndex.java,Java,,68,21,102,191
SnmpMib.java,Java,,291,99,347,737
SnmpMibAgent.java,Java,,301,66,401,768
SnmpMibAgentMBean.java,Java,,38,29,249,316
SnmpMibEntry.java,Java,,28,12,148,188
SnmpMibGroup.java,Java,,159,61,301,521
SnmpMibHandler.java,Java,,17,13,125,155
SnmpMibNode.java,Java,,113,43,250,406
SnmpMibOid.java,Java,,276,78,212,566
SnmpMibRequest.java,Java,,23,12,140,175
SnmpMibRequestImpl.java,Java,,94,25,138,257
SnmpMibSubRequest.java,Java,,24,10,177,211
SnmpMibTable.java,Java,,875,219,1467,2561
SnmpRequestTree.java,Java,,551,163,377,1091
SnmpStandardMetaServer.java,Java,,11,6,102,119
SnmpStandardObjectServer.java,Java,,50,13,193,256
SnmpTableCallbackHandler.java,Java,,13,3,60,76
SnmpTableEntryFactory.java,Java,,10,5,76,91
SnmpTableEntryNotification.java,Java,,25,18,98,141
SnmpTableSupport.java,Java,,125,51,395,571
SnmpUserDataFactory.java,Java,,10,4,110,124
BerDecoder.java,Java,,380,119,258,757
BerEncoder.java,Java,,196,92,189,477
BerException.java,Java,,18,13,32,63
ClientHandler.java,Java,,57,21,55,133
CommunicationException.java,Java,,20,10,47,77
CommunicatorServer.java,Java,,635,129,609,1373
CommunicatorServerMBean.java,Java,,13,16,142,171
SnmpAdaptorServer.java,Java,,1285,274,1187,2746
SnmpAdaptorServerMBean.java,Java,,100,73,529,702
SnmpInformHandler.java,Java,,8,7,65,80
SnmpInformRequest.java,Java,,686,144,346,1176
SnmpMibTree.java,Java,,159,46,64,269
SnmpQManager.java,Java,,228,52,29,309
SnmpRequestCounter.java,Java,,10,5,20,35
SnmpRequestHandler.java,Java,,753,125,271,1149
SnmpResponseHandler.java,Java,,71,18,22,111
SnmpSendServer.java,Java,,128,24,32,184
SnmpSession.java,Java,,271,53,149,473
SnmpSocket.java,Java,,169,41,88,298
SnmpSubBulkRequestHandler.java,Java,,208,40,95,343
SnmpSubNextRequestHandler.java,Java,,153,25,94,272
SnmpSubRequestHandler.java,Java,,326,85,219,630
SnmpTimerServer.java,Java,,73,18,19,110
DefaultPaths.java,Java,,105,20,120,245
SnmpProperties.java,Java,,32,19,127,178
Enumerated.java,Java,,63,38,120,221
EnumRowStatus.java,Java,,89,29,186,304
InetAddressAcl.java,Java,,15,14,99,128
SnmpAccessControlModel.java,Java,,25,3,64,92
SnmpAccessControlSubSystem.java,Java,,21,2,53,76
SnmpDecryptedPdu.java,Java,,7,1,42,50
SnmpEngineImpl.java,Java,,185,45,194,424
SnmpIncomingRequest.java,Java,,36,9,119,164
SnmpIncomingResponse.java,Java,,29,9,84,122
SnmpLcd.java,Java,,56,16,64,136
SnmpModel.java,Java,,5,1,38,44
SnmpModelLcd.java,Java,,3,2,30,35
SnmpMsgProcessingModel.java,Java,,38,9,100,147
SnmpMsgProcessingSubSystem.java,Java,,51,7,104,162
SnmpOutgoingRequest.java,Java,,21,5,62,88
SnmpSecurityCache.java,Java,,3,1,30,34
SnmpSecurityModel.java,Java,,64,4,108,176
SnmpSecuritySubSystem.java,Java,,65,4,109,178
SnmpSubSystem.java,Java,,12,6,55,73
SnmpTools.java,Java,,67,7,51,125
AclEntryImpl.java,Java,,96,30,137,263
AclImpl.java,Java,,97,25,173,295
ASCII_CharStream.java,Java,,306,56,40,402
GroupImpl.java,Java,,44,19,79,142
Host.java,Java,,120,25,36,181
JDMAccess.java,Java,,25,10,29,64
JDMAclBlock.java,Java,,22,10,33,65
JDMAclItem.java,Java,,23,10,25,58
JDMCommunities.java,Java,,19,9,25,53
JDMCommunity.java,Java,,19,9,25,53
JDMEnterprise.java,Java,,16,8,25,49
JDMHost.java,Java,,15,11,25,51
JDMHostInform.java,Java,,16,7,25,48
JDMHostName.java,Java,,25,12,25,62
JDMHostTrap.java,Java,,16,8,25,49
JDMInformBlock.java,Java,,22,9,33,64
JDMInformCommunity.java,Java,,19,7,25,51
JDMInformInterestedHost.java,Java,,15,6,25,46
JDMInformItem.java,Java,,19,7,25,51
JDMIpAddress.java,Java,,26,12,25,63
JDMIpMask.java,Java,,26,12,25,63
JDMIpV6Address.java,Java,,10,6,25,41
JDMManagers.java,Java,,15,7,25,47
JDMNetMask.java,Java,,26,7,25,58
JDMNetMaskV6.java,Java,,15,6,25,46
JDMSecurityDefs.java,Java,,15,7,25,47
JDMTrapBlock.java,Java,,22,10,33,65
JDMTrapCommunity.java,Java,,19,8,25,52
JDMTrapInterestedHost.java,Java,,15,7,25,47
JDMTrapItem.java,Java,,19,9,25,53
JDMTrapNum.java,Java,,17,8,25,50
JJTParserState.java,Java,,81,20,47,148
NetMaskImpl.java,Java,,160,26,80,266
Node.java,Java,,10,11,39,60
OwnerImpl.java,Java,,45,19,73,137
ParseError.java,Java,,9,4,25,38
ParseException.java,Java,,110,14,93,217
Parser.java,Java,,1175,57,53,1285
ParserConstants.java,Java,,80,6,25,111
ParserTokenManager.java,Java,,1481,8,25,1514
ParserTreeConstants.java,Java,,58,5,25,88
PermissionImpl.java,Java,,25,14,50,89
PrincipalImpl.java,Java,,50,18,80,148
SimpleNode.java,Java,,87,23,45,155
SnmpAcl.java,Java,,248,41,197,486
Token.java,Java,,19,12,76,107
TokenMgrError.java,Java,,73,15,72,160
SnmpMsgTranslator.java,Java,,19,1,72,92
ServiceName.java,Java,,24,23,123,170
SnmpAckPdu.java,Java,,4,0,35,39
SnmpBadSecurityLevelException.java,Java,,7,1,30,38
SnmpCounter.java,Java,,20,12,67,99
SnmpCounter64.java,Java,,71,23,120,214
SnmpDataTypeEnums.java,Java,,25,30,84,139
SnmpDefinitions.java,Java,,82,78,341,501
SnmpEngine.java,Java,,7,3,60,70
SnmpEngineFactory.java,Java,,6,2,50,58
SnmpEngineId.java,Java,,239,49,201,489
SnmpEngineParameters.java,Java,,36,12,69,117
SnmpGauge.java,Java,,20,12,67,99
SnmpInt.java,Java,,99,29,154,282
SnmpIpAddress.java,Java,,92,22,103,217
SnmpMessage.java,Java,,202,27,133,362
SnmpMsg.java,Java,,272,36,168,476
SnmpNull.java,Java,,65,22,96,183
SnmpOid.java,Java,,320,62,260,642
SnmpOidDatabase.java,Java,,13,11,51,75
SnmpOidDatabaseSupport.java,Java,,68,15,57,140
SnmpOidRecord.java,Java,,20,9,61,90
SnmpOidTable.java,Java,,9,10,45,64
SnmpOidTableSupport.java,Java,,77,22,77,176
SnmpOpaque.java,Java,,27,12,61,100
SnmpParameters.java,Java,,96,24,112,232
SnmpParams.java,Java,,16,5,55,76
SnmpPdu.java,Java,,34,10,80,124
SnmpPduBulk.java,Java,,31,12,76,119
SnmpPduBulkType.java,Java,,7,5,46,58
SnmpPduFactory.java,Java,,6,9,79,94
SnmpPduFactoryBER.java,Java,,35,10,86,131
SnmpPduPacket.java,Java,,6,4,31,41
SnmpPduRequest.java,Java,,27,12,70,109
SnmpPduRequestType.java,Java,,7,1,52,60
SnmpPduTrap.java,Java,,13,14,66,93
SnmpPeer.java,Java,,140,58,252,450
SnmpPermission.java,Java,,10,6,22,38
SnmpScopedPduBulk.java,Java,,37,10,63,110
SnmpScopedPduPacket.java,Java,,17,11,76,104
SnmpScopedPduRequest.java,Java,,33,5,57,95
SnmpSecurityException.java,Java,,13,2,52,67
SnmpSecurityParameters.java,Java,,8,2,44,54
SnmpStatusException.java,Java,,33,24,89,146
SnmpString.java,Java,,118,27,133,278
SnmpStringFixed.java,Java,,76,16,101,193
SnmpTimeticks.java,Java,,45,15,69,129
SnmpTooBigException.java,Java,,14,10,58,82
SnmpUnknownAccContrModelException.java,Java,,8,3,36,47
SnmpUnknownModelException.java,Java,,7,1,34,42
SnmpUnknownModelLcdException.java,Java,,7,1,34,42
SnmpUnknownMsgProcModelException.java,Java,,8,3,34,45
SnmpUnknownSecModelException.java,Java,,8,3,34,45
SnmpUnknownSubSystemException.java,Java,,7,1,34,42
SnmpUnsignedInt.java,Java,,32,15,78,125
SnmpUsmKeyHandler.java,Java,,10,8,80,98
SnmpV3Message.java,Java,,301,39,171,511
SnmpValue.java,Java,,19,14,63,96
SnmpVarBind.java,Java,,269,83,381,733
SnmpVarBindList.java,Java,,247,51,255,553
Task.java,Java,,4,1,62,67
TaskServer.java,Java,,4,4,49,57
ThreadService.java,Java,,142,42,62,246
ThreadContext.java,Java,,81,22,223,326
Timestamp.java,Java,,39,20,67,126
UserAcl.java,Java,,11,11,75,97
FactoryEnumeration.java,Java,,52,10,54,116
NamedWeakReference.java,Java,,11,8,29,48
ResourceManager.java,Java,,332,55,261,648
VersionHelper.java,Java,,65,21,69,155
VersionHelper12.java,Java,,173,29,66,268
AccessFlags.java,Java,,74,22,78,174
Attribute.java,Java,,113,41,154,308
AttributeReader.java,Java,,7,2,91,100
ClassFormatException.java,Java,,5,2,64,71
ClassParser.java,Java,,120,41,170,331
Code.java,Java,,152,50,174,376
CodeException.java,Java,,74,21,137,232
Constant.java,Java,,43,13,95,151
ConstantClass.java,Java,,39,14,104,157
ConstantCP.java,Java,,40,12,105,157
ConstantDouble.java,Java,,36,8,101,145
ConstantFieldref.java,Java,,19,6,82,107
ConstantFloat.java,Java,,36,6,102,144
ConstantInteger.java,Java,,36,14,101,151
ConstantInterfaceMethodref.java,Java,,19,6,82,107
ConstantLong.java,Java,,36,5,101,142
ConstantMethodref.java,Java,,19,6,82,107
ConstantNameAndType.java,Java,,48,15,111,174
ConstantObject.java,Java,,4,2,66,72
ConstantPool.java,Java,,160,42,173,375
ConstantString.java,Java,,41,6,103,150
ConstantUtf8.java,Java,,37,14,99,150
ConstantValue.java,Java,,58,14,109,181
Deprecated.java,Java,,48,16,108,172
DescendingVisitor.java,Java,,232,58,80,370
EmptyVisitor.java,Java,,39,4,66,109
ExceptionTable.java,Java,,70,17,118,205
Field.java,Java,,51,16,101,168
FieldOrMethod.java,Java,,83,25,118,226
InnerClass.java,Java,,84,15,125,224
InnerClasses.java,Java,,56,17,111,184
JavaClass.java,Java,,420,122,284,826
LineNumber.java,Java,,44,15,108,167
LineNumberTable.java,Java,,91,28,124,243
LocalVariable.java,Java,,89,28,145,262
LocalVariableTable.java,Java,,70,22,107,199
LocalVariableTypeTable.java,Java,,72,23,51,146
Method.java,Java,,84,26,121,231
Node.java,Java,,4,2,62,68
PMGClass.java,Java,,56,16,120,192
Signature.java,Java,,134,44,121,299
SourceFile.java,Java,,44,13,119,176
StackMap.java,Java,,56,22,110,188
StackMapEntry.java,Java,,90,26,96,212
StackMapType.java,Java,,59,18,98,175
Synthetic.java,Java,,51,14,114,179
Unknown.java,Java,,73,21,122,216
Utility.java,Java,,780,215,402,1397
Visitor.java,Java,,36,2,67,105
Constants.java,Java,,630,35,125,790
ExceptionConstants.java,Java,,36,12,78,126
AALOAD.java,Java,,13,4,73,90
AASTORE.java,Java,,13,4,73,90
ACONST_NULL.java,Java,,16,5,76,97
AllocationInstruction.java,Java,,2,2,62,66
ALOAD.java,Java,,13,4,78,95
ANEWARRAY.java,Java,,33,9,75,117
ARETURN.java,Java,,13,4,74,91
ArithmeticInstruction.java,Java,,31,7,71,109
ArrayInstruction.java,Java,,32,6,71,109
ARRAYLENGTH.java,Java,,15,5,75,95
ArrayType.java,Java,,53,17,89,159
ASTORE.java,Java,,13,4,78,95
ATHROW.java,Java,,14,5,76,95
BALOAD.java,Java,,13,4,73,90
BasicType.java,Java,,33,7,70,110
BASTORE.java,Java,,13,4,73,90
BIPUSH.java,Java,,34,11,89,134
BranchHandle.java,Java,,48,17,88,153
BranchInstruction.java,Java,,99,27,143,269
BREAKPOINT.java,Java,,9,3,70,82
CALOAD.java,Java,,13,4,73,90
CASTORE.java,Java,,13,4,73,90
CHECKCAST.java,Java,,32,8,80,120
ClassGen.java,Java,,224,69,161,454
ClassGenException.java,Java,,5,2,63,70
ClassObserver.java,Java,,4,2,63,69
CodeExceptionGen.java,Java,,78,20,113,211
CompoundInstruction.java,Java,,4,2,72,78
ConstantPoolGen.java,Java,,374,152,263,789
ConstantPushInstruction.java,Java,,4,2,66,72
ConversionInstruction.java,Java,,29,4,71,104
CPInstruction.java,Java,,48,17,104,169
D2F.java,Java,,13,4,73,90
D2I.java,Java,,13,4,73,90
D2L.java,Java,,13,4,73,90
DADD.java,Java,,13,4,74,91
DALOAD.java,Java,,13,4,73,90
DASTORE.java,Java,,13,4,73,90
DCMPG.java,Java,,16,6,74,96
DCMPL.java,Java,,16,5,74,95
DCONST.java,Java,,27,9,78,114
DDIV.java,Java,,13,4,74,91
DLOAD.java,Java,,13,4,78,95
DMUL.java,Java,,13,4,74,91
DNEG.java,Java,,13,4,71,88
DREM.java,Java,,13,4,74,91
DRETURN.java,Java,,13,4,73,90
DSTORE.java,Java,,13,4,78,95
DSUB.java,Java,,13,4,74,91
DUP.java,Java,,12,4,71,87
DUP2.java,Java,,12,4,71,87
DUP2_X1.java,Java,,10,4,71,85
DUP2_X2.java,Java,,10,4,71,85
DUP_X1.java,Java,,10,4,71,85
DUP_X2.java,Java,,10,4,71,85
EmptyVisitor.java,Java,,183,2,62,247
ExceptionThrower.java,Java,,4,2,76,82
F2D.java,Java,,13,4,73,90
F2I.java,Java,,13,4,73,90
F2L.java,Java,,13,4,73,90
FADD.java,Java,,13,4,73,90
FALOAD.java,Java,,13,4,73,90
FASTORE.java,Java,,13,4,73,90
FCMPG.java,Java,,16,5,73,94
FCMPL.java,Java,,16,5,73,94
FCONST.java,Java,,29,9,78,116
FDIV.java,Java,,13,4,73,90
FieldGen.java,Java,,154,53,106,313
FieldGenOrMethodGen.java,Java,,40,14,84,138
FieldInstruction.java,Java,,29,9,80,118
FieldObserver.java,Java,,4,2,63,69
FieldOrMethod.java,Java,,31,9,80,120
FLOAD.java,Java,,13,4,78,95
FMUL.java,Java,,13,4,73,90
FNEG.java,Java,,13,4,71,88
FREM.java,Java,,13,4,73,90
FRETURN.java,Java,,13,4,73,90
FSTORE.java,Java,,13,4,78,95
FSUB.java,Java,,13,4,73,90
GETFIELD.java,Java,,32,11,77,120
GETSTATIC.java,Java,,29,10,77,116
GOTO.java,Java,,35,9,81,125
GotoInstruction.java,Java,,9,3,66,78
GOTO_W.java,Java,,26,6,81,113
I2B.java,Java,,13,4,73,90
I2C.java,Java,,13,4,73,90
I2D.java,Java,,13,4,73,90
I2F.java,Java,,13,4,73,90
I2L.java,Java,,13,4,73,90
I2S.java,Java,,13,4,71,88
IADD.java,Java,,13,4,73,90
IALOAD.java,Java,,13,4,74,91
IAND.java,Java,,13,4,71,88
IASTORE.java,Java,,13,4,74,91
ICONST.java,Java,,26,8,78,112
IDIV.java,Java,,17,5,75,97
IFEQ.java,Java,,16,6,79,101
IFGE.java,Java,,16,6,79,101
IFGT.java,Java,,16,6,79,101
IfInstruction.java,Java,,8,4,72,84
IFLE.java,Java,,16,6,79,101
IFLT.java,Java,,16,6,79,101
IFNE.java,Java,,16,6,79,101
IFNONNULL.java,Java,,16,5,79,100
IFNULL.java,Java,,16,6,79,101
IF_ACMPEQ.java,Java,,16,5,79,100
IF_ACMPNE.java,Java,,16,6,79,101
IF_ICMPEQ.java,Java,,16,6,79,101
IF_ICMPGE.java,Java,,16,6,79,101
IF_ICMPGT.java,Java,,16,6,79,101
IF_ICMPLE.java,Java,,16,6,79,101
IF_ICMPLT.java,Java,,16,6,79,101
IF_ICMPNE.java,Java,,16,6,79,101
IINC.java,Java,,68,19,99,186
ILOAD.java,Java,,13,4,78,95
IMPDEP1.java,Java,,9,4,70,83
IMPDEP2.java,Java,,9,4,70,83
IMUL.java,Java,,13,4,73,90
IndexedInstruction.java,Java,,5,2,63,70
INEG.java,Java,,13,4,71,88
INSTANCEOF.java,Java,,26,8,75,109
Instruction.java,Java,,108,39,161,308
InstructionComparator.java,Java,,37,6,69,112
InstructionConstants.java,Java,,237,8,84,329
InstructionFactory.java,Java,,421,66,139,626
InstructionHandle.java,Java,,110,35,142,287
InstructionList.java,Java,,612,194,483,1289
InstructionListObserver.java,Java,,4,2,63,69
InstructionTargeter.java,Java,,5,2,66,73
InvokeInstruction.java,Java,,45,14,90,149
INVOKEINTERFACE.java,Java,,59,18,89,166
INVOKESPECIAL.java,Java,,30,9,77,116
INVOKESTATIC.java,Java,,28,9,76,113
INVOKEVIRTUAL.java,Java,,30,9,76,115
IOR.java,Java,,13,4,71,88
IREM.java,Java,,17,5,75,97
IRETURN.java,Java,,13,4,73,90
ISHL.java,Java,,13,4,71,88
ISHR.java,Java,,13,4,71,88
ISTORE.java,Java,,13,4,78,95
ISUB.java,Java,,13,4,73,90
IUSHR.java,Java,,13,4,71,88
IXOR.java,Java,,13,4,71,88
JSR.java,Java,,35,9,78,122
JsrInstruction.java,Java,,26,10,82,118
JSR_W.java,Java,,26,6,81,113
L2D.java,Java,,13,4,71,88
L2F.java,Java,,13,4,71,88
L2I.java,Java,,13,4,71,88
LADD.java,Java,,13,4,72,89
LALOAD.java,Java,,13,4,73,90
LAND.java,Java,,13,4,72,89
LASTORE.java,Java,,13,4,73,90
LCMP.java,Java,,17,4,74,95
LCONST.java,Java,,27,9,78,114
LDC.java,Java,,72,16,87,175
LDC2_W.java,Java,,34,9,76,119
LDC_W.java,Java,,15,4,72,91
LDIV.java,Java,,17,5,72,94
LineNumberGen.java,Java,,43,10,83,136
LLOAD.java,Java,,13,4,75,92
LMUL.java,Java,,13,4,72,89
LNEG.java,Java,,13,4,71,88
LoadClass.java,Java,,5,3,81,89
LoadInstruction.java,Java,,18,4,81,103
LocalVariableGen.java,Java,,115,34,141,290
LocalVariableInstruction.java,Java,,99,21,109,229
LOOKUPSWITCH.java,Java,,40,12,84,136
LOR.java,Java,,13,4,71,88
LREM.java,Java,,15,5,71,91
LRETURN.java,Java,,13,4,71,88
LSHL.java,Java,,13,4,71,88
LSHR.java,Java,,13,4,71,88
LSTORE.java,Java,,13,4,75,92
LSUB.java,Java,,13,4,72,89
LUSHR.java,Java,,13,4,71,88
LXOR.java,Java,,13,4,71,88
MethodGen.java,Java,,597,166,326,1089
MethodObserver.java,Java,,4,2,63,69
MONITORENTER.java,Java,,15,5,71,91
MONITOREXIT.java,Java,,15,5,71,91
MULTIANEWARRAY.java,Java,,59,20,96,175
NamedAndTyped.java,Java,,7,3,63,73
NEW.java,Java,,30,9,75,114
NEWARRAY.java,Java,,40,11,92,143
NOP.java,Java,,9,4,70,83
ObjectType.java,Java,,45,12,82,139
POP.java,Java,,12,4,72,88
POP2.java,Java,,12,4,72,88
PopInstruction.java,Java,,3,2,65,70
PUSH.java,Java,,80,14,104,198
PushInstruction.java,Java,,3,2,70,75
PUTFIELD.java,Java,,33,11,77,121
PUTSTATIC.java,Java,,30,10,77,117
ReferenceType.java,Java,,140,40,172,352
RET.java,Java,,54,16,94,164
RETURN.java,Java,,13,4,71,88
ReturnaddressType.java,Java,,27,9,75,111
ReturnInstruction.java,Java,,28,7,71,106
SALOAD.java,Java,,13,4,71,88
SASTORE.java,Java,,13,4,71,88
Select.java,Java,,106,36,125,267
SIPUSH.java,Java,,34,10,87,131
StackConsumer.java,Java,,4,2,64,70
StackInstruction.java,Java,,10,4,71,85
StackProducer.java,Java,,4,2,65,71
StoreInstruction.java,Java,,18,4,81,103
SWAP.java,Java,,12,4,71,87
SWITCH.java,Java,,79,22,85,186
TABLESWITCH.java,Java,,44,16,90,150
TargetLostException.java,Java,,9,4,90,103
Type.java,Java,,147,33,110,290
TypedInstruction.java,Java,,4,2,63,69
UnconditionalBranch.java,Java,,2,2,65,69
VariableLengthInstruction.java,Java,,2,2,68,72
Visitor.java,Java,,183,2,65,250
Repository.java,Java,,85,25,140,250
AttributeHTML.java,Java,,138,47,73,258
BCELFactory.java,Java,,231,64,65,360
BCELifier.java,Java,,183,51,73,307
ByteSequence.java,Java,,16,5,64,85
Class2HTML.java,Java,,138,31,97,266
ClassLoader.java,Java,,91,26,107,224
ClassLoaderRepository.java,Java,,56,18,83,157
ClassPath.java,Java,,189,66,129,384
ClassQueue.java,Java,,14,6,64,84
ClassSet.java,Java,,26,8,65,99
ClassStack.java,Java,,10,3,63,76
ClassVector.java,Java,,14,4,64,82
CodeHTML.java,Java,,381,100,140,621
ConstantHTML.java,Java,,151,39,75,265
InstructionFinder.java,Java,,203,59,181,443
JavaWrapper.java,Java,,54,16,85,155
MethodHTML.java,Java,,94,27,81,202
Repository.java,Java,,12,8,85,105
SecuritySupport.java,Java,,147,21,55,223
SyntheticRepository.java,Java,,82,28,97,207
CharacterArrayCharacterIterator.java,Java,,37,7,32,76
CharacterIterator.java,Java,,8,5,29,42
RE.java,Java,,895,166,699,1760
ReaderCharacterIterator.java,Java,,112,17,35,164
recompile.java,Java,,56,11,70,137
RECompiler.java,Java,,993,181,346,1520
REDebugCompiler.java,Java,,103,25,97,225
REProgram.java,Java,,73,15,70,158
RESyntaxException.java,Java,,8,2,33,43
RETest.java,Java,,640,82,161,883
REUtil.java,Java,,17,4,40,61
StreamCharacterIterator.java,Java,,109,17,35,161
StringCharacterIterator.java,Java,,25,7,30,62
ExpressionContext.java,Java,,17,11,67,95
ExsltBase.java,Java,,43,4,39,86
ExsltCommon.java,Java,,31,4,73,108
ExsltDatetime.java,Java,,564,81,477,1122
ExsltDynamic.java,Java,,296,70,250,616
ExsltMath.java,Java,,157,36,198,391
ExsltSets.java,Java,,104,27,110,241
ExsltStrings.java,Java,,158,33,160,351
Extensions.java,Java,,169,37,182,388
NodeInfo.java,Java,,105,24,121,250
XSLMessages.java,Java,,31,8,54,93
XSLTErrorResources.java,Java,,966,284,197,1447
XSLTErrorResources_de.java,Java,,966,284,197,1447
XSLTErrorResources_en.java,Java,,4,2,27,33
XSLTErrorResources_es.java,Java,,966,284,197,1447
XSLTErrorResources_fr.java,Java,,966,284,197,1447
XSLTErrorResources_it.java,Java,,966,284,197,1447
XSLTErrorResources_ja.java,Java,,966,284,197,1447
XSLTErrorResources_ko.java,Java,,966,284,197,1447
XSLTErrorResources_pt_BR.java,Java,,966,284,197,1447
XSLTErrorResources_sv.java,Java,,966,284,197,1447
XSLTErrorResources_zh_CN.java,Java,,966,284,197,1447
XSLTErrorResources_zh_TW.java,Java,,966,284,197,1447
Constants.java,Java,,278,36,87,401
ConfigurationError.java,Java,,12,9,40,61
FactoryImpl.java,Java,,23,6,28,57
FeatureManager.java,Java,,48,17,59,124
FeaturePropertyBase.java,Java,,86,21,108,215
ObjectFactory.java,Java,,120,21,80,221
SecuritySupport.java,Java,,223,31,91,345
XMLSecurityManager.java,Java,,241,49,176,466
XMLSecurityPropertyManager.java,Java,,44,14,44,102
Version.java,Java,,46,11,98,155
XalanConstants.java,Java,,65,35,166,266
EnvironmentCheck.java,Java,,678,168,407,1253
Process.java,Java,,796,116,314,1226
Compile.java,Java,,111,17,43,171
GetOpt.java,Java,,144,18,96,258
GetOptsException.java,Java,,7,2,25,34
IllegalArgumentException.java,Java,,7,3,22,32
MissingOptArgException.java,Java,,7,3,25,35
Transform.java,Java,,223,26,43,292
CollatorFactory.java,Java,,7,4,26,37
AbsoluteLocationPath.java,Java,,79,13,38,130
AbsolutePathPattern.java,Java,,94,17,31,142
AlternativePattern.java,Java,,54,15,33,102
AncestorPattern.java,Java,,121,26,37,184
ApplyImports.java,Java,,83,22,56,161
ApplyTemplates.java,Java,,144,22,39,205
ArgumentList.java,Java,,14,4,26,44
Attribute.java,Java,,14,5,28,47
AttributeSet.java,Java,,114,28,66,208
AttributeValue.java,Java,,19,5,26,50
AttributeValueTemplate.java,Java,,201,18,43,262
BinOpExpr.java,Java,,85,14,33,132
BooleanCall.java,Java,,25,8,26,59
BooleanExpr.java,Java,,43,10,28,81
CallTemplate.java,Java,,146,29,68,243
CastCall.java,Java,,48,13,41,102
CastExpr.java,Java,,161,29,51,241
CeilingCall.java,Java,,19,5,26,50
Choose.java,Java,,101,18,49,168
Closure.java,Java,,7,6,39,52
Comment.java,Java,,68,12,38,118
CompilerException.java,Java,,23,8,25,56
ConcatCall.java,Java,,59,11,27,97
Constants.java,Java,,429,41,38,508
ContainsCall.java,Java,,50,14,45,109
Copy.java,Java,,103,15,41,159
CopyOf.java,Java,,97,15,31,143
CurrentCall.java,Java,,11,4,26,41
DecimalFormatting.java,Java,,170,28,60,258
DocumentCall.java,Java,,88,23,47,158
ElementAvailableCall.java,Java,,44,9,42,95
EqualityExpr.java,Java,,273,42,46,361
Expression.java,Java,,121,26,77,224
Fallback.java,Java,,32,10,39,81
FilteredAbsoluteLocationPath.java,Java,,77,14,36,127
FilterExpr.java,Java,,149,31,74,254
FilterParentPath.java,Java,,106,21,49,176
FloorCall.java,Java,,17,5,26,48
FlowList.java,Java,,72,14,33,119
ForEach.java,Java,,114,27,56,197
FormatNumberCall.java,Java,,75,13,28,116
FunctionAvailableCall.java,Java,,111,25,60,196
FunctionCall.java,Java,,820,151,177,1148
GenerateIdCall.java,Java,,25,5,27,57
IdKeyPattern.java,Java,,73,20,36,129
IdPattern.java,Java,,6,5,26,37
If.java,Java,,53,11,48,112
IllegalCharException.java,Java,,7,2,26,35
Import.java,Java,,113,19,33,165
Include.java,Java,,111,19,34,164
Instruction.java,Java,,16,4,32,52
IntExpr.java,Java,,25,7,26,58
Key.java,Java,,168,50,83,301
KeyCall.java,Java,,111,26,101,238
KeyPattern.java,Java,,6,4,26,36
LangCall.java,Java,,45,9,39,93
LastCall.java,Java,,37,8,26,71
LiteralAttribute.java,Java,,84,21,54,159
LiteralElement.java,Java,,343,57,136,536
LiteralExpr.java,Java,,40,12,35,87
LocalNameCall.java,Java,,31,9,36,76
LocationPathPattern.java,Java,,58,15,36,109
LogicalExpr.java,Java,,115,33,87,235
Message.java,Java,,104,22,43,169
Mode.java,Java,,951,212,355,1518
NameBase.java,Java,,69,16,45,130
NameCall.java,Java,,24,8,36,68
NamespaceAlias.java,Java,,19,7,31,57
NamespaceUriCall.java,Java,,25,8,36,69
NodeTest.java,Java,,13,5,27,45
NotCall.java,Java,,28,6,26,60
Number.java,Java,,436,76,88,600
NumberCall.java,Java,,35,9,26,70
Otherwise.java,Java,,24,5,26,55
Output.java,Java,,289,53,79,421
Param.java,Java,,153,24,81,258
ParameterRef.java,Java,,62,12,37,111
ParentLocationPath.java,Java,,162,37,53,252
ParentPattern.java,Java,,99,24,30,153
Parser.java,Java,,1058,152,243,1453
Pattern.java,Java,,11,5,46,62
PositionCall.java,Java,,34,8,27,69
Predicate.java,Java,,352,78,189,619
ProcessingInstruction.java,Java,,86,19,37,142
ProcessingInstructionPattern.java,Java,,97,19,44,160
QName.java,Java,,46,14,27,87
RealExpr.java,Java,,25,7,26,58
RelationalExpr.java,Java,,203,36,44,283
RelativeLocationPath.java,Java,,5,2,26,33
RelativePathPattern.java,Java,,2,2,26,30
RoundCall.java,Java,,19,7,27,53
SimpleAttributeValue.java,Java,,28,9,40,77
Sort.java,Java,,496,105,133,734
SourceLoader.java,Java,,5,5,34,44
StartsWithCall.java,Java,,42,12,39,93
Step.java,Java,,334,53,151,538
StepPattern.java,Java,,379,78,77,534
StringCall.java,Java,,41,9,26,76
StringLengthCall.java,Java,,27,5,26,58
Stylesheet.java,Java,,901,202,339,1442
sym.java,Java,,57,3,6,66
SymbolTable.java,Java,,176,37,82,295
SyntaxTreeNode.java,Java,,448,95,359,902
Template.java,Java,,233,57,49,339
TestSeq.java,Java,,135,38,115,288
Text.java,Java,,148,27,72,247
TopLevelElement.java,Java,,44,12,44,100
TransletOutput.java,Java,,76,22,50,148
UnaryOpExpr.java,Java,,45,12,33,90
UnionPathExpr.java,Java,,97,17,34,148
UnparsedEntityUriCall.java,Java,,35,7,30,72
UnresolvedRef.java,Java,,62,14,28,104
UnsupportedElement.java,Java,,80,14,57,151
UseAttributeSets.java,Java,,58,12,48,118
AttributeSetMethodGenerator.java,Java,,44,10,25,79
BooleanType.java,Java,,137,22,66,225
ClassGenerator.java,Java,,81,16,47,144
CompareGenerator.java,Java,,76,17,27,120
ErrorMessages.java,Java,,282,124,616,1022
ErrorMessages_ca.java,Java,,203,107,553,863
ErrorMessages_cs.java,Java,,203,107,553,863
ErrorMessages_de.java,Java,,234,124,616,974
ErrorMessages_es.java,Java,,234,124,616,974
ErrorMessages_fr.java,Java,,234,124,616,974
ErrorMessages_it.java,Java,,234,124,616,974
ErrorMessages_ja.java,Java,,234,124,616,974
ErrorMessages_ko.java,Java,,234,124,616,974
ErrorMessages_pt_BR.java,Java,,234,124,616,974
ErrorMessages_sk.java,Java,,203,107,553,863
ErrorMessages_sv.java,Java,,234,124,616,974
ErrorMessages_zh_CN.java,Java,,234,124,616,974
ErrorMessages_zh_TW.java,Java,,234,124,616,974
ErrorMsg.java,Java,,242,33,51,326
FilterGenerator.java,Java,,22,7,37,66
InternalError.java,Java,,6,1,30,37
IntType.java,Java,,196,29,77,302
MarkerInstruction.java,Java,,25,6,67,98
MatchGenerator.java,Java,,51,15,38,104
MethodGenerator.java,Java,,1155,251,739,2145
MethodType.java,Java,,126,17,30,173
MultiHashtable.java,Java,,37,7,50,94
NamedMethodGenerator.java,Java,,30,8,29,67
NodeCounterGenerator.java,Java,,25,7,43,75
NodeSetType.java,Java,,194,30,107,331
NodeSortRecordFactGenerator.java,Java,,14,5,30,49
NodeSortRecordGenerator.java,Java,,22,7,36,65
NodeType.java,Java,,201,32,91,324
NumberType.java,Java,,9,4,26,39
ObjectType.java,Java,,101,22,56,179
OutlineableChunkEnd.java,Java,,17,5,48,70
OutlineableChunkStart.java,Java,,17,6,57,80
RealType.java,Java,,225,33,85,343
ReferenceType.java,Java,,257,31,91,379
ResultTreeType.java,Java,,272,46,147,465
RtMethodGenerator.java,Java,,33,9,28,70
SlotAllocator.java,Java,,63,13,26,102
StringStack.java,Java,,14,5,26,45
StringType.java,Java,,129,23,79,231
TestGenerator.java,Java,,72,17,28,117
Type.java,Java,,164,38,96,298
TypeCheckError.java,Java,,41,12,26,79
Util.java,Java,,126,29,49,204
VoidType.java,Java,,47,11,42,100
ValueOf.java,Java,,81,14,45,140
Variable.java,Java,,121,21,63,205
VariableBase.java,Java,,172,32,95,299
VariableRef.java,Java,,57,10,30,97
VariableRefBase.java,Java,,79,22,64,165
When.java,Java,,50,14,43,107
Whitespace.java,Java,,337,63,132,532
WithParam.java,Java,,132,24,88,244
XPathLexer.java,Java,,1557,19,43,1619
XPathParser.java,Java,,2639,259,248,3146
XslAttribute.java,Java,,184,39,70,293
XslElement.java,Java,,187,40,66,293
XSLTC.java,Java,,594,117,323,1034
AbsoluteIterator.java,Java,,50,12,39,101
AdaptiveResultTreeImpl.java,Java,,1115,150,81,1346
AnyNodeCounter.java,Java,,82,9,40,131
ArrayNodeListIterator.java,Java,,48,21,22,91
BitArray.java,Java,,159,33,76,268
CachedNodeListIterator.java,Java,,66,16,33,115
ClonedNodeListIterator.java,Java,,37,14,32,83
CollatorFactoryBase.java,Java,,19,8,25,52
CurrentNodeListFilter.java,Java,,7,3,27,37
CurrentNodeListIterator.java,Java,,117,28,56,201
DocumentCache.java,Java,,213,45,80,338
DOMAdapter.java,Java,,357,70,37,464
DOMBuilder.java,Java,,2,2,25,29
DOMWSFilter.java,Java,,63,14,56,133
DupFilterIterator.java,Java,,85,22,59,166
EmptyFilter.java,Java,,6,2,26,34
ExtendedSAX.java,Java,,9,2,25,36
Filter.java,Java,,4,2,26,32
FilteredStepIterator.java,Java,,20,7,29,56
FilterIterator.java,Java,,62,18,40,120
ForwardPositionIterator.java,Java,,41,11,57,109
KeyIndex.java,Java,,382,114,404,900
LoadDocument.java,Java,,195,35,75,305
MatchingIterator.java,Java,,61,18,50,129
MultiDOM.java,Java,,547,106,67,720
MultipleNodeCounter.java,Java,,75,14,31,120
MultiValuedNodeHeapIterator.java,Java,,165,35,96,296
NodeCounter.java,Java,,271,48,97,416
NodeIteratorBase.java,Java,,65,19,88,172
NodeSortRecord.java,Java,,136,30,86,252
NodeSortRecordFactory.java,Java,,92,21,53,166
NthIterator.java,Java,,61,13,43,117
SAXImpl.java,Java,,1155,228,499,1882
SimpleResultTreeImpl.java,Java,,740,172,112,1024
SingleNodeCounter.java,Java,,109,18,31,158
SingletonIterator.java,Java,,53,11,30,94
SortingIterator.java,Java,,99,18,34,151
SortSettings.java,Java,,39,16,85,140
StepIterator.java,Java,,68,16,56,140
StripWhitespaceFilter.java,Java,,5,3,26,34
UnionIterator.java,Java,,53,14,33,100
XSLTCDTMManager.java,Java,,231,45,172,448
DOM.java,Java,,67,9,27,103
DOMCache.java,Java,,4,5,49,58
DOMEnhancedForDTM.java,Java,,12,1,34,47
NodeIterator.java,Java,,15,14,57,86
ProcessorVersion.java,Java,,10,4,37,51
AbstractTranslet.java,Java,,447,105,246,798
Attributes.java,Java,,29,10,26,65
BasisLibrary.java,Java,,1204,156,318,1678
Constants.java,Java,,19,6,28,53
ErrorMessages.java,Java,,57,32,195,284
ErrorMessages_ca.java,Java,,43,24,167,234
ErrorMessages_cs.java,Java,,43,24,167,234
ErrorMessages_de.java,Java,,57,32,195,284
ErrorMessages_es.java,Java,,57,32,195,284
ErrorMessages_fr.java,Java,,57,32,195,284
ErrorMessages_it.java,Java,,57,32,195,284
ErrorMessages_ja.java,Java,,57,32,195,284
ErrorMessages_ko.java,Java,,57,32,195,284
ErrorMessages_pt_BR.java,Java,,57,32,195,284
ErrorMessages_sk.java,Java,,43,24,167,234
ErrorMessages_sv.java,Java,,57,32,195,284
ErrorMessages_zh_CN.java,Java,,57,32,195,284
ErrorMessages_zh_TW.java,Java,,57,32,195,284
InternalRuntimeError.java,Java,,6,4,26,36
MessageHandler.java,Java,,6,2,25,33
Node.java,Java,,9,3,28,40
Operators.java,Java,,26,7,27,60
OutputBuffer.java,Java,,7,4,25,36
StringOutputBuffer.java,Java,,22,8,25,55
TransletOutputHandlerFactory.java,Java,,199,46,27,272
WriterOutputBuffer.java,Java,,55,10,32,97
Parameter.java,Java,,16,5,27,48
StringValueHandler.java,Java,,76,18,33,127
StripFilter.java,Java,,4,3,26,33
Translet.java,Java,,24,7,26,57
TransletException.java,Java,,15,6,27,48
DOM2SAX.java,Java,,308,54,122,484
DOM2TO.java,Java,,260,58,118,436
OutputSettings.java,Java,,17,7,25,49
SAX2DOM.java,Java,,217,45,75,337
SAX2StAXBaseWriter.java,Java,,155,50,43,248
SAX2StAXEventWriter.java,Java,,223,151,46,420
SAX2StAXStreamWriter.java,Java,,139,110,53,302
SmartTransformerFactoryImpl.java,Java,,289,35,131,455
StAXEvent2SAX.java,Java,,372,76,152,600
StAXStream2SAX.java,Java,,313,74,146,533
TemplatesHandlerImpl.java,Java,,174,47,131,352
TemplatesImpl.java,Java,,275,62,190,527
TransformerFactoryImpl.java,Java,,996,156,464,1616
TransformerHandlerImpl.java,Java,,297,55,161,513
TransformerImpl.java,Java,,873,124,415,1412
TrAXFilter.java,Java,,99,20,29,148
Util.java,Java,,178,34,45,257
XSLTCSource.java,Java,,75,19,48,142
IntegerArray.java,Java,,158,33,37,228
AttributeMap.java,Java,,362,70,174,606
AttrImpl.java,Java,,573,159,507,1239
AttrNSImpl.java,Java,,182,34,136,352
CDATASectionImpl.java,Java,,17,11,61,89
CharacterDataImpl.java,Java,,163,75,187,425
ChildNode.java,Java,,35,24,91,150
CommentImpl.java,Java,,18,11,42,71
CoreDocumentImpl.java,Java,,1397,326,1147,2870
CoreDOMImplementationImpl.java,Java,,257,24,207,488
DeepNodeListImpl.java,Java,,113,31,103,247
DeferredAttrImpl.java,Java,,32,20,93,145
DeferredAttrNSImpl.java,Java,,40,24,66,130
DeferredCDATASectionImpl.java,Java,,21,18,70,109
DeferredCommentImpl.java,Java,,21,18,51,90
DeferredDocumentImpl.java,Java,,1296,369,493,2158
DeferredDocumentTypeImpl.java,Java,,75,34,78,187
DeferredDOMImplementationImpl.java,Java,,9,8,41,58
DeferredElementDefinitionImpl.java,Java,,39,26,61,126
DeferredElementImpl.java,Java,,40,25,73,138
DeferredElementNSImpl.java,Java,,61,29,71,161
DeferredEntityImpl.java,Java,,40,27,86,153
DeferredEntityReferenceImpl.java,Java,,31,22,102,155
DeferredNode.java,Java,,6,8,29,43
DeferredNotationImpl.java,Java,,27,20,70,117
DeferredProcessingInstructionImpl.java,Java,,23,18,53,94
DeferredTextImpl.java,Java,,22,20,65,107
DocumentFragmentImpl.java,Java,,48,17,90,155
DocumentImpl.java,Java,,697,130,552,1379
DocumentTypeImpl.java,Java,,277,81,200,558
DOMConfigurationImpl.java,Java,,651,140,312,1103
DOMErrorImpl.java,Java,,47,27,62,136
DOMImplementationImpl.java,Java,,51,19,81,151
DOMImplementationListImpl.java,Java,,23,8,44,75
DOMImplementationSourceImpl.java,Java,,73,10,53,136
DOMInputImpl.java,Java,,96,45,250,391
DOMLocatorImpl.java,Java,,57,29,76,162
DOMMessageFormatter.java,Java,,82,10,51,143
DOMNormalizer.java,Java,,1172,250,626,2048
DOMOutputImpl.java,Java,,35,24,114,173
DOMStringListImpl.java,Java,,28,12,50,90
DOMXSImplementationSourceImpl.java,Java,,39,9,52,100
ElementDefinitionImpl.java,Java,,35,20,66,121
ElementImpl.java,Java,,577,144,457,1178
ElementNSImpl.java,Java,,263,58,168,489
EntityImpl.java,Java,,136,65,166,367
EntityReferenceImpl.java,Java,,139,41,222,402
EventImpl.java,Java,,56,15,64,135
MutationEventImpl.java,Java,,49,12,51,112
LCount.java,Java,,13,4,33,50
NamedNodeMapImpl.java,Java,,325,81,224,630
NodeImpl.java,Java,,878,213,932,2023
NodeIteratorImpl.java,Java,,179,68,127,374
NodeListCache.java,Java,,13,10,36,59
NotationImpl.java,Java,,81,33,98,212
ParentNode.java,Java,,505,120,412,1037
ProcessingInstructionImpl.java,Java,,44,24,93,161
PSVIAttrNSImpl.java,Java,,91,38,124,253
PSVIDocumentImpl.java,Java,,55,21,74,150
PSVIDOMImplementationImpl.java,Java,,32,13,79,124
PSVIElementNSImpl.java,Java,,106,44,146,296
RangeExceptionImpl.java,Java,,8,5,24,37
RangeImpl.java,Java,,1273,181,631,2085
TextImpl.java,Java,,318,92,255,665
TreeWalkerImpl.java,Java,,279,93,135,507
Constants.java,Java,,345,210,386,941
BalancedDTDGrammar.java,Java,,114,27,147,288
DTDGrammar.java,Java,,1451,390,810,2651
DTDGrammarBucket.java,Java,,36,17,59,112
CMAny.java,Java,,63,25,104,192
CMBinOp.java,Java,,71,15,105,191
CMLeaf.java,Java,,66,25,95,186
CMNode.java,Java,,53,16,121,190
CMStateSet.java,Java,,189,27,127,343
CMUniOp.java,Java,,36,14,93,143
ContentModelValidator.java,Java,,5,6,77,88
DFAContentModel.java,Java,,368,118,547,1033
MixedContentModel.java,Java,,91,26,141,258
SimpleContentModel.java,Java,,92,35,193,320
XML11DTDProcessor.java,Java,,40,14,74,128
XML11DTDValidator.java,Java,,33,13,80,126
XML11NSDTDValidator.java,Java,,130,23,113,266
XMLAttributeDecl.java,Java,,17,11,82,110
XMLContentSpec.java,Java,,72,43,221,336
XMLDTDDescription.java,Java,,107,18,104,229
XMLDTDLoader.java,Java,,298,49,212,559
XMLDTDProcessor.java,Java,,766,233,753,1752
XMLDTDValidator.java,Java,,1061,288,720,2069
XMLDTDValidatorFilter.java,Java,,7,7,79,93
XMLElementDecl.java,Java,,29,19,93,141
XMLEntityDecl.java,Java,,38,17,103,158
XMLNotationDecl.java,Java,,19,11,82,112
XMLNSDTDValidator.java,Java,,133,29,113,275
XMLSimpleType.java,Java,,69,34,109,212
DatatypeException.java,Java,,41,12,57,110
DatatypeValidator.java,Java,,6,5,34,45
DTDDVFactoryImpl.java,Java,,34,9,38,81
ENTITYDatatypeValidator.java,Java,,10,8,50,68
IDDatatypeValidator.java,Java,,23,9,52,84
IDREFDatatypeValidator.java,Java,,20,9,49,78
ListDatatypeValidator.java,Java,,19,8,41,68
NMTOKENDatatypeValidator.java,Java,,12,6,39,57
NOTATIONDatatypeValidator.java,Java,,8,6,41,55
StringDatatypeValidator.java,Java,,8,6,46,60
XML11DTDDVFactoryImpl.java,Java,,32,6,41,79
XML11IDDatatypeValidator.java,Java,,24,9,53,86
XML11IDREFDatatypeValidator.java,Java,,21,9,50,80
XML11NMTOKENDatatypeValidator.java,Java,,13,6,40,59
DTDDVFactory.java,Java,,32,11,58,101
DVFactoryException.java,Java,,10,5,27,42
InvalidDatatypeFacetException.java,Java,,7,5,36,48
InvalidDatatypeValueException.java,Java,,7,5,76,88
SchemaDVFactory.java,Java,,29,16,104,149
Base64.java,Java,,198,52,57,307
ByteListImpl.java,Java,,38,13,55,106
HexBin.java,Java,,67,8,40,115
ValidatedInfo.java,Java,,22,11,65,98
ValidationContext.java,Java,,16,13,38,67
AbstractDateTimeDV.java,Java,,775,119,284,1178
AnyAtomicDV.java,Java,,11,6,27,44
AnySimpleDV.java,Java,,11,6,29,46
AnyURIDV.java,Java,,105,14,52,171
Base64BinaryDV.java,Java,,50,11,33,94
BaseDVFactory.java,Java,,138,30,82,250
BaseSchemaDVFactory.java,Java,,217,45,67,329
BooleanDV.java,Java,,19,8,28,55
DateDV.java,Java,,42,13,40,95
DateTimeDV.java,Java,,39,15,42,96
DayDV.java,Java,,55,17,47,119
DayTimeDurationDV.java,Java,,29,6,28,63
DecimalDV.java,Java,,287,45,60,392
DoubleDV.java,Java,,159,25,76,260
DurationDV.java,Java,,251,55,84,390
EntityDV.java,Java,,20,8,28,56
ExtendedSchemaDVFactoryImpl.java,Java,,26,10,50,86
FloatDV.java,Java,,144,26,71,241
FullDVFactory.java,Java,,94,25,49,168
HexBinaryDV.java,Java,,50,11,30,91
IDDV.java,Java,,21,6,28,55
IDREFDV.java,Java,,18,7,28,53
IntegerDV.java,Java,,12,5,27,44
ListDV.java,Java,,84,17,36,137
MonthDayDV.java,Java,,60,18,53,131
MonthDV.java,Java,,58,14,96,168
PrecisionDecimalDV.java,Java,,292,59,95,446
QNameDV.java,Java,,56,16,39,111
SchemaDateTimeException.java,Java,,10,5,24,39
SchemaDVFactoryImpl.java,Java,,18,11,48,77
StringDV.java,Java,,12,6,28,46
TimeDV.java,Java,,45,14,54,113
TypeValidator.java,Java,,35,16,59,110
UnionDV.java,Java,,11,6,30,47
XSSimpleTypeDecl.java,Java,,2387,349,662,3398
XSSimpleTypeDelegate.java,Java,,147,45,27,219
YearDV.java,Java,,58,16,53,127
YearMonthDurationDV.java,Java,,30,6,28,64
YearMonthDV.java,Java,,42,13,46,101
XSFacets.java,Java,,46,21,69,136
XSSimpleType.java,Java,,39,14,150,203
ExternalSubsetResolver.java,Java,,11,7,48,66
ASCIIReader.java,Java,,78,24,145,247
MalformedByteSequenceException.java,Java,,38,19,82,139
UCSReader.java,Java,,131,25,155,311
UTF8Reader.java,Java,,444,68,204,716
XMLMessageFormatter.java,Java,,54,12,55,121
XMLMessageFormatter_de.java,Java,,55,13,55,123
XMLMessageFormatter_es.java,Java,,55,13,55,123
XMLMessageFormatter_fr.java,Java,,55,13,55,123
XMLMessageFormatter_it.java,Java,,55,13,55,123
XMLMessageFormatter_ja.java,Java,,55,13,55,123
XMLMessageFormatter_ko.java,Java,,55,13,55,123
XMLMessageFormatter_pt_BR.java,Java,,55,13,55,123
XMLMessageFormatter_sv.java,Java,,55,13,55,123
XMLMessageFormatter_zh_CN.java,Java,,55,13,55,123
XMLMessageFormatter_zh_TW.java,Java,,55,13,55,123
PropertyManager.java,Java,,127,29,64,220
RevalidationHandler.java,Java,,6,5,73,84
EntityState.java,Java,,5,4,40,49
ValidationManager.java,Java,,32,13,40,85
ValidationState.java,Java,,123,30,59,212
Version.java,Java,,11,10,81,102
XML11DocumentScannerImpl.java,Java,,307,33,170,510
XML11DTDScannerImpl.java,Java,,111,23,122,256
XML11EntityScanner.java,Java,,1068,95,336,1499
XML11NamespaceBinder.java,Java,,8,10,88,106
XML11NSDocumentScannerImpl.java,Java,,537,103,252,892
XMLDocumentFragmentScannerImpl.java,Java,aa,1637,441,1214,3292
XMLDocumentScannerImpl.java,Java,,781,229,489,1499
XMLDTDScannerImpl.java,Java,,1359,211,630,2200
XMLEntityDescription.java,Java,,6,6,38,50
XMLEntityHandler.java,Java,,11,7,101,119
XMLEntityManager.java,Java,,1698,363,974,3035
XMLEntityScanner.java,Java,,1437,197,684,2318
XMLErrorReporter.java,Java,,204,72,336,612
XMLNamespaceBinder.java,Java,,350,108,431,889
XMLNSDocumentScannerImpl.java,Java,,350,92,206,648
XMLScanner.java,Java,,926,174,457,1557
XMLStreamFilterImpl.java,Java,,223,57,253,533
XMLStreamReaderImpl.java,Java,,792,143,431,1366
XMLVersionDetector.java,Java,,123,31,84,238
BMPattern.java,Java,,170,12,55,237
CaseInsensitiveMap.java,Java,,120,28,28,176
Match.java,Java,,98,14,74,186
Op.java,Java,,211,11,32,254
ParseException.java,Java,,12,6,37,55
ParserForXMLSchema.java,Java,,430,31,52,513
RangeToken.java,Java,,492,29,102,623
RegexParser.java,Java,,1062,82,97,1241
RegularExpression.java,Java,,1472,203,771,2446
REUtil.java,Java,,260,25,50,335
Token.java,Java,,1294,163,117,1574
XPath.java,Java,,1362,156,508,2026
XPathException.java,Java,,17,9,35,61
AttributePSVImpl.java,Java,,78,31,113,222
ElementPSVImpl.java,Java,,98,39,140,277
Field.java,Java,,117,37,95,249
FieldActivator.java,Java,,9,10,69,88
IdentityConstraint.java,Java,,120,38,92,250
KeyRef.java,Java,,18,11,43,72
Selector.java,Java,,107,42,108,257
UniqueOrKey.java,Java,,9,6,36,51
ValueStore.java,Java,,6,9,55,70
XPathMatcher.java,Java,,275,59,188,522
CMBuilder.java,Java,,271,37,142,450
CMNodeFactory.java,Java,,81,28,59,168
XSAllCM.java,Java,,98,36,90,224
XSCMBinOp.java,Java,,60,15,66,141
XSCMLeaf.java,Java,,54,25,56,135
XSCMRepeatingLeaf.java,Java,,17,6,28,51
XSCMUniOp.java,Java,,36,15,61,112
XSCMValidator.java,Java,,16,16,79,111
XSDFACM.java,Java,,585,135,522,1242
XSEmptyCM.java,Java,,38,24,79,141
AttrImpl.java,Java,,50,16,86,152
DefaultDocument.java,Java,,115,63,113,291
DefaultElement.java,Java,,75,45,31,151
DefaultNode.java,Java,,121,65,32,218
DefaultText.java,Java,,54,16,168,238
DefaultXMLDocumentHandler.java,Java,,174,69,628,871
ElementImpl.java,Java,,178,57,39,274
NamedNodeMapImpl.java,Java,,48,15,25,88
NodeImpl.java,Java,,39,22,26,87
SchemaDOM.java,Java,,319,55,87,461
SchemaDOMImplementation.java,Java,,31,10,26,67
SchemaDOMParser.java,Java,,287,68,256,611
SchemaParsingConfig.java,Java,,500,156,375,1031
TextImpl.java,Java,,50,16,64,130
SchemaGrammar.java,Java,,1074,218,396,1688
SchemaNamespaceSupport.java,Java,,50,8,54,112
SchemaSymbols.java,Java,,164,14,39,217
SubstitutionGroupHandler.java,Java,,198,36,118,352
SchemaContentHandler.java,Java,,255,36,91,382
StAXSchemaParser.java,Java,,338,31,56,425
XSAnnotationInfo.java,Java,,30,9,33,72
XSAttributeChecker.java,Java,,1233,129,460,1822
XSDAbstractIDConstraintTraverser.java,Java,,132,18,44,194
XSDAbstractParticleTraverser.java,Java,,229,45,111,385
XSDAbstractTraverser.java,Java,,669,58,126,853
XSDAttributeGroupTraverser.java,Java,,119,36,54,209
XSDAttributeTraverser.java,Java,,314,61,113,488
XSDComplexTypeTraverser.java,Java,,896,141,222,1259
XSDElementTraverser.java,Java,,357,67,141,565
XSDGroupTraverser.java,Java,,185,30,54,269
XSDHandler.java,Java,,3124,432,780,4336
XSDKeyrefTraverser.java,Java,,69,14,42,125
XSDNotationTraverser.java,Java,,77,15,42,134
XSDocumentInfo.java,Java,,132,39,81,252
XSDSimpleTypeTraverser.java,Java,,360,35,127,522
XSDUniqueOrKeyTraverser.java,Java,,49,14,39,102
XSDWildcardTraverser.java,Java,,94,22,86,202
LSInputListImpl.java,Java,,54,16,56,126
ObjectListImpl.java,Java,,68,16,35,119
ShortListImpl.java,Java,,54,16,54,124
SimpleLocator.java,Java,,73,24,50,147
StringListImpl.java,Java,,91,19,56,166
XInt.java,Java,,19,9,24,52
XIntPool.java,Java,,15,4,24,43
XSGrammarPool.java,Java,,32,9,33,74
XSInputSource.java,Java,,30,11,25,66
XSNamedMap4Types.java,Java,,59,11,74,144
XSNamedMapImpl.java,Java,,179,21,102,302
XSObjectListImpl.java,Java,,182,29,56,267
XMLSchemaException.java,Java,,16,7,30,53
XMLSchemaLoader.java,Java,,931,144,319,1394
XMLSchemaValidator.java,Java,,2517,573,1217,4307
XSAnnotationImpl.java,Java,,91,17,79,187
XSAttributeDecl.java,Java,,107,24,84,215
XSAttributeGroupDecl.java,Java,,212,54,136,402
XSAttributeUseImpl.java,Java,,67,18,68,153
XSComplexTypeDecl.java,Java,,382,99,238,719
XSConstraints.java,Java,,1030,208,295,1533
XSDDescription.java,Java,,111,23,140,274
XSDeclarationPool.java,Java,,218,53,47,318
XSElementDecl.java,Java,,199,40,149,388
XSGrammarBucket.java,Java,,111,23,106,240
XSGroupDecl.java,Java,,39,14,58,111
XSImplementationImpl.java,Java,,41,17,61,119
XSLoaderImpl.java,Java,,174,32,116,322
XSMessageFormatter.java,Java,,36,11,48,95
XSModelGroupImpl.java,Java,,136,28,82,246
XSModelImpl.java,Java,,514,69,226,809
XSNotationDecl.java,Java,,42,16,63,121
XSParticleDecl.java,Java,,135,26,87,248
XSWildcardDecl.java,Java,,311,81,207,599
DatatypeFactoryImpl.java,Java,,133,34,485,652
DurationDayTimeImpl.java,Java,,69,20,107,196
DurationImpl.java,Java,,838,184,998,2020
DurationYearMonthImpl.java,Java,,51,18,131,200
XMLGregorianCalendarImpl.java,Java,,1367,267,1456,3090
DefaultValidationErrorHandler.java,Java,,31,7,24,62
DocumentBuilderFactoryImpl.java,Java,,143,20,59,222
DocumentBuilderImpl.java,Java,,279,49,85,413
JAXPConstants.java,Java,,9,4,28,41
JAXPValidatorComponent.java,Java,,364,85,150,599
SAXParserFactoryImpl.java,Java,,129,25,58,212
SAXParserImpl.java,Java,,517,71,150,738
SchemaValidatorConfiguration.java,Java,,96,27,69,192
TeeXMLDocumentFilterImpl.java,Java,,106,30,40,176
UnparsedEntityHandler.java,Java,,179,40,43,262
AbstractXMLSchema.java,Java,,32,16,61,109
DOMDocumentHandler.java,Java,,18,12,59,89
DOMResultAugmentor.java,Java,,183,41,34,258
DOMResultBuilder.java,Java,,274,49,50,373
DOMValidatorHelper.java,Java,,412,70,131,613
DraconianErrorHandler.java,Java,,20,10,32,62
EmptyXMLSchema.java,Java,,24,16,33,73
ErrorHandlerAdaptor.java,Java,,35,8,79,122
JAXPValidationMessageFormatter.java,Java,,51,8,43,102
ReadOnlyGrammarPool.java,Java,,24,12,29,65
SimpleXMLSchema.java,Java,,32,17,32,81
SoftReferenceGrammarPool.java,Java,,221,41,173,435
StAXValidatorHelper.java,Java,,73,14,32,119
StreamValidatorHelper.java,Java,,122,29,47,198
Util.java,Java,,36,9,32,77
ValidatorHandlerImpl.java,Java,,771,141,175,1087
ValidatorHelper.java,Java,,9,6,25,40
ValidatorImpl.java,Java,,198,31,52,281
WeakReferenceXMLSchema.java,Java,,18,10,34,62
WrappedSAXException.java,Java,,8,3,76,87
XMLSchema.java,Java,,14,9,43,66
XMLSchemaFactory.java,Java,,396,65,86,547
XMLSchemaValidatorComponentManager.java,Java,,317,83,161,561
XSGrammarPoolContainer.java,Java,,10,10,55,75
AbstractDOMParser.java,Java,,1597,298,762,2657
AbstractSAXParser.java,Java,,1128,282,1007,2417
AbstractXMLDocumentParser.java,Java,,170,73,569,812
BasicParserConfiguration.java,Java,,207,80,299,586
CachingParserPool.java,Java,,117,56,257,430
DOMParser.java,Java,,369,72,226,667
DOMParserImpl.java,Java,,995,156,241,1392
DTDConfiguration.java,Java,,438,128,317,883
DTDParser.java,Java,,100,40,341,481
IntegratedParserConfiguration.java,Java,,111,31,109,251
NonValidatingConfiguration.java,Java,,390,126,290,806
SAXParser.java,Java,,82,25,72,179
SecurityConfiguration.java,Java,,27,12,75,114
StandardParserConfiguration.java,Java,,148,62,175,385
XIncludeAwareParserConfiguration.java,Java,,177,34,86,297
XIncludeParserConfiguration.java,Java,,119,31,71,221
XML11Configurable.java,Java,,2,2,26,30
XML11Configuration.java,Java,,831,218,513,1562
XML11DTDConfiguration.java,Java,,671,189,475,1335
XML11NonValidatingConfiguration.java,Java,,607,184,439,1230
XMLDocumentParser.java,Java,,24,9,46,79
XMLGrammarCachingConfiguration.java,Java,,111,40,161,312
XMLGrammarParser.java,Java,,12,8,34,54
XMLGrammarPreparser.java,Java,,156,37,148,341
XMLParser.java,Java,,46,29,80,155
XPointerParserConfiguration.java,Java,,127,43,73,243
AttributesProxy.java,Java,,110,33,49,192
AugmentationsImpl.java,Java,,175,53,58,286
DatatypeMessageFormatter.java,Java,,52,9,43,104
DefaultErrorHandler.java,Java,,48,18,50,116
DOMEntityResolverWrapper.java,Java,,79,25,66,170
DOMErrorHandlerWrapper.java,Java,,257,48,117,422
DOMInputSource.java,Java,,37,11,28,76
DOMUtil.java,Java,,562,146,193,901
DraconianErrorHandler.java,Java,,17,4,69,90
EncodingMap.java,Java,,439,36,506,981
EntityResolver2Wrapper.java,Java,,91,32,92,215
EntityResolverWrapper.java,Java,,59,20,62,141
ErrorHandlerProxy.java,Java,,35,7,38,80
ErrorHandlerWrapper.java,Java,,96,28,108,232
FeatureState.java,Java,,25,10,29,64
HTTPInputSource.java,Java,,46,20,129,195
IntStack.java,Java,,52,17,47,116
JAXPNamespaceContextWrapper.java,Java,,90,26,34,150
LocatorProxy.java,Java,,28,16,44,88
LocatorWrapper.java,Java,,20,8,82,110
MessageFormatter.java,Java,,7,6,47,60
NamespaceContextWrapper.java,Java,,35,10,45,90
NamespaceSupport.java,Java,,216,71,197,484
ParserConfigurationSettings.java,Java,,135,51,146,332
PrimeNumberSequenceGenerator.java,Java,,19,4,22,45
PropertyState.java,Java,,23,10,29,62
SAX2XNI.java,Java,,138,33,85,256
SAXInputSource.java,Java,,88,18,58,164
SAXLocatorWrapper.java,Java,,63,19,29,111
SAXMessageFormatter.java,Java,,51,7,44,102
SecurityManager.java,Java,,66,22,127,215
ShadowedSymbolTable.java,Java,,26,18,77,121
Status.java,Java,,22,8,29,59
StAXInputSource.java,Java,,55,15,25,95
StAXLocationWrapper.java,Java,,55,20,31,106
SymbolHash.java,Java,,161,43,125,329
SymbolTable.java,Java,,199,69,199,467
SynchronizedSymbolTable.java,Java,,34,23,72,129
TeeXMLDocumentFilterImpl.java,Java,,106,29,82,217
URI.java,Java,,1178,209,823,2210
XML11Char.java,Java,,211,35,169,415
XMLAttributesImpl.java,Java,,577,122,597,1296
XMLAttributesIteratorImpl.java,Java,,33,14,55,102
XMLCatalogResolver.java,Java,,228,59,299,586
XMLChar.java,Java,,790,49,226,1065
XMLDocumentFilterImpl.java,Java,,83,28,71,182
XMLEntityDescriptionImpl.java,Java,,69,19,93,181
XMLErrorCode.java,Java,,22,9,53,84
XMLGrammarPoolImpl.java,Java,,157,32,177,366
XMLInputSourceAdaptor.java,Java,,22,6,79,107
XMLResourceIdentifierImpl.java,Java,,116,32,82,230
XMLStringBuffer.java,Java,,77,23,130,230
XMLSymbols.java,Java,,21,25,57,103
ConfigurationError.java,Java,,12,9,37,58
ObjectFactory.java,Java,,125,20,86,231
SecuritySupport.java,Java,,223,28,88,339
XMLLimitAnalyzer.java,Java,,136,24,104,264
XMLSecurityManager.java,Java,,310,60,211,581
XMLSecurityPropertyManager.java,Java,,98,24,103,225
MultipleScopeNamespaceSupport.java,Java,,109,21,66,196
SecuritySupport.java,Java,,106,16,30,152
XInclude11TextReader.java,Java,,14,5,43,62
XIncludeHandler.java,Java,,2048,293,739,3080
XIncludeMessageFormatter.java,Java,,36,10,44,90
XIncludeNamespaceSupport.java,Java,,30,9,56,95
XIncludeTextReader.java,Java,,301,44,171,516
XPointerElementHandler.java,Java,,455,123,185,763
XPointerFramework.java,Java,,122,23,64,209
XPointerSchema.java,Java,,13,12,20,45
Augmentations.java,Java,,9,15,65,89
Grammar.java,Java,,4,4,47,55
XMLDTDDescription.java,Java,,4,4,29,37
XMLGrammarDescription.java,Java,,7,8,44,59
XMLGrammarLoader.java,Java,,28,18,101,147
XMLGrammarPool.java,Java,,9,9,87,105
XMLSchemaDescription.java,Java,,19,11,108,138
XSGrammar.java,Java,,6,6,43,55
NamespaceContext.java,Java,,16,20,143,179
XMLComponent.java,Java,,13,11,102,126
XMLComponentManager.java,Java,,13,11,66,90
XMLConfigurationException.java,Java,,26,14,59,99
XMLDocumentFilter.java,Java,,5,5,26,36
XMLDocumentScanner.java,Java,,10,7,58,75
XMLDocumentSource.java,Java,,6,7,36,49
XMLDTDContentModelFilter.java,Java,,5,4,26,35
XMLDTDContentModelSource.java,Java,,6,7,77,90
XMLDTDFilter.java,Java,,5,4,26,35
XMLDTDScanner.java,Java,,16,9,84,109
XMLDTDSource.java,Java,,6,7,36,49
XMLEntityResolver.java,Java,,8,7,46,61
XMLErrorHandler.java,Java,,10,8,88,106
XMLInputSource.java,Java,,77,31,146,254
XMLParseException.java,Java,,96,28,57,181
XMLParserConfiguration.java,Java,,34,29,190,253
XMLPullParserConfiguration.java,Java,,10,10,77,97
QName.java,Java,,90,25,128,243
XMLAttributes.java,Java,,33,40,366,439
XMLDocumentFragmentHandler.java,Java,,35,18,206,259
XMLDocumentHandler.java,Java,,33,25,238,296
XMLDTDContentModelHandler.java,Java,,25,25,223,273
XMLDTDHandler.java,Java,,59,30,289,378
XMLLocator.java,Java,,12,14,53,79
XMLResourceIdentifier.java,Java,,13,14,37,64
XMLString.java,Java,,58,22,111,191
XNIException.java,Java,,23,12,61,96
ElementSchemePointer.java,Java,,430,131,318,879
ShortHandPointer.java,Java,,121,38,137,296
XPointerErrorHandler.java,Java,,47,17,51,115
XPointerHandler.java,Java,,656,152,440,1248
XPointerMessageFormatter.java,Java,,40,10,47,97
XPointerPart.java,Java,,19,14,99,132
XPointerProcessor.java,Java,,15,11,78,104
AttributePSVI.java,Java,,4,3,26,33
ByteList.java,Java,,8,7,49,64
ObjectList.java,Java,,7,6,49,62
XSDateTime.java,Java,,19,16,258,293
XSDecimal.java,Java,,11,8,48,67
XSDouble.java,Java,,4,3,28,35
XSFloat.java,Java,,4,3,28,35
XSQName.java,Java,,5,4,30,39
ElementPSVI.java,Java,,7,6,37,50
ItemPSVI.java,Java,,24,14,151,189
LSInputList.java,Java,,7,6,37,50
PSVIProvider.java,Java,,7,5,81,93
ShortList.java,Java,,8,6,45,59
StringList.java,Java,,7,6,44,57
XSAnnotation.java,Java,,9,5,49,63
XSAttributeDeclaration.java,Java,,16,11,84,111
XSAttributeGroupDefinition.java,Java,,7,5,36,48
XSAttributeUse.java,Java,,14,9,76,99
XSComplexTypeDefinition.java,Java,,17,13,86,116
XSConstants.java,Java,,84,7,254,345
XSElementDeclaration.java,Java,,24,19,137,180
XSException.java,Java,,11,5,40,56
XSFacet.java,Java,,8,6,40,54
XSIDCDefinition.java,Java,,11,8,53,72
XSImplementation.java,Java,,6,5,40,51
XSLoader.java,Java,,10,8,75,93
XSModel.java,Java,,22,14,125,161
XSModelGroup.java,Java,,10,6,50,66
XSModelGroupDefinition.java,Java,,6,4,32,42
XSMultiValueFacet.java,Java,,6,5,32,43
XSNamedMap.java,Java,,8,6,55,69
XSNamespaceItem.java,Java,,13,12,85,110
XSNamespaceItemList.java,Java,,6,5,37,48
XSNotationDeclaration.java,Java,,7,5,37,49
XSObject.java,Java,,7,6,45,58
XSObjectList.java,Java,,6,5,37,48
XSParticle.java,Java,,8,6,41,55
XSSimpleTypeDefinition.java,Java,,42,23,177,242
XSTerm.java,Java,,3,2,25,30
XSTypeDefinition.java,Java,,15,9,81,105
XSWildcard.java,Java,,14,8,68,90
Axis.java,Java,,74,29,119,222
DTM.java,Java,,95,95,779,969
DTMAxisIterator.java,Java,,17,15,80,112
DTMAxisTraverser.java,Java,,14,5,99,118
DTMConfigurationException.java,Java,,26,8,67,101
DTMDOMException.java,Java,,13,2,41,56
DTMException.java,Java,,175,64,146,385
DTMFilter.java,Java,,21,20,149,190
DTMIterator.java,Java,,32,33,281,346
DTMManager.java,Java,,99,47,295,441
DTMWSFilter.java,Java,,8,5,45,58
ChunkedIntArray.java,Java,,146,22,140,308
CoroutineManager.java,Java,,91,23,232,346
CoroutineParser.java,Java,,14,13,115,142
CustomStringPool.java,Java,,34,7,50,91
DOM2DTM.java,Java,,904,190,671,1765
DOM2DTMdefaultNamespaceDeclarationNode.java,Java,,219,42,419,680
DTMAxisIteratorBase.java,Java,,101,40,142,283
DTMAxisIterNodeList.java,Java,,57,10,77,144
DTMChildIterNodeList.java,Java,,32,8,81,121
DTMDefaultBase.java,Java,,1026,291,1054,2371
DTMDefaultBaseIterators.java,Java,,1140,327,728,2195
DTMDefaultBaseTraversers.java,Java,,744,212,791,1747
DTMDocumentImpl.java,Java,,728,238,1447,2413
DTMManagerDefault.java,Java,,388,104,369,861
DTMNamedNodeMap.java,Java,,101,26,175,302
DTMNodeIterator.java,Java,,66,20,102,188
DTMNodeList.java,Java,,40,8,81,129
DTMNodeListBase.java,Java,,12,4,67,83
DTMNodeProxy.java,Java,,946,190,1279,2415
DTMSafeStringPool.java,Java,,60,14,38,112
DTMStringPool.java,Java,,100,25,68,193
DTMTreeWalker.java,Java,,237,55,113,405
EmptyIterator.java,Java,,21,18,25,64
ExpandedNameTable.java,Java,,168,50,175,393
ExtendedType.java,Java,,65,11,71,147
IncrementalSAXSource.java,Java,,12,11,68,91
IncrementalSAXSource_Filter.java,Java,,428,63,322,813
IncrementalSAXSource_Xerces.java,Java,,263,46,148,457
NodeLocator.java,Java,,39,9,64,112
SAX2DTM.java,Java,,1127,358,1055,2540
SAX2DTM2.java,Java,,1937,494,954,3385
SAX2RTFDTM.java,Java,,135,41,188,364
XMLErrorResources.java,Java,,244,95,111,450
XMLErrorResources_ca.java,Java,,239,91,113,443
XMLErrorResources_cs.java,Java,,239,91,113,443
XMLErrorResources_de.java,Java,,244,95,111,450
XMLErrorResources_en.java,Java,,4,2,27,33
XMLErrorResources_es.java,Java,,244,95,111,450
XMLErrorResources_fr.java,Java,,244,95,111,450
XMLErrorResources_it.java,Java,,244,95,111,450
XMLErrorResources_ja.java,Java,,244,95,111,450
XMLErrorResources_ko.java,Java,,244,95,111,450
XMLErrorResources_pt_BR.java,Java,,244,95,111,450
XMLErrorResources_sk.java,Java,,239,91,113,443
XMLErrorResources_sv.java,Java,,244,95,111,450
XMLErrorResources_tr.java,Java,,239,91,113,443
XMLErrorResources_zh_CN.java,Java,,244,95,111,450
XMLErrorResources_zh_HK.java,Java,,4,3,70,77
XMLErrorResources_zh_TW.java,Java,,244,95,111,450
XMLMessages.java,Java,,72,22,65,159
Catalog.java,Java,,1114,283,807,2204
CatalogEntry.java,Java,,89,25,137,251
CatalogException.java,Java,,58,13,97,168
CatalogManager.java,Java,,388,108,350,846
BootstrapResolver.java,Java,,112,26,62,200
Debug.java,Java,,29,9,73,111
FileURL.java,Java,,11,5,77,93
Namespaces.java,Java,,39,13,62,114
PublicId.java,Java,,63,20,78,161
CatalogReader.java,Java,,12,6,63,81
DOMCatalogParser.java,Java,,6,4,43,53
DOMCatalogReader.java,Java,,102,19,122,243
ExtendedXMLCatalogReader.java,Java,,108,27,52,187
OASISXMLCatalogReader.java,Java,,389,78,74,541
SAXCatalogParser.java,Java,,6,4,35,45
SAXCatalogReader.java,Java,,316,55,131,502
SAXParserHandler.java,Java,,96,21,33,150
TextCatalogReader.java,Java,,179,36,88,303
TR9401CatalogReader.java,Java,,70,17,56,143
XCatalogReader.java,Java,,102,26,60,188
Resolver.java,Java,,355,66,273,694
CatalogResolver.java,Java,,172,37,134,343
ResolvingParser.java,Java,,263,57,126,446
ResolvingXMLFilter.java,Java,,188,42,123,353
ResolvingXMLReader.java,Java,,35,9,53,97
Algorithm.java,Java,,25,7,47,79
ClassLoaderUtils.java,Java,,167,26,87,280
IntegrityHmac.java,Java,,259,63,217,539
SignatureBaseRSA.java,Java,,196,47,101,344
SignatureDSA.java,Java,,176,34,89,299
SignatureECDSA.java,Java,,262,72,122,456
JCEMapper.java,Java,,254,25,77,356
MessageDigestAlgorithm.java,Java,,96,28,131,255
SignatureAlgorithm.java,Java,,230,40,195,465
SignatureAlgorithmSpi.java,Java,,32,20,125,177
CanonicalizationException.java,Java,,22,8,58,88
Canonicalizer.java,Java,,172,37,193,402
CanonicalizerSpi.java,Java,,51,20,98,169
AttrCompare.java,Java,,48,12,62,122
C14nHelper.java,Java,,61,15,79,155
Canonicalizer11.java,Java,,497,45,145,687
Canonicalizer11_OmitComments.java,Java,,13,5,25,43
Canonicalizer11_WithComments.java,Java,,13,5,25,43
Canonicalizer20010315.java,Java,,263,34,98,395
Canonicalizer20010315Excl.java,Java,,194,29,109,332
Canonicalizer20010315ExclOmitComments.java,Java,,13,5,27,45
Canonicalizer20010315ExclWithComments.java,Java,,13,5,31,49
Canonicalizer20010315OmitComments.java,Java,,13,5,31,49
Canonicalizer20010315WithComments.java,Java,,13,5,30,48
CanonicalizerBase.java,Java,,645,82,165,892
CanonicalizerPhysical.java,Java,,77,24,83,184
NameSpaceSymbTable.java,Java,,252,50,106,408
UtfHelpper.java,Java,,144,11,25,180
InvalidCanonicalizerException.java,Java,,22,8,53,83
AbstractSerializer.java,Java,,123,20,106,249
AgreementMethod.java,Java,,16,12,129,157
CipherData.java,Java,,10,9,76,95
CipherReference.java,Java,,8,6,81,95
CipherValue.java,Java,,5,2,39,46
DocumentSerializer.java,Java,,60,11,43,114
EncryptedData.java,Java,,3,2,41,46
EncryptedKey.java,Java,,9,8,96,113
EncryptedType.java,Java,,19,18,160,197
EncryptionMethod.java,Java,,17,14,102,133
EncryptionProperties.java,Java,,9,8,70,87
EncryptionProperty.java,Java,,14,11,96,121
Reference.java,Java,,11,7,81,99
ReferenceList.java,Java,,13,11,85,109
Serializer.java,Java,,12,7,58,77
Transforms.java,Java,,4,2,44,50
XMLCipher.java,Java,,2060,421,1058,3539
XMLCipherInput.java,Java,,100,22,70,192
XMLCipherParameters.java,Java,,41,20,25,86
XMLEncryptionException.java,Java,,20,8,52,80
AlgorithmAlreadyRegisteredException.java,Java,,21,7,53,81
Base64DecodingException.java,Java,,19,8,55,82
XMLSecurityException.java,Java,,73,27,116,216
XMLSecurityRuntimeException.java,Java,,73,26,113,212
Init.java,Java,,258,46,74,378
DEREncodedKeyValue.java,Java,,68,16,74,158
KeyInfoContent.java,Java,,3,1,27,31
KeyInfoReference.java,Java,,36,10,61,107
KeyName.java,Java,,21,7,44,72
KeyValue.java,Java,,66,21,70,157
DSAKeyValue.java,Java,,71,13,47,131
KeyValueContent.java,Java,,6,5,28,39
RSAKeyValue.java,Java,,65,14,45,124
MgmtData.java,Java,,22,7,44,73
PGPData.java,Java,,13,4,34,51
RetrievalMethod.java,Java,,58,15,62,135
SPKIData.java,Java,,14,4,34,52
XMLX509Certificate.java,Java,,86,19,63,168
XMLX509CRL.java,Java,,21,7,42,70
XMLX509DataContent.java,Java,,3,1,27,31
XMLX509Digest.java,Java,,51,13,75,139
XMLX509IssuerSerial.java,Java,,69,18,74,161
XMLX509SKI.java,Java,,74,22,87,183
XMLX509SubjectName.java,Java,,41,13,52,106
X509Data.java,Java,,218,62,259,539
ContentHandlerAlreadyRegisteredException.java,Java,,22,9,53,84
KeyInfo.java,Java,,659,143,485,1287
DEREncodedKeyValueResolver.java,Java,,50,17,16,83
DSAKeyValueResolver.java,Java,,53,13,36,102
EncryptedKeyResolver.java,Java,,81,15,54,150
KeyInfoReferenceResolver.java,Java,,187,40,63,290
PrivateKeyResolver.java,Java,,235,45,73,353
RetrievalMethodResolver.java,Java,,270,23,98,391
RSAKeyValueResolver.java,Java,,54,14,28,96
SecretKeyResolver.java,Java,,62,11,56,129
SingleKeyResolver.java,Java,,88,17,67,172
X509CertificateResolver.java,Java,,59,12,55,126
X509DigestResolver.java,Java,,103,31,30,164
X509IssuerSerialResolver.java,Java,,102,22,26,150
X509SKIResolver.java,Java,,85,22,50,157
X509SubjectNameResolver.java,Java,,101,26,49,176
InvalidKeyResolverException.java,Java,,20,8,53,81
KeyResolver.java,Java,,203,43,176,422
KeyResolverException.java,Java,,20,8,53,81
KeyResolverSpi.java,Java,,100,24,137,261
KeyUtils.java,Java,,35,13,35,83
CertsInFilesystemDirectoryResolver.java,Java,,134,32,63,229
KeyStoreResolver.java,Java,,77,21,55,153
SingleCertificateResolver.java,Java,,35,13,46,94
StorageResolver.java,Java,,81,25,82,188
StorageResolverException.java,Java,,21,9,53,83
StorageResolverSpi.java,Java,,6,3,27,36
InvalidDigestValueException.java,Java,,19,7,60,86
InvalidSignatureValueException.java,Java,,19,7,59,85
Manifest.java,Java,,304,71,234,609
MissingResourceFailureException.java,Java,,31,13,80,124
NodeFilter.java,Java,,6,5,44,55
ObjectContainer.java,Java,,46,13,78,137
ReferenceData.java,Java,,2,1,31,34
ReferenceNodeSetData.java,Java,,6,5,42,53
ReferenceOctetStreamData.java,Java,,31,8,66,105
ReferenceSubTreeData.java,Java,,109,14,58,181
Reference.java,Java,,428,92,282,802
ReferenceNotInitializedException.java,Java,,19,7,59,85
SignatureProperties.java,Java,,63,15,70,148
SignatureProperty.java,Java,,43,12,78,133
SignedInfo.java,Java,,197,42,158,397
XMLSignature.java,Java,,420,100,354,874
XMLSignatureException.java,Java,,20,8,59,87
XMLSignatureInput.java,Java,,280,56,256,592
XMLSignatureInputDebugger.java,Java,,387,126,117,630
ClassLoaderUtils.java,Java,,167,26,87,280
FuncHere.java,Java,,64,23,65,152
TransformBase64Decode.java,Java,,99,12,66,177
TransformC14N.java,Java,,30,6,32,68
TransformC14N11.java,Java,,28,5,28,61
TransformC14N11_WithComments.java,Java,,28,7,28,63
TransformC14NExclusive.java,Java,,54,10,32,96
TransformC14NExclusiveWithComments.java,Java,,52,10,34,96
TransformC14NWithComments.java,Java,,30,8,31,69
TransformEnvelopedSignature.java,Java,,68,17,57,142
TransformXPath.java,Java,,84,17,63,164
TransformXPath2Filter.java,Java,,209,29,58,296
TransformXPointer.java,Java,,20,9,36,65
TransformXSLT.java,Java,,87,24,56,167
InvalidTransformException.java,Java,,20,8,57,85
InclusiveNamespaces.java,Java,,66,19,85,170
XPath2FilterContainer.java,Java,,120,40,132,292
XPath2FilterContainer04.java,Java,,107,31,114,252
XPathContainer.java,Java,,28,9,45,82
XPathFilterCHGPContainer.java,Java,,134,41,141,316
Transform.java,Java,,208,31,137,376
TransformationException.java,Java,,20,7,57,84
TransformParam.java,Java,,3,2,22,27
Transforms.java,Java,,167,44,131,342
TransformSpi.java,Java,,29,7,76,112
Base64.java,Java,,471,116,211,798
ClassLoaderUtils.java,Java,,167,26,84,277
Constants.java,Java,,78,73,122,273
DigesterOutputStream.java,Java,,31,9,35,75
DOMNamespaceContext.java,Java,,45,10,24,79
ElementChecker.java,Java,,10,3,28,41
ElementCheckerImpl.java,Java,,52,11,27,90
ElementProxy.java,Java,,254,66,201,521
EncryptionConstants.java,Java,,91,61,87,239
EncryptionElementProxy.java,Java,,16,6,41,63
HelperNodeList.java,Java,,35,11,52,98
I18n.java,Java,,71,13,84,168
IdResolver.java,Java,,15,7,42,64
IgnoreAllErrorHandler.java,Java,,36,11,34,81
JavaUtils.java,Java,,144,31,89,264
JDKXPathAPI.java,Java,,75,10,47,132
JDKXPathFactory.java,Java,,6,3,28,37
ResolverAnonymous.java,Java,,35,11,38,84
ResolverDirectHTTP.java,Java,,156,42,75,273
ResolverFragment.java,Java,,80,13,56,149
ResolverLocalFilesystem.java,Java,,97,22,42,161
ResolverXPointer.java,Java,,94,24,62,180
ResourceResolver.java,Java,,180,34,160,374
ResourceResolverContext.java,Java,,14,7,22,43
ResourceResolverException.java,Java,,44,18,76,138
ResourceResolverSpi.java,Java,,90,28,122,240
RFC2253Parser.java,Java,,236,79,159,474
Signature11ElementProxy.java,Java,,22,8,40,70
SignatureElementProxy.java,Java,,22,8,40,70
SignerOutputStream.java,Java,,41,8,32,81
UnsyncBufferedOutputStream.java,Java,,49,14,35,98
UnsyncByteArrayOutputStream.java,Java,,64,11,28,103
XalanXPathAPI.java,Java,,126,26,58,210
XalanXPathFactory.java,Java,,6,3,28,37
XMLUtils.java,Java,,600,101,339,1040
XPathAPI.java,Java,,12,7,47,66
XPathFactory.java,Java,,27,8,36,71
BaseMarkupSerializer.java,Java,,1220,262,485,1967
DOMSerializer.java,Java,,14,15,50,79
DOMSerializerImpl.java,Java,,853,75,283,1211
ElementState.java,Java,,16,30,62,108
EncodingInfo.java,Java,,143,31,97,271
Encodings.java,Java,,67,13,44,124
HTMLdtd.java,Java,,270,85,201,556
HTMLSerializer.java,Java,,521,94,261,876
IndentPrinter.java,Java,,162,58,145,365
LineSeparator.java,Java,,8,14,35,57
Method.java,Java,,9,16,38,63
OutputFormat.java,Java,,332,159,470,961
Printer.java,Java,,198,64,102,364
SecuritySupport.java,Java,,106,16,30,152
Serializer.java,Java,,18,21,84,123
SerializerFactory.java,Java,,61,27,63,151
SerializerFactoryImpl.java,Java,,64,25,27,116
TextSerializer.java,Java,,189,74,127,390
XHTMLSerializer.java,Java,,29,18,57,104
XML11Serializer.java,Java,,311,64,162,537
XMLSerializer.java,Java,,888,170,406,1464
AttributesImplSerializer.java,Java,,103,21,114,238
CharInfo.java,Java,,318,91,337,746
DOMSerializer.java,Java,,7,3,58,68
ElemContext.java,Java,,57,18,146,221
ElemDesc.java,Java,,55,36,89,180
EmptySerializer.java,Java,,438,21,293,752
EncodingInfo.java,Java,,188,45,281,514
Encodings.java,Java,,265,54,247,566
ExtendedContentHandler.java,Java,,49,17,207,273
ExtendedLexicalHandler.java,Java,,6,2,33,41
Method.java,Java,,11,7,60,78
NamespaceMappings.java,Java,,157,33,137,327
OutputPropertiesFactory.java,Java,,261,50,228,539
OutputPropertyUtils.java,Java,,21,8,56,85
SerializationHandler.java,Java,,31,14,89,134
Serializer.java,Java,,17,11,195,223
SerializerBase.java,Java,,591,152,659,1402
SerializerConstants.java,Java,,19,7,35,61
SerializerFactory.java,Java,,73,21,85,179
SerializerTrace.java,Java,,22,24,109,155
SerializerTraceWriter.java,Java,,152,44,147,343
ToHTMLSAXHandler.java,Java,,284,65,398,747
ToHTMLStream.java,Java,,1384,240,696,2320
ToSAXHandler.java,Java,,204,48,188,440
ToStream.java,Java,,1762,337,1290,3389
ToTextSAXHandler.java,Java,,215,55,144,414
ToTextStream.java,Java,,247,54,335,636
ToUnknownStream.java,Java,,674,154,510,1338
ToXMLSAXHandler.java,Java,,407,102,269,778
ToXMLStream.java,Java,,360,71,225,656
TransformStateSetter.java,Java,,8,6,44,58
TreeWalker.java,Java,,315,70,125,510
AttList.java,Java,,86,22,157,265
BoolStack.java,Java,,67,27,112,206
DOM2Helper.java,Java,,30,14,92,136
Messages.java,Java,,104,22,146,272
MsgKey.java,Java,,58,6,38,102
SerializerMessages.java,Java,,82,41,82,205
SerializerMessages_ca.java,Java,,73,35,22,130
SerializerMessages_cs.java,Java,,65,31,26,122
SerializerMessages_de.java,Java,,82,41,82,205
SerializerMessages_en.java,Java,,4,2,26,32
SerializerMessages_es.java,Java,,82,41,82,205
SerializerMessages_fr.java,Java,,82,41,82,205
SerializerMessages_it.java,Java,,82,41,82,205
SerializerMessages_ja.java,Java,,82,41,82,205
SerializerMessages_ko.java,Java,,82,41,82,205
SerializerMessages_pt_BR.java,Java,,82,41,82,205
SerializerMessages_sv.java,Java,,82,41,82,205
SerializerMessages_zh_CN.java,Java,,82,41,82,205
SerializerMessages_zh_TW.java,Java,,82,41,82,205
StringToIntTable.java,Java,,82,35,88,205
SystemIDResolver.java,Java,,154,27,123,304
URI.java,Java,,913,220,538,1671
Utils.java,Java,,7,1,35,43
WrappedRuntimeException.java,Java,,20,9,54,83
Version.java,Java,,46,11,95,152
WriterChain.java,Java,,14,4,66,84
WriterToASCI.java,Java,,49,15,93,157
WriterToUTF8Buffered.java,Java,,225,53,227,505
XSLOutputAttributes.java,Java,,24,12,148,184
AttList.java,Java,,86,22,148,256
BoolStack.java,Java,,72,29,103,204
CharKey.java,Java,,24,9,53,86
Constants.java,Java,,32,9,73,114
DefaultErrorHandler.java,Java,,143,31,170,344
DOM2Helper.java,Java,,90,32,194,316
DOMBuilder.java,Java,,263,87,440,790
DOMHelper.java,Java,,619,167,544,1330
DOMOrder.java,Java,,5,2,36,43
ElemDesc.java,Java,,57,37,99,193
FastStringBuffer.java,Java,,539,192,567,1298
Hashtree2Node.java,Java,,69,12,61,142
IntStack.java,Java,,86,25,102,213
IntVector.java,Java,,177,70,174,421
ListingErrorHandler.java,Java,,236,65,266,567
LocaleUtility.java,Java,,45,15,28,88
MutableAttrListImpl.java,Java,,51,18,72,141
NameSpace.java,Java,,14,6,41,61
NodeConsumer.java,Java,,6,3,33,42
NodeVector.java,Java,,338,133,270,741
NSInfo.java,Java,,33,15,64,112
ObjectPool.java,Java,,69,22,84,175
ObjectStack.java,Java,,88,27,102,217
ObjectVector.java,Java,,183,74,176,433
PrefixResolver.java,Java,,8,5,61,74
PrefixResolverDefault.java,Java,,65,17,65,147
QName.java,Java,,343,94,274,711
RawCharacterHandler.java,Java,,6,2,36,44
CharArrayWrapper.java,Java,,13,4,27,44
IntArrayWrapper.java,Java,,13,4,27,44
LongArrayWrapper.java,Java,,13,4,27,44
StringArrayWrapper.java,Java,,13,4,27,44
XResourceBundle.java,Java,,33,5,37,75
XResourceBundleBase.java,Java,,7,4,41,52
XResources_de.java,Java,,22,6,48,76
XResources_en.java,Java,,22,6,48,76
XResources_es.java,Java,,22,6,48,76
XResources_fr.java,Java,,22,6,48,76
XResources_it.java,Java,,22,6,48,76
XResources_ja_JP_A.java,Java,,38,8,43,89
XResources_ja_JP_HA.java,Java,,38,8,43,89
XResources_ja_JP_HI.java,Java,,38,8,44,90
XResources_ja_JP_I.java,Java,,37,8,44,89
XResources_ko.java,Java,,34,8,41,83
XResources_sv.java,Java,,22,6,48,76
XResources_zh_CN.java,Java,,34,8,41,83
XResources_zh_TW.java,Java,,34,8,41,83
SAXSourceLocator.java,Java,,52,13,107,172
SerializableLocatorImpl.java,Java,,52,33,142,227
StopParseException.java,Java,,9,1,32,42
StringBufferPool.java,Java,,15,4,43,62
StringComparable.java,Java,,155,28,32,215
StringToIntTable.java,Java,,82,35,81,198
StringToStringTable.java,Java,,104,40,100,244
StringToStringTableVector.java,Java,,80,32,89,201
StringVector.java,Java,,92,41,92,225
StylesheetPIHandler.java,Java,,206,33,103,342
SuballocatedByteVector.java,Java,,267,37,196,500
SuballocatedIntVector.java,Java,,290,47,222,559
SystemIDResolver.java,Java,,154,27,116,297
ThreadControllerWrapper.java,Java,,50,15,61,126
TreeWalker.java,Java,,292,72,125,489
Trie.java,Java,,93,24,90,207
UnImplNode.java,Java,,634,274,1146,2054
URI.java,Java,,924,221,547,1692
WrappedRuntimeException.java,Java,,20,9,47,76
WrongParserException.java,Java,,9,2,31,42
XML11Char.java,Java,,222,41,169,432
XMLChar.java,Java,,322,80,267,669
XMLCharacterRecognizer.java,Java,,41,15,55,111
XMLReaderManager.java,Java,,143,25,89,257
XMLString.java,Java,,48,40,603,691
XMLStringDefault.java,Java,,174,43,603,820
XMLStringFactory.java,Java,,10,5,58,73
XMLStringFactoryDefault.java,Java,,21,5,60,86
Arg.java,Java,,102,28,137,267
AttributeIterator.java,Java,,23,8,46,77
AxesWalker.java,Java,,274,79,239,592
BasicTestIterator.java,Java,,111,27,89,227
ChildIterator.java,Java,,45,15,63,123
ChildTestIterator.java,Java,,54,22,104,180
ContextNodeList.java,Java,,18,14,106,138
DescendantIterator.java,Java,,226,48,109,383
FilterExprIterator.java,Java,,98,26,92,216
FilterExprIteratorSimple.java,Java,,159,38,119,316
FilterExprWalker.java,Java,,156,43,153,352
HasPositionalPredChecker.java,Java,,55,11,59,125
IteratorPool.java,Java,,51,11,59,121
LocPathIterator.java,Java,,363,123,549,1035
MatchPatternIterator.java,Java,,198,44,91,333
NodeSequence.java,Java,,496,97,368,961
OneStepIterator.java,Java,,163,52,132,347
OneStepIteratorForward.java,Java,,49,20,105,174
PathComponent.java,Java,,5,2,30,37
PredicatedNodeTest.java,Java,,333,76,240,649
ReverseAxesWalker.java,Java,,109,38,102,249
RTFIterator.java,Java,,9,4,31,44
SelfIteratorNoPredicate.java,Java,,47,15,68,130
SubContextList.java,Java,,7,4,43,54
UnionChildIterator.java,Java,,72,13,67,152
UnionPathIterator.java,Java,,323,77,186,586
WalkerFactory.java,Java,,1244,195,388,1827
WalkingIterator.java,Java,,167,52,146,365
WalkingIteratorSorted.java,Java,,73,18,125,216
CachedXPathAPI.java,Java,,85,32,220,337
Compiler.java,Java,,609,149,512,1270
FuncLoader.java,Java,,40,12,57,109
FunctionTable.java,Java,,232,58,120,410
Keywords.java,Java,,119,69,202,390
Lexer.java,Java,,422,88,154,664
OpCodes.java,Java,,68,66,500,634
OpMap.java,Java,,192,57,208,457
OpMapVector.java,Java,,36,22,60,118
PsuedoNames.java,Java,,10,7,44,61
XPathDumper.java,Java,,4,3,26,33
XPathParser.java,Java,,1264,395,744,2403
XPathEvaluatorImpl.java,Java,,68,26,179,273
XPathExpressionImpl.java,Java,,60,18,107,185
XPathNamespaceImpl.java,Java,,131,49,144,324
XPathNSResolverImpl.java,Java,,12,6,45,63
XPathResultImpl.java,Java,,232,60,220,512
XPathStylesheetDOM3Exception.java,Java,,9,4,50,63
Expression.java,Java,,194,56,341,591
ExpressionNode.java,Java,,10,5,38,53
ExpressionOwner.java,Java,,6,4,36,46
ExtensionsProvider.java,Java,,16,7,39,62
FoundIndex.java,Java,,6,2,31,39
FuncBoolean.java,Java,,12,4,34,50
FuncCeiling.java,Java,,12,3,34,49
FuncConcat.java,Java,,33,10,49,92
FuncContains.java,Java,,17,7,35,59
FuncCount.java,Java,,16,6,44,66
FuncCurrent.java,Java,,37,8,39,84
FuncDoclocation.java,Java,,27,8,38,73
FuncExtElementAvailable.java,Java,,41,8,50,99
FuncExtFunction.java,Java,,146,43,153,342
FuncExtFunctionAvailable.java,Java,,55,9,42,106
FuncFalse.java,Java,,15,5,38,58
FuncFloor.java,Java,,12,3,34,49
FuncGenerateId.java,Java,,19,5,40,64
FuncId.java,Java,,82,22,49,153
FuncLang.java,Java,,39,10,35,84
FuncLast.java,Java,,40,12,56,108
FuncLocalPart.java,Java,,20,5,34,59
FuncNamespace.java,Java,,35,9,36,80
FuncNormalizeSpace.java,Java,,36,6,46,88
FuncNot.java,Java,,12,3,34,49
FuncNumber.java,Java,,12,3,34,49
FuncPosition.java,Java,,60,14,62,136
FuncQname.java,Java,,25,6,34,65
FuncRound.java,Java,,17,3,34,54
FuncStartsWith.java,Java,,13,3,34,50
FuncString.java,Java,,12,3,34,49
FuncStringLength.java,Java,,12,3,34,49
FuncSubstring.java,Java,,61,14,51,126
FuncSubstringAfter.java,Java,,18,5,34,57
FuncSubstringBefore.java,Java,,16,5,34,55
FuncSum.java,Java,,26,7,34,67
FuncSystemProperty.java,Java,,111,23,54,188
Function.java,Java,,49,14,83,146
Function2Args.java,Java,,79,21,86,186
Function3Args.java,Java,,79,21,85,185
FunctionDef1Arg.java,Java,,68,13,88,169
FunctionMultiArgs.java,Java,,121,29,88,238
FunctionOneArg.java,Java,,71,20,85,176
FuncTranslate.java,Java,,34,11,45,90
FuncTrue.java,Java,,15,5,38,58
FuncUnparsedEntityURI.java,Java,,18,6,33,57
WrongNumberArgsException.java,Java,,9,3,33,45
JAXPExtensionsProvider.java,Java,,129,30,55,214
JAXPPrefixResolver.java,Java,,55,24,49,128
JAXPVariableStack.java,Java,,36,10,28,74
XPathExpressionImpl.java,Java,,181,34,165,380
XPathFactoryImpl.java,Java,,138,38,152,328
XPathImpl.java,Java,,257,49,231,537
NodeSet.java,Java,,598,234,540,1372
NodeSetDTM.java,Java,,399,167,683,1249
DTMXRTreeFrag.java,Java,,27,7,26,60
XBoolean.java,Java,,58,21,91,170
XBooleanStatic.java,Java,,22,6,43,71
XMLStringFactoryImpl.java,Java,,29,8,66,103
XNodeSet.java,Java,,408,102,461,971
XNodeSetForDOM.java,Java,,56,15,59,130
XNull.java,Java,,39,12,81,132
XNumber.java,Java,,136,43,260,439
XObject.java,Java,,287,106,368,761
XObjectFactory.java,Java,,107,11,45,163
XRTreeFrag.java,Java,,143,33,127,303
XRTreeFragSelectWrapper.java,Java,,59,14,83,156
XString.java,Java,,356,95,673,1124
XStringForChars.java,Java,,70,23,125,218
XStringForFSB.java,Java,,402,122,464,988
And.java,Java,,24,8,45,77
Bool.java,Java,,20,6,44,70
Div.java,Java,,18,6,45,69
Equals.java,Java,,23,6,47,76
Gt.java,Java,,12,3,36,51
Gte.java,Java,,13,3,36,52
Lt.java,Java,,12,3,36,51
Lte.java,Java,,12,3,36,51
Minus.java,Java,,18,6,46,70
Mod.java,Java,,18,6,45,69
Mult.java,Java,,18,5,45,68
Neg.java,Java,,17,6,44,67
NotEquals.java,Java,,12,3,36,51
Number.java,Java,,20,7,44,71
Operation.java,Java,,92,26,96,214
Or.java,Java,,24,8,45,77
Plus.java,Java,,18,6,45,69
Quo.java,Java,,12,4,38,54
String.java,Java,,11,3,35,49
UnaryOperation.java,Java,,59,21,85,165
Variable.java,Java,,130,46,223,399
VariableSafeAbsRef.java,Java,,24,5,46,75
ContextMatchStepPattern.java,Java,,95,24,62,181
FunctionPattern.java,Java,,112,40,98,250
NodeTest.java,Java,,297,102,295,694
NodeTestFilter.java,Java,,5,2,34,41
StepPattern.java,Java,,601,136,318,1055
UnionPattern.java,Java,,116,29,75,220
XPATHErrorResources.java,Java,,549,186,201,936
XPATHErrorResources_de.java,Java,,549,186,201,936
XPATHErrorResources_en.java,Java,,4,2,27,33
XPATHErrorResources_es.java,Java,,549,186,201,936
XPATHErrorResources_fr.java,Java,,549,186,201,936
XPATHErrorResources_it.java,Java,,549,186,201,936
XPATHErrorResources_ja.java,Java,,549,186,201,936
XPATHErrorResources_ko.java,Java,,549,186,201,936
XPATHErrorResources_pt_BR.java,Java,,549,186,201,936
XPATHErrorResources_sv.java,Java,,549,186,201,936
XPATHErrorResources_zh_CN.java,Java,,549,186,201,936
XPATHErrorResources_zh_TW.java,Java,,549,186,201,936
XPATHMessages.java,Java,,65,17,67,149
SourceTree.java,Java,,11,5,38,54
SourceTreeManager.java,Java,,191,54,147,392
VariableStack.java,Java,,152,67,301,520
WhitespaceStrippingElementMatcher.java,Java,,9,4,43,56
XPath.java,Java,,292,80,273,645
XPathAPI.java,Java,,73,27,185,285
XPathContext.java,Java,,563,152,609,1324
XPathException.java,Java,,161,57,112,330
XPathFactory.java,Java,,8,4,40,52
XPathProcessorException.java,Java,,13,4,39,56
XPathVisitable.java,Java,,5,1,37,43
XPathVisitor.java,Java,,63,16,125,204
DialogCallbackHandler.java,Java,,198,43,78,319
package-info.java,Java,,2,1,24,27
TextCallbackHandler.java,Java,,180,29,53,262
LdapPrincipal.java,Java,,43,14,82,139
ConfigFile.java,Java,,23,10,108,141
package-info.java,Java,,2,1,24,27
Crypt.java,Java,,263,53,82,398
JndiLoginModule.java,Java,,387,75,317,779
KeyStoreLoginModule.java,Java,,631,85,223,939
Krb5LoginModule.java,Java,,663,79,538,1280
LdapLoginModule.java,Java,,467,106,440,1013
NTLoginModule.java,Java,,231,32,136,399
NTSystem.java,Java,,47,15,86,148
package-info.java,Java,,2,1,24,27
SolarisLoginModule.java,Java,,151,25,139,315
SolarisSystem.java,Java,,25,9,61,95
UnixLoginModule.java,Java,,149,25,134,308
UnixSystem.java,Java,,25,9,61,95
NTDomainPrincipal.java,Java,,44,13,92,149
NTNumericCredential.java,Java,,34,12,74,120
NTSid.java,Java,,51,13,95,159
NTSidDomainPrincipal.java,Java,,25,9,75,109
NTSidGroupPrincipal.java,Java,,25,10,70,105
NTSidPrimaryGroupPrincipal.java,Java,,25,10,73,108
NTSidUserPrincipal.java,Java,,25,9,69,103
NTUserPrincipal.java,Java,,44,13,86,143
package-info.java,Java,,2,1,24,27
PolicyFile.java,Java,,21,7,277,305
PrincipalComparator.java,Java,,5,2,58,65
SolarisNumericGroupPrincipal.java,Java,,61,19,137,217
SolarisNumericUserPrincipal.java,Java,,50,18,115,183
SolarisPrincipal.java,Java,,42,16,89,147
UnixNumericGroupPrincipal.java,Java,,68,19,133,220
UnixNumericUserPrincipal.java,Java,,52,15,112,179
UnixPrincipal.java,Java,,44,14,86,144
UserPrincipal.java,Java,,31,10,72,113
X500Principal.java,Java,,62,20,103,185
AuthorizationDataEntry.java,Java,,21,7,41,69
ExtendedGSSContext.java,Java,,9,5,143,157
ExtendedGSSCredential.java,Java,,6,3,44,53
GSSUtil.java,Java,,12,5,56,73
InquireSecContextPermission.java,Java,,9,4,43,56
InquireType.java,Java,,8,2,45,55
package-info.java,Java,,2,1,24,27
AttributeTree.java,Java,,11,4,29,44
AuthorTree.java,Java,,6,3,32,41
BlockTagTree.java,Java,,5,2,30,37
CommentTree.java,Java,,5,3,32,40
DeprecatedTree.java,Java,,6,3,32,41
DocCommentTree.java,Java,,8,3,32,43
DocRootTree.java,Java,,3,2,32,37
DocTree.java,Java,,48,38,170,256
DocTreeVisitor.java,Java,,33,3,52,88
EndElementTree.java,Java,,6,3,32,41
EntityTree.java,Java,,6,4,32,42
ErroneousTree.java,Java,,7,2,35,44
IdentifierTree.java,Java,,6,3,32,41
InheritDocTree.java,Java,,3,2,33,38
InlineTagTree.java,Java,,5,2,30,37
LinkTree.java,Java,,7,3,33,43
LiteralTree.java,Java,,5,2,33,40
package-info.java,Java,,2,1,32,35
ParamTree.java,Java,,8,3,32,43
ReferenceTree.java,Java,,5,2,32,39
ReturnTree.java,Java,,6,3,32,41
SeeTree.java,Java,,6,3,35,44
SerialDataTree.java,Java,,6,3,32,41
SerialFieldTree.java,Java,,8,3,32,43
SerialTree.java,Java,,6,3,32,41
SinceTree.java,Java,,6,3,32,41
StartElementTree.java,Java,,9,3,32,44
TextTree.java,Java,,5,2,29,36
ThrowsTree.java,Java,,7,3,35,45
UnknownBlockTagTree.java,Java,,6,2,33,41
UnknownInlineTagTree.java,Java,,6,2,33,41
ValueTree.java,Java,,5,2,32,39
VersionTree.java,Java,,6,3,33,42
AnnotatedTypeTree.java,Java,,7,3,38,48
AnnotationTree.java,Java,,7,3,39,49
ArrayAccessTree.java,Java,,6,2,38,46
ArrayTypeTree.java,Java,,5,2,38,45
AssertTree.java,Java,,6,2,40,48
AssignmentTree.java,Java,,6,2,38,46
BinaryTree.java,Java,,6,2,39,47
BlockTree.java,Java,,7,3,42,52
BreakTree.java,Java,,6,3,40,49
CaseTree.java,Java,,7,3,45,55
CatchTree.java,Java,,6,2,39,47
ClassTree.java,Java,,12,3,44,59
CompilationUnitTree.java,Java,,12,4,38,54
CompoundAssignmentTree.java,Java,,6,2,39,47
ConditionalExpressionTree.java,Java,,7,2,38,47
ContinueTree.java,Java,,6,3,39,48
DoWhileLoopTree.java,Java,,6,2,40,48
EmptyStatementTree.java,Java,,3,2,38,43
EnhancedForLoopTree.java,Java,,7,2,39,48
ErroneousTree.java,Java,,6,3,31,40
ExpressionStatementTree.java,Java,,5,2,38,45
ExpressionTree.java,Java,,3,2,34,39
ForLoopTree.java,Java,,9,3,39,51
IdentifierTree.java,Java,,6,3,38,47
IfTree.java,Java,,7,2,47,56
ImportTree.java,Java,,6,2,44,52
InstanceOfTree.java,Java,,6,2,38,46
IntersectionTypeTree.java,Java,,6,3,31,40
LabeledStatementTree.java,Java,,7,3,38,48
LambdaExpressionTree.java,Java,,13,5,40,58
LineMap.java,Java,,8,6,65,79
LiteralTree.java,Java,,5,2,39,46
MemberReferenceTree.java,Java,,15,5,40,60
MemberSelectTree.java,Java,,7,3,38,48
MethodInvocationTree.java,Java,,8,3,40,51
MethodTree.java,Java,,15,5,48,68
ModifiersTree.java,Java,,9,3,40,52
NewArrayTree.java,Java,,10,3,40,53
NewClassTree.java,Java,,10,3,45,58
package-info.java,Java,,2,1,32,35
ParameterizedTypeTree.java,Java,,7,3,38,48
ParenthesizedTree.java,Java,,5,2,39,46
PrimitiveTypeTree.java,Java,,6,3,38,47
ReturnTree.java,Java,,5,2,39,46
Scope.java,Java,,11,6,55,72
StatementTree.java,Java,,3,2,34,39
SwitchTree.java,Java,,7,3,40,50
SynchronizedTree.java,Java,,6,2,39,47
ThrowTree.java,Java,,5,2,38,45
Tree.java,Java,,117,110,405,632
TreeVisitor.java,Java,,57,2,55,114
TryTree.java,Java,,9,3,42,54
TypeCastTree.java,Java,,6,2,38,46
TypeParameterTree.java,Java,,9,4,53,66
UnaryTree.java,Java,,5,2,41,48
UnionTypeTree.java,Java,,6,3,31,40
VariableTree.java,Java,,10,3,39,52
WhileLoopTree.java,Java,,6,2,40,48
WildcardTree.java,Java,,5,2,43,50
DocSourcePositions.java,Java,,9,6,83,98
DocTreePath.java,Java,,88,20,63,171
DocTreePathScanner.java,Java,,29,6,45,80
DocTrees.java,Java,,24,9,56,89
DocTreeScanner.java,Java,,156,41,77,274
JavacTask.java,Java,,35,15,103,153
package-info.java,Java,,2,1,31,34
Plugin.java,Java,,8,3,54,65
SimpleDocTreeVisitor.java,Java,,113,38,29,180
SimpleTreeVisitor.java,Java,,184,61,30,275
SourcePositions.java,Java,,7,6,74,87
TaskEvent.java,Java,,57,15,53,125
TaskListener.java,Java,,7,4,30,41
TreePath.java,Java,,83,18,57,158
TreePathScanner.java,Java,,29,8,46,83
Trees.java,Java,,66,26,131,223
TreeScanner.java,Java,,278,63,77,418
Applet.java,Java,,149,38,408,595
AppletContext.java,Java,,21,12,161,194
AppletStub.java,Java,,10,8,93,111
AudioClip.java,Java,,6,4,43,53
ActiveEvent.java,Java,,4,3,52,59
Adjustable.java,Java,,23,23,114,160
AlphaComposite.java,Java,,121,46,632,799
AttributeValue.java,Java,,25,5,26,56
AWTError.java,Java,,7,4,38,49
AWTEvent.java,Java,,316,69,235,620
AWTEventMulticaster.java,Java,,367,88,578,1033
AWTException.java,Java,,7,4,40,51
AWTKeyStroke.java,Java,,454,67,368,889
AWTPermission.java,Java,,13,9,214,236
BasicStroke.java,Java,,141,36,270,447
BorderLayout.java,Java,,335,57,495,887
BufferCapabilities.java,Java,,60,21,136,217
Button.java,Java,[PENDING:  WDW -- need to provide a localized string,205,54,416,675
Canvas.java,Java,,70,20,164,254
CardLayout.java,Java,,321,48,243,612
Checkbox.java,Java,,281,70,515,866
CheckboxGroup.java,Java,,34,9,107,150
CheckboxMenuItem.java,Java,,191,51,399,641
Choice.java,Java,,262,67,496,825
CMMException.java,Java,,6,7,45,58
ColorSpace.java,Java,,189,75,347,611
ICC_ColorSpace.java,Java,,209,36,370,615
ICC_Profile.java,Java,,871,354,860,2085
ICC_ProfileGray.java,Java,,26,18,106,150
ICC_ProfileRGB.java,Java,,74,34,174,282
ProfileDataException.java,Java,,6,4,32,42
Color.java,Java,,463,79,702,1244
ColorPaintContext.java,Java,,34,12,37,83
Component.java,Java,,4556,747,4852,10155
ComponentOrientation.java,Java,,54,16,132,202
Composite.java,Java,,7,5,74,86
CompositeContext.java,Java,,9,7,52,68
Conditional.java,Java,,4,2,31,37
Container.java,Java,,2502,390,2078,4970
ContainerOrderFocusTraversalPolicy.java,Java,,317,74,214,605
Cursor.java,Java,,243,69,163,475
Clipboard.java,Java,,116,28,209,353
ClipboardOwner.java,Java,,4,5,47,56
DataFlavor.java,Java,,530,131,804,1465
FlavorEvent.java,Java,,7,3,41,51
FlavorListener.java,Java,,5,3,47,55
FlavorMap.java,Java,,6,6,63,75
FlavorTable.java,Java,,6,6,70,82
MimeType.java,Java,,172,40,182,394
MimeTypeParameterList.java,Java,,241,56,107,404
MimeTypeParseException.java,Java,,10,6,39,55
StringSelection.java,Java,,38,12,91,141
SystemFlavorMap.java,Java,,684,121,460,1265
Transferable.java,Java,,7,8,58,73
UnsupportedFlavorException.java,Java,,7,4,39,50
DefaultFocusTraversalPolicy.java,Java,,33,7,88,128
DefaultKeyboardFocusManager.java,Java,,907,131,381,1419
Desktop.java,Java,,154,31,299,484
Dialog.java,Java,,671,119,935,1725
Dimension.java,Java,,60,20,159,239
DisplayMode.java,Java,,46,16,97,159
Autoscroll.java,Java,,7,9,64,80
DnDConstants.java,Java,,11,12,61,84
DnDEventMulticaster.java,Java,,79,19,133,231
DragGestureEvent.java,Java,,113,55,244,412
DragGestureListener.java,Java,,5,8,51,64
DragGestureRecognizer.java,Java,,105,59,315,479
DragSource.java,Java,,258,75,588,921
DragSourceAdapter.java,Java,,10,8,124,142
DragSourceContext.java,Java,,235,83,345,663
DragSourceDragEvent.java,Java,,97,26,205,328
DragSourceDropEvent.java,Java,,23,19,125,167
DragSourceEvent.java,Java,,37,17,131,185
DragSourceListener.java,Java,,9,9,108,126
DragSourceMotionListener.java,Java,,5,5,51,61
DropTarget.java,Java,,311,145,418,874
DropTargetAdapter.java,Java,,7,6,96,109
DropTargetContext.java,Java,,131,65,224,420
DropTargetDragEvent.java,Java,,47,31,165,243
DropTargetDropEvent.java,Java,,59,43,197,299
DropTargetEvent.java,Java,,14,11,56,81
DropTargetListener.java,Java,,11,15,126,152
InvalidDnDOperationException.java,Java,,7,10,40,57
MouseDragGestureRecognizer.java,Java,,35,33,140,208
DragSourceContextPeer.java,Java,,12,13,46,71
DropTargetContextPeer.java,Java,,18,27,66,111
DropTargetPeer.java,Java,,6,8,45,59
SerializationTester.java,Java,,33,6,34,73
ActionEvent.java,Java,,51,22,216,289
ActionListener.java,Java,,5,5,42,52
AdjustmentEvent.java,Java,,75,27,189,291
AdjustmentListener.java,Java,,5,5,33,43
AWTEventListener.java,Java,,6,5,51,62
AWTEventListenerProxy.java,Java,,18,7,56,81
ComponentAdapter.java,Java,,7,5,60,72
ComponentEvent.java,Java,,45,14,107,166
ComponentListener.java,Java,,8,6,60,74
ContainerAdapter.java,Java,,5,3,54,62
ContainerEvent.java,Java,,35,13,111,159
ContainerListener.java,Java,,6,5,55,66
FocusAdapter.java,Java,,5,3,54,62
FocusEvent.java,Java,,52,18,179,249
FocusListener.java,Java,,6,5,50,61
HierarchyBoundsAdapter.java,Java,,6,3,52,61
HierarchyBoundsListener.java,Java,,6,4,52,62
HierarchyEvent.java,Java,,86,19,232,337
HierarchyListener.java,Java,,5,3,49,57
InputEvent.java,Java,,167,49,317,533
InputMethodEvent.java,Java,,143,33,266,442
InputMethodListener.java,Java,,6,7,43,56
InvocationEvent.java,Java,,105,30,289,424
ItemEvent.java,Java,,49,18,135,202
ItemListener.java,Java,,5,5,46,56
KeyAdapter.java,Java,,6,4,59,69
KeyEvent.java,Java,,713,167,819,1699
KeyListener.java,Java,,7,6,60,73
MouseAdapter.java,Java,,11,9,93,113
MouseEvent.java,Java,,343,62,768,1173
MouseListener.java,Java,,9,8,67,84
MouseMotionAdapter.java,Java,,5,3,63,71
MouseMotionListener.java,Java,,6,6,63,75
MouseWheelEvent.java,Java,,64,30,355,449
MouseWheelListener.java,Java,,5,4,49,58
NativeLibLoader.java,Java,,12,3,49,64
PaintEvent.java,Java,,35,13,91,139
TextEvent.java,Java,,22,11,80,113
TextListener.java,Java,,5,5,45,55
WindowAdapter.java,Java,,15,11,91,117
WindowEvent.java,Java,,98,31,302,431
WindowFocusListener.java,Java,,6,5,58,69
WindowListener.java,Java,,11,9,83,103
WindowStateListener.java,Java,,5,3,47,55
Event.java,Java,,230,106,543,879
EventDispatchThread.java,Java,,199,28,65,292
EventFilter.java,Java,,9,3,49,61
EventQueue.java,Java,,808,107,451,1366
FileDialog.java,Java,,170,40,373,583
FlowLayout.java,Java,,275,52,369,696
FocusTraversalPolicy.java,Java,,20,7,148,175
CharArrayIterator.java,Java,,84,27,82,193
FontRenderContext.java,Java,,143,20,194,357
GlyphJustificationInfo.java,Java,,60,23,129,212
GlyphMetrics.java,Java,,69,29,226,324
GlyphVector.java,Java,,82,41,488,611
GraphicAttribute.java,Java,,52,23,146,221
ImageGraphicAttribute.java,Java,,68,34,125,227
LayoutPath.java,Java,,7,3,74,84
LineBreakMeasurer.java,Java,,113,35,385,533
LineMetrics.java,Java,,14,16,113,143
MultipleMaster.java,Java,,15,10,81,106
NumericShaper.java,Java,,869,111,545,1525
OpenType.java,Java,,61,63,308,432
ShapeGraphicAttribute.java,Java,,87,36,133,256
StyledParagraph.java,Java,,282,62,155,499
TextAttribute.java,Java,,146,73,897,1116
TextHitInfo.java,Java,,54,18,175,247
TextJustifier.java,Java,,146,26,68,240
TextLayout.java,Java,,1286,327,1149,2762
TextLine.java,Java,,997,276,169,1442
TextMeasurer.java,Java,,406,118,240,764
TransformAttribute.java,Java,,53,14,90,157
Font.java,Java,,1037,190,1459,2686
FontFormatException.java,Java,,8,3,40,51
FontMetrics.java,Java,,150,39,453,642
Frame.java,Java,,466,98,759,1323
AffineTransform.java,Java,,2138,150,1653,3941
Arc2D.java,Java,,552,102,820,1474
ArcIterator.java,Java,,143,10,159,312
Area.java,Java,,314,38,392,744
CubicCurve2D.java,Java,,624,134,817,1575
CubicIterator.java,Java,,66,9,81,156
Dimension2D.java,Java,,18,8,88,114
Ellipse2D.java,Java,,159,39,266,464
EllipseIterator.java,Java,,91,11,87,189
FlatteningPathIterator.java,Java,,184,36,175,395
GeneralPath.java,Java,,29,9,89,127
IllegalPathStateException.java,Java,,8,4,44,56
Line2D.java,Java,,306,74,748,1128
LineIterator.java,Java,,58,9,81,148
NoninvertibleTransformException.java,Java,,6,3,37,46
Path2D.java,Java,,1385,143,1174,2702
PathIterator.java,Java,,16,14,187,217
Point2D.java,Java,,117,36,275,428
QuadCurve2D.java,Java,,505,104,792,1401
QuadIterator.java,Java,,62,9,81,152
Rectangle2D.java,Java,,317,68,545,930
RectangularShape.java,Java,,103,29,265,397
RectIterator.java,Java,,66,9,81,156
RoundRectangle2D.java,Java,,250,55,376,681
RoundRectIterator.java,Java,,92,11,86,189
GradientPaint.java,Java,,87,19,172,278
GradientPaintContext.java,Java,,209,24,62,295
Graphics.java,Java,,164,57,1035,1256
Graphics2D.java,Java,,99,47,1088,1234
GraphicsCallback.java,Java,,109,13,24,146
GraphicsConfigTemplate.java,Java,,14,10,87,111
GraphicsConfiguration.java,Java,,101,26,327,454
GraphicsDevice.java,Java,,154,33,407,594
GraphicsEnvironment.java,Java,,133,29,297,459
GridBagConstraints.java,Java,,100,53,510,663
GridBagLayout.java,Java,,1060,158,1016,2234
GridBagLayoutInfo.java,Java,,23,6,58,87
GridLayout.java,Java,,159,24,298,481
HeadlessException.java,Java,,19,3,35,57
IllegalComponentStateException.java,Java,,10,4,43,57
InputContext.java,Java,,41,18,278,337
InputMethodHighlight.java,Java,,48,21,126,195
InputMethodRequests.java,Java,,15,11,182,208
InputSubset.java,Java,,24,15,75,114
InputMethod.java,Java,,23,22,337,382
InputMethodContext.java,Java,,15,8,117,140
InputMethodDescriptor.java,Java,,11,10,103,124
AffineTransformOp.java,Java,,274,39,248,561
AreaAveragingScaleFilter.java,Java,,164,11,106,281
BandCombineOp.java,Java,,132,15,142,289
BandedSampleModel.java,Java,,395,94,360,849
BufferedImage.java,Java,,745,128,768,1641
BufferedImageFilter.java,Java,,263,15,139,417
BufferedImageOp.java,Java,,12,7,117,136
BufferStrategy.java,Java,,13,9,182,204
ByteLookupTable.java,Java,,79,13,118,210
ColorConvertOp.java,Java,,732,85,298,1115
ColorModel.java,Java,,713,89,1162,1964
ComponentColorModel.java,Java,,1824,79,1045,2948
ComponentSampleModel.java,Java,,623,125,494,1242
ConvolveOp.java,Java,,140,33,175,348
CropImageFilter.java,Java,,86,11,96,193
DataBuffer.java,Java,,177,52,314,543
DataBufferByte.java,Java,,69,18,199,286
DataBufferDouble.java,Java,,96,27,280,403
DataBufferFloat.java,Java,,96,27,283,406
DataBufferInt.java,Java,,69,18,197,284
DataBufferShort.java,Java,,69,18,196,283
DataBufferUShort.java,Java,,100,20,198,318
DirectColorModel.java,Java,,715,55,646,1416
FilteredImageSource.java,Java,,60,10,139,209
ImageConsumer.java,Java,,22,19,186,227
ImageFilter.java,Java,,52,13,193,258
ImageObserver.java,Java,,14,12,145,171
ImageProducer.java,Java,,8,6,98,112
ImagingOpException.java,Java,,6,4,35,45
IndexColorModel.java,Java,,684,79,772,1535
Kernel.java,Java,,59,13,81,153
LookupOp.java,Java,,331,50,186,567
LookupTable.java,Java,,25,10,74,109
MemoryImageSource.java,Java,,220,24,327,571
MultiPixelPackedSampleModel.java,Java,,291,60,348,699
PackedColorModel.java,Java,,209,36,241,486
PixelGrabber.java,Java,,308,28,336,672
PixelInterleavedSampleModel.java,Java,,67,6,98,171
Raster.java,Java,,630,139,1005,1774
RasterFormatException.java,Java,,6,4,34,44
RasterOp.java,Java,,11,7,89,107
ContextualRenderedImageFactory.java,Java,,15,9,119,143
ParameterBlock.java,Java,,191,50,484,725
RenderableImage.java,Java,,18,15,165,198
RenderableImageOp.java,Java,,121,29,200,350
RenderableImageProducer.java,Java,,93,19,107,219
RenderContext.java,Java,,63,22,187,272
RenderedImageFactory.java,Java,,7,4,67,78
RenderedImage.java,Java,,27,25,165,217
ReplicateScaleFilter.java,Java,,115,16,124,255
RescaleOp.java,Java,,348,63,255,666
RGBImageFilter.java,Java,,101,13,178,292
SampleModel.java,Java,,562,168,777,1507
ShortLookupTable.java,Java,,79,13,112,204
SinglePixelPackedSampleModel.java,Java,,374,75,352,801
TileObserver.java,Java,,6,4,45,55
VolatileImage.java,Java,,33,22,287,342
WritableRaster.java,Java,,223,37,481,741
WritableRenderedImage.java,Java,,13,13,125,151
Image.java,Java,,70,24,260,354
ImageCapabilities.java,Java,,20,8,53,81
Insets.java,Java,,53,15,120,188
ItemSelectable.java,Java,,7,7,51,65
JobAttributes.java,Java,,443,68,554,1065
KeyboardFocusManager.java,Java,,1512,264,1374,3150
KeyEventDispatcher.java,Java,,6,4,81,91
KeyEventPostProcessor.java,Java,,6,4,84,94
Label.java,Java,,123,33,204,360
LayoutManager.java,Java,,8,5,70,83
LayoutManager2.java,Java,,8,7,72,87
LinearGradientPaint.java,Java,,98,16,269,383
LinearGradientPaintContext.java,Java,,54,20,91,165
List.java,Java,[FIXME,625,154,1170,1949
MediaTracker.java,Java,,428,60,504,992
Menu.java,Java,,251,60,319,630
MenuBar.java,Java,,220,43,252,515
MenuComponent.java,Java,,348,101,618,1067
MenuContainer.java,Java,,7,3,33,43
MenuItem.java,Java,[PENDING:  WDW -- need to provide a localized string,325,76,541,942
MenuShortcut.java,Java,,52,13,143,208
ModalEventFilter.java,Java,,156,23,37,216
MouseInfo.java,Java,,53,12,70,135
MultipleGradientPaint.java,Java,,124,38,149,311
MultipleGradientPaintContext.java,Java,,357,94,273,724
PageAttributes.java,Java,,521,52,805,1378
Paint.java,Java,,11,5,92,108
PaintContext.java,Java,,11,7,63,81
Panel.java,Java,,37,14,82,133
ButtonPeer.java,Java,,5,4,41,50
CanvasPeer.java,Java,,7,2,40,49
CheckboxMenuItemPeer.java,Java,,5,3,41,49
CheckboxPeer.java,Java,,8,6,58,72
ChoicePeer.java,Java,,8,7,61,76
ComponentPeer.java,Java,,60,51,435,546
ContainerPeer.java,Java,,9,7,63,79
DesktopPeer.java,Java,,13,10,84,107
DialogPeer.java,Java,,7,6,57,70
FileDialogPeer.java,Java,,8,6,55,69
FontPeer.java,Java,,3,2,34,39
FramePeer.java,Java,,14,13,107,134
KeyboardFocusManagerPeer.java,Java,,10,9,61,80
LabelPeer.java,Java,,6,4,50,60
LightweightPeer.java,Java,,3,3,38,44
ListPeer.java,Java,,15,13,110,138
MenuBarPeer.java,Java,,8,5,54,67
MenuComponentPeer.java,Java,,7,4,46,57
MenuItemPeer.java,Java,,6,5,44,55
MenuPeer.java,Java,,8,5,52,65
MouseInfoPeer.java,Java,,7,6,56,69
PanelPeer.java,Java,,3,1,35,39
PopupMenuPeer.java,Java,,6,3,41,50
RobotPeer.java,Java,,14,11,99,124
ScrollbarPeer.java,Java,,7,5,57,69
ScrollPanePeer.java,Java,,12,8,77,97
SystemTrayPeer.java,Java,,6,4,35,45
TextAreaPeer.java,Java,,9,7,72,88
TextComponentPeer.java,Java,,14,11,96,121
TextFieldPeer.java,Java,,8,6,60,74
TrayIconPeer.java,Java,,10,8,62,80
WindowPeer.java,Java,,15,14,91,120
Point.java,Java,,56,18,160,234
PointerInfo.java,Java,,15,7,59,81
Polygon.java,Java,,268,52,357,677
PopupMenu.java,Java,,97,22,122,241
Book.java,Java,,66,27,128,221
Pageable.java,Java,,10,7,68,85
PageFormat.java,Java,,142,59,164,365
Paper.java,Java,,53,25,131,209
Printable.java,Java,,8,8,128,144
PrinterAbortException.java,Java,,9,6,40,55
PrinterException.java,Java,,8,6,39,53
PrinterGraphics.java,Java,,4,5,38,47
PrinterIOException.java,Java,,16,6,66,88
PrinterJob.java,Java,,165,47,407,619
PrintGraphics.java,Java,,4,4,33,41
PrintJob.java,Java,,11,9,60,80
RadialGradientPaint.java,Java,,158,25,463,646
RadialGradientPaintContext.java,Java,,176,65,208,449
Rectangle.java,Java,,436,62,718,1216
RenderingHints.java,Java,,223,76,1002,1301
Robot.java,Java,,228,49,309,586
Scrollbar.java,Java,,355,90,898,1343
ScrollPane.java,Java,,358,79,411,848
ScrollPaneAdjustable.java,Java,,147,45,261,453
SecondaryLoop.java,Java,,5,5,137,147
SentEvent.java,Java,,49,7,35,91
SequencedEvent.java,Java,,122,19,84,225
Shape.java,Java,,17,12,385,414
SplashScreen.java,Java,,196,21,206,423
Stroke.java,Java,,4,2,62,68
SystemColor.java,Java,,145,68,335,548
SystemTray.java,Java,,165,30,322,517
TextArea.java,Java,,245,60,409,714
TextComponent.java,Java,,480,87,627,1194
TextField.java,Java,,230,56,475,761
TexturePaint.java,Java,,46,12,93,151
TexturePaintContext.java,Java,,704,48,75,827
Toolkit.java,Java,,872,174,1559,2605
Transparency.java,Java,,8,7,46,61
TrayIcon.java,Java,,281,52,449,782
WaitDispatchSupport.java,Java,,199,26,95,320
Window.java,Java,,1676,287,2162,4125
AppletInitializer.java,Java,,7,10,73,90
BeanContext.java,Java,,17,13,105,135
BeanContextChild.java,Java,,13,12,112,137
BeanContextChildComponentProxy.java,Java,,5,6,43,54
BeanContextChildSupport.java,Java,,100,57,220,377
BeanContextContainerProxy.java,Java,,5,5,42,52
BeanContextEvent.java,Java,,20,12,72,104
BeanContextMembershipEvent.java,Java,,32,19,84,135
BeanContextMembershipListener.java,Java,,7,7,47,61
BeanContextProxy.java,Java,,4,4,77,85
BeanContextServiceAvailableEvent.java,Java,,20,13,53,86
BeanContextServiceProvider.java,Java,,7,7,90,104
BeanContextServiceProviderBeanInfo.java,Java,,5,5,37,47
BeanContextServiceRevokedEvent.java,Java,,21,12,66,99
BeanContextServiceRevokedListener.java,Java,,6,4,36,46
BeanContextServices.java,Java,,17,17,126,160
BeanContextServicesListener.java,Java,,7,4,35,46
BeanContextServicesSupport.java,Java,,625,314,318,1257
BeanContextSupport.java,Java,,590,258,566,1414
BeanDescriptor.java,Java,,37,12,60,109
BeanInfo.java,Java,,16,15,145,176
Beans.java,Java,,272,88,266,626
ChangeListenerMap.java,Java,,117,15,109,241
ConstructorProperties.java,Java,,8,3,65,76
Customizer.java,Java,,6,7,52,65
DefaultPersistenceDelegate.java,Java,,200,24,196,420
DesignMode.java,Java,,6,9,74,89
Encoder.java,Java,,115,20,216,351
EventHandler.java,Java,,191,18,506,715
EventSetDescriptor.java,Java,,277,45,218,540
ExceptionListener.java,Java,,4,1,38,43
Expression.java,Java,,32,11,141,184
FeatureDescriptor.java,Java,,193,44,208,445
IndexedPropertyChangeEvent.java,Java,,17,5,56,78
IndexedPropertyDescriptor.java,Java,,289,52,184,525
IntrospectionException.java,Java,,8,4,38,50
Introspector.java,Java,,1042,156,435,1633
MetaData.java,Java,,1082,149,223,1454
MethodDescriptor.java,Java,,136,27,70,233
MethodRef.java,Java,,55,8,24,87
NameGenerator.java,Java,,53,11,53,117
ParameterDescriptor.java,Java,,8,6,39,53
PersistenceDelegate.java,Java,,26,6,184,216
PropertyChangeEvent.java,Java,,43,15,108,166
PropertyChangeListener.java,Java,,4,6,34,44
PropertyChangeListenerProxy.java,Java,,17,7,57,81
PropertyChangeSupport.java,Java,,201,33,313,547
PropertyDescriptor.java,Java,,433,67,250,750
PropertyEditor.java,Java,,15,25,185,225
PropertyEditorManager.java,Java,,23,7,95,125
PropertyEditorSupport.java,Java,,90,33,184,307
PropertyVetoException.java,Java,,13,7,44,64
SimpleBeanInfo.java,Java,,44,13,78,135
Statement.java,Java,,189,20,154,363
ThreadGroupContext.java,Java,,71,22,37,130
Transient.java,Java,,10,4,60,74
VetoableChangeListener.java,Java,,5,2,37,44
VetoableChangeListenerProxy.java,Java,,17,7,60,84
VetoableChangeSupport.java,Java,,213,29,294,536
Visibility.java,Java,,7,8,52,67
WeakIdentityMap.java,Java,,129,17,44,190
XMLDecoder.java,Java,,102,20,184,306
XMLEncoder.java,Java,,420,54,338,812
Bits.java,Java,,69,18,36,123
BufferedInputStream.java,Java,,165,28,296,489
BufferedOutputStream.java,Java,,44,9,90,143
BufferedReader.java,Java,,302,40,251,593
BufferedWriter.java,Java,,109,23,140,272
ByteArrayInputStream.java,Java,,64,20,198,282
ByteArrayOutputStream.java,Java,,77,23,183,283
CharArrayReader.java,Java,,95,17,120,232
CharArrayWriter.java,Java,,90,20,170,280
CharConversionException.java,Java,,11,2,38,51
Closeable.java,Java,,5,4,44,53
Console.java,Java,,262,20,298,580
DataInput.java,Java,,19,16,554,589
DataInputStream.java,Java,,212,35,416,663
DataOutput.java,Java,,18,15,321,354
DataOutputStream.java,Java,,145,29,242,416
DefaultFileSystem.java,Java,,6,3,31,40
DeleteOnExitHook.java,Java,,36,10,37,83
EOFException.java,Java,,11,4,49,64
ExpiringCache.java,Java,,84,15,28,127
Externalizable.java,Java,,7,4,86,97
File.java,Java,,613,108,1520,2241
FileDescriptor.java,Java,,89,23,118,230
FileFilter.java,Java,,5,4,41,50
FileInputStream.java,Java,,101,28,271,400
FilenameFilter.java,Java,,5,2,46,53
FileNotFoundException.java,Java,,15,8,59,82
FileOutputStream.java,Java,,119,32,284,435
FilePermission.java,Java,,346,86,406,838
FileReader.java,Java,,12,7,66,85
FileSystem.java,Java,,58,45,143,246
FileWriter.java,Java,,18,10,91,119
FilterInputStream.java,Java,,35,12,198,245
FilterOutputStream.java,Java,,30,9,122,161
FilterReader.java,Java,,32,15,77,124
FilterWriter.java,Java,,23,12,72,107
Flushable.java,Java,,5,4,37,46
InputStream.java,Java,,62,19,286,367
InputStreamReader.java,Java,,50,15,136,201
InterruptedIOException.java,Java,,12,5,57,74
InvalidClassException.java,Java,,18,7,56,81
InvalidObjectException.java,Java,,7,4,40,51
IOError.java,Java,,7,3,40,50
IOException.java,Java,,17,6,78,101
LineNumberInputStream.java,Java,,98,19,176,293
LineNumberReader.java,Java,,102,23,158,283
NotActiveException.java,Java,,10,5,38,53
NotSerializableException.java,Java,,10,5,40,55
ObjectInput.java,Java,,11,8,88,107
ObjectInputStream.java,Java,,2133,316,1416,3865
ObjectInputValidation.java,Java,,4,2,39,45
ObjectOutput.java,Java,,10,7,73,90
ObjectOutputStream.java,Java,,1275,186,1013,2474
ObjectStreamClass.java,Java,,1558,199,624,2381
ObjectStreamConstants.java,Java,,34,36,165,235
ObjectStreamException.java,Java,,10,5,38,53
ObjectStreamField.java,Java,,140,22,164,326
OptionalDataException.java,Java,,14,6,63,83
OutputStream.java,Java,,24,7,123,154
OutputStreamWriter.java,Java,,56,17,162,235
PipedInputStream.java,Java,,191,31,227,449
PipedOutputStream.java,Java,,53,11,115,179
PipedReader.java,Java,,158,27,177,362
PipedWriter.java,Java,,53,14,117,184
PrintStream.java,Java,,355,63,711,1129
PrintWriter.java,Java,,324,59,683,1066
PushbackInputStream.java,Java,,115,19,249,383
PushbackReader.java,Java,,120,20,141,281
RandomAccessFile.java,Java,,309,70,774,1153
Reader.java,Java,,64,20,178,262
SequenceInputStream.java,Java,,79,13,143,235
SerialCallbackContext.java,Java,,34,8,39,81
Serializable.java,Java,,3,2,165,170
SerializablePermission.java,Java,,17,10,104,131
StreamCorruptedException.java,Java,,10,5,39,54
StreamTokenizer.java,Java,,365,52,417,834
StringBufferInputStream.java,Java,,54,11,107,172
StringReader.java,Java,,78,15,108,201
StringWriter.java,Java,,59,19,158,236
SyncFailedException.java,Java,,7,3,38,48
UncheckedIOException.java,Java,,23,6,61,90
UnsupportedEncodingException.java,Java,,12,3,37,52
UTFDataFormatException.java,Java,,11,4,54,69
WinNTFileSystem.java,Java,,447,69,132,648
WriteAbortedException.java,Java,,19,6,68,93
Writer.java,Java,,64,20,241,325
AbstractMethodError.java,Java,,11,4,43,58
AbstractStringBuilder.java,Java,,449,71,946,1466
Annotation.java,Java,,7,5,124,136
AnnotationFormatError.java,Java,,13,6,60,79
AnnotationTypeMismatchException.java,Java,,19,7,65,91
Documented.java,Java,,6,2,35,43
ElementType.java,Java,,13,11,87,111
IncompleteAnnotationException.java,Java,,20,7,57,84
Inherited.java,Java,,6,2,45,53
Native.java,Java,,6,3,34,43
package-info.java,Java,,1,1,31,33
Repeatable.java,Java,,7,2,40,49
Retention.java,Java,,7,2,43,52
RetentionPolicy.java,Java,,6,4,47,57
Target.java,Java,,7,2,78,87
Appendable.java,Java,,7,6,108,121
ApplicationShutdownHooks.java,Java,,52,14,44,110
ArithmeticException.java,Java,,10,4,47,61
ArrayIndexOutOfBoundsException.java,Java,,14,5,48,67
ArrayStoreException.java,Java,,11,4,45,60
AssertionError.java,Java,,35,12,120,167
AssertionStatusDirectives.java,Java,,8,6,80,94
AutoCloseable.java,Java,,4,2,92,98
Boolean.java,Java,,71,23,241,335
BootstrapMethodError.java,Java,,17,6,57,80
Byte.java,Java,,103,36,381,520
Character.java,Java,,2748,525,3958,7231
CharacterData.java,Java,,57,10,30,97
CharacterData00.java,Java,,1325,51,111,1487
CharacterData01.java,Java,,550,41,83,674
CharacterData02.java,Java,,270,39,82,391
CharacterData0E.java,Java,,271,39,82,392
CharacterDataLatin1.java,Java,,221,41,69,331
CharacterDataPrivateUse.java,Java,,54,21,26,101
CharacterDataUndefined.java,Java,,50,19,26,95
CharacterName.java,Java,,75,8,25,108
CharSequence.java,Java,,94,19,121,234
Class.java,Java,,1429,283,1926,3638
ClassCastException.java,Java,,11,4,45,60
ClassCircularityError.java,Java,,10,4,41,55
ClassFormatError.java,Java,,11,4,41,56
ClassLoader.java,Java,,900,144,1172,2216
ClassLoaderHelper.java,Java,,8,4,30,42
ClassNotFoundException.java,Java,,21,8,96,125
ClassValue.java,Java,,375,53,332,760
Cloneable.java,Java,,3,2,49,54
CloneNotSupportedException.java,Java,,11,5,49,65
Comparable.java,Java,,5,2,130,137
Compiler.java,Java,,40,10,86,136
ConditionalSpecialCasing.java,Java,,280,61,131,472
Deprecated.java,Java,,8,3,34,45
Double.java,Java,,149,55,854,1058
Enum.java,Java,,65,17,175,257
EnumConstantNotPresentException.java,Java,,15,7,58,80
Error.java,Java,,21,7,100,128
Exception.java,Java,,21,7,96,124
ExceptionInInitializerError.java,Java,,22,8,96,126
Float.java,Java,,132,49,784,965
FunctionalInterface.java,Java,,6,3,59,68
IllegalAccessError.java,Java,,10,4,44,58
IllegalAccessException.java,Java,,10,4,64,78
IllegalArgumentException.java,Java,,17,6,71,94
IllegalMonitorStateException.java,Java,,11,4,47,62
IllegalStateException.java,Java,,17,6,74,97
IllegalThreadStateException.java,Java,,10,4,45,59
IncompatibleClassChangeError.java,Java,,11,4,42,57
IndexOutOfBoundsException.java,Java,,11,4,43,58
InheritableThreadLocal.java,Java,,13,5,65,83
InstantiationError.java,Java,,11,6,44,61
InstantiationException.java,Java,,11,4,50,65
ClassDefinition.java,Java,,22,7,59,88
ClassFileTransformer.java,Java,,11,5,172,188
IllegalClassFormatException.java,Java,,12,5,47,64
Instrumentation.java,Java,,39,20,606,665
UnmodifiableClassException.java,Java,,12,4,42,58
Integer.java,Java,,452,98,1045,1595
InternalError.java,Java,,16,8,66,90
InterruptedException.java,Java,,11,4,54,69
AbstractValidatingLambdaMetafactory.java,Java,,211,25,139,375
BoundMethodHandle.java,Java,types,543,84,218,845
CallSite.java,Java,,167,21,172,360
ConstantCallSite.java,Java,,23,7,90,120
DelegatingMethodHandle.java,Java,,114,16,34,164
DirectMethodHandle.java,Java,,561,45,89,695
DontInline.java,Java,,6,3,28,37
ForceInline.java,Java,,6,3,28,37
InfoFromMemberName.java,Java,,99,13,33,145
InjectedProfile.java,Java,,6,3,28,37
InnerClassLambdaMetafactory.java,Java,,382,49,132,563
InvokeDynamic.java,Java,,4,2,27,33
InvokerBytecodeGenerator.java,Java,,1033,143,272,1448
Invokers.java,Java,,322,34,97,453
LambdaConversionException.java,Java,,18,7,51,76
LambdaForm.java,Java,,1437,112,297,1846
LambdaFormBuffer.java,Java,,309,33,56,398
LambdaFormEditor.java,Java,,717,72,69,858
LambdaMetafactory.java,Java,,73,11,392,476
MemberName.java,Java,,758,52,280,1090
MethodHandle.java,Java,won,242,53,1161,1456
MethodHandleImpl.java,Java,,1308,142,214,1664
MethodHandleInfo.java,Java,,41,13,230,284
MethodHandleNatives.java,Java,,344,33,163,540
MethodHandleProxies.java,Java,,154,14,154,322
MethodHandles.java,Java,,1071,109,1933,3113
MethodHandleStatics.java,Java,,115,14,35,164
MethodType.java,Java,,600,94,611,1305
MethodTypeForm.java,Java,,306,26,94,426
MutableCallSite.java,Java,,29,8,246,283
package-info.java,Java,,1,2,208,211
ProxyClassesDumper.java,Java,,102,12,33,147
SerializedLambda.java,Java,,111,17,130,258
SimpleMethodHandle.java,Java,,63,10,28,101
Stable.java,Java,,6,3,64,73
SwitchPoint.java,Java,,31,7,190,228
TypeConvertingMethodAdapter.java,Java,,202,31,69,302
VolatileCallSite.java,Java,,20,6,83,109
WrongMethodTypeException.java,Java,,16,6,63,85
Iterable.java,Java,,18,4,81,103
LinkageError.java,Java,,14,5,50,69
Long.java,Java,,469,96,1055,1620
BufferPoolMXBean.java,Java,,7,6,80,93
ClassLoadingMXBean.java,Java,,8,8,98,114
CompilationMXBean.java,Java,,6,4,91,101
GarbageCollectorMXBean.java,Java,,5,5,84,94
LockInfo.java,Java,,38,12,114,164
ManagementFactory.java,Java,,262,38,597,897
ManagementPermission.java,Java,,20,5,101,126
MemoryManagerMXBean.java,Java,,6,4,78,88
MemoryMXBean.java,Java,,10,9,285,304
MemoryNotificationInfo.java,Java,,50,13,193,256
MemoryPoolMXBean.java,Java,,21,19,603,643
MemoryType.java,Java,,13,8,52,73
MemoryUsage.java,Java,,80,15,206,301
MonitorInfo.java,Java,,47,10,102,159
OperatingSystemMXBean.java,Java,,8,6,128,142
PlatformComponent.java,Java,,320,45,103,468
PlatformLoggingMXBean.java,Java,,7,6,125,138
PlatformManagedObject.java,Java,,5,3,53,61
RuntimeMXBean.java,Java,,19,18,302,339
ThreadInfo.java,Java,,279,36,519,834
ThreadMXBean.java,Java,,31,30,745,806
Math.java,Java,,496,114,1760,2370
NegativeArraySizeException.java,Java,,11,4,40,55
NoClassDefFoundError.java,Java,,11,4,46,61
NoSuchFieldError.java,Java,,11,4,44,59
NoSuchFieldException.java,Java,,10,4,38,52
NoSuchMethodError.java,Java,,11,4,45,60
NoSuchMethodException.java,Java,,11,4,38,53
NullPointerException.java,Java,,11,4,57,72
Number.java,Java,,14,8,102,124
NumberFormatException.java,Java,,14,5,48,67
Object.java,Java,,36,17,503,556
OutOfMemoryError.java,Java,,10,4,46,60
Override.java,Java,,6,3,43,52
package-info.java,Java,,1,1,69,71
Package.java,Java,,322,44,278,644
Process.java,Java,,41,12,212,265
ProcessBuilder.java,Java,,260,57,738,1055
ProcessEnvironment.java,Java,,217,42,92,351
ProcessImpl.java,Java,,336,69,136,541
Readable.java,Java,,5,4,44,53
Finalizer.java,Java,,157,21,51,229
FinalReference.java,Java,,6,3,27,36
PhantomReference.java,Java,,9,7,67,83
Reference.java,Java,,101,35,175,311
ReferenceQueue.java,Java,,83,13,71,167
SoftReference.java,Java,,19,10,89,118
WeakReference.java,Java,,9,7,56,72
AccessibleObject.java,Java,,101,26,182,309
AnnotatedArrayType.java,Java,,4,4,36,44
AnnotatedElement.java,Java,,51,11,388,450
AnnotatedParameterizedType.java,Java,,4,3,36,43
AnnotatedType.java,Java,,4,3,37,44
AnnotatedTypeVariable.java,Java,,4,3,36,43
AnnotatedWildcardType.java,Java,,5,4,41,50
Array.java,Java,,56,29,403,488
Constructor.java,Java,,250,48,274,572
Executable.java,Java,,320,71,330,721
Field.java,Java,,403,56,719,1178
GenericArrayType.java,Java,,4,2,46,52
GenericDeclaration.java,Java,,4,2,43,49
GenericSignatureFormatError.java,Java,,10,5,41,56
InvocationHandler.java,Java,,5,3,87,95
InvocationTargetException.java,Java,,22,8,81,111
MalformedParameterizedTypeException.java,Java,,4,3,32,39
MalformedParametersException.java,Java,,8,5,59,72
Member.java,Java,,10,8,74,92
Method.java,Java,,253,45,357,655
Modifier.java,Java,,130,50,316,496
package-info.java,Java,,1,1,47,49
Parameter.java,Java,,129,37,183,349
ParameterizedType.java,Java,,6,5,84,95
Proxy.java,Java,,297,53,486,836
ReflectAccess.java,Java,,101,18,31,150
ReflectPermission.java,Java,,11,6,89,106
Type.java,Java,,6,2,40,48
TypeVariable.java,Java,,7,5,90,102
UndeclaredThrowableException.java,Java,,21,7,91,119
WeakCache.java,Java,,191,42,146,379
WildcardType.java,Java,,5,3,75,83
ReflectiveOperationException.java,Java,,16,6,69,91
Runnable.java,Java,,5,2,62,69
Runtime.java,Java,,130,35,762,927
RuntimeException.java,Java,,21,7,91,119
RuntimePermission.java,Java,,16,9,362,387
SafeVarargs.java,Java,,6,3,84,93
SecurityException.java,Java,,16,6,62,84
SecurityManager.java,Java,,387,66,1326,1779
Short.java,Java,,110,37,390,537
Shutdown.java,Java,,112,26,100,238
StackOverflowError.java,Java,,11,4,40,55
StackTraceElement.java,Java,,55,13,153,221
StrictMath.java,Java,,201,80,1429,1710
String.java,Java,,962,136,2070,3168
StringBuffer.java,Java,,318,64,333,715
StringBuilder.java,Java,,205,46,188,439
StringCoding.java,Java,,302,31,71,404
StringIndexOutOfBoundsException.java,Java,,14,5,52,71
SuppressWarnings.java,Java,,8,3,61,72
System.java,Java,,278,67,929,1274
Terminator.java,Java,,25,11,40,76
Thread.java,Java,,544,144,1359,2047
ThreadDeath.java,Java,,4,3,44,51
ThreadGroup.java,Java,,469,51,574,1094
ThreadLocal.java,Java,,304,64,354,722
Throwable.java,Java,,265,67,749,1081
TypeNotPresentException.java,Java,,10,5,55,70
UnknownError.java,Java,,11,4,40,55
UnsatisfiedLinkError.java,Java,,11,4,41,56
UnsupportedClassVersionError.java,Java,,11,4,41,56
UnsupportedOperationException.java,Java,,15,6,73,94
VerifyError.java,Java,,11,4,40,55
VirtualMachineError.java,Java,,16,6,67,89
Void.java,Java,,7,4,39,50
BigDecimal.java,Java,,2656,300,2298,5254
BigInteger.java,Java,,2389,531,1674,4594
BitSieve.java,Java,,84,20,108,212
MathContext.java,Java,,87,29,210,326
MutableBigInteger.java,Java,,1410,261,582,2253
package-info.java,Java,,1,1,43,45
RoundingMode.java,Java,,37,22,297,356
SignedMutableBigInteger.java,Java,,42,18,75,135
AbstractPlainDatagramSocketImpl.java,Java,,203,41,123,367
AbstractPlainSocketImpl.java,Java,,483,58,185,726
Authenticator.java,Java,,152,28,245,425
BindException.java,Java,,8,5,41,54
CacheRequest.java,Java,,7,5,51,63
CacheResponse.java,Java,,9,5,50,64
ConnectException.java,Java,,8,4,42,54
ContentHandler.java,Java,,15,6,90,111
ContentHandlerFactory.java,Java,,4,2,48,54
CookieHandler.java,Java,,28,7,115,150
CookieManager.java,Java,,219,44,185,448
CookiePolicy.java,Java,,21,6,51,78
CookieStore.java,Java,,11,13,105,129
DatagramPacket.java,Java,,110,23,255,388
DatagramSocket.java,Java,,478,62,774,1314
DatagramSocketImpl.java,Java,,95,30,189,314
DatagramSocketImplFactory.java,Java,,5,2,39,46
DefaultDatagramSocketImplFactory.java,Java,,74,14,54,142
DefaultInterface.java,Java,,6,4,31,41
DualStackPlainDatagramSocketImpl.java,Java,,179,65,53,297
DualStackPlainSocketImpl.java,Java,,192,61,47,300
FileNameMap.java,Java,,4,3,37,44
HostPortrange.java,Java,,193,33,57,283
HttpConnectSocketImpl.java,Java,,145,27,38,210
HttpCookie.java,Java,,507,95,544,1146
HttpRetryException.java,Java,,26,9,64,99
HttpURLConnection.java,Java,,202,84,531,817
IDN.java,Java,,213,63,223,499
Inet4Address.java,Java,,116,29,235,380
Inet4AddressImpl.java,Java,,38,4,32,74
Inet6Address.java,Java,,440,93,418,951
Inet6AddressImpl.java,Java,,60,6,42,108
InetAddress.java,Java,,726,155,767,1648
InetAddressContainer.java,Java,,4,2,24,30
InetAddressImpl.java,Java,,12,3,33,48
InetSocketAddress.java,Java,,192,35,192,419
InMemoryCookieStore.java,Java,,239,46,113,398
InterfaceAddress.java,Java,,36,10,88,134
JarURLConnection.java,Java,,57,19,233,309
MalformedURLException.java,Java,,10,5,41,56
MulticastSocket.java,Java,,230,51,428,709
NetPermission.java,Java,,16,8,180,204
NetworkInterface.java,Java,,262,61,257,580
NoRouteToHostException.java,Java,,8,4,42,54
package-info.java,Java,,1,1,159,161
PasswordAuthentication.java,Java,,15,8,58,81
PlainSocketImpl.java,Java,,221,66,58,345
PortUnreachableException.java,Java,,8,5,39,52
ProtocolException.java,Java,,11,5,40,56
ProtocolFamily.java,Java,,4,3,34,41
Proxy.java,Java,,49,12,110,171
ProxySelector.java,Java,,33,8,124,165
ResponseCache.java,Java,,26,8,129,163
SdpSocketImpl.java,Java,,17,5,27,49
SecureCacheResponse.java,Java,,14,7,87,108
ServerSocket.java,Java,,286,40,597,923
Socket.java,Java,,566,81,1083,1730
SocketAddress.java,Java,,4,4,37,45
SocketException.java,Java,,11,5,39,55
SocketImpl.java,Java,,110,35,253,398
SocketImplFactory.java,Java,,5,2,41,48
SocketInputStream.java,Java,,139,26,127,292
SocketOption.java,Java,,5,5,49,59
SocketOptions.java,Java,,21,29,281,331
SocketOutputStream.java,Java,,73,18,94,185
SocketPermission.java,Java,,757,186,543,1486
SocketSecrets.java,Java,,32,12,26,70
SocketTimeoutException.java,Java,,8,5,37,50
SocksConsts.java,Java,,25,6,27,58
SocksSocketImpl.java,Java,,836,44,210,1090
StandardProtocolFamily.java,Java,,5,5,35,45
StandardSocketOptions.java,Java,,37,22,308,367
TwoStacksPlainDatagramSocketImpl.java,Java,,115,43,58,216
TwoStacksPlainSocketImpl.java,Java,,128,31,84,243
UnknownHostException.java,Java,,11,5,40,56
UnknownServiceException.java,Java,,10,5,43,58
URI.java,Java,,1542,285,1718,3545
URISyntaxException.java,Java,,40,12,83,135
URL.java,Java,,608,129,796,1533
URLClassLoader.java,Java,,445,51,320,816
URLConnection.java,Java,,584,149,1050,1783
URLDecoder.java,Java,,67,20,120,207
URLEncoder.java,Java,,110,19,163,292
URLPermission.java,Java,,264,43,232,539
URLStreamHandler.java,Java,,308,42,245,595
URLStreamHandlerFactory.java,Java,,4,2,45,51
Bits.java,Java,,613,152,99,864
Buffer.java,Java,,137,38,395,570
BufferOverflowException.java,Java,,7,8,36,51
BufferUnderflowException.java,Java,,7,8,36,51
ByteBuffer.java,Java,,194,532,1352,2078
ByteBufferAsCharBufferB.java,Java,,127,71,27,225
ByteBufferAsCharBufferL.java,Java,,127,71,27,225
ByteBufferAsCharBufferRB.java,Java,,83,116,26,225
ByteBufferAsCharBufferRL.java,Java,,83,116,26,225
ByteBufferAsDoubleBufferB.java,Java,,93,106,26,225
ByteBufferAsDoubleBufferL.java,Java,,93,106,26,225
ByteBufferAsDoubleBufferRB.java,Java,,52,148,25,225
ByteBufferAsDoubleBufferRL.java,Java,,52,148,25,225
ByteBufferAsFloatBufferB.java,Java,,93,106,26,225
ByteBufferAsFloatBufferL.java,Java,,93,106,26,225
ByteBufferAsFloatBufferRB.java,Java,,52,148,25,225
ByteBufferAsFloatBufferRL.java,Java,,52,148,25,225
ByteBufferAsIntBufferB.java,Java,,93,106,26,225
ByteBufferAsIntBufferL.java,Java,,93,106,26,225
ByteBufferAsIntBufferRB.java,Java,,52,148,25,225
ByteBufferAsIntBufferRL.java,Java,,52,148,25,225
ByteBufferAsLongBufferB.java,Java,,93,106,26,225
ByteBufferAsLongBufferL.java,Java,,93,106,26,225
ByteBufferAsLongBufferRB.java,Java,,52,148,25,225
ByteBufferAsLongBufferRL.java,Java,,52,148,25,225
ByteBufferAsShortBufferB.java,Java,,93,106,26,225
ByteBufferAsShortBufferL.java,Java,,93,106,26,225
ByteBufferAsShortBufferRB.java,Java,,52,148,25,225
ByteBufferAsShortBufferRL.java,Java,,52,148,25,225
ByteOrder.java,Java,,17,11,60,88
AcceptPendingException.java,Java,,7,8,36,51
AlreadyBoundException.java,Java,,7,8,36,51
AlreadyConnectedException.java,Java,,7,8,36,51
AsynchronousByteChannel.java,Java,,15,7,191,213
AsynchronousChannel.java,Java,,9,4,104,117
AsynchronousChannelGroup.java,Java,,41,14,288,343
AsynchronousCloseException.java,Java,,7,8,37,52
AsynchronousFileChannel.java,Java,,67,20,692,779
AsynchronousServerSocketChannel.java,Java,,43,14,271,328
AsynchronousSocketChannel.java,Java,,87,29,571,687
ByteChannel.java,Java,,6,6,33,45
CancelledKeyException.java,Java,,7,8,36,51
Channel.java,Java,,7,8,69,84
Channels.java,Java,,318,55,242,615
ClosedByInterruptException.java,Java,,7,8,38,53
ClosedChannelException.java,Java,,7,8,39,54
ClosedSelectorException.java,Java,,7,8,36,51
CompletionHandler.java,Java,,5,5,56,66
ConnectionPendingException.java,Java,,7,8,37,52
DatagramChannel.java,Java,,54,29,509,592
FileChannel.java,Java,,87,43,1028,1158
FileLock.java,Java,,71,18,242,331
FileLockInterruptionException.java,Java,,7,8,37,52
GatheringByteChannel.java,Java,,10,9,147,166
IllegalBlockingModeException.java,Java,,7,8,36,51
IllegalChannelGroupException.java,Java,,7,8,36,51
IllegalSelectorException.java,Java,,7,8,37,52
InterruptedByTimeoutException.java,Java,,7,8,36,51
InterruptibleChannel.java,Java,,7,8,67,82
MembershipKey.java,Java,,16,12,149,177
MulticastChannel.java,Java,,16,6,208,230
NetworkChannel.java,Java,,14,8,141,163
NoConnectionPendingException.java,Java,,7,8,37,52
NonReadableChannelException.java,Java,,7,8,36,51
NonWritableChannelException.java,Java,,7,8,36,51
NotYetBoundException.java,Java,,7,8,36,51
NotYetConnectedException.java,Java,,7,8,36,51
OverlappingFileLockException.java,Java,,7,8,38,53
package-info.java,Java,,1,2,287,290
Pipe.java,Java,,33,16,109,158
ReadableByteChannel.java,Java,,6,7,95,108
ReadPendingException.java,Java,,7,8,36,51
ScatteringByteChannel.java,Java,,10,8,144,162
SeekableByteChannel.java,Java,,15,9,144,168
SelectableChannel.java,Java,,25,17,302,344
SelectionKey.java,Java,,40,34,327,401
Selector.java,Java,,21,17,358,396
ServerSocketChannel.java,Java,,34,16,242,292
ShutdownChannelGroupException.java,Java,,7,8,37,52
SocketChannel.java,Java,,69,29,428,526
AbstractInterruptibleChannel.java,Java,,65,18,131,214
AbstractSelectableChannel.java,Java,,142,34,142,318
AbstractSelectionKey.java,Java,,22,10,45,77
AbstractSelector.java,Java,,60,23,151,234
AsynchronousChannelProvider.java,Java,,83,14,148,245
SelectorProvider.java,Java,,89,19,209,317
UnresolvedAddressException.java,Java,,7,8,36,51
UnsupportedAddressTypeException.java,Java,,7,8,36,51
WritableByteChannel.java,Java,,8,7,90,105
WritePendingException.java,Java,,7,8,36,51
CharBuffer.java,Java,,209,207,1087,1503
CharBufferSpliterator.java,Java,,55,10,31,96
CharacterCodingException.java,Java,,7,8,36,51
Charset.java,Java,,303,58,556,917
CharsetDecoder.java,Java,,219,201,576,996
CharsetEncoder.java,Java,,264,149,583,996
CoderMalfunctionError.java,Java,,9,7,38,54
CoderResult.java,Java,,97,29,162,288
CodingErrorAction.java,Java,,16,11,57,84
IllegalCharsetNameException.java,Java,,14,10,44,68
MalformedInputException.java,Java,,16,10,44,70
CharsetProvider.java,Java,,12,9,89,110
StandardCharsets.java,Java,,12,2,52,66
UnmappableCharacterException.java,Java,,16,10,44,70
UnsupportedCharsetException.java,Java,,14,10,44,68
DirectByteBuffer.java,Java,,625,361,47,1033
DirectByteBufferR.java,Java,,343,659,31,1033
DirectCharBufferRS.java,Java,,93,373,28,494
DirectCharBufferRU.java,Java,,93,373,28,494
DirectCharBufferS.java,Java,,205,252,37,494
DirectCharBufferU.java,Java,,205,252,37,494
DirectDoubleBufferRS.java,Java,,62,405,27,494
DirectDoubleBufferRU.java,Java,,62,405,27,494
DirectDoubleBufferS.java,Java,,171,287,36,494
DirectDoubleBufferU.java,Java,,171,287,36,494
DirectFloatBufferRS.java,Java,,62,405,27,494
DirectFloatBufferRU.java,Java,,62,405,27,494
DirectFloatBufferS.java,Java,,171,287,36,494
DirectFloatBufferU.java,Java,,171,287,36,494
DirectIntBufferRS.java,Java,,62,405,27,494
DirectIntBufferRU.java,Java,,62,405,27,494
DirectIntBufferS.java,Java,,171,287,36,494
DirectIntBufferU.java,Java,,171,287,36,494
DirectLongBufferRS.java,Java,,62,405,27,494
DirectLongBufferRU.java,Java,,62,405,27,494
DirectLongBufferS.java,Java,,171,287,36,494
DirectLongBufferU.java,Java,,171,287,36,494
DirectShortBufferRS.java,Java,,62,405,27,494
DirectShortBufferRU.java,Java,,62,405,27,494
DirectShortBufferS.java,Java,,171,287,36,494
DirectShortBufferU.java,Java,,171,287,36,494
DoubleBuffer.java,Java,,150,555,798,1503
AccessDeniedException.java,Java,,12,5,51,68
AccessMode.java,Java,,6,3,38,47
AtomicMoveNotSupportedException.java,Java,,12,4,40,56
AclEntry.java,Java,,175,33,209,417
AclEntryFlag.java,Java,,7,7,51,65
AclEntryPermission.java,Java,,20,20,90,130
AclEntryType.java,Java,,7,6,43,56
AclFileAttributeView.java,Java,,12,6,191,209
AttributeView.java,Java,,4,3,38,45
BasicFileAttributes.java,Java,,12,12,131,155
BasicFileAttributeView.java,Java,,12,6,159,177
DosFileAttributes.java,Java,,9,6,69,84
DosFileAttributeView.java,Java,,14,9,156,179
FileAttribute.java,Java,,5,4,45,54
FileAttributeView.java,Java,,5,3,34,42
FileOwnerAttributeView.java,Java,,10,6,85,101
FileStoreAttributeView.java,Java,,5,3,30,38
FileTime.java,Java,,247,24,204,475
GroupPrincipal.java,Java,,2,3,37,42
package-info.java,Java,,1,2,107,110
PosixFileAttributes.java,Java,,9,6,60,75
PosixFileAttributeView.java,Java,,14,7,172,193
PosixFilePermission.java,Java,,12,12,60,84
PosixFilePermissions.java,Java,,78,9,93,180
UserDefinedFileAttributeView.java,Java,,15,9,207,231
UserPrincipal.java,Java,,3,4,47,54
UserPrincipalLookupService.java,Java,,10,7,87,104
UserPrincipalNotFoundException.java,Java,,15,7,42,64
ClosedDirectoryStreamException.java,Java,,8,4,33,45
ClosedFileSystemException.java,Java,,8,4,31,43
ClosedWatchServiceException.java,Java,,8,4,31,43
CopyMoveHelper.java,Java,,98,14,48,160
CopyOption.java,Java,,3,3,39,45
DirectoryIteratorException.java,Java,,26,7,54,87
DirectoryNotEmptyException.java,Java,,9,4,36,49
DirectoryStream.java,Java,,13,5,141,159
FileAlreadyExistsException.java,Java,,12,5,46,63
Files.java,Java,,783,117,2887,3787
FileStore.java,Java,,18,15,188,221
FileSystem.java,Java,,25,16,427,468
FileSystemAlreadyExistsException.java,Java,,11,5,37,53
FileSystemException.java,Java,,45,11,69,125
FileSystemLoopException.java,Java,,9,4,37,50
FileSystemNotFoundException.java,Java,,11,5,36,52
FileSystems.java,Java,,107,22,280,409
FileTreeIterator.java,Java,,61,11,52,124
FileTreeWalker.java,Java,,242,46,137,425
FileVisitOption.java,Java,,4,3,34,41
FileVisitor.java,Java,,13,8,156,177
FileVisitResult.java,Java,,7,3,52,62
InvalidPathException.java,Java,,40,10,80,130
LinkOption.java,Java,,4,3,36,43
LinkPermission.java,Java,,21,6,80,107
NoSuchFileException.java,Java,,12,5,46,63
NotDirectoryException.java,Java,,9,4,36,49
NotLinkException.java,Java,,12,5,46,63
OpenOption.java,Java,,3,3,39,45
package-info.java,Java,,1,1,115,117
Path.java,Java,,47,36,718,801
PathMatcher.java,Java,,5,2,42,49
Paths.java,Java,,22,9,118,149
ProviderMismatchException.java,Java,,11,4,38,53
ProviderNotFoundException.java,Java,,11,5,36,52
ReadOnlyFileSystemException.java,Java,,8,4,31,43
SecureDirectoryStream.java,Java,,23,9,280,312
SimpleFileVisitor.java,Java,,40,8,64,112
FileSystemProvider.java,Java,,171,44,888,1103
FileTypeDetector.java,Java,,17,7,82,106
package-info.java,Java,,1,2,36,39
StandardCopyOption.java,Java,,6,3,38,47
StandardOpenOption.java,Java,,13,12,100,125
StandardWatchEventKinds.java,Java,,23,8,63,94
TempFileHelper.java,Java,,109,14,52,175
Watchable.java,Java,,10,7,110,127
WatchEvent.java,Java,,13,9,96,118
WatchKey.java,Java,,9,9,132,150
WatchService.java,Java,,14,8,152,174
FloatBuffer.java,Java,,150,555,798,1503
HeapByteBuffer.java,Java,,302,238,61,601
HeapByteBufferR.java,Java,,201,351,49,601
HeapCharBuffer.java,Java,,136,409,56,601
HeapCharBufferR.java,Java,,80,477,44,601
HeapDoubleBuffer.java,Java,,113,433,55,601
HeapDoubleBufferR.java,Java,,60,498,43,601
HeapFloatBuffer.java,Java,,113,433,55,601
HeapFloatBufferR.java,Java,,60,498,43,601
HeapIntBuffer.java,Java,,113,433,55,601
HeapIntBufferR.java,Java,,60,498,43,601
HeapLongBuffer.java,Java,,113,433,55,601
HeapLongBufferR.java,Java,,60,498,43,601
HeapShortBuffer.java,Java,,113,433,55,601
HeapShortBufferR.java,Java,,60,498,43,601
IntBuffer.java,Java,,147,558,798,1503
InvalidMarkException.java,Java,,7,8,36,51
LongBuffer.java,Java,,147,558,798,1503
MappedByteBuffer.java,Java,,73,20,118,211
ReadOnlyBufferException.java,Java,,7,8,36,51
ShortBuffer.java,Java,,147,558,798,1503
StringCharBuffer.java,Java,,80,22,26,128
AccessException.java,Java,,10,5,55,70
Activatable.java,Java,,134,22,423,579
ActivateFailedException.java,Java,,10,5,47,62
ActivationDesc.java,Java,,98,22,227,347
ActivationException.java,Java,,28,9,81,118
ActivationGroup.java,Java,,175,31,332,538
ActivationGroupDesc.java,Java,,122,31,217,370
ActivationGroupID.java,Java,,26,9,82,117
ActivationID.java,Java,,94,16,182,292
ActivationInstantiator.java,Java,,9,4,63,76
ActivationMonitor.java,Java,,16,7,85,108
ActivationSystem.java,Java,,32,14,183,229
Activator.java,Java,,10,4,100,114
UnknownGroupException.java,Java,,7,4,49,60
UnknownObjectException.java,Java,,7,4,51,62
AlreadyBoundException.java,Java,,10,4,48,62
ConnectException.java,Java,,10,5,47,62
ConnectIOException.java,Java,,10,6,48,64
DGC.java,Java,,9,4,102,115
Lease.java,Java,,19,6,52,77
VMID.java,Java,,57,12,65,134
MarshalException.java,Java,,10,5,56,71
MarshalledObject.java,Java,,134,32,186,352
Naming.java,Java,,171,22,163,356
NoSuchObjectException.java,Java,,7,4,51,62
NotBoundException.java,Java,,10,4,50,64
LocateRegistry.java,Java,,68,15,158,241
Registry.java,Java,,18,8,166,192
RegistryHandler.java,Java,,11,5,57,73
Remote.java,Java,,2,2,46,50
RemoteException.java,Java,,28,9,85,122
RMISecurityException.java,Java,,13,4,50,67
RMISecurityManager.java,Java,,7,4,56,67
ExportException.java,Java,,10,6,52,68
LoaderHandler.java,Java,,15,7,73,95
LogStream.java,Java,,123,27,122,272
ObjID.java,Java,,68,18,162,248
Operation.java,Java,,17,5,51,73
RemoteCall.java,Java,,24,10,98,132
RemoteObject.java,Java,,89,15,354,458
RemoteObjectInvocationHandler.java,Java,,157,20,139,316
RemoteRef.java,Java,,22,14,159,195
RemoteServer.java,Java,,27,8,80,115
RemoteStub.java,Java,,15,5,63,83
RMIClassLoader.java,Java,,134,25,563,722
RMIClassLoaderSpi.java,Java,,15,7,170,192
RMIClientSocketFactory.java,Java,,7,4,63,74
RMIFailureHandler.java,Java,,4,4,52,60
RMIServerSocketFactory.java,Java,,7,4,63,74
RMISocketFactory.java,Java,,52,12,164,228
ServerCloneException.java,Java,,25,8,79,112
ServerNotActiveException.java,Java,,9,5,47,61
ServerRef.java,Java,,9,6,53,68
Skeleton.java,Java,,10,3,57,70
SkeletonMismatchException.java,Java,,10,6,46,62
SkeletonNotFoundException.java,Java,,12,6,50,68
SocketSecurityException.java,Java,,11,6,47,64
UID.java,Java,,88,17,164,269
UnicastRemoteObject.java,Java,,84,18,283,385
Unreferenced.java,Java,,4,2,39,45
ServerError.java,Java,,7,4,45,56
ServerException.java,Java,,10,5,52,67
ServerRuntimeException.java,Java,,9,4,52,65
StubNotFoundException.java,Java,,10,5,52,67
UnexpectedException.java,Java,,10,5,49,64
UnknownHostException.java,Java,,10,5,47,62
UnmarshalException.java,Java,,10,5,61,76
AccessControlContext.java,Java,,490,116,349,955
AccessControlException.java,Java,,15,8,59,82
AccessController.java,Java,,170,43,673,886
Acl.java,Java,,16,12,213,241
AclEntry.java,Java,,15,13,126,154
AclNotFoundException.java,Java,,6,5,33,44
Group.java,Java,,9,9,69,87
LastOwnerException.java,Java,,6,4,35,45
NotOwnerException.java,Java,,6,4,34,44
Owner.java,Java,,9,7,79,95
package-info.java,Java,,1,1,31,33
Permission.java,Java,,5,6,43,54
AlgorithmConstraints.java,Java,,9,8,91,108
AlgorithmParameterGenerator.java,Java,,78,18,247,343
AlgorithmParameterGeneratorSpi.java,Java,,9,7,70,86
AlgorithmParameters.java,Java,,108,21,270,399
AlgorithmParametersSpi.java,Java,,20,11,122,153
AllPermission.java,Java,,63,29,137,229
AuthProvider.java,Java,,14,8,106,128
BasicPermission.java,Java,,204,70,280,554
Certificate.java,Java,,97,26,184,307
CertificateEncodingException.java,Java,,16,7,65,88
CertificateException.java,Java,,17,8,63,88
CertificateExpiredException.java,Java,,10,5,44,59
CertificateFactory.java,Java,,102,22,413,537
CertificateFactorySpi.java,Java,,38,12,265,315
CertificateNotYetValidException.java,Java,,10,5,44,59
CertificateParsingException.java,Java,,16,7,66,89
CertificateRevokedException.java,Java,,96,21,130,247
CertPath.java,Java,,92,25,226,343
CertPathBuilder.java,Java,,68,14,249,331
CertPathBuilderException.java,Java,,17,9,78,104
CertPathBuilderResult.java,Java,,5,4,59,68
CertPathBuilderSpi.java,Java,,10,6,82,98
CertPathChecker.java,Java,,6,5,66,77
CertPathHelperImpl.java,Java,,20,9,37,66
CertPathParameters.java,Java,,4,3,42,49
CertPathValidator.java,Java,,70,14,259,343
CertPathValidatorException.java,Java,,77,26,193,296
CertPathValidatorResult.java,Java,,4,3,43,50
CertPathValidatorSpi.java,Java,,11,6,91,108
CertSelector.java,Java,,5,4,58,67
CertStore.java,Java,,100,15,307,422
CertStoreException.java,Java,,17,9,77,103
CertStoreParameters.java,Java,,4,3,73,80
CertStoreSpi.java,Java,,11,6,108,125
CollectionCertStoreParameters.java,Java,,33,9,99,141
CRL.java,Java,,12,8,68,88
CRLException.java,Java,,17,8,63,88
CRLReason.java,Java,,14,12,78,104
CRLSelector.java,Java,,5,4,57,66
Extension.java,Java,,10,7,84,101
LDAPCertStoreParameters.java,Java,,39,13,97,149
package-info.java,Java,,1,1,62,64
PKIXBuilderParameters.java,Java,,40,9,150,199
PKIXCertPathBuilderResult.java,Java,,28,7,84,119
PKIXCertPathChecker.java,Java,,28,10,158,196
PKIXCertPathValidatorResult.java,Java,,43,10,106,159
PKIXParameters.java,Java,,251,42,443,736
PKIXReason.java,Java,,11,9,57,77
PKIXRevocationChecker.java,Java,,87,16,215,318
PolicyNode.java,Java,,12,10,111,133
PolicyQualifierInfo.java,Java,,46,12,115,173
TrustAnchor.java,Java,,98,16,219,333
X509Certificate.java,Java,,64,31,583,678
X509CertSelector.java,Java,,1245,107,1271,2623
X509CRL.java,Java,,88,28,352,468
X509CRLEntry.java,Java,,50,16,125,191
X509CRLSelector.java,Java,,271,39,408,718
X509Extension.java,Java,,8,8,170,186
Certificate.java,Java,,15,11,130,156
CodeSigner.java,Java,,68,16,89,173
CodeSource.java,Java,,272,59,314,645
CryptoPrimitive.java,Java,,13,11,59,83
DigestException.java,Java,,16,7,63,86
DigestInputStream.java,Java,,41,14,133,188
DigestOutputStream.java,Java,,39,12,120,171
DomainCombiner.java,Java,,5,3,104,112
DomainLoadStoreParameter.java,Java,,27,8,136,171
GeneralSecurityException.java,Java,,16,8,64,88
Guard.java,Java,,4,4,48,56
GuardedObject.java,Java,,25,11,66,102
Identity.java,Java,,177,42,276,495
IdentityScope.java,Java,,67,26,164,257
DSAKey.java,Java,,4,3,43,50
DSAKeyPairGenerator.java,Java,,8,5,104,117
DSAParams.java,Java,,7,6,51,64
DSAPrivateKey.java,Java,,6,6,46,58
DSAPublicKey.java,Java,,6,6,46,58
ECKey.java,Java,,5,2,38,45
ECPrivateKey.java,Java,,7,3,43,53
ECPublicKey.java,Java,,7,4,44,55
package-info.java,Java,,1,1,72,74
RSAKey.java,Java,,5,5,39,49
RSAMultiPrimePrivateCrtKey.java,Java,,13,12,80,105
RSAPrivateCrtKey.java,Java,,11,11,68,90
RSAPrivateKey.java,Java,,7,6,42,55
RSAPublicKey.java,Java,,7,5,40,52
InvalidAlgorithmParameterException.java,Java,,17,8,72,97
InvalidKeyException.java,Java,,16,9,64,89
InvalidParameterException.java,Java,,10,6,43,59
Key.java,Java,,7,8,137,152
KeyException.java,Java,,16,8,66,90
KeyFactory.java,Java,,188,25,263,476
KeyFactorySpi.java,Java,,14,9,119,142
KeyManagementException.java,Java,,16,8,75,99
KeyPair.java,Java,,17,9,55,81
KeyPairGenerator.java,Java,,248,44,423,715
KeyPairGeneratorSpi.java,Java,,11,7,88,106
KeyRep.java,Java,,61,21,114,196
KeyStore.java,Java,,713,121,1167,2001
KeyStoreException.java,Java,,16,8,66,90
KeyStoreSpi.java,Java,,181,39,373,593
MessageDigest.java,Java,,228,47,329,604
MessageDigestSpi.java,Java,,56,15,135,206
NoSuchAlgorithmException.java,Java,,16,8,65,89
NoSuchProviderException.java,Java,,10,6,42,58
package-info.java,Java,,1,1,110,112
Permission.java,Java,,31,21,179,231
PermissionCollection.java,Java,,30,12,153,195
Permissions.java,Java,,241,80,282,603
PKCS12Attribute.java,Java,,136,19,130,285
Policy.java,Java,,335,71,447,853
PolicySpi.java,Java,,14,8,96,118
Principal.java,Java,,13,8,73,94
PrivateKey.java,Java,,4,4,59,67
PrivilegedAction.java,Java,,4,4,48,56
PrivilegedActionException.java,Java,,19,7,79,105
PrivilegedExceptionAction.java,Java,,4,5,53,62
ProtectionDomain.java,Java,,306,64,224,594
Provider.java,Java,,1019,129,698,1846
ProviderException.java,Java,,16,7,66,89
PublicKey.java,Java,,4,3,46,53
SecureClassLoader.java,Java,,69,16,142,227
SecureRandom.java,Java,,195,45,448,688
SecureRandomSpi.java,Java,,7,7,60,74
Security.java,Java,,533,95,498,1126
SecurityPermission.java,Java,,16,7,325,348
Signature.java,Java,,670,100,571,1341
SignatureException.java,Java,,16,8,63,87
SignatureSpi.java,Java,,92,22,276,390
SignedObject.java,Java,,57,16,185,258
Signer.java,Java,,61,17,105,183
AlgorithmParameterSpec.java,Java,,2,3,39,44
DSAGenParameterSpec.java,Java,,50,7,70,127
DSAParameterSpec.java,Java,,22,9,58,89
DSAPrivateKeySpec.java,Java,,27,10,69,106
DSAPublicKeySpec.java,Java,,27,10,69,106
ECField.java,Java,,6,2,41,49
ECFieldF2m.java,Java,,91,12,138,241
ECFieldFp.java,Java,,28,8,62,98
ECGenParameterSpec.java,Java,,13,4,51,68
ECParameterSpec.java,Java,,42,8,63,113
ECPoint.java,Java,,37,10,67,114
ECPrivateKeySpec.java,Java,,22,6,53,81
ECPublicKeySpec.java,Java,,24,5,56,85
EllipticCurve.java,Java,,81,13,102,196
EncodedKeySpec.java,Java,,11,7,67,85
InvalidKeySpecException.java,Java,,17,9,68,94
InvalidParameterSpecException.java,Java,,11,7,48,66
KeySpec.java,Java,,2,3,57,62
MGF1ParameterSpec.java,Java,,24,7,82,113
package-info.java,Java,,1,1,71,73
PKCS8EncodedKeySpec.java,Java,,12,6,78,96
PSSParameterSpec.java,Java,,59,14,139,212
RSAKeyGenParameterSpec.java,Java,,19,10,57,86
RSAMultiPrimePrivateCrtKeySpec.java,Java,,90,13,109,212
RSAOtherPrimeInfo.java,Java,,35,10,75,120
RSAPrivateCrtKeySpec.java,Java,,44,14,85,143
RSAPrivateKeySpec.java,Java,,16,8,53,77
RSAPublicKeySpec.java,Java,,16,8,53,77
X509EncodedKeySpec.java,Java,,12,6,68,86
Timestamp.java,Java,,62,16,86,164
UnrecoverableEntryException.java,Java,,10,6,40,56
UnrecoverableKeyException.java,Java,,10,6,40,56
UnresolvedPermission.java,Java,,292,47,263,602
UnresolvedPermissionCollection.java,Java,,92,27,101,220
URIParameter.java,Java,,14,6,43,63
Array.java,Java,,17,14,335,366
BatchUpdateException.java,Java,,99,27,438,564
Blob.java,Java,,15,16,273,304
CallableStatement.java,Java,,197,129,2498,2824
ClientInfoStatus.java,Java,,8,8,46,62
Clob.java,Java,,17,19,312,348
Connection.java,Java,,81,68,1337,1486
DatabaseMetaData.java,Java,,282,251,3155,3688
DataTruncation.java,Java,,44,18,126,188
Date.java,Java,,103,28,175,306
Driver.java,Java,,13,14,154,181
DriverAction.java,Java,,4,3,59,66
DriverManager.java,Java,,281,83,364,728
DriverPropertyInfo.java,Java,,12,9,63,84
JDBCType.java,Java,,63,12,186,261
NClob.java,Java,,3,4,48,55
ParameterMetaData.java,Java,,19,20,157,196
PreparedStatement.java,Java,,101,59,1160,1320
PseudoColumnUsage.java,Java,,7,8,42,57
Ref.java,Java,,7,8,112,127
ResultSet.java,Java,,272,219,3800,4291
ResultSetMetaData.java,Java,,27,28,222,277
RowId.java,Java,,7,7,106,120
RowIdLifetime.java,Java,,9,9,49,67
Savepoint.java,Java,,5,5,50,60
SQLClientInfoException.java,Java,,63,27,231,321
SQLData.java,Java,,6,5,126,137
SQLDataException.java,Java,,28,11,134,173
SQLException.java,Java,,152,35,188,375
SQLFeatureNotSupportedException.java,Java,,28,11,140,179
SQLInput.java,Java,,33,37,389,459
SQLIntegrityConstraintViolationException.java,Java,,28,11,135,174
SQLInvalidAuthorizationSpecException.java,Java,,28,11,135,174
SQLNonTransientConnectionException.java,Java,,28,12,136,176
SQLNonTransientException.java,Java,,28,12,135,175
SQLOutput.java,Java,,33,40,402,475
SQLPermission.java,Java,,11,11,138,160
SQLRecoverableException.java,Java,,28,11,136,175
SQLSyntaxErrorException.java,Java,,28,11,134,173
SQLTimeoutException.java,Java,,28,11,134,173
SQLTransactionRollbackException.java,Java,,28,10,135,173
SQLTransientConnectionException.java,Java,,28,11,135,174
SQLTransientException.java,Java,,28,11,133,172
SQLType.java,Java,,6,4,46,56
SQLWarning.java,Java,,52,14,151,217
SQLXML.java,Java,,19,13,395,427
Statement.java,Java,,80,68,1222,1370
Struct.java,Java,,7,6,93,106
Time.java,Java,,101,24,168,293
Timestamp.java,Java,,295,41,283,619
Types.java,Java,,43,49,250,342
Wrapper.java,Java,,5,6,70,81
Annotation.java,Java,,13,8,68,89
AttributedCharacterIterator.java,Java,,54,29,203,286
AttributedString.java,Java,,721,140,272,1133
Bidi.java,Java,,88,32,214,334
BreakIterator.java,Java,,153,40,425,618
CalendarBuilder.java,Java,,116,18,45,179
CharacterIterator.java,Java,,15,17,161,193
CharacterIteratorFieldDelegate.java,Java,,60,11,53,124
ChoiceFormat.java,Java,,265,39,336,640
CollationElementIterator.java,Java,,411,57,314,782
CollationKey.java,Java,,15,10,124,149
Collator.java,Java,,132,26,357,515
DateFormat.java,Java,,283,69,688,1040
DateFormatSymbols.java,Java,,330,68,478,876
DecimalFormat.java,Java,,1879,344,1967,4190
DecimalFormatSymbols.java,Java,,289,74,515,878
DigitList.java,Java,,411,69,343,823
DontCareFieldPosition.java,Java,,18,5,30,53
EntryPair.java,Java,,15,4,41,60
FieldPosition.java,Java,,96,27,191,314
Format.java,Java,,68,28,310,406
MergeCollation.java,Java,,187,31,124,342
MessageFormat.java,Java,,672,85,846,1603
Normalizer.java,Java,,18,12,149,179
NumberFormat.java,Java,,318,88,828,1234
ParseException.java,Java,,13,7,63,83
ParsePosition.java,Java,,38,13,99,150
PatternEntry.java,Java,,206,29,71,306
RBCollationTables.java,Java,,127,31,143,301
RBTableBuilder.java,Java,,338,55,225,618
RuleBasedCollationKey.java,Java,,38,10,75,123
RuleBasedCollator.java,Java,,276,44,449,769
SimpleDateFormat.java,Java,,1314,164,964,2442
BreakIteratorProvider.java,Java,,12,8,87,107
CollatorProvider.java,Java,,9,5,47,61
DateFormatProvider.java,Java,,12,7,95,114
DateFormatSymbolsProvider.java,Java,,9,5,48,62
DecimalFormatSymbolsProvider.java,Java,,9,5,58,72
NumberFormatProvider.java,Java,,12,8,93,113
StringCharacterIterator.java,Java,,129,26,126,281
AbstractChronology.java,Java,,386,44,355,785
ChronoLocalDate.java,Java,,149,34,616,799
ChronoLocalDateImpl.java,Java,,159,28,257,444
ChronoLocalDateTime.java,Java,,144,31,427,602
ChronoLocalDateTimeImpl.java,Java,,241,35,183,459
Chronology.java,Java,,122,35,597,754
ChronoPeriod.java,Java,,55,20,290,365
ChronoPeriodImpl.java,Java,,238,33,130,401
ChronoZonedDateTime.java,Java,,190,39,448,677
ChronoZonedDateTimeImpl.java,Java,,201,31,159,391
Era.java,Java,,61,13,251,325
HijrahChronology.java,Java,,480,75,549,1104
HijrahDate.java,Java,,312,53,333,698
HijrahEra.java,Java,,28,9,121,158
IsoChronology.java,Java,,192,34,387,613
IsoEra.java,Java,,20,7,126,153
JapaneseChronology.java,Java,,251,38,245,534
JapaneseDate.java,Java,,319,51,387,757
JapaneseEra.java,Java,,141,34,217,392
MinguoChronology.java,Java,,137,29,198,364
MinguoDate.java,Java,,241,44,234,519
MinguoEra.java,Java,,20,7,128,155
package-info.java,Java,,1,2,168,171
Ser.java,Java,,93,15,148,256
ThaiBuddhistChronology.java,Java,,155,29,216,400
ThaiBuddhistDate.java,Java,,241,44,234,519
ThaiBuddhistEra.java,Java,,20,7,128,155
Clock.java,Java,,251,28,370,649
DateTimeException.java,Java,,10,6,85,101
DayOfWeek.java,Java,,98,18,341,457
Duration.java,Java,,451,70,826,1347
DateTimeFormatter.java,Java,,566,59,1540,2165
DateTimeFormatterBuilder.java,Java,,2415,221,1867,4503
DateTimeParseContext.java,Java,,152,30,256,438
DateTimeParseException.java,Java,,23,10,105,138
DateTimePrintContext.java,Java,,153,19,146,318
DateTimeTextProvider.java,Java,,328,31,199,558
DecimalStyle.java,Java,,124,24,233,381
FormatStyle.java,Java,,7,4,88,99
package-info.java,Java,,1,2,92,95
Parsed.java,Java,,485,36,156,677
ResolverStyle.java,Java,,6,4,106,116
SignStyle.java,Java,,19,5,115,139
TextStyle.java,Java,,31,11,133,175
ZoneName.java,Java,,759,9,31,799
Instant.java,Java,,367,56,948,1371
LocalDate.java,Java,,635,86,1361,2082
LocalDateTime.java,Java,,530,92,1391,2013
LocalTime.java,Java,,554,69,1070,1693
Month.java,Java,,184,23,408,615
MonthDay.java,Java,,217,41,534,792
OffsetDateTime.java,Java,,453,95,1405,1953
OffsetTime.java,Java,,346,68,1003,1417
package-info.java,Java,,1,2,285,288
Period.java,Java,,345,52,684,1081
Ser.java,Java,,116,15,153,284
ChronoField.java,Java,,136,23,594,753
ChronoUnit.java,Java,,59,15,207,281
IsoFields.java,Java,,432,31,261,724
JulianFields.java,Java,,94,24,190,308
package-info.java,Java,,1,2,156,159
Temporal.java,Java,,20,12,417,449
TemporalAccessor.java,Java,,36,9,272,317
TemporalAdjuster.java,Java,,6,5,141,152
TemporalAdjusters.java,Java,,107,20,351,478
TemporalAmount.java,Java,,11,7,201,219
TemporalField.java,Java,,30,17,347,394
TemporalQueries.java,Java,,62,21,315,398
TemporalQuery.java,Java,,6,5,134,145
TemporalUnit.java,Java,,42,12,243,297
UnsupportedTemporalTypeException.java,Java,,11,7,83,101
ValueRange.java,Java,,128,25,277,430
WeekFields.java,Java,,474,68,616,1158
Year.java,Java,,277,52,793,1122
YearMonth.java,Java,,346,58,846,1250
package-info.java,Java,,1,2,83,86
Ser.java,Java,,105,20,156,281
TzdbZoneRulesProvider.java,Java,,104,10,92,206
ZoneOffsetTransition.java,Java,,136,28,291,455
ZoneOffsetTransitionRule.java,Java,,242,28,357,627
ZoneRules.java,Java,,438,48,542,1028
ZoneRulesException.java,Java,,11,7,80,98
ZoneRulesProvider.java,Java,,118,19,302,439
ZonedDateTime.java,Java,,515,93,1646,2254
ZoneId.java,Java,,192,27,448,667
ZoneOffset.java,Java,,286,39,474,799
ZoneRegion.java,Java,,78,15,128,221
AbstractCollection.java,Java,,162,29,278,469
AbstractList.java,Java,,336,78,367,781
AbstractMap.java,Java,,308,74,478,860
AbstractQueue.java,Java,,42,10,140,192
AbstractSequentialList.java,Java,,57,14,182,253
AbstractSet.java,Java,,47,10,129,186
ArrayDeque.java,Java,,457,84,444,985
ArrayList.java,Java,,783,142,535,1460
ArrayPrefixHelpers.java,Java,,583,26,87,696
Arrays.java,Java,...,1617,297,3201,5115
ArraysParallelSortHelpers.java,Java,,879,40,91,1010
Base64.java,Java,,556,57,385,998
BitSet.java,Java,,516,146,586,1248
Calendar.java,Java,,1226,252,2154,3632
Collection.java,Java,,43,28,533,604
Collections.java,Java,,2960,575,2029,5564
ComparableTimSort.java,Java,,468,71,369,908
Comparator.java,Java,,87,20,427,534
Comparators.java,Java,,52,10,36,98
AbstractExecutorService.java,Java,,170,23,114,307
ArrayBlockingQueue.java,Java,,761,96,560,1417
AtomicBoolean.java,Java,,49,15,100,164
AtomicInteger.java,Java,,106,30,200,336
AtomicIntegerArray.java,Java,,127,33,204,364
AtomicIntegerFieldUpdater.java,Java,,238,44,261,543
AtomicLong.java,Java,,108,32,210,350
AtomicLongArray.java,Java,,127,32,203,362
AtomicLongFieldUpdater.java,Java,,326,55,278,659
AtomicMarkableReference.java,Java,,76,17,119,212
AtomicReference.java,Java,,77,20,143,240
AtomicReferenceArray.java,Java,,132,27,171,330
AtomicReferenceFieldUpdater.java,Java,,193,35,243,471
AtomicStampedReference.java,Java,,76,17,119,212
DoubleAccumulator.java,Java,,106,21,167,294
DoubleAdder.java,Java,,92,21,154,267
LongAccumulator.java,Java,,100,21,169,290
LongAdder.java,Java,,92,22,154,268
package-info.java,Java,,1,2,209,212
Striped64.java,Java,,237,18,158,413
BlockingDeque.java,Java,,39,34,578,651
BlockingQueue.java,Java,,18,14,344,376
BrokenBarrierException.java,Java,,8,5,53,66
Callable.java,Java,,5,3,58,66
CancellationException.java,Java,,8,5,50,63
CompletableFuture.java,Java,,1633,180,572,2385
CompletionException.java,Java,,14,7,69,90
CompletionService.java,Java,,8,7,109,124
CompletionStage.java,Java,,103,39,638,780
ConcurrentHashMap.java,Java,,4264,294,1754,6312
ConcurrentLinkedDeque.java,Java,,761,125,700,1586
ConcurrentLinkedQueue.java,Java,,448,67,433,948
ConcurrentMap.java,Java,,120,18,379,517
ConcurrentNavigableMap.java,Java,,17,12,138,167
ConcurrentSkipListMap.java,Java,,2136,266,1196,3598
ConcurrentSkipListSet.java,Java,,168,47,311,526
CopyOnWriteArrayList.java,Java,,1037,114,535,1686
CopyOnWriteArraySet.java,Java,,105,26,302,433
CountDownLatch.java,Java,,47,14,254,315
CountedCompleter.java,Java,,145,29,593,767
CyclicBarrier.java,Java,,132,23,336,491
Delayed.java,Java,,4,4,52,60
DelayQueue.java,Java,,269,33,255,557
Exchanger.java,Java,,232,28,404,664
ExecutionException.java,Java,,14,7,71,92
Executor.java,Java,,4,4,133,141
ExecutorCompletionService.java,Java,,65,14,126,205
Executors.java,Java,,314,45,385,744
ExecutorService.java,Java,,24,15,331,370
ForkJoinPool.java,Java,,1721,156,1600,3477
ForkJoinTask.java,Java,,682,81,766,1529
ForkJoinWorkerThread.java,Java,,121,25,130,276
Future.java,Java,,9,8,152,169
FutureTask.java,Java,,251,30,205,486
LinkedBlockingDeque.java,Java,,750,104,479,1333
LinkedBlockingQueue.java,Java,,590,69,385,1044
LinkedTransferQueue.java,Java,,655,91,735,1481
AbstractOwnableSynchronizer.java,Java,,13,8,65,86
AbstractQueuedLongSynchronizer.java,Java,,836,126,1133,2095
AbstractQueuedSynchronizer.java,Java,,836,125,1354,2315
Condition.java,Java,,12,10,465,487
Lock.java,Java,,10,9,338,357
LockSupport.java,Java,,79,15,320,414
package-info.java,Java,,1,2,76,79
ReadWriteLock.java,Java,,5,4,124,133
ReentrantLock.java,Java,,177,41,544,762
ReentrantReadWriteLock.java,Java,,430,85,995,1510
StampedLock.java,Java,,788,69,557,1414
package-info.java,Java,,1,2,304,307
Phaser.java,Java,,466,57,638,1161
PriorityBlockingQueue.java,Java,,553,65,425,1043
RecursiveAction.java,Java,,11,8,174,193
RecursiveTask.java,Java,,16,9,73,98
RejectedExecutionException.java,Java,,14,7,70,91
RejectedExecutionHandler.java,Java,,4,4,54,62
RunnableFuture.java,Java,,4,3,47,54
RunnableScheduledFuture.java,Java,,4,4,50,58
ScheduledExecutorService.java,Java,,15,8,163,186
ScheduledFuture.java,Java,,3,3,42,48
ScheduledThreadPoolExecutor.java,Java,,653,92,538,1283
Semaphore.java,Java,,146,36,525,707
SynchronousQueue.java,Java,,557,92,563,1212
ThreadFactory.java,Java,,4,4,61,69
ThreadLocalRandom.java,Java,,507,83,482,1072
ThreadPoolExecutor.java,Java,,721,124,1253,2098
TimeoutException.java,Java,,8,5,54,67
TimeUnit.java,Java,,141,26,223,390
TransferQueue.java,Java,,9,7,145,161
ConcurrentModificationException.java,Java,,15,6,103,124
Currency.java,Java,,407,65,311,783
Date.java,Java,,545,61,770,1376
Deque.java,Java,,30,35,519,584
Dictionary.java,Java,,13,9,133,155
DoubleSummaryStatistics.java,Java,,64,12,157,233
DualPivotQuicksort.java,Java,,1594,229,1255,3078
DuplicateFormatFlagsException.java,Java,,16,7,45,68
EmptyStackException.java,Java,,7,3,36,46
Enumeration.java,Java,,5,3,71,79
EnumMap.java,Java,,446,89,277,812
EnumSet.java,Java,,146,32,286,464
EventListener.java,Java,,3,2,28,33
EventListenerProxy.java,Java,,11,5,59,75
EventObject.java,Java,,16,9,53,78
FormatFlagsConversionMismatchException.java,Java,,23,8,53,84
Formattable.java,Java,,5,4,155,164
FormattableFlags.java,Java,,7,6,62,75
Formatter.java,Java,,1958,253,2487,4698
FormatterClosedException.java,Java,,5,4,36,45
BiConsumer.java,Java,,13,5,57,75
BiFunction.java,Java,,10,4,58,72
BinaryOperator.java,Java,,14,3,59,76
BiPredicate.java,Java,,17,6,84,107
BooleanSupplier.java,Java,,5,3,42,50
Consumer.java,Java,,10,4,53,67
DoubleBinaryOperator.java,Java,,5,1,43,49
DoubleConsumer.java,Java,,10,4,53,67
DoubleFunction.java,Java,,5,2,43,50
DoublePredicate.java,Java,,17,6,81,104
DoubleSupplier.java,Java,,5,2,42,49
DoubleToIntFunction.java,Java,,5,2,41,48
DoubleToLongFunction.java,Java,,5,2,41,48
DoubleUnaryOperator.java,Java,,17,6,72,95
Function.java,Java,,17,6,77,100
IntBinaryOperator.java,Java,,5,2,43,50
IntConsumer.java,Java,,10,4,53,67
IntFunction.java,Java,,5,2,43,50
IntPredicate.java,Java,,17,6,81,104
IntSupplier.java,Java,,5,2,42,49
IntToDoubleFunction.java,Java,,5,2,41,48
IntToLongFunction.java,Java,,5,2,41,48
IntUnaryOperator.java,Java,,17,6,72,95
LongBinaryOperator.java,Java,,5,2,43,50
LongConsumer.java,Java,,10,4,53,67
LongFunction.java,Java,,5,2,43,50
LongPredicate.java,Java,,17,6,81,104
LongSupplier.java,Java,,5,2,42,49
LongToDoubleFunction.java,Java,,5,2,41,48
LongToIntFunction.java,Java,,5,2,41,48
LongUnaryOperator.java,Java,,17,6,72,95
ObjDoubleConsumer.java,Java,,5,2,45,52
ObjIntConsumer.java,Java,,5,2,45,52
ObjLongConsumer.java,Java,,5,2,45,52
package-info.java,Java,,1,1,112,114
Predicate.java,Java,,22,7,90,119
Supplier.java,Java,,5,2,42,49
ToDoubleBiFunction.java,Java,,5,2,45,52
ToDoubleFunction.java,Java,,5,2,42,49
ToIntBiFunction.java,Java,,5,2,45,52
ToIntFunction.java,Java,,5,2,42,49
ToLongBiFunction.java,Java,,5,2,45,52
ToLongFunction.java,Java,,5,2,42,49
UnaryOperator.java,Java,,7,2,43,52
GregorianCalendar.java,Java,,1728,205,1368,3301
HashMap.java,Java,,1625,136,626,2387
HashSet.java,Java,,98,31,224,353
Hashtable.java,Java,,791,138,484,1413
IdentityHashMap.java,Java,,913,132,552,1597
IllegalFormatCodePointException.java,Java,,14,7,48,69
IllegalFormatConversionException.java,Java,,21,8,55,84
IllegalFormatException.java,Java,,5,4,33,42
IllegalFormatFlagsException.java,Java,,16,7,44,67
IllegalFormatPrecisionException.java,Java,,14,7,42,63
IllegalFormatWidthException.java,Java,,14,7,41,62
IllformedLocaleException.java,Java,,18,9,63,90
InputMismatchException.java,Java,,11,4,44,59
IntSummaryStatistics.java,Java,,49,11,111,171
InvalidPropertiesFormatException.java,Java,,23,10,60,93
Iterator.java,Java,,14,6,98,118
JapaneseImperialCalendar.java,Java,,1538,157,659,2354
Attributes.java,Java,,267,62,343,672
JarEntry.java,Java,,32,9,88,129
JarException.java,Java,,10,4,38,52
JarFile.java,Java,,491,70,230,791
JarInputStream.java,Java,,101,13,119,233
JarOutputStream.java,Java,,60,10,79,149
JarVerifier.java,Java,,588,119,173,880
JavaUtilJarAccessImpl.java,Java,,30,9,24,63
Manifest.java,Java,,263,34,150,447
Pack200.java,Java,,95,53,675,823
JumboEnumSet.java,Java,,190,48,141,379
LinkedHashMap.java,Java,,343,53,360,756
LinkedHashSet.java,Java,,23,9,163,195
LinkedList.java,Java,,606,115,541,1262
List.java,Java,,50,45,639,734
ListIterator.java,Java,,12,13,170,195
ListResourceBundle.java,Java,,46,13,151,210
Locale.java,Java,,985,202,2096,3283
LocaleISOData.java,Java,,447,4,31,482
ConsoleHandler.java,Java,,33,7,89,129
ErrorManager.java,Java,,24,7,68,99
FileHandler.java,Java,,381,42,316,739
Filter.java,Java,,5,4,40,49
Formatter.java,Java,,36,12,99,147
Handler.java,Java,,94,23,196,313
Level.java,Java,,243,61,313,617
Logger.java,Java,,741,157,1290,2188
Logging.java,Java,,60,15,44,119
LoggingMXBean.java,Java,,7,7,125,139
LoggingPermission.java,Java,,14,7,57,78
LoggingProxyImpl.java,Java,,70,19,28,117
LogManager.java,Java,,949,144,740,1833
LogRecord.java,Java,,220,53,310,583
MemoryHandler.java,Java,,110,16,166,292
SimpleFormatter.java,Java,,38,7,124,169
SocketHandler.java,Java,,75,15,116,206
StreamHandler.java,Java,,127,18,159,304
XMLFormatter.java,Java,,167,27,75,269
LongSummaryStatistics.java,Java,,54,12,117,183
Map.java,Java,,178,49,956,1183
MissingFormatArgumentException.java,Java,,16,7,47,70
MissingFormatWidthException.java,Java,,16,7,45,68
MissingResourceException.java,Java,,23,11,90,124
NavigableMap.java,Java,,25,23,376,424
NavigableSet.java,Java,,19,17,283,319
NoSuchElementException.java,Java,,11,4,44,59
Objects.java,Java,,54,15,224,293
Observable.java,Java,,47,15,151,213
Observer.java,Java,,4,1,42,47
Optional.java,Java,,96,22,231,349
OptionalDouble.java,Java,,72,18,162,252
OptionalInt.java,Java,,72,18,162,252
OptionalLong.java,Java,,72,18,162,252
AbstractPreferences.java,Java,,535,105,979,1619
BackingStoreException.java,Java,,11,5,42,58
Base64.java,Java,,145,20,96,261
InvalidPreferencesFormatException.java,Java,,14,6,57,77
NodeChangeEvent.java,Java,,24,10,70,104
NodeChangeListener.java,Java,,5,4,45,54
PreferenceChangeEvent.java,Java,,30,12,83,125
PreferenceChangeListener.java,Java,,5,2,40,47
Preferences.java,Java,,165,57,1036,1258
PreferencesFactory.java,Java,,6,3,51,60
WindowsPreferences.java,Java,,723,67,344,1134
WindowsPreferencesFactory.java,Java,,9,3,39,51
XmlSupport.java,Java,,245,33,143,421
PrimitiveIterator.java,Java,,87,19,196,302
PriorityQueue.java,Java,,424,69,412,905
Properties.java,Java,,523,50,638,1211
PropertyPermission.java,Java,,268,82,307,657
PropertyResourceBundle.java,Java,,34,10,157,201
Queue.java,Java,,9,8,201,218
Random.java,Java,,435,68,724,1227
RandomAccess.java,Java,,3,2,63,68
ASCII.java,Java,,205,40,29,274
Matcher.java,Java,,375,69,875,1319
MatchResult.java,Java,,10,10,168,188
Pattern.java,Java,,3616,299,1941,5856
PatternSyntaxException.java,Java,,43,13,68,124
UnicodeProp.java,Java,,167,28,51,246
RegularEnumSet.java,Java,,135,38,131,304
ResourceBundle.java,Java,,981,149,1870,3000
Scanner.java,Java,,1089,170,1358,2617
ServiceConfigurationError.java,Java,,12,8,67,87
ServiceLoader.java,Java,,228,38,320,586
Set.java,Java,,22,26,365,413
SimpleTimeZone.java,Java,,630,110,966,1706
SortedMap.java,Java,,12,11,261,284
SortedSet.java,Java,,19,9,236,264
CalendarDataProvider.java,Java,,9,6,66,81
CalendarNameProvider.java,Java,,14,5,272,291
CurrencyNameProvider.java,Java,,32,9,81,122
LocaleNameProvider.java,Java,,12,8,124,144
LocaleServiceProvider.java,Java,,16,6,179,201
ResourceBundleControlProvider.java,Java,,5,3,57,65
TimeZoneNameProvider.java,Java,,10,6,94,110
Spliterator.java,Java,,144,38,650,832
Spliterators.java,Java,,977,169,978,2124
SplittableRandom.java,Java,,417,68,506,991
Stack.java,Java,,34,13,94,141
AbstractPipeline.java,Java,,316,72,318,706
AbstractShortCircuitTask.java,Java,,108,16,110,234
AbstractSpinedBuffer.java,Java,,35,16,76,127
AbstractTask.java,Java,,111,25,216,352
BaseStream.java,Java,,22,9,129,160
Collector.java,Java,,53,11,277,341
Collectors.java,Java,,500,63,1005,1568
DistinctOps.java,Java,,119,16,48,183
DoublePipeline.java,Java,,422,69,148,639
DoubleStream.java,Java,,119,51,724,894
FindOps.java,Java,,181,33,104,318
ForEachOps.java,Java,,275,47,186,508
IntPipeline.java,Java,,440,69,124,633
IntStream.java,Java,,133,54,725,912
LongPipeline.java,Java,,421,69,123,613
LongStream.java,Java,,143,53,724,920
MatchOps.java,Java,,168,40,110,318
Node.java,Java,,204,48,279,531
Nodes.java,Java,,1550,300,377,2227
package-info.java,Java,,3,2,735,740
PipelineHelper.java,Java,,18,12,173,203
ReduceOps.java,Java,,503,73,185,761
ReferencePipeline.java,Java,,459,73,129,661
Sink.java,Java,,124,33,205,362
SliceOps.java,Java,,491,53,171,715
SortedOps.java,Java,,463,85,153,701
SpinedBuffer.java,Java,,730,133,198,1061
Stream.java,Java,,118,50,977,1145
StreamOpFlag.java,Java,,147,69,537,753
Streams.java,Java,,573,111,212,896
StreamShape.java,Java,,7,1,62,70
StreamSpliterators.java,Java,,1099,249,200,1548
StreamSupport.java,Java,,59,11,248,318
TerminalOp.java,Java,,14,5,79,98
TerminalSink.java,Java,,3,2,33,38
Tripwire.java,Java,,13,6,50,69
StringJoiner.java,Java,,67,11,169,247
StringTokenizer.java,Java,,153,27,251,431
Timer.java,Java,,231,49,440,720
TimerTask.java,Java,,27,14,117,158
TimeZone.java,Java,,293,56,516,865
TimSort.java,Java,,474,69,398,941
TooManyListenersException.java,Java,,10,7,54,71
TreeMap.java,Java,,1931,301,787,3019
TreeSet.java,Java,,148,48,364,560
Tripwire.java,Java,,13,6,50,69
UnknownFormatConversionException.java,Java,,16,7,45,68
UnknownFormatFlagsException.java,Java,,16,7,45,68
UUID.java,Java,,127,35,282,444
Vector.java,Java,,612,107,711,1430
WeakHashMap.java,Java,,792,131,416,1339
Adler32.java,Java,,53,13,76,142
CheckedInputStream.java,Java,,42,8,66,116
CheckedOutputStream.java,Java,,23,7,54,84
Checksum.java,Java,,8,5,47,60
CRC32.java,Java,,52,13,74,139
DataFormatException.java,Java,,11,4,37,52
Deflater.java,Java,,196,40,334,570
DeflaterInputStream.java,Java,,117,30,146,293
DeflaterOutputStream.java,Java,,102,23,159,284
GZIPInputStream.java,Java,,148,20,125,293
GZIPOutputStream.java,Java,,81,16,125,222
Inflater.java,Java,,161,28,218,407
InflaterInputStream.java,Java,,121,23,144,288
InflaterOutputStream.java,Java,,120,29,127,276
ZipCoder.java,Java,,110,16,33,159
ZipConstants.java,Java,,43,7,48,98
ZipConstants64.java,Java,,36,13,56,105
ZipEntry.java,Java,,210,38,346,594
ZipError.java,Java,,7,3,34,44
ZipException.java,Java,,12,7,41,60
ZipFile.java,Java,,472,74,274,820
ZipInputStream.java,Java,,255,22,135,412
ZipOutputStream.java,Java,,533,40,177,750
ZipUtils.java,Java,,63,15,69,147
ZStreamRef.java,Java,,13,6,27,46
Accessible.java,Java,,4,3,44,51
AccessibleAction.java,Java,,14,11,88,113
AccessibleAttributeSequence.java,Java,,12,8,58,78
AccessibleBundle.java,Java,,56,19,83,158
AccessibleComponent.java,Java,,32,30,253,315
AccessibleContext.java,Java,,146,60,568,774
AccessibleEditableText.java,Java,,15,14,104,133
AccessibleExtendedComponent.java,Java,,6,5,63,74
AccessibleExtendedTable.java,Java,,6,4,63,73
AccessibleExtendedText.java,Java,,13,12,117,142
AccessibleHyperlink.java,Java,,14,13,113,140
AccessibleHypertext.java,Java,,9,8,63,80
AccessibleIcon.java,Java,,7,7,68,82
AccessibleKeyBinding.java,Java,,5,4,54,63
AccessibleRelation.java,Java,,65,35,269,369
AccessibleRelationSet.java,Java,,115,16,113,244
AccessibleResourceBundle.java,Java,,89,5,58,152
AccessibleRole.java,Java,,135,84,442,661
AccessibleSelection.java,Java,,10,9,95,114
AccessibleState.java,Java,,68,35,272,375
AccessibleStateSet.java,Java,,86,14,99,199
AccessibleStreamable.java,Java,,7,4,54,65
AccessibleTable.java,Java,,25,24,173,222
AccessibleTableModelChange.java,Java,,11,10,84,105
AccessibleText.java,Java,,20,19,149,188
AccessibleTextSequence.java,Java,,11,7,58,76
AccessibleValue.java,Java,,7,7,79,93
Generated.java,Java,,13,5,53,71
PostConstruct.java,Java,,9,3,69,81
PreDestroy.java,Java,,9,4,69,82
AbstractProcessor.java,Java,,72,14,109,195
Completion.java,Java,,5,4,42,51
Completions.java,Java,,30,10,47,87
Filer.java,Java,,18,6,239,263
FilerException.java,Java,,8,3,41,52
Messager.java,Java,,14,6,81,101
package-info.java,Java,,1,1,41,43
ProcessingEnvironment.java,Java,,15,9,110,134
Processor.java,Java,,18,8,415,441
RoundEnvironment.java,Java,,12,7,94,113
SupportedAnnotationTypes.java,Java,,10,3,42,55
SupportedOptions.java,Java,,10,3,41,54
SupportedSourceVersion.java,Java,,11,4,40,55
Resource.java,Java,,19,11,102,132
Resources.java,Java,,10,3,33,46
IIOReadProgressListener.java,Java,,15,12,143,170
IIOReadUpdateListener.java,Java,,34,9,206,249
IIOReadWarningListener.java,Java,,6,4,48,58
IIOWriteProgressListener.java,Java,,14,10,116,140
IIOWriteWarningListener.java,Java,,8,4,50,62
IIOException.java,Java,,11,5,57,73
IIOImage.java,Java,,88,20,214,322
IIOParam.java,Java,,152,38,486,676
IIOParamController.java,Java,,4,3,111,118
ImageIO.java,Java,,817,138,664,1619
ImageReader.java,Java,,850,147,1897,2894
ImageReadParam.java,Java,,98,24,386,508
ImageTranscoder.java,Java,,9,5,138,152
ImageTypeSpecifier.java,Java,,722,100,419,1241
ImageWriteParam.java,Java,,395,59,1016,1470
ImageWriter.java,Java,,441,92,1504,2037
IIOInvalidTreeException.java,Java,,18,7,72,97
IIOMetadata.java,Java,,222,44,634,900
IIOMetadataController.java,Java,,4,3,79,86
IIOMetadataFormat.java,Java,,59,57,723,839
IIOMetadataFormatImpl.java,Java,,621,118,534,1273
IIOMetadataNode.java,Java,,526,155,451,1132
BMPImageWriteParam.java,Java,,24,11,82,117
JPEGHuffmanTable.java,Java,,146,23,87,256
JPEGImageReadParam.java,Java,,48,11,138,197
JPEGImageWriteParam.java,Java,,105,17,198,320
JPEGQTable.java,Java,,96,18,96,210
DigraphNode.java,Java,,62,20,79,161
IIORegistry.java,Java,,109,14,130,253
IIOServiceProvider.java,Java,,32,12,128,172
ImageInputStreamSpi.java,Java,,32,11,158,201
ImageOutputStreamSpi.java,Java,,33,11,156,200
ImageReaderSpi.java,Java,,79,18,316,413
ImageReaderWriterSpi.java,Java,,181,35,385,601
ImageTranscoderSpi.java,Java,,13,8,74,95
ImageWriterSpi.java,Java,,87,20,333,440
PartiallyOrderedSet.java,Java,,97,31,86,214
RegisterableService.java,Java,,5,4,55,64
ServiceRegistry.java,Java,,324,59,463,846
FileCacheImageInputStream.java,Java,,146,35,113,294
FileCacheImageOutputStream.java,Java,,129,29,103,261
FileImageInputStream.java,Java,,72,15,77,164
FileImageOutputStream.java,Java,,82,17,73,172
IIOByteBuffer.java,Java,,29,12,102,143
ImageInputStream.java,Java,,52,48,900,1000
ImageInputStreamImpl.java,Java,,544,109,227,880
ImageOutputStream.java,Java,,28,26,608,662
ImageOutputStreamImpl.java,Java,,385,53,72,510
MemoryCache.java,Java,,185,37,142,364
MemoryCacheImageInputStream.java,Java,,91,26,85,202
MemoryCacheImageOutputStream.java,Java,,88,24,84,196
AnnotatedConstruct.java,Java,,10,5,220,235
AnnotationMirror.java,Java,,7,5,62,74
AnnotationValue.java,Java,,6,5,62,73
AnnotationValueVisitor.java,Java,,21,21,172,214
Element.java,Java,,25,17,204,246
ElementKind.java,Java,,29,13,87,129
ElementVisitor.java,Java,,12,10,126,148
ExecutableElement.java,Java,,15,11,115,141
Modifier.java,Java,,18,7,50,75
Name.java,Java,,6,4,79,89
NestingKind.java,Java,,10,6,99,115
package-info.java,Java,,1,1,99,101
PackageElement.java,Java,,12,8,72,92
Parameterizable.java,Java,,5,3,37,45
QualifiedNameable.java,Java,,4,2,35,41
TypeElement.java,Java,,17,10,137,164
TypeParameterElement.java,Java,,10,6,57,73
UnknownAnnotationValueException.java,Java,,18,8,61,87
UnknownElementException.java,Java,,18,8,59,85
VariableElement.java,Java,,9,6,75,90
package-info.java,Java,,1,2,57,60
SourceVersion.java,Java,,85,25,165,275
ArrayType.java,Java,,4,4,39,47
DeclaredType.java,Java,,10,9,70,89
ErrorType.java,Java,,3,2,37,42
ExecutableType.java,Java,,10,10,87,107
IntersectionType.java,Java,,5,4,46,55
MirroredTypeException.java,Java,,21,9,50,80
MirroredTypesException.java,Java,,31,10,53,94
NoType.java,Java,,4,5,41,50
NullType.java,Java,,3,4,33,40
package-info.java,Java,,1,1,39,41
PrimitiveType.java,Java,,3,3,34,40
ReferenceType.java,Java,,3,3,34,40
TypeKind.java,Java,,39,25,113,177
TypeMirror.java,Java,,12,8,90,110
TypeVariable.java,Java,,9,8,66,83
TypeVisitor.java,Java,,18,16,163,197
UnionType.java,Java,,5,4,38,47
UnknownTypeException.java,Java,,18,8,59,85
WildcardType.java,Java,,5,5,55,65
UnknownEntityException.java,Java,,7,4,46,57
AbstractAnnotationValueVisitor6.java,Java,,19,9,95,123
AbstractAnnotationValueVisitor7.java,Java,,10,4,65,79
AbstractAnnotationValueVisitor8.java,Java,,10,4,65,79
AbstractElementVisitor6.java,Java,,18,7,106,131
AbstractElementVisitor7.java,Java,,10,4,68,82
AbstractElementVisitor8.java,Java,,10,4,68,82
AbstractTypeVisitor6.java,Java,,20,8,124,152
AbstractTypeVisitor7.java,Java,,8,4,75,87
AbstractTypeVisitor8.java,Java,,8,4,75,87
ElementFilter.java,Java,,85,20,105,210
ElementKindVisitor6.java,Java,,120,39,254,413
ElementKindVisitor7.java,Java,,18,5,96,119
ElementKindVisitor8.java,Java,,14,4,88,106
Elements.java,Java,,24,22,218,264
ElementScanner6.java,Java,,45,14,161,220
ElementScanner7.java,Java,,18,6,98,122
ElementScanner8.java,Java,,14,5,91,110
package-info.java,Java,,1,1,41,43
SimpleAnnotationValueVisitor6.java,Java,,62,22,188,272
SimpleAnnotationValueVisitor7.java,Java,,13,4,79,96
SimpleAnnotationValueVisitor8.java,Java,,13,4,79,96
SimpleElementVisitor6.java,Java,,36,11,143,190
SimpleElementVisitor7.java,Java,,18,5,91,114
SimpleElementVisitor8.java,Java,,13,4,84,101
SimpleTypeVisitor6.java,Java,,45,16,167,228
SimpleTypeVisitor7.java,Java,,18,5,92,115
SimpleTypeVisitor8.java,Java,,18,5,92,115
TypeKindVisitor6.java,Java,,85,29,196,310
TypeKindVisitor7.java,Java,,18,5,94,117
TypeKindVisitor8.java,Java,,18,5,94,117
Types.java,Java,,30,22,260,312
AndQueryExp.java,Java,,26,14,67,107
Attribute.java,Java,,41,22,72,135
AttributeChangeNotification.java,Java,,29,20,97,146
AttributeChangeNotificationFilter.java,Java,,34,18,74,126
AttributeList.java,Java,,102,25,210,337
AttributeNotFoundException.java,Java,,10,7,38,55
AttributeValueExp.java,Java,,47,19,102,168
BadAttributeValueExpException.java,Java,,33,12,46,91
BadBinaryOpValueExpException.java,Java,,14,12,49,75
BadStringOperationException.java,Java,,11,9,43,63
BetweenQueryExp.java,Java,,52,18,72,142
BinaryOpValueExp.java,Java,,122,28,107,257
BinaryRelQueryExp.java,Java,,113,27,72,212
BooleanValueExp.java,Java,,25,15,53,93
ClassAttributeValueExp.java,Java,,48,14,80,142
DefaultLoaderRepository.java,Java,,13,6,71,90
Descriptor.java,Java,,28,19,587,634
DescriptorAccess.java,Java,,5,2,50,57
DescriptorKey.java,Java,,8,3,161,172
DescriptorRead.java,Java,,4,2,35,41
DynamicMBean.java,Java,,12,12,98,122
ImmutableDescriptor.java,Java,,306,35,215,556
InQueryExp.java,Java,,56,21,66,143
InstanceAlreadyExistsException.java,Java,,10,7,38,55
InstanceNotFoundException.java,Java,,10,6,38,54
InstanceOfQueryExp.java,Java,,37,12,71,120
IntrospectionException.java,Java,,10,6,38,54
InvalidApplicationException.java,Java,,8,8,42,58
InvalidAttributeValueException.java,Java,,10,6,38,54
JMException.java,Java,,10,7,39,56
JMRuntimeException.java,Java,,13,7,43,63
JMX.java,Java,,81,22,333,436
ListenerNotFoundException.java,Java,,10,7,38,55
ClassLoaderRepository.java,Java,,12,7,132,151
DefaultLoaderRepository.java,Java,,37,8,75,120
MLet.java,Java,,635,94,609,1338
MLetContent.java,Java,,75,28,136,239
MLetMBean.java,Java,,21,18,147,186
MLetObjectInputStream.java,Java,,61,21,40,122
MLetParser.java,Java,,187,23,77,287
PrivateClassLoader.java,Java,,2,2,33,37
PrivateMLet.java,Java,,18,6,75,99
MalformedObjectNameException.java,Java,,10,7,38,55
MatchQueryExp.java,Java,,91,18,73,182
MBeanAttributeInfo.java,Java,,165,32,157,354
MBeanConstructorInfo.java,Java,,84,19,112,215
MBeanException.java,Java,,19,12,58,89
MBeanFeatureInfo.java,Java,,82,30,153,265
MBeanInfo.java,Java,,284,70,367,721
MBeanNotificationInfo.java,Java,,80,22,114,216
MBeanOperationInfo.java,Java,,136,31,170,337
MBeanParameterInfo.java,Java,,52,17,81,150
MBeanPermission.java,Java,,666,95,398,1159
MBeanRegistration.java,Java,,8,9,100,117
MBeanRegistrationException.java,Java,,10,6,45,61
MBeanServer.java,Java,,115,46,634,795
MBeanServerBuilder.java,Java,,15,5,93,113
MBeanServerConnection.java,Java,,97,42,898,1037
MBeanServerDelegate.java,Java,,108,24,102,234
MBeanServerDelegateMBean.java,Java,,10,11,67,88
MBeanServerFactory.java,Java,,167,38,338,543
MBeanServerInvocationHandler.java,Java,,241,46,210,497
MBeanServerNotification.java,Java,,21,10,127,158
MBeanServerPermission.java,Java,,165,43,163,371
MBeanTrustPermission.java,Java,,34,10,64,108
DescriptorSupport.java,Java,,850,131,420,1401
InvalidTargetObjectTypeException.java,Java,,88,17,94,199
ModelMBean.java,Java,,17,7,99,123
ModelMBeanAttributeInfo.java,Java,,225,41,264,530
ModelMBeanConstructorInfo.java,Java,,233,34,224,491
ModelMBeanInfo.java,Java,,36,31,303,370
ModelMBeanInfoSupport.java,Java,,697,102,268,1067
ModelMBeanNotificationBroadcaster.java,Java,,27,16,149,192
ModelMBeanNotificationInfo.java,Java,,182,33,205,420
ModelMBeanOperationInfo.java,Java,,253,35,254,542
RequiredModelMBean.java,Java,,1862,314,831,3007
XMLParseException.java,Java,,66,10,82,158
CounterMonitor.java,Java,,470,85,426,981
CounterMonitorMBean.java,Java,,25,21,170,216
GaugeMonitor.java,Java,,431,73,380,884
GaugeMonitorMBean.java,Java,,19,17,126,162
Monitor.java,Java,,891,162,598,1651
MonitorMBean.java,Java,,19,17,121,157
MonitorNotification.java,Java,,39,34,186,259
MonitorSettingException.java,Java,,10,6,42,58
StringMonitor.java,Java,,202,44,217,463
StringMonitorMBean.java,Java,,16,14,108,138
MXBean.java,Java,,30,5,1153,1188
NotCompliantMBeanException.java,Java,,10,8,38,56
Notification.java,Java,,138,31,228,397
NotificationBroadcaster.java,Java,,11,7,109,127
NotificationBroadcasterSupport.java,Java,,153,39,175,367
NotificationEmitter.java,Java,,8,3,87,98
NotificationFilter.java,Java,,4,4,36,44
NotificationFilterSupport.java,Java,,41,17,105,163
NotificationListener.java,Java,,4,4,40,48
NotQueryExp.java,Java,,21,13,59,93
NumericValueExp.java,Java,,139,22,99,260
ObjectInstance.java,Java,,45,17,92,154
ObjectName.java,Java,,882,178,1051,2111
ArrayType.java,Java,,349,71,607,1027
CompositeData.java,Java,,13,18,143,174
CompositeDataInvocationHandler.java,Java,,80,11,154,245
CompositeDataSupport.java,Java,,212,51,223,486
CompositeDataView.java,Java,,4,2,122,128
CompositeType.java,Java,,161,52,265,478
InvalidKeyException.java,Java,,10,6,39,55
InvalidOpenTypeException.java,Java,,10,6,37,53
KeyAlreadyExistsException.java,Java,,10,6,39,55
OpenDataException.java,Java,,11,7,41,59
OpenMBeanAttributeInfo.java,Java,,9,21,108,138
OpenMBeanAttributeInfoSupport.java,Java,,558,99,473,1130
OpenMBeanConstructorInfo.java,Java,,10,18,109,137
OpenMBeanConstructorInfoSupport.java,Java,,84,33,188,305
OpenMBeanInfo.java,Java,,16,22,150,188
OpenMBeanInfoSupport.java,Java,,131,41,244,416
OpenMBeanOperationInfo.java,Java,,13,22,145,180
OpenMBeanOperationInfoSupport.java,Java,,136,48,243,427
OpenMBeanParameterInfo.java,Java,,20,29,163,212
OpenMBeanParameterInfoSupport.java,Java,,151,68,408,627
OpenType.java,Java,,175,41,202,418
SimpleType.java,Java,,89,49,182,320
TabularData.java,Java,,21,52,231,304
TabularDataSupport.java,Java,,242,140,534,916
TabularType.java,Java,,126,51,203,380
OperationsException.java,Java,,10,8,39,57
OrQueryExp.java,Java,,27,15,65,107
PersistentMBean.java,Java,,10,7,77,94
QualifiedAttributeValueExp.java,Java,,38,16,68,122
Query.java,Java,,113,47,494,654
QueryEval.java,Java,,13,7,58,78
QueryExp.java,Java,,7,8,56,71
ReflectionException.java,Java,,19,11,57,87
InvalidRelationIdException.java,Java,,10,5,39,54
InvalidRelationServiceException.java,Java,,10,5,38,53
InvalidRelationTypeException.java,Java,,10,5,42,57
InvalidRoleInfoException.java,Java,,10,5,39,54
InvalidRoleValueException.java,Java,,10,5,44,59
MBeanServerNotificationFilter.java,Java,,233,56,189,478
Relation.java,Java,,43,16,205,264
RelationException.java,Java,,11,6,39,56
RelationNotFoundException.java,Java,,10,5,39,54
RelationNotification.java,Java,,271,65,279,615
RelationService.java,Java,,1893,490,1406,3789
RelationServiceMBean.java,Java,,143,41,614,798
RelationServiceNotRegisteredException.java,Java,,10,5,39,54
RelationSupport.java,Java,,750,208,773,1731
RelationSupportMBean.java,Java,,7,4,65,76
RelationType.java,Java,,11,8,56,75
RelationTypeNotFoundException.java,Java,,10,5,39,54
RelationTypeSupport.java,Java,,232,61,193,486
Role.java,Java,,152,35,151,338
RoleInfo.java,Java,,293,53,263,609
RoleInfoNotFoundException.java,Java,,10,5,39,54
RoleList.java,Java,,148,37,188,373
RoleNotFoundException.java,Java,,10,5,39,54
RoleResult.java,Java,,118,25,118,261
RoleStatus.java,Java,,22,5,66,93
RoleUnresolved.java,Java,,164,32,162,358
RoleUnresolvedList.java,Java,,149,37,184,370
JMXAddressable.java,Java,,4,3,45,52
JMXAuthenticator.java,Java,,6,4,60,70
JMXConnectionNotification.java,Java,,39,13,145,197
JMXConnector.java,Java,,33,12,254,299
JMXConnectorFactory.java,Java,,266,54,254,574
JMXConnectorProvider.java,Java,,8,4,61,73
JMXConnectorServer.java,Java,,141,37,236,414
JMXConnectorServerFactory.java,Java,,127,22,210,359
JMXConnectorServerMBean.java,Java,,14,11,187,212
JMXConnectorServerProvider.java,Java,,10,4,68,82
JMXPrincipal.java,Java,,47,16,87,150
JMXProviderException.java,Java,,18,10,55,83
JMXServerErrorException.java,Java,,14,9,48,71
JMXServiceURL.java,Java,...,359,64,310,733
MBeanServerForwarder.java,Java,,6,5,54,65
NotificationResult.java,Java,,59,14,97,170
NoCallStackClassLoader.java,Java,,64,13,220,297
RMIConnection.java,Java,,194,32,866,1092
RMIConnectionImpl.java,Java,,1470,245,121,1836
RMIConnectionImpl_Stub.java,Java,,540,33,31,604
RMIConnector.java,Java,,1770,291,584,2645
RMIConnectorServer.java,Java,,420,94,339,853
RMIIIOPServerImpl.java,Java,,66,17,81,164
RMIJRMPServerImpl.java,Java,,160,29,89,278
RMIServer.java,Java,,8,4,79,91
RMIServerImpl.java,Java,,242,59,250,551
RMIServerImpl_Stub.java,Java,,49,8,6,63
SubjectDelegationPermission.java,Java,,13,7,76,96
TargetedNotification.java,Java,,42,14,95,151
RuntimeErrorException.java,Java,,19,10,55,84
RuntimeMBeanException.java,Java,,19,10,58,87
RuntimeOperationsException.java,Java,,19,11,56,86
ServiceNotFoundException.java,Java,,11,8,39,58
StandardEmitterMBean.java,Java,,83,14,216,313
StandardMBean.java,Java,,509,72,656,1237
StringValueExp.java,Java,,22,13,72,107
Timer.java,Java,,489,148,605,1242
TimerAlarmClock.java,Java,,26,11,43,80
TimerAlarmClockNotification.java,Java,,8,5,39,52
TimerMBean.java,Java,,36,33,307,376
TimerNotification.java,Java,,18,16,80,114
ValueExp.java,Java,,8,5,90,103
AuthenticationException.java,Java,,10,5,60,75
AuthenticationNotSupportedException.java,Java,,10,5,65,80
BinaryRefAddr.java,Java,,50,13,120,183
Binding.java,Java,,40,14,145,199
CannotProceedException.java,Java,,42,21,223,286
CommunicationException.java,Java,,10,4,52,66
CompositeName.java,Java,,125,32,473,630
CompoundName.java,Java,,127,29,468,624
ConfigurationException.java,Java,,10,4,58,72
Context.java,Java,,56,49,994,1099
ContextNotEmptyException.java,Java,,10,4,58,72
Attribute.java,Java,,26,22,292,340
AttributeInUseException.java,Java,,11,5,51,67
AttributeModificationException.java,Java,,26,12,102,140
Attributes.java,Java,,16,15,152,183
BasicAttribute.java,Java,,270,51,236,557
BasicAttributes.java,Java,,171,45,162,378
DirContext.java,Java,,77,35,927,1039
InitialDirContext.java,Java,,181,38,81,300
InvalidAttributeIdentifierException.java,Java,,11,6,49,66
InvalidAttributesException.java,Java,,11,6,55,72
InvalidAttributeValueException.java,Java,,11,6,53,70
InvalidSearchControlsException.java,Java,,11,6,50,67
InvalidSearchFilterException.java,Java,,11,6,50,67
ModificationItem.java,Java,,37,13,83,133
NoSuchAttributeException.java,Java,,11,7,48,66
SchemaViolationException.java,Java,,11,6,60,77
SearchControls.java,Java,,70,26,240,336
SearchResult.java,Java,,34,14,141,189
EventContext.java,Java,,15,12,222,249
EventDirContext.java,Java,,15,6,138,159
NamespaceChangeListener.java,Java,,6,5,80,91
NamingEvent.java,Java,,52,20,228,300
NamingExceptionEvent.java,Java,,19,9,66,94
NamingListener.java,Java,,4,2,59,65
ObjectChangeListener.java,Java,,4,3,66,73
InitialContext.java,Java,,199,50,316,565
InsufficientResourcesException.java,Java,,10,5,57,72
InterruptedNamingException.java,Java,,10,5,61,76
InvalidNameException.java,Java,,10,5,57,72
BasicControl.java,Java,,24,11,82,117
Control.java,Java,,8,7,81,96
ControlFactory.java,Java,,27,13,117,157
ExtendedRequest.java,Java,,8,7,133,148
ExtendedResponse.java,Java,,5,6,88,99
HasControls.java,Java,,5,5,60,70
InitialLdapContext.java,Java,,63,20,129,212
LdapContext.java,Java,,17,11,319,347
LdapName.java,Java,,295,53,439,787
LdapReferralException.java,Java,,22,9,131,162
ManageReferralControl.java,Java,,11,6,50,67
PagedResultsControl.java,Java,,31,14,153,198
PagedResultsResponseControl.java,Java,,28,13,92,133
Rdn.java,Java,,367,69,323,759
Rfc2253Parser.java,Java,,153,34,66,253
SortControl.java,Java,,44,17,161,222
SortKey.java,Java,,24,11,83,118
SortResponseControl.java,Java,,35,16,118,169
StartTlsRequest.java,Java,,76,27,146,249
StartTlsResponse.java,Java,,23,19,164,206
UnsolicitedNotification.java,Java,,6,5,53,64
UnsolicitedNotificationEvent.java,Java,,16,8,60,84
UnsolicitedNotificationListener.java,Java,,5,4,59,68
LimitExceededException.java,Java,,11,7,56,74
LinkException.java,Java,,63,23,218,304
LinkLoopException.java,Java,,10,5,52,67
LinkRef.java,Java,,21,7,88,116
MalformedLinkException.java,Java,,10,6,51,67
Name.java,Java,,22,20,235,277
NameAlreadyBoundException.java,Java,,10,5,58,73
NameClassPair.java,Java,,48,21,229,298
NameImpl.java,Java,,533,82,120,735
NameNotFoundException.java,Java,,10,5,50,65
NameParser.java,Java,,4,3,50,57
NamingEnumeration.java,Java,,7,5,135,147
NamingException.java,Java,,104,24,307,435
NamingSecurityException.java,Java,,10,5,56,71
NoInitialContextException.java,Java,,10,4,61,75
NoPermissionException.java,Java,,10,4,50,64
NotContextException.java,Java,,10,5,58,73
OperationNotSupportedException.java,Java,,10,5,52,67
PartialResultException.java,Java,,10,5,51,66
RefAddr.java,Java,,36,12,104,152
Reference.java,Java,,109,29,257,395
Referenceable.java,Java,,4,2,52,58
ReferralException.java,Java,,18,11,175,204
ServiceUnavailableException.java,Java,,10,5,53,68
SizeLimitExceededException.java,Java,,11,6,52,69
ContinuationContext.java,Java,,181,34,31,246
ContinuationDirContext.java,Java,,245,52,37,334
DirectoryManager.java,Java,,122,30,186,338
DirObjectFactory.java,Java,,10,4,118,132
DirStateFactory.java,Java,,20,10,158,188
InitialContextFactory.java,Java,,7,4,61,72
InitialContextFactoryBuilder.java,Java,,8,3,60,71
NamingManager.java,Java,,303,83,489,875
ObjectFactory.java,Java,,8,5,161,174
ObjectFactoryBuilder.java,Java,,8,3,64,75
Resolver.java,Java,,12,7,77,96
ResolveResult.java,Java,,63,13,125,201
StateFactory.java,Java,,8,2,128,138
StringRefAddr.java,Java,,12,5,69,86
TimeLimitExceededException.java,Java,,11,6,52,69
Attribute.java,Java,,6,6,51,63
AttributeSet.java,Java,,16,19,275,310
AttributeSetUtilities.java,Java,,259,73,246,578
DateTimeSyntax.java,Java,,27,17,102,146
DocAttribute.java,Java,,3,4,41,48
DocAttributeSet.java,Java,,5,6,100,111
EnumSyntax.java,Java,,60,23,198,281
HashAttributeSet.java,Java,,163,37,328,528
HashDocAttributeSet.java,Java,,18,10,74,102
HashPrintJobAttributeSet.java,Java,,18,9,73,100
HashPrintRequestAttributeSet.java,Java,,19,12,73,104
HashPrintServiceAttributeSet.java,Java,,19,10,73,102
IntegerSyntax.java,Java,,30,12,92,134
PrintJobAttribute.java,Java,,3,2,40,45
PrintJobAttributeSet.java,Java,,5,5,99,109
PrintRequestAttribute.java,Java,,3,4,44,51
PrintRequestAttributeSet.java,Java,,5,6,100,111
PrintServiceAttribute.java,Java,,3,2,36,41
PrintServiceAttributeSet.java,Java,,5,7,102,114
ResolutionSyntax.java,Java,,82,29,247,358
SetOfIntegerSyntax.java,Java,,265,41,252,558
Size2DSyntax.java,Java,,85,23,235,343
Chromaticity.java,Java,,31,15,113,159
ColorSupported.java,Java,,29,13,88,130
Compression.java,Java,,34,16,84,134
Copies.java,Java,,21,8,107,136
CopiesSupported.java,Java,,31,10,100,141
DateTimeAtCompleted.java,Java,,22,9,94,125
DateTimeAtCreation.java,Java,,22,8,93,123
DateTimeAtProcessing.java,Java,,22,8,94,124
Destination.java,Java,,23,9,91,123
DialogTypeSelection.java,Java,,32,17,82,131
DocumentName.java,Java,,20,9,92,121
Fidelity.java,Java,,35,13,81,129
Finishings.java,Java,,122,30,325,477
JobHoldUntil.java,Java,,22,10,121,153
JobImpressions.java,Java,,21,9,114,144
JobImpressionsCompleted.java,Java,,21,8,99,128
JobImpressionsSupported.java,Java,,27,10,93,130
JobKOctets.java,Java,,21,8,165,194
JobKOctetsProcessed.java,Java,,21,8,111,140
JobKOctetsSupported.java,Java,,27,8,93,128
JobMediaSheets.java,Java,,21,9,108,138
JobMediaSheetsCompleted.java,Java,,21,8,99,128
JobMediaSheetsSupported.java,Java,,27,8,93,128
JobMessageFromOperator.java,Java,,22,9,98,129
JobName.java,Java,,22,9,94,125
JobOriginatingUserName.java,Java,,22,9,98,129
JobPriority.java,Java,,21,8,98,127
JobPrioritySupported.java,Java,,21,11,92,124
JobSheets.java,Java,,35,14,85,134
JobState.java,Java,,52,22,163,237
JobStateReason.java,Java,,138,41,282,461
JobStateReasons.java,Java,,33,12,136,181
Media.java,Java,,24,8,91,123
MediaName.java,Java,,33,15,65,113
MediaPrintableArea.java,Java,,85,24,226,335
MediaSize.java,Java,,319,35,502,856
MediaSizeName.java,Java,,260,35,270,565
MediaTray.java,Java,,45,20,75,140
MultipleDocumentHandling.java,Java,,44,17,207,268
NumberOfDocuments.java,Java,,21,9,84,114
NumberOfInterveningJobs.java,Java,,21,8,84,113
NumberUp.java,Java,,22,9,161,192
NumberUpSupported.java,Java,,51,11,117,179
OrientationRequested.java,Java,,48,16,124,188
OutputDeviceAssigned.java,Java,,22,11,95,128
PageRanges.java,Java,,60,13,192,265
PagesPerMinute.java,Java,,21,8,85,114
PagesPerMinuteColor.java,Java,,21,8,97,126
PDLOverrideSupported.java,Java,,35,14,79,128
PresentationDirection.java,Java,,60,19,107,186
PrinterInfo.java,Java,,21,9,91,121
PrinterIsAcceptingJobs.java,Java,,35,13,80,128
PrinterLocation.java,Java,,21,9,89,119
PrinterMakeAndModel.java,Java,,22,8,88,118
PrinterMessageFromOperator.java,Java,,22,9,103,134
PrinterMoreInfo.java,Java,,22,9,92,123
PrinterMoreInfoManufacturer.java,Java,,22,9,96,127
PrinterName.java,Java,,21,9,91,121
PrinterResolution.java,Java,,24,8,119,151
PrinterState.java,Java,,43,15,84,142
PrinterStateReason.java,Java,,156,45,243,444
PrinterStateReasons.java,Java,,107,23,178,308
PrinterURI.java,Java,,22,10,84,116
PrintQuality.java,Java,,41,14,80,135
QueuedJobCount.java,Java,,21,8,82,111
ReferenceUriSchemesSupported.java,Java,,51,19,113,183
RequestingUserName.java,Java,,22,9,99,130
Severity.java,Java,,34,15,109,158
SheetCollate.java,Java,,35,13,186,234
Sides.java,Java,,40,17,165,222
SupportedValuesAttribute.java,Java,,3,3,38,44
TextSyntax.java,Java,,42,16,94,152
UnmodifiableSetException.java,Java,,8,3,40,51
URISyntax.java,Java,,30,13,78,121
AttributeException.java,Java,,6,8,52,66
CancelablePrintJob.java,Java,,4,5,68,77
Doc.java,Java,,12,11,183,206
DocFlavor.java,Java,,225,123,1085,1433
DocPrintJob.java,Java,,19,12,145,176
PrintEvent.java,Java,,10,7,37,54
PrintJobAdapter.java,Java,,15,13,77,105
PrintJobAttributeEvent.java,Java,,19,16,47,82
PrintJobAttributeListener.java,Java,,4,4,38,46
PrintJobEvent.java,Java,,22,20,83,125
PrintJobListener.java,Java,,9,15,71,95
PrintServiceAttributeEvent.java,Java,,19,15,50,84
PrintServiceAttributeListener.java,Java,,4,5,39,48
FlavorException.java,Java,,5,5,37,47
MimeType.java,Java,,389,43,215,647
MultiDoc.java,Java,,6,8,122,136
MultiDocPrintJob.java,Java,,6,6,55,67
MultiDocPrintService.java,Java,,4,5,33,42
PrintException.java,Java,,15,8,50,73
PrintService.java,Java,,37,25,426,488
PrintServiceLookup.java,Java,,254,41,193,488
ServiceUI.java,Java,,132,27,177,336
ServiceUIFactory.java,Java,,13,15,114,142
SimpleDoc.java,Java,,79,22,153,254
StreamPrintService.java,Java,,21,12,81,114
StreamPrintServiceFactory.java,Java,,101,26,108,235
URIException.java,Java,,9,10,54,73
ClassDesc.java,Java,,5,4,39,48
GetORBPropertiesFileAction.java,Java,,54,18,36,108
PortableRemoteObjectDelegate.java,Java,,17,9,58,84
Stub.java,Java,,134,43,84,261
StubDelegate.java,Java,,17,10,66,93
Tie.java,Java,,18,9,58,85
Util.java,Java,,189,55,177,421
UtilDelegate.java,Java,,28,19,88,135
ValueHandler.java,Java,,14,9,73,96
ValueHandlerMultiFormat.java,Java,,7,4,59,70
PortableRemoteObject.java,Java,,150,42,101,293
SslRMIClientSocketFactory.java,Java,,67,10,135,212
SslRMIServerSocketFactory.java,Java,,144,22,212,378
AbstractScriptEngine.java,Java,,88,42,181,311
Bindings.java,Java,,9,6,110,125
Compilable.java,Java,,9,5,58,72
CompiledScript.java,Java,,23,13,81,117
Invocable.java,Java,,9,7,98,114
ScriptContext.java,Java,,22,24,161,207
ScriptEngine.java,Java,,27,33,263,323
ScriptEngineFactory.java,Java,,16,18,195,229
ScriptEngineManager.java,Java,,217,30,169,416
ScriptException.java,Java,,56,14,84,154
SimpleBindings.java,Java,,75,19,129,223
SimpleScriptContext.java,Java,,140,39,154,333
AuthPermission.java,Java,,13,5,154,172
Callback.java,Java,,2,3,47,52
CallbackHandler.java,Java,,5,3,142,150
ChoiceCallback.java,Java,,48,15,148,211
ConfirmationCallback.java,Java,,122,37,342,501
LanguageCallback.java,Java,,13,8,58,79
NameCallback.java,Java,,31,11,102,144
package-info.java,Java,,1,1,33,35
PasswordCallback.java,Java,,31,11,100,142
TextInputCallback.java,Java,,31,11,103,145
TextOutputCallback.java,Java,,23,9,75,107
UnsupportedCallbackException.java,Java,,16,7,58,81
Destroyable.java,Java,,9,4,55,68
DestroyFailedException.java,Java,,10,5,45,60
DelegationPermission.java,Java,,133,45,211,389
JavaxSecurityAuthKerberosAccessImpl.java,Java,,11,3,24,38
KerberosKey.java,Java,,112,30,162,304
KerberosPrincipal.java,Java,,95,37,156,288
KerberosTicket.java,Java,,371,85,328,784
KeyImpl.java,Java,,142,37,65,244
KeyTab.java,Java,,123,26,231,380
package-info.java,Java,,1,1,51,53
ServicePermission.java,Java,,234,89,293,616
AccountException.java,Java,,10,5,42,57
AccountExpiredException.java,Java,,10,5,48,63
AccountLockedException.java,Java,,10,5,46,61
AccountNotFoundException.java,Java,,10,5,45,60
AppConfigurationEntry.java,Java,,50,17,106,173
Configuration.java,Java,,197,37,386,620
ConfigurationSpi.java,Java,,6,5,64,75
CredentialException.java,Java,,10,5,42,57
CredentialExpiredException.java,Java,,10,5,50,65
CredentialNotFoundException.java,Java,,10,5,45,60
FailedLoginException.java,Java,,10,5,45,60
LoginContext.java,Java,,397,86,483,966
LoginException.java,Java,,10,6,42,58
package-info.java,Java,,1,1,37,39
package-info.java,Java,,1,1,36,38
Policy.java,Java,,105,18,239,362
PrivateCredentialPermission.java,Java,,227,81,253,561
Refreshable.java,Java,,5,4,53,62
RefreshFailedException.java,Java,,10,5,45,60
LoginModule.java,Java,,15,8,217,240
package-info.java,Java,,1,1,30,32
Subject.java,Java,,688,143,636,1467
SubjectDomainCombiner.java,Java,,351,65,167,583
package-info.java,Java,,1,1,47,49
X500Principal.java,Java,,140,23,350,513
X500PrivateCredential.java,Java,,41,14,79,134
Certificate.java,Java,,49,12,116,177
CertificateEncodingException.java,Java,,10,5,49,64
CertificateException.java,Java,,10,5,48,63
CertificateExpiredException.java,Java,,10,5,51,66
CertificateNotYetValidException.java,Java,,10,5,51,66
CertificateParsingException.java,Java,,10,6,50,66
package-info.java,Java,,1,1,38,40
X509Certificate.java,Java,,79,24,349,452
AuthenticationException.java,Java,,13,5,65,83
AuthorizeCallback.java,Java,,34,14,97,145
package-info.java,Java,,1,1,101,103
RealmCallback.java,Java,,11,6,50,67
RealmChoiceCallback.java,Java,,9,5,48,62
Sasl.java,Java,,181,38,402,621
SaslClient.java,Java,,14,11,200,225
SaslClientFactory.java,Java,,13,4,95,112
SaslException.java,Java,,33,11,85,129
SaslServer.java,Java,,14,11,191,216
SaslServerFactory.java,Java,,12,4,95,111
ControllerEventListener.java,Java,,5,5,54,64
Instrument.java,Java,,12,13,63,88
InvalidMidiDataException.java,Java,,9,8,46,63
MetaEventListener.java,Java,,5,5,40,50
MetaMessage.java,Java,,75,31,138,244
MidiChannel.java,Java,,29,30,478,537
MidiDevice.java,Java,,48,52,293,393
MidiDeviceReceiver.java,Java,,4,2,35,41
MidiDeviceTransmitter.java,Java,,4,4,35,43
MidiEvent.java,Java,,18,15,63,96
MidiFileFormat.java,Java,,59,34,211,304
MidiMessage.java,Java,,36,20,136,192
MidiSystem.java,Java,,593,158,734,1485
MidiUnavailableException.java,Java,,9,8,46,63
Patch.java,Java,,15,17,80,112
Receiver.java,Java,,5,6,63,74
Sequence.java,Java,,81,51,208,340
Sequencer.java,Java,,68,114,686,868
ShortMessage.java,Java,,143,60,293,496
Soundbank.java,Java,,11,17,105,133
SoundbankResource.java,Java,,21,26,130,177
MidiDeviceProvider.java,Java,,15,8,55,78
MidiFileReader.java,Java,,22,10,115,147
MidiFileWriter.java,Java,,31,12,94,137
SoundbankReader.java,Java,,15,7,60,82
Synthesizer.java,Java,,19,48,327,394
SysexMessage.java,Java,,57,28,167,252
Track.java,Java,,110,30,135,275
Transmitter.java,Java,,6,9,61,76
VoiceStatus.java,Java,,9,16,135,160
AudioFileFormat.java,Java,,106,61,251,418
AudioFormat.java,Java,,191,73,406,670
AudioInputStream.java,Java,,199,81,235,515
AudioPermission.java,Java,,10,10,216,236
AudioSystem.java,Java,,627,203,803,1633
BooleanControl.java,Java,,34,41,118,193
Clip.java,Java,,14,13,196,223
CompoundControl.java,Java,,33,38,69,140
Control.java,Java,,28,29,89,146
DataLine.java,Java,,105,56,333,494
EnumControl.java,Java,,43,51,120,214
FloatControl.java,Java,,108,93,328,529
Line.java,Java,,46,47,266,359
LineEvent.java,Java,,49,44,188,281
LineListener.java,Java,,4,6,58,68
LineUnavailableException.java,Java,,9,8,51,68
Mixer.java,Java,,49,38,267,354
Port.java,Java,,45,45,118,208
ReverbType.java,Java,,48,32,219,299
SourceDataLine.java,Java,,6,10,187,203
AudioFileReader.java,Java,,16,10,111,137
AudioFileWriter.java,Java,,31,22,94,147
FormatConversionProvider.java,Java,,48,34,118,200
MixerProvider.java,Java,,15,11,75,101
TargetDataLine.java,Java,,6,9,177,192
UnsupportedAudioFileException.java,Java,,9,8,49,66
CommonDataSource.java,Java,,12,9,109,130
ConnectionEvent.java,Java,,14,10,71,95
ConnectionEventListener.java,Java,,5,6,65,76
ConnectionPoolDataSource.java,Java,,7,7,59,73
DataSource.java,Java,,9,6,94,109
PooledConnection.java,Java,,11,11,156,178
BaseRowSet.java,Java,,757,283,3494,4534
CachedRowSet.java,Java,,53,51,1520,1624
FilteredRowSet.java,Java,,10,6,144,160
JdbcRowSet.java,Java,,17,16,256,289
Joinable.java,Java,,14,13,264,291
JoinRowSet.java,Java,,34,28,474,536
Predicate.java,Java,,8,8,146,162
RowSetFactory.java,Java,,9,9,81,99
RowSetMetaDataImpl.java,Java,,325,95,681,1101
RowSetProvider.java,Java,,141,24,158,323
RowSetWarning.java,Java,,28,10,113,151
SerialArray.java,Java,,213,54,393,660
SerialBlob.java,Java,,209,49,344,602
SerialClob.java,Java,,252,55,387,694
SerialDatalink.java,Java,,46,16,108,170
SerialException.java,Java,,10,6,40,56
SerialJavaObject.java,Java,,110,29,142,281
SerialRef.java,Java,,96,26,135,257
SerialStruct.java,Java,,111,36,200,347
SQLInputImpl.java,Java,,136,44,488,668
SQLOutputImpl.java,Java,,194,49,401,644
SyncFactory.java,Java,,397,112,458,967
SyncFactoryException.java,Java,,10,6,42,58
SyncProvider.java,Java,,28,26,376,430
SyncProviderException.java,Java,,40,11,113,164
SyncResolver.java,Java,,16,15,344,375
TransactionalWriter.java,Java,,11,7,65,83
XmlReader.java,Java,,9,6,59,74
XmlWriter.java,Java,,9,8,57,74
WebRowSet.java,Java,,18,12,475,505
RowSet.java,Java,,166,132,1888,2186
RowSetEvent.java,Java,,6,5,51,62
RowSetInternal.java,Java,,9,10,84,103
RowSetListener.java,Java,,6,6,65,77
RowSetMetaData.java,Java,,21,22,192,235
RowSetReader.java,Java,,5,6,62,73
RowSetWriter.java,Java,,5,6,53,64
StatementEvent.java,Java,,28,14,76,118
StatementEventListener.java,Java,,5,4,77,86
XAConnection.java,Java,,5,8,48,61
XADataSource.java,Java,,7,6,70,83
AbstractAction.java,Java,,150,36,181,367
AbstractButton.java,Java,,1433,233,1442,3108
AbstractCellEditor.java,Java,,50,15,102,167
AbstractListModel.java,Java,,59,19,144,222
AbstractSpinnerModel.java,Java,,33,17,90,140
Action.java,Java,,24,12,354,390
ActionMap.java,Java,,108,22,96,226
ActionPropertyChangeListener.java,Java,,81,16,60,157
AncestorNotifier.java,Java,,149,31,60,240
ArrayTable.java,Java,,222,23,97,342
Autoscroller.java,Java,,84,20,75,179
AbstractBorder.java,Java,,51,11,137,199
BevelBorder.java,Java,,121,36,140,297
Border.java,Java,,11,4,75,90
CompoundBorder.java,Java,,67,14,88,169
EmptyBorder.java,Java,,38,9,66,113
EtchedBorder.java,Java,,64,21,120,205
LineBorder.java,Java,,84,18,89,191
MatteBorder.java,Java,,97,21,104,222
SoftBevelBorder.java,Java,,67,18,80,165
StrokeBorder.java,Java,,53,8,103,164
TitledBorder.java,Java,,454,50,222,726
BorderFactory.java,Java,,196,47,519,762
BoundedRangeModel.java,Java,,18,30,220,268
Box.java,Java,,101,27,313,441
BoxLayout.java,Java,,195,42,302,539
BufferStrategyPaintManager.java,Java,,613,62,277,952
ButtonGroup.java,Java,,68,16,107,191
ButtonModel.java,Java,,27,25,190,242
CellEditor.java,Java,,12,10,112,134
CellRendererPane.java,Java,,83,30,114,227
ClientPropertyKey.java,Java,,26,13,85,124
AbstractColorChooserPanel.java,Java,,73,20,138,231
CenterLayout.java,Java,,41,9,29,79
ColorChooserComponentFactory.java,Java,,17,6,40,63
ColorChooserPanel.java,Java,,151,24,30,205
ColorModel.java,Java,,61,17,24,102
ColorModelCMYK.java,Java,,45,7,42,94
ColorModelHSL.java,Java,,105,15,68,188
ColorModelHSV.java,Java,,84,12,42,138
ColorPanel.java,Java,,173,23,24,220
ColorSelectionModel.java,Java,,10,6,57,73
DefaultColorSelectionModel.java,Java,,46,16,92,154
DefaultPreviewPanel.java,Java,,167,45,39,251
DefaultSwatchChooserPanel.java,Java,,608,77,85,770
DiagramComponent.java,Java,,116,20,24,160
SlidingSpinner.java,Java,,81,13,24,118
SmartGridLayout.java,Java,,108,49,33,190
ValueFormatter.java,Java,,109,18,24,151
ComboBoxEditor.java,Java,,11,8,37,56
ComboBoxModel.java,Java,,5,3,49,57
ComponentInputMap.java,Java,,44,7,68,119
DebugGraphics.java,Java,,1035,180,253,1468
DebugGraphicsFilter.java,Java,,13,5,28,46
DebugGraphicsInfo.java,Java,,35,7,29,71
DebugGraphicsObserver.java,Java,,19,6,28,53
DefaultBoundedRangeModel.java,Java,,141,49,233,423
DefaultButtonModel.java,Java,,207,62,264,533
DefaultCellEditor.java,Java,,164,42,192,398
DefaultComboBoxModel.java,Java,,87,22,70,179
DefaultDesktopManager.java,Java,,502,109,204,815
DefaultFocusManager.java,Java,,98,26,48,172
DefaultListCellRenderer.java,Java,,139,36,173,348
DefaultListModel.java,Java,,144,42,360,546
DefaultListSelectionModel.java,Java,,374,97,378,849
DefaultRowSorter.java,Java,,678,119,582,1379
DefaultSingleSelectionModel.java,Java,,51,13,111,175
DelegatingDefaultFocusManager.java,Java,,109,9,44,162
DesktopManager.java,Java,,19,10,89,118
DropMode.java,Java,,11,9,83,103
AncestorEvent.java,Java,,26,7,71,104
AncestorListener.java,Java,,10,6,53,69
CaretEvent.java,Java,,9,6,56,71
CaretListener.java,Java,,5,4,35,44
CellEditorListener.java,Java,,7,6,32,45
ChangeEvent.java,Java,,8,3,45,56
ChangeListener.java,Java,,5,4,34,43
DocumentEvent.java,Java,,28,20,135,183
DocumentListener.java,Java,,7,5,66,78
EventListenerList.java,Java,,119,18,157,294
HyperlinkEvent.java,Java,,62,21,145,228
HyperlinkListener.java,Java,,5,4,34,43
InternalFrameAdapter.java,Java,,10,8,61,79
InternalFrameEvent.java,Java,,49,18,125,192
InternalFrameListener.java,Java,,11,9,65,85
ListDataEvent.java,Java,,27,9,85,121
ListDataListener.java,Java,,7,8,54,69
ListSelectionEvent.java,Java,,29,9,85,123
ListSelectionListener.java,Java,,6,6,36,48
MenuDragMouseEvent.java,Java,,35,7,103,145
MenuDragMouseListener.java,Java,,8,4,53,65
MenuEvent.java,Java,,8,3,47,58
MenuKeyEvent.java,Java,,24,6,67,97
MenuKeyListener.java,Java,,7,6,39,52
MenuListener.java,Java,,7,4,44,55
MouseInputAdapter.java,Java,,5,3,34,42
MouseInputListener.java,Java,,5,4,31,40
PopupMenuEvent.java,Java,,8,2,45,55
PopupMenuListener.java,Java,,7,5,39,51
RowSorterEvent.java,Java,,38,10,96,144
RowSorterListener.java,Java,,4,1,37,42
SwingPropertyChangeSupport.java,Java,,34,11,79,124
TableColumnModelEvent.java,Java,,15,10,65,90
TableColumnModelListener.java,Java,,12,8,39,59
TableModelEvent.java,Java,,38,18,122,178
TableModelListener.java,Java,,6,4,35,45
TreeExpansionEvent.java,Java,,12,5,58,75
TreeExpansionListener.java,Java,,7,5,40,52
TreeModelEvent.java,Java,,75,16,223,314
TreeModelListener.java,Java,,8,8,82,98
TreeSelectionEvent.java,Java,,71,14,125,210
TreeSelectionListener.java,Java,,6,3,41,50
TreeWillExpandListener.java,Java,,7,5,39,51
UndoableEditEvent.java,Java,,12,5,50,67
UndoableEditListener.java,Java,,5,5,33,43
FileFilter.java,Java,,6,4,52,62
FileNameExtensionFilter.java,Java,,56,8,94,158
FileSystemView.java,Java,,429,112,277,818
FileView.java,Java,,20,8,83,111
FocusManager.java,Java,,38,9,104,151
GraphicsWrapper.java,Java,,10,8,29,47
GrayFilter.java,Java,,31,8,54,93
GroupLayout.java,Java,,2122,303,1320,3745
Icon.java,Java,,9,6,44,59
ImageIcon.java,Java,,287,68,360,715
InputMap.java,Java,,117,25,90,232
InputVerifier.java,Java,,8,11,116,135
InternalFrameFocusTraversalPolicy.java,Java,,10,4,54,68
JApplet.java,Java,,154,46,368,568
JButton.java,Java,,88,30,207,325
JCheckBox.java,Java,,93,35,222,350
JCheckBoxMenuItem.java,Java,,83,25,199,307
JColorChooser.java,Java,,308,93,362,763
JComboBox.java,Java,,881,198,1356,2435
JComponent.java,Java,,2398,432,2745,5575
JDesktopPane.java,Java,,298,50,285,633
JDialog.java,Java,,299,70,926,1295
JEditorPane.java,Java,,1200,165,1046,2411
JFileChooser.java,Java,,765,186,1063,2014
JFormattedTextField.java,Java,,413,88,685,1186
JFrame.java,Java,,273,62,610,945
JInternalFrame.java,Java,,894,186,1342,2422
JLabel.java,Java,,706,130,800,1636
JLayer.java,Java,,374,51,440,865
JLayeredPane.java,Java,,313,67,406,786
JList.java,Java,,1606,341,1786,3733
JMenu.java,Java,,721,145,756,1622
JMenuBar.java,Java,,325,75,374,774
JMenuItem.java,Java,,420,83,446,949
JOptionPane.java,Java,,916,168,1516,2600
JPanel.java,Java,,63,22,163,248
JPasswordField.java,Java,,208,44,413,665
JPopupMenu.java,Java,,728,154,679,1561
JProgressBar.java,Java,,304,91,731,1126
JRadioButton.java,Java,,71,31,198,300
JRadioButtonMenuItem.java,Java,,72,21,187,280
JRootPane.java,Java,,358,85,663,1106
JScrollBar.java,Java,,305,111,517,933
JScrollPane.java,Java,,535,147,873,1555
JSeparator.java,Java,,88,25,183,296
JSlider.java,Java,,508,174,838,1520
JSpinner.java,Java,,787,200,1054,2041
JSplitPane.java,Java,,409,166,678,1253
JTabbedPane.java,Java,,1001,248,1169,2418
JTable.java,Java,,4444,831,4325,9600
JTextArea.java,Java,,301,54,459,814
JTextField.java,Java,,326,70,565,961
JTextPane.java,Java,,178,34,281,493
JToggleButton.java,Java,,147,48,229,424
JToolBar.java,Java,[WDW - need to add orientation from BoxLayout,375,83,413,871
JToolTip.java,Java,,87,31,174,292
JTree.java,Java,,2616,491,2456,5563
JViewport.java,Java,,772,181,812,1765
JWindow.java,Java,,172,44,457,673
KeyboardManager.java,Java,,234,49,109,392
KeyStroke.java,Java,,61,11,244,316
LayoutComparator.java,Java,,91,24,44,159
LayoutFocusTraversalPolicy.java,Java,,107,12,155,274
LayoutStyle.java,Java,,40,11,166,217
LegacyGlueFocusTraversalPolicy.java,Java,,147,15,38,200
ListCellRenderer.java,Java,,11,4,101,116
ListModel.java,Java,,9,6,56,71
ListSelectionModel.java,Java,,28,35,249,312
LookAndFeel.java,Java,,154,46,529,729
MenuElement.java,Java,,10,9,64,83
MenuSelectionManager.java,Java,,326,53,128,507
MultiUIDefaults.java,Java,,151,27,28,206
MutableComboBoxModel.java,Java,,7,6,60,73
OverlayLayout.java,Java,,121,26,141,288
Painter.java,Java,,5,2,100,107
ActionMapUIResource.java,Java,,6,4,31,41
BasicArrowButton.java,Java,,159,31,118,308
BasicBorders.java,Java,,441,78,83,602
BasicButtonListener.java,Java,,224,36,57,317
BasicButtonUI.java,Java,,298,68,105,471
BasicCheckBoxMenuItemUI.java,Java,,32,7,31,70
BasicCheckBoxUI.java,Java,,24,11,41,76
BasicColorChooserUI.java,Java,,256,46,52,354
BasicComboBoxEditor.java,Java,,85,20,67,172
BasicComboBoxRenderer.java,Java,,61,18,65,144
BasicComboBoxUI.java,Java,,1194,227,579,2000
BasicComboPopup.java,Java,,675,145,510,1330
BasicDesktopIconUI.java,Java,,195,45,56,296
BasicDesktopPaneUI.java,Java,,529,62,124,715
BasicDirectoryModel.java,Java,,318,60,119,497
BasicEditorPaneUI.java,Java,,282,28,103,413
BasicFileChooserUI.java,Java,,981,200,193,1374
BasicFormattedTextFieldUI.java,Java,,11,3,43,57
BasicGraphicsUtils.java,Java,,190,54,70,314
BasicHTML.java,Java,,275,55,314,644
BasicIconFactory.java,Java,,151,32,39,222
BasicInternalFrameTitlePane.java,Java,,582,106,116,804
BasicInternalFrameUI.java,Java,,1071,197,189,1457
BasicLabelUI.java,Java,,338,48,99,485
BasicListUI.java,Java,,1861,317,702,2880
BasicLookAndFeel.java,Java,,1710,174,442,2326
BasicMenuBarUI.java,Java,,162,37,39,238
BasicMenuItemUI.java,Java,,684,96,192,972
BasicMenuUI.java,Java,,415,75,141,631
BasicOptionPaneUI.java,Java,,1016,172,268,1456
BasicPanelUI.java,Java,,54,13,46,113
BasicPasswordFieldUI.java,Java,,36,11,61,108
BasicPopupMenuSeparatorUI.java,Java,,27,9,30,66
BasicPopupMenuUI.java,Java,,951,135,139,1225
BasicProgressBarUI.java,Java,,686,135,454,1275
BasicRadioButtonMenuItemUI.java,Java,,33,5,30,68
BasicRadioButtonUI.java,Java,,358,92,158,608
BasicRootPaneUI.java,Java,,173,33,42,248
BasicScrollBarUI.java,Java,,1093,215,314,1622
BasicScrollPaneUI.java,Java,,824,132,223,1179
BasicSeparatorUI.java,Java,,69,18,31,118
BasicSliderUI.java,Java,,1480,290,255,2025
BasicSpinnerUI.java,Java,,630,120,312,1062
BasicSplitPaneDivider.java,Java,,636,146,308,1090
BasicSplitPaneUI.java,Java,,1297,281,668,2246
BasicTabbedPaneUI.java,Java,,2934,401,602,3937
BasicTableHeaderUI.java,Java,,673,122,166,961
BasicTableUI.java,Java,,1528,312,377,2217
BasicTextAreaUI.java,Java,,202,37,155,394
BasicTextFieldUI.java,Java,,198,29,193,420
BasicTextPaneUI.java,Java,,25,8,65,98
BasicTextUI.java,Java,,1353,245,1055,2653
BasicToggleButtonUI.java,Java,,99,31,45,175
BasicToolBarSeparatorUI.java,Java,,47,10,31,88
BasicToolBarUI.java,Java,,987,184,272,1443
BasicToolTipUI.java,Java,,167,32,54,253
BasicTransferable.java,Java,,163,33,97,293
BasicTreeUI.java,Java,,3078,605,908,4591
BasicViewportUI.java,Java,,33,10,30,73
CenterLayout.java,Java,,40,11,29,80
ComboPopup.java,Java,,15,11,75,101
DefaultMenuLayout.java,Java,,21,8,33,62
DragRecognitionSupport.java,Java,,92,25,64,181
LazyActionMap.java,Java,,87,17,61,165
BorderUIResource.java,Java,,158,43,50,251
ButtonUI.java,Java,,8,2,29,39
ColorChooserUI.java,Java,,6,5,30,41
ColorUIResource.java,Java,,19,6,41,66
ComboBoxUI.java,Java,,7,6,39,52
ComponentInputMapUIResource.java,Java,,8,4,31,43
ComponentUI.java,Java,,65,18,278,361
DesktopIconUI.java,Java,,3,3,29,35
DesktopPaneUI.java,Java,,3,3,29,35
DimensionUIResource.java,Java,,9,4,43,56
FileChooserUI.java,Java,,17,7,36,60
FontUIResource.java,Java,,12,5,42,59
IconUIResource.java,Java,,25,8,50,83
InputMapUIResource.java,Java,,6,4,31,41
InsetsUIResource.java,Java,,9,4,42,55
InternalFrameUI.java,Java,,3,2,29,34
LabelUI.java,Java,,3,2,29,34
LayerUI.java,Java,,157,34,528,719
ListUI.java,Java,,10,9,65,84
MenuBarUI.java,Java,,5,4,30,39
MenuItemUI.java,Java,,5,2,31,38
DefaultMetalTheme.java,Java,,178,40,215,433
MetalBorders.java,Java,,714,153,109,976
MetalBumps.java,Java,,158,31,46,235
MetalButtonUI.java,Java,,112,23,72,207
MetalCheckBoxIcon.java,Java,,55,14,38,107
MetalCheckBoxUI.java,Java,,37,15,48,100
MetalComboBoxButton.java,Java,,147,31,46,224
MetalComboBoxEditor.java,Java,,63,13,63,139
MetalComboBoxIcon.java,Java,,24,11,39,74
MetalComboBoxUI.java,Java,,229,37,116,382
MetalDesktopIconUI.java,Java,,87,21,36,144
MetalFileChooserUI.java,Java,,919,198,163,1280
MetalFontDesktopProperty.java,Java,,33,8,58,99
MetalHighContrastTheme.java,Java,,121,33,35,189
MetalIconFactory.java,Java,,1966,370,321,2657
MetalInternalFrameTitlePane.java,Java,,404,69,78,551
MetalInternalFrameUI.java,Java,,176,36,43,255
MetalLabelUI.java,Java,,32,11,44,87
MetalLookAndFeel.java,Java,,1420,189,826,2435
MetalMenuBarUI.java,Java,,48,6,65,119
MetalPopupMenuSeparatorUI.java,Java,,29,9,30,68
MetalProgressBarUI.java,Java,,96,25,69,190
MetalRadioButtonUI.java,Java,,135,34,57,226
MetalRootPaneUI.java,Java,,594,93,302,989
MetalScrollBarUI.java,Java,,346,80,52,478
MetalScrollButton.java,Java,,228,56,62,346
MetalScrollPaneUI.java,Java,,93,19,50,162
MetalSeparatorUI.java,Java,,45,11,39,95
MetalSliderUI.java,Java,,399,83,74,556
MetalSplitPaneDivider.java,Java,,269,41,106,416
MetalSplitPaneUI.java,Java,,13,6,44,63
MetalTabbedPaneUI.java,Java,,861,166,201,1228
MetalTextFieldUI.java,Java,,15,7,46,68
MetalTheme.java,Java,,68,56,361,485
MetalTitlePane.java,Java,,674,135,231,1040
MetalToggleButtonUI.java,Java,,122,26,77,225
MetalToolBarUI.java,Java,,244,42,110,396
MetalToolTipUI.java,Java,,124,27,46,197
MetalTreeUI.java,Java,,127,40,71,238
MetalUtils.java,Java,,297,51,104,452
OceanTheme.java,Java,,248,54,158,460
MultiButtonUI.java,Java,,88,18,104,210
MultiColorChooserUI.java,Java,,88,18,104,210
MultiComboBoxUI.java,Java,,110,21,119,250
MultiDesktopIconUI.java,Java,,88,18,104,210
MultiDesktopPaneUI.java,Java,,88,18,104,210
MultiFileChooserUI.java,Java,,135,24,134,293
MultiInternalFrameUI.java,Java,,88,18,104,210
MultiLabelUI.java,Java,,88,18,104,210
MultiListUI.java,Java,,115,21,122,258
MultiLookAndFeel.java,Java,,123,16,164,303
MultiMenuBarUI.java,Java,,88,18,104,210
MultiMenuItemUI.java,Java,,89,19,107,215
MultiOptionPaneUI.java,Java,,102,20,113,235
MultiPanelUI.java,Java,,88,18,104,210
MultiPopupMenuUI.java,Java,,107,20,118,245
MultiProgressBarUI.java,Java,,88,18,104,210
MultiRootPaneUI.java,Java,,88,18,105,211
MultiScrollBarUI.java,Java,,88,18,104,210
MultiScrollPaneUI.java,Java,,88,18,104,210
MultiSeparatorUI.java,Java,,88,18,104,210
MultiSliderUI.java,Java,,88,18,104,210
MultiSpinnerUI.java,Java,,88,18,105,211
MultiSplitPaneUI.java,Java,,128,24,131,283
MultiTabbedPaneUI.java,Java,,114,21,122,257
MultiTableHeaderUI.java,Java,,88,18,104,210
MultiTableUI.java,Java,,88,18,104,210
MultiTextUI.java,Java,,173,28,159,360
MultiToolBarUI.java,Java,,88,18,104,210
MultiToolTipUI.java,Java,,88,18,104,210
MultiTreeUI.java,Java,,165,28,158,351
MultiViewportUI.java,Java,,88,18,104,210
AbstractRegionPainter.java,Java,,347,39,366,752
ArrowButtonPainter.java,Java,,56,26,36,118
ButtonPainter.java,Java,,554,62,36,652
CheckBoxMenuItemPainter.java,Java,,93,33,36,162
CheckBoxPainter.java,Java,,529,70,36,635
ComboBoxArrowButtonEditableState.java,Java,,12,6,24,42
ComboBoxArrowButtonPainter.java,Java,,382,58,36,476
ComboBoxEditableState.java,Java,,11,7,24,42
ComboBoxPainter.java,Java,,628,69,36,733
ComboBoxTextFieldPainter.java,Java,,182,36,36,254
DerivedColor.java,Java,,118,18,56,192
DesktopIconPainter.java,Java,,95,28,36,159
DesktopPanePainter.java,Java,,274,40,36,350
DropShadowEffect.java,Java,,65,5,58,128
EditorPanePainter.java,Java,,60,28,36,124
Effect.java,Java,,58,14,61,133
EffectUtils.java,Java,,220,37,169,426
FileChooserPainter.java,Java,,2035,177,36,2248
FormattedTextFieldPainter.java,Java,,296,49,36,381
ImageCache.java,Java,,125,15,77,217
ImageScalingHelper.java,Java,,164,22,94,280
InnerGlowEffect.java,Java,,8,2,29,39
InnerShadowEffect.java,Java,,68,5,58,131
InternalFramePainter.java,Java,,323,43,36,402
InternalFrameTitlePaneCloseButtonPainter.java,Java,,377,50,36,463
InternalFrameTitlePaneCloseButtonWindowNotFocusedState.java,Java,,21,6,24,51
InternalFrameTitlePaneIconifyButtonPainter.java,Java,,518,52,36,606
InternalFrameTitlePaneIconifyButtonWindowNotFocusedState.java,Java,,21,6,24,51
InternalFrameTitlePaneMaximizeButtonPainter.java,Java,,927,82,36,1045
InternalFrameTitlePaneMaximizeButtonWindowMaximizedState.java,Java,,21,6,24,51
InternalFrameTitlePaneMaximizeButtonWindowNotFocusedState.java,Java,,21,6,24,51
InternalFrameTitlePaneMenuButtonPainter.java,Java,,427,54,36,517
InternalFrameTitlePaneMenuButtonWindowNotFocusedState.java,Java,,21,6,24,51
InternalFrameTitlePanePainter.java,Java,,31,21,36,88
InternalFrameTitlePaneWindowFocusedState.java,Java,,11,6,24,41
InternalFrameWindowFocusedState.java,Java,,11,6,24,41
LoweredBorder.java,Java,,95,12,95,202
MenuBarMenuPainter.java,Java,,47,24,36,107
MenuBarPainter.java,Java,,87,29,36,152
MenuItemPainter.java,Java,,47,24,36,107
MenuPainter.java,Java,,89,32,36,157
NimbusDefaults.java,Java,,1303,130,345,1778
NimbusIcon.java,Java,,158,10,57,225
NimbusLookAndFeel.java,Java,,340,49,232,621
NimbusStyle.java,Java,,521,72,525,1118
OptionPaneMessageAreaOptionPaneLabelPainter.java,Java,,45,24,36,105
OptionPaneMessageAreaPainter.java,Java,,31,21,36,88
OptionPanePainter.java,Java,,491,56,36,583
OuterGlowEffect.java,Java,,8,2,29,39
PasswordFieldPainter.java,Java,,296,49,36,381
PopupMenuPainter.java,Java,,97,30,36,163
PopupMenuSeparatorPainter.java,Java,,45,24,36,105
ProgressBarFinishedState.java,Java,,12,7,24,43
ProgressBarIndeterminateState.java,Java,,12,7,24,43
ProgressBarPainter.java,Java,,529,63,36,628
RadioButtonMenuItemPainter.java,Java,,101,34,36,171
RadioButtonPainter.java,Java,,595,73,36,704
ScrollBarButtonPainter.java,Java,,302,42,36,380
ScrollBarPainter.java,Java,,30,21,36,87
ScrollBarThumbPainter.java,Java,,301,42,36,379
ScrollBarTrackPainter.java,Java,,203,36,36,275
ScrollPanePainter.java,Java,,112,30,36,178
SeparatorPainter.java,Java,,45,24,36,105
ShadowEffect.java,Java,,52,15,36,103
SliderArrowShapeState.java,Java,,11,5,24,40
SliderPainter.java,Java,,30,21,36,87
SliderThumbArrowShapeState.java,Java,,11,5,24,40
SliderThumbPainter.java,Java,,544,74,36,654
SliderTrackArrowShapeState.java,Java,,11,5,24,40
SliderTrackPainter.java,Java,,159,34,36,229
SpinnerNextButtonPainter.java,Java,,474,72,36,582
SpinnerPainter.java,Java,,31,21,36,88
SpinnerPanelSpinnerFormattedTextFieldPainter.java,Java,,242,42,36,320
SpinnerPreviousButtonPainter.java,Java,,402,66,36,504
SplitPaneDividerPainter.java,Java,,213,40,36,289
SplitPaneDividerVerticalState.java,Java,,11,6,24,41
SplitPanePainter.java,Java,,31,21,36,88
SplitPaneVerticalState.java,Java,,11,6,24,41
State.java,Java,,81,16,116,213
SynthPainterImpl.java,Java,,961,149,1692,2802
TabbedPanePainter.java,Java,,35,21,36,92
TabbedPaneTabAreaPainter.java,Java,,149,35,36,220
TabbedPaneTabPainter.java,Java,,570,71,36,677
TableEditorPainter.java,Java,,71,27,36,134
TableHeaderPainter.java,Java,,76,28,36,140
TableHeaderRendererPainter.java,Java,,297,47,36,380
TableHeaderRendererSortedState.java,Java,,12,6,24,42
TableScrollPaneCorner.java,Java,,28,4,36,68
TextAreaNotInScrollPaneState.java,Java,,11,6,24,41
TextAreaPainter.java,Java,,321,54,36,411
TextFieldPainter.java,Java,,296,49,36,381
TextPanePainter.java,Java,,60,28,36,124
ToggleButtonPainter.java,Java,,601,68,36,705
ToolBarButtonPainter.java,Java,,213,39,36,288
ToolBarEastState.java,Java,,12,7,24,43
ToolBarNorthState.java,Java,,12,7,24,43
ToolBarPainter.java,Java,,137,38,36,211
ToolBarSeparatorPainter.java,Java,,25,5,41,71
ToolBarSouthState.java,Java,,12,7,24,43
ToolBarToggleButtonPainter.java,Java,,435,64,36,535
ToolBarWestState.java,Java,,12,7,24,43
ToolTipPainter.java,Java,,86,28,36,150
TreeCellEditorPainter.java,Java,,80,27,36,143
TreeCellPainter.java,Java,,80,29,36,145
TreePainter.java,Java,,553,63,36,652
OptionPaneUI.java,Java,,7,5,37,49
PanelUI.java,Java,,3,3,29,35
PopupMenuUI.java,Java,,14,6,43,63
ProgressBarUI.java,Java,,3,3,29,35
RootPaneUI.java,Java,,3,2,30,35
ScrollBarUI.java,Java,,3,2,29,34
ScrollPaneUI.java,Java,,3,4,29,36
SeparatorUI.java,Java,,3,3,30,36
SliderUI.java,Java,,3,2,29,34
SpinnerUI.java,Java,,3,3,30,36
SplitPaneUI.java,Java,,12,8,49,69
ColorType.java,Java,,34,12,95,141
DefaultSynthStyleFactory.java,Java,,106,24,79,209
ImagePainter.java,Java,,779,149,92,1020
ParsedSynthStyle.java,Java,,1831,312,32,2175
Region.java,Java,,173,71,333,577
SynthArrowButton.java,Java,,90,17,38,145
SynthBorder.java,Java,,89,7,40,136
SynthButtonUI.java,Java,,339,54,141,534
SynthCheckBoxMenuItemUI.java,Java,,23,9,46,78
SynthCheckBoxUI.java,Java,,23,8,46,77
SynthColorChooserUI.java,Java,,92,24,91,207
SynthComboBoxUI.java,Java,,391,87,290,768
SynthComboPopup.java,Java,,42,6,42,90
SynthConstants.java,Java,,11,3,57,71
SynthContext.java,Java,,77,20,81,178
SynthDefaultLookup.java,Java,,16,2,29,47
SynthDesktopIconUI.java,Java,,143,24,86,253
SynthDesktopPaneUI.java,Java,,354,50,107,511
SynthEditorPaneUI.java,Java,,94,22,87,203
SynthFormattedTextFieldUI.java,Java,,24,5,49,78
SynthGraphicsUtils.java,Java,,372,67,218,657
SynthInternalFrameTitlePane.java,Java,,408,47,41,496
SynthInternalFrameUI.java,Java,,148,29,100,277
SynthLabelUI.java,Java,,181,27,93,301
SynthListUI.java,Java,,132,29,70,231
SynthLookAndFeel.java,Java,,583,93,308,984
SynthMenuBarUI.java,Java,,89,19,86,194
SynthMenuItemLayoutHelper.java,Java,,218,28,62,308
SynthMenuItemUI.java,Java,,172,38,98,308
SynthMenuLayout.java,Java,,18,6,29,53
SynthMenuUI.java,Java,,174,32,98,304
SynthOptionPaneUI.java,Java,,146,35,103,284
SynthPainter.java,Java,,572,139,1706,2417
SynthPanelUI.java,Java,,85,24,97,206
SynthParser.java,Java,,1079,104,151,1334
SynthPasswordFieldUI.java,Java,,39,9,59,107
SynthPopupMenuUI.java,Java,,92,21,88,201
SynthProgressBarUI.java,Java,,315,40,126,481
SynthRadioButtonMenuItemUI.java,Java,,24,7,44,75
SynthRadioButtonUI.java,Java,,27,8,50,85
SynthRootPaneUI.java,Java,,74,18,82,174
SynthScrollBarUI.java,Java,,290,46,139,475
SynthScrollPaneUI.java,Java,,187,35,86,308
SynthSeparatorUI.java,Java,,127,29,103,259
SynthSliderUI.java,Java,,693,117,196,1006
SynthSpinnerUI.java,Java,,246,50,173,469
SynthSplitPaneDivider.java,Java,,96,17,38,151
SynthSplitPaneUI.java,Java,,196,45,117,358
SynthStyle.java,Java,,792,62,199,1053
SynthStyleFactory.java,Java,,7,3,65,75
SynthTabbedPaneUI.java,Java,,622,95,213,930
SynthTableHeaderUI.java,Java,,148,30,98,276
SynthTableUI.java,Java,,584,105,141,830
SynthTextAreaUI.java,Java,,87,22,95,204
SynthTextFieldUI.java,Java,,143,36,99,278
SynthTextPaneUI.java,Java,,75,17,103,195
SynthToggleButtonUI.java,Java,,27,7,46,80
SynthToolBarUI.java,Java,,348,62,151,561
SynthToolTipUI.java,Java,,127,25,92,244
SynthTreeUI.java,Java,,583,101,137,821
SynthUI.java,Java,,8,4,46,58
SynthViewportUI.java,Java,,91,24,112,227
TabbedPaneUI.java,Java,,8,3,30,41
TableHeaderUI.java,Java,,3,2,29,34
TableUI.java,Java,,3,2,29,34
TextUI.java,Java,,28,11,126,165
ToolBarUI.java,Java,,5,4,29,38
ToolTipUI.java,Java,,3,2,29,34
TreeUI.java,Java,,18,12,75,105
UIResource.java,Java,,3,4,60,67
ViewportUI.java,Java,,3,3,29,35
Popup.java,Java,,110,32,130,272
PopupFactory.java,Java,,585,121,268,974
ProgressMonitor.java,Java,,457,100,489,1046
ProgressMonitorInputStream.java,Java,,73,25,90,188
Renderer.java,Java,,6,3,42,51
RepaintManager.java,Java,,1021,165,556,1742
RootPaneContainer.java,Java,,13,17,149,179
RowFilter.java,Java,,239,54,317,610
RowSorter.java,Java,,79,28,318,425
Scrollable.java,Java,,11,11,107,129
ScrollPaneConstants.java,Java,,25,7,85,117
ScrollPaneLayout.java,Java,,544,138,439,1121
SingleSelectionModel.java,Java,,10,8,59,77
SizeRequirements.java,Java,,175,27,286,488
SizeSequence.java,Java,,140,24,242,406
SortingFocusTraversalPolicy.java,Java,,369,73,232,674
SortOrder.java,Java,,6,3,45,54
SpinnerDateModel.java,Java,,110,33,321,464
SpinnerListModel.java,Java,,73,27,147,247
SpinnerModel.java,Java,,12,14,113,139
SpinnerNumberModel.java,Java,,118,38,294,450
Spring.java,Java,,293,93,305,691
SpringLayout.java,Java,,505,95,633,1233
SwingConstants.java,Java,,22,8,108,138
SwingHeavyWeight.java,Java,,3,1,30,34
SwingPaintEventDispatcher.java,Java,,56,6,32,94
SwingUtilities.java,Java,,1171,180,738,2089
SwingWorker.java,Java,,271,45,550,866
AbstractTableModel.java,Java,,73,24,243,340
DefaultTableCellRenderer.java,Java,,148,41,210,399
DefaultTableColumnModel.java,Java,,267,72,400,739
DefaultTableModel.java,Java,,214,55,438,707
JTableHeader.java,Java,,782,155,535,1472
TableCellEditor.java,Java,,9,6,57,72
TableCellRenderer.java,Java,,8,5,81,94
TableColumn.java,Java,,226,71,528,825
TableColumnModel.java,Java,,27,26,188,241
TableModel.java,Java,,15,12,116,143
TableRowSorter.java,Java,,99,21,188,308
TableStringConverter.java,Java,,4,1,43,48
TablePrintable.java,Java,,208,95,218,521
AbstractDocument.java,Java,,1282,294,1540,3116
AbstractWriter.java,Java,,329,54,330,713
AsyncBoxView.java,Java,,652,109,667,1428
AttributeSet.java,Java,,23,18,152,193
BadLocationException.java,Java,,13,3,50,66
BoxView.java,Java,,565,84,539,1188
Caret.java,Java,,24,20,160,204
ChangedCharSetException.java,Java,,16,7,30,53
ComponentView.java,Java,,245,37,222,504
CompositeView.java,Java,,324,47,431,802
DateFormatter.java,Java,,64,17,79,160
DefaultCaret.java,Java,,981,147,792,1920
DefaultEditorKit.java,Java,,1141,221,950,2312
DefaultFormatter.java,Java,,378,78,310,766
DefaultFormatterFactory.java,Java,,84,22,207,313
DefaultHighlighter.java,Java,,381,61,212,654
DefaultStyledDocument.java,Java,,1635,220,889,2744
DefaultTextUI.java,Java,,5,4,33,42
Document.java,Java,,23,23,430,476
DocumentFilter.java,Java,,26,8,152,186
EditorKit.java,Java,,34,16,158,208
Element.java,Java,,13,13,113,139
ElementIterator.java,Java,,167,42,172,381
FieldView.java,Java,,149,19,143,311
FlowView.java,Java,,426,68,401,895
GapContent.java,Java,,545,94,315,954
GapVector.java,Java,,120,31,148,299
GlyphPainter1.java,Java,,120,23,107,250
GlyphPainter2.java,Java,,212,28,144,384
GlyphView.java,Java,,674,96,581,1351
Highlighter.java,Java,,22,19,111,152
AccessibleHTML.java,Java,,1551,296,1211,3058
BlockView.java,Java,,206,32,205,443
BRView.java,Java,,14,4,39,57
CommentView.java,Java,,92,13,36,141
CSS.java,Java,,2245,340,819,3404
CSSBorder.java,Java,,267,48,121,436
CSSParser.java,Java,,583,77,194,854
EditableView.java,Java,,70,11,47,128
FormSubmitEvent.java,Java,,21,9,62,92
FormView.java,Java,,592,75,303,970
FrameSetView.java,Java,,178,31,113,322
FrameView.java,Java,,289,51,139,479
HiddenTagView.java,Java,,254,39,68,361
HRuleView.java,Java,,182,26,113,321
HTML.java,Java,,411,47,239,697
HTMLDocument.java,Java,,2086,300,1815,4201
HTMLEditorKit.java,Java,,1322,172,792,2286
HTMLFrameHyperlinkEvent.java,Java,,37,12,85,134
HTMLWriter.java,Java,,816,105,352,1273
ImageView.java,Java,,623,95,290,1008
InlineView.java,Java,,69,16,140,225
IsindexView.java,Java,,51,15,48,114
LineView.java,Java,,63,11,112,186
ListView.java,Java,,53,8,61,122
Map.java,Java,,346,48,109,503
MinimalHTMLWriter.java,Java,,348,82,296,726
MuxingAttributeSet.java,Java,,148,28,135,311
NoFramesView.java,Java,,57,15,101,173
ObjectView.java,Java,,67,9,88,164
Option.java,Java,,37,11,72,120
OptionComboBoxModel.java,Java,,12,7,43,62
OptionListModel.java,Java,,303,72,194,569
ParagraphView.java,Java,,136,20,138,294
AttributeList.java,Java,,83,19,70,172
ContentModel.java,Java,,144,26,84,254
ContentModelState.java,Java,,173,27,95,295
DocumentParser.java,Java,,152,19,110,281
DTD.java,Java,,261,40,165,466
DTDConstants.java,Java,,39,6,37,82
Element.java,Java,,88,23,74,185
Entity.java,Java,,53,14,72,139
Parser.java,Java,,1595,245,510,2350
ParserDelegator.java,Java,,68,18,43,129
TagElement.java,Java,,33,11,30,74
TagStack.java,Java,,114,25,65,204
StyleSheet.java,Java,,2083,224,1031,3338
TableView.java,Java,,1030,166,605,1801
TextAreaDocument.java,Java,,20,8,40,68
IconView.java,Java,,56,11,101,168
InternationalFormatter.java,Java,,535,96,427,1058
JTextComponent.java,Java,,2420,394,2213,5027
Keymap.java,Java,,18,16,113,147
LabelView.java,Java,,96,24,196,316
LayeredHighlighter.java,Java,,14,4,45,63
LayoutQueue.java,Java,,62,15,52,129
MaskFormatter.java,Java,,468,86,460,1014
MutableAttributeSet.java,Java,,10,9,68,87
NavigationFilter.java,Java,,22,8,117,147
NumberFormatter.java,Java,,264,37,169,470
ParagraphView.java,Java,,650,76,468,1194
PasswordView.java,Java,,113,12,111,236
PlainDocument.java,Java,,169,16,136,321
PlainView.java,Java,,384,46,285,715
Position.java,Java,,15,8,70,93
AbstractFilter.java,Java,,108,25,96,229
Constants.java,Java,,28,10,40,78
MockAttributeSet.java,Java,,78,20,26,124
RTFAttribute.java,Java,,26,7,34,67
RTFAttributes.java,Java,,323,64,34,421
RTFEditorKit.java,Java,,43,13,99,155
RTFGenerator.java,Java,,757,130,114,1001
RTFParser.java,Java,,228,34,71,333
RTFReader.java,Java,,1115,224,300,1639
Segment.java,Java,,122,29,165,316
SegmentCache.java,Java,,39,15,73,127
SimpleAttributeSet.java,Java,,186,33,170,389
StateInvariantError.java,Java,,7,2,36,45
StringContent.java,Java,,264,40,194,498
Style.java,Java,,11,10,54,75
StyleConstants.java,Java,,282,100,470,852
StyleContext.java,Java,,711,147,763,1621
StyledDocument.java,Java,,17,16,144,177
StyledEditorKit.java,Java,,397,76,422,895
TabableView.java,Java,,5,4,61,70
TabExpander.java,Java,,4,4,39,47
TableView.java,Java,,426,75,406,907
TabSet.java,Java,,103,17,92,212
TabStop.java,Java,,76,14,87,177
TextAction.java,Java,,43,6,86,135
TextLayoutStrategy.java,Java,,302,53,200,555
Utilities.java,Java,,689,59,330,1078
View.java,Java,,387,70,920,1377
ViewFactory.java,Java,,5,4,39,48
WhitespaceBasedBreakIterator.java,Java,,71,16,32,119
WrappedPlainView.java,Java,,450,65,338,853
ZoneView.java,Java,,247,49,355,651
Timer.java,Java,,192,73,381,646
TimerQueue.java,Java,,204,40,62,306
ToolTipManager.java,Java,,549,78,235,862
TransferHandler.java,Java,,808,206,782,1796
AbstractLayoutCache.java,Java,,140,56,335,531
DefaultMutableTreeNode.java,Java,,641,227,634,1502
DefaultTreeCellEditor.java,Java,,381,88,311,780
DefaultTreeCellRenderer.java,Java,,306,81,304,691
DefaultTreeModel.java,Java,,263,55,363,681
DefaultTreeSelectionModel.java,Java,,689,116,423,1228
ExpandVetoException.java,Java,,12,6,45,63
FixedHeightLayoutCache.java,Java,,964,186,452,1602
MutableTreeNode.java,Java,,10,8,55,73
RowMapper.java,Java,,6,3,37,46
TreeCellEditor.java,Java,,10,4,51,65
TreeCellRenderer.java,Java,,8,4,64,76
TreeModel.java,Java,,13,15,132,160
TreeNode.java,Java,,12,10,65,87
TreePath.java,Java,,126,27,207,360
TreeSelectionModel.java,Java,,36,33,242,311
VariableHeightLayoutCache.java,Java,,1046,192,530,1768
UIDefaults.java,Java,,537,122,669,1328
UIManager.java,Java,,597,133,763,1493
AbstractUndoableEdit.java,Java,,73,23,182,278
CannotRedoException.java,Java,,3,1,38,42
CannotUndoException.java,Java,,3,2,38,43
CompoundEdit.java,Java,,110,21,131,262
StateEdit.java,Java,,59,27,107,193
StateEditable.java,Java,,7,8,39,54
UndoableEdit.java,Java,,15,13,173,201
UndoableEditSupport.java,Java,,69,15,92,176
UndoManager.java,Java,,208,44,372,624
UnsupportedLookAndFeelException.java,Java,,7,1,43,51
ViewportLayout.java,Java,,83,19,101,203
WindowConstants.java,Java,,8,7,69,84
Diagnostic.java,Java,,21,14,144,179
DiagnosticCollector.java,Java,,15,5,38,58
DiagnosticListener.java,Java,,4,2,43,49
DocumentationTool.java,Java,,35,11,137,183
FileObject.java,Java,,18,13,128,159
ForwardingFileObject.java,Java,,41,14,65,120
ForwardingJavaFileManager.java,Java,,74,18,74,166
ForwardingJavaFileObject.java,Java,,19,9,37,65
JavaCompiler.java,Java,,24,9,302,335
JavaFileManager.java,Java,,43,17,342,402
JavaFileObject.java,Java,,20,12,98,130
OptionChecker.java,Java,,4,4,38,46
package-info.java,Java,,1,1,76,78
SimpleJavaFileObject.java,Java,,69,19,128,216
StandardJavaFileManager.java,Java,,16,11,212,239
StandardLocation.java,Java,,36,14,65,115
Tool.java,Java,,9,6,57,72
ToolProvider.java,Java,,122,26,68,216
CollapsedStringAdapter.java,Java,,44,17,58,119
HexBinaryAdapter.java,Java,,12,4,33,49
NormalizedStringAdapter.java,Java,,24,14,54,92
XmlAdapter.java,Java,,6,5,182,193
XmlJavaTypeAdapter.java,Java,,24,11,81,116
XmlJavaTypeAdapters.java,Java,,9,3,50,62
DomHandler.java,Java,,9,5,105,119
W3CDomHandler.java,Java,,47,13,49,109
XmlAccessOrder.java,Java,,5,3,40,48
XmlAccessorOrder.java,Java,,11,5,64,80
XmlAccessorType.java,Java,,11,6,83,100
XmlAccessType.java,Java,,7,5,58,70
XmlAnyAttribute.java,Java,,12,4,58,74
XmlAnyElement.java,Java,,17,7,264,288
XmlAttachmentRef.java,Java,,10,3,61,74
XmlAttribute.java,Java,,11,7,134,152
XmlElement.java,Java,,17,12,181,210
XmlElementDecl.java,Java,,16,10,190,216
XmlElementRef.java,Java,,16,7,267,290
XmlElementRefs.java,Java,,12,3,44,59
XmlElements.java,Java,,11,3,163,177
XmlElementWrapper.java,Java,,14,7,124,145
XmlEnum.java,Java,,9,4,62,75
XmlEnumValue.java,Java,,10,3,110,123
XmlID.java,Java,,7,4,83,94
XmlIDREF.java,Java,,7,4,239,250
XmlInlineBinaryData.java,Java,,14,4,41,59
XmlList.java,Java,,10,3,98,111
XmlMimeType.java,Java,,13,4,43,60
XmlMixed.java,Java,,12,5,115,132
XmlNs.java,Java,,9,5,45,59
XmlNsForm.java,Java,,2,2,62,66
XmlRegistry.java,Java,,9,3,31,43
XmlRootElement.java,Java,,11,6,165,182
XmlSchema.java,Java,,14,11,181,206
XmlSchemaType.java,Java,,14,9,85,108
XmlSchemaTypes.java,Java,,9,3,49,61
XmlSeeAlso.java,Java,,11,3,65,79
XmlTransient.java,Java,,7,4,84,95
XmlType.java,Java,,14,9,429,452
XmlValue.java,Java,,7,4,120,131
AttachmentMarshaller.java,Java,,9,7,184,200
AttachmentUnmarshaller.java,Java,,7,5,127,139
Binder.java,Java,,21,20,380,421
ContextFinder.java,Java,,402,68,159,629
DataBindingException.java,Java,,9,3,35,47
DatatypeConverter.java,Java,,177,46,472,695
DatatypeConverterImpl.java,Java,,705,169,168,1042
DatatypeConverterInterface.java,Java,,43,41,439,523
Element.java,Java,,3,3,36,42
GetPropertyAction.java,Java,,11,5,28,44
AbstractMarshallerImpl.java,Java,,259,73,163,495
AbstractUnmarshallerImpl.java,Java,,219,64,152,435
DefaultValidationEventHandler.java,Java,,62,16,53,131
Messages.java,Java,,44,19,34,97
NotIdentifiableEventImpl.java,Java,,15,8,62,85
ParseConversionEventImpl.java,Java,,16,8,62,86
PrintConversionEventImpl.java,Java,,16,8,62,86
ValidationEventImpl.java,Java,,68,18,89,175
ValidationEventLocatorImpl.java,Java,,103,28,142,273
JAXB.java,Java,,231,34,364,629
JAXBContext.java,Java,,71,34,663,768
JAXBElement.java,Java,,55,23,140,218
JAXBException.java,Java,,52,19,113,184
JAXBIntrospector.java,Java,,13,5,74,92
JAXBPermission.java,Java,,8,5,80,93
MarshalException.java,Java,,18,8,73,99
Marshaller.java,Java,,58,35,728,821
Messages.java,Java,,40,17,34,91
NotIdentifiableEvent.java,Java,,3,3,33,39
ParseConversionEvent.java,Java,,3,3,34,40
PrintConversionEvent.java,Java,,3,3,34,40
PropertyException.java,Java,,26,12,75,113
SchemaOutputResolver.java,Java,,6,3,73,82
TypeConstraintException.java,Java,,48,19,117,184
UnmarshalException.java,Java,,18,8,75,101
Unmarshaller.java,Java,,51,35,1056,1142
UnmarshallerHandler.java,Java,,6,3,74,83
JAXBResult.java,Java,,25,10,115,150
JAXBSource.java,Java,,124,30,118,272
Messages.java,Java,,34,15,34,83
ValidationEventCollector.java,Java,,44,10,59,113
ValidationEvent.java,Java,,10,10,72,92
ValidationEventHandler.java,Java,,4,3,87,94
ValidationEventLocator.java,Java,,9,9,72,90
ValidationException.java,Java,,18,8,73,99
Validator.java,Java,,12,9,264,285
WhiteSpaceProcessor.java,Java,,82,30,86,198
AlgorithmMethod.java,Java,,6,4,48,58
Data.java,Java,,3,2,37,42
DOMCryptoContext.java,Java,,103,21,120,244
DOMStructure.java,Java,,23,6,59,88
DOMURIReference.java,Java,,6,3,42,51
CanonicalizationMethod.java,Java,,14,7,83,104
DigestMethod.java,Java,,12,7,79,98
DOMSignContext.java,Java,,74,11,124,209
DOMValidateContext.java,Java,,44,9,82,135
KeyInfo.java,Java,,12,5,107,124
KeyInfoFactory.java,Java,,112,27,389,528
KeyName.java,Java,,5,3,59,67
KeyValue.java,Java,,14,5,115,134
PGPData.java,Java,,11,6,100,117
RetrievalMethod.java,Java,,14,5,94,113
X509Data.java,Java,,11,5,98,114
X509IssuerSerial.java,Java,,8,4,77,89
Manifest.java,Java,,9,5,77,91
Reference.java,Java,,18,10,141,169
SignatureMethod.java,Java,,14,6,77,97
SignatureProperties.java,Java,,10,5,77,92
SignatureProperty.java,Java,,9,5,82,96
SignedInfo.java,Java,,12,7,84,103
C14NMethodParameterSpec.java,Java,,3,2,38,43
DigestMethodParameterSpec.java,Java,,4,2,38,44
ExcC14NParameterSpec.java,Java,,31,9,81,121
HMACParameterSpec.java,Java,,11,5,59,75
SignatureMethodParameterSpec.java,Java,,4,2,38,44
TransformParameterSpec.java,Java,,4,2,38,44
XPathFilter2ParameterSpec.java,Java,,32,7,59,98
XPathFilterParameterSpec.java,Java,,44,9,79,132
XPathType.java,Java,,62,16,127,205
XSLTTransformParameterSpec.java,Java,,15,4,59,78
Transform.java,Java,,23,10,115,148
TransformException.java,Java,,42,12,102,156
TransformService.java,Java,,151,16,226,393
XMLObject.java,Java,,11,8,110,129
XMLSignature.java,Java,,28,15,203,246
XMLSignatureException.java,Java,,42,12,99,153
XMLSignatureFactory.java,Java,,151,38,615,804
XMLSignContext.java,Java,,4,2,57,63
XMLValidateContext.java,Java,,3,2,58,63
KeySelector.java,Java,,40,14,98,152
KeySelectorException.java,Java,,33,12,103,148
KeySelectorResult.java,Java,,5,3,46,54
MarshalException.java,Java,,38,12,105,155
NodeSetData.java,Java,,6,3,48,57
NoSuchMechanismException.java,Java,,38,12,106,156
OctetStreamData.java,Java,,31,8,67,106
URIDereferencer.java,Java,,5,3,67,75
URIReference.java,Java,,5,3,52,60
URIReferenceException.java,Java,,46,15,127,188
XMLCryptoContext.java,Java,,17,15,194,226
XMLStructure.java,Java,,4,2,44,50
DatatypeConfigurationException.java,Java,,15,11,53,79
DatatypeConstants.java,Java,,55,46,173,274
DatatypeFactory.java,Java,,277,61,736,1074
Duration.java,Java,,186,53,749,988
FactoryFinder.java,Java,,169,22,120,311
SecuritySupport.java,Java,,65,10,31,106
XMLGregorianCalendar.java,Java,,102,57,903,1062
NamespaceContext.java,Java,,7,7,274,288
QName.java,Java,,128,31,357,516
DocumentBuilder.java,Java,,80,42,226,348
DocumentBuilderFactory.java,Java,,101,47,459,607
FactoryConfigurationError.java,Java,,35,21,79,135
FactoryFinder.java,Java,,168,20,128,316
ParserConfigurationException.java,Java,,9,8,39,56
SAXParser.java,Java,,150,42,363,555
SAXParserFactory.java,Java,,74,28,341,443
SecuritySupport.java,Java,,65,12,33,110
AttachmentPart.java,Java,,61,37,428,526
Detail.java,Java,,8,7,84,99
DetailEntry.java,Java,,3,3,30,36
FactoryFinder.java,Java,,112,21,103,236
MessageFactory.java,Java,,33,16,151,200
MimeHeader.java,Java,,15,7,48,70
MimeHeaders.java,Java,,123,31,115,269
Name.java,Java,,7,5,98,110
Node.java,Java,,9,8,95,112
SAAJMetaFactory.java,Java,,24,7,82,113
SAAJResult.java,Java,,19,9,105,133
SOAPBody.java,Java,,22,18,257,297
SOAPBodyElement.java,Java,,3,2,38,43
SOAPConnection.java,Java,,11,6,78,95
SOAPConnectionFactory.java,Java,,21,5,60,86
SOAPConstants.java,Java,,42,23,136,201
SOAPElement.java,Java,,44,33,447,524
SOAPElementFactory.java,Java,,25,8,104,137
SOAPEnvelope.java,Java,,12,7,181,200
SOAPException.java,Java,,41,11,111,163
SOAPFactory.java,Java,,50,20,229,299
SOAPFault.java,Java,,34,32,445,511
SOAPFaultElement.java,Java,,3,2,32,37
SOAPHeader.java,Java,,22,15,225,262
SOAPHeaderElement.java,Java,,11,10,145,166
SOAPMessage.java,Java,,52,28,376,456
SOAPPart.java,Java,,36,17,212,265
Text.java,Java,,4,3,35,42
EventFilter.java,Java,,5,4,41,50
Attribute.java,Java,,8,9,52,69
Characters.java,Java,,7,7,62,76
Comment.java,Java,,4,4,37,45
DTD.java,Java,,8,8,58,74
EndDocument.java,Java,,3,3,36,42
EndElement.java,Java,,7,6,46,59
EntityDeclaration.java,Java,,9,9,62,80
EntityReference.java,Java,,5,4,53,62
Namespace.java,Java,,7,7,45,59
NotationDeclaration.java,Java,,6,4,48,58
ProcessingInstruction.java,Java,,5,4,43,52
StartDocument.java,Java,,9,8,57,74
StartElement.java,Java,,13,11,93,117
XMLEvent.java,Java,,22,21,135,178
FactoryConfigurationError.java,Java,,38,14,73,125
FactoryFinder.java,Java,,198,24,153,375
Location.java,Java,,8,7,62,77
SecuritySupport.java,Java,,65,12,33,110
StreamFilter.java,Java,,4,4,43,51
EventReaderDelegate.java,Java,,60,18,56,134
StreamReaderDelegate.java,Java,,177,55,55,287
XMLEventAllocator.java,Java,,11,8,63,82
XMLEventConsumer.java,Java,,7,5,46,58
XMLEventFactory.java,Java,,82,29,353,464
XMLEventReader.java,Java,,12,11,83,106
XMLEventWriter.java,Java,,16,16,224,256
XMLInputFactory.java,Java,,86,45,379,510
XMLOutputFactory.java,Java,,44,24,291,359
XMLReporter.java,Java,,5,4,56,65
XMLResolver.java,Java,,8,4,48,60
XMLStreamConstants.java,Java,,18,15,94,127
XMLStreamException.java,Java,,39,15,76,130
XMLStreamReader.java,Java,,53,52,599,704
XMLStreamWriter.java,Java,,75,40,413,528
DOMLocator.java,Java,,6,6,37,49
DOMResult.java,Java,,84,30,248,362
DOMSource.java,Java,,29,14,94,137
ErrorListener.java,Java,,9,5,103,117
FactoryFinder.java,Java,,202,24,123,349
OutputKeys.java,Java,,15,13,172,200
Result.java,Java,,9,6,71,86
SAXResult.java,Java,,34,17,93,144
SAXSource.java,Java,,59,22,128,209
SAXTransformerFactory.java,Java,,22,13,115,150
TemplatesHandler.java,Java,,8,7,53,68
TransformerHandler.java,Java,,13,8,55,76
SecuritySupport.java,Java,,65,10,33,108
Source.java,Java,,5,4,44,53
SourceLocator.java,Java,,7,6,83,96
StAXResult.java,Java,,39,20,124,183
StAXSource.java,Java,,62,23,151,236
StreamResult.java,Java,,48,21,134,203
StreamSource.java,Java,,61,26,197,284
Templates.java,Java,,6,8,68,82
Transformer.java,Java,,28,19,292,339
TransformerConfigurationException.java,Java,,24,8,70,102
TransformerException.java,Java,,164,60,146,370
TransformerFactory.java,Java,,36,22,361,419
TransformerFactoryConfigurationError.java,Java,,35,20,75,130
URIResolver.java,Java,,5,3,42,50
Schema.java,Java,,7,5,92,104
SchemaFactory.java,Java,,94,30,676,800
SchemaFactoryConfigurationError.java,Java,,15,9,56,80
SchemaFactoryFinder.java,Java,,261,46,141,448
SchemaFactoryLoader.java,Java,,6,4,58,68
SecuritySupport.java,Java,,117,13,33,163
TypeInfoProvider.java,Java,,10,8,179,197
Validator.java,Java,,52,28,444,524
ValidatorHandler.java,Java,,45,24,416,485
Action.java,Java,,14,6,127,147
AsyncHandler.java,Java,,4,3,35,42
Binding.java,Java,,6,6,55,67
BindingProvider.java,Java,,22,16,144,182
BindingType.java,Java,,12,3,47,62
Dispatch.java,Java,,8,7,101,116
Endpoint.java,Java,,50,32,416,498
EndpointContext.java,Java,,6,5,48,59
EndpointReference.java,Java,,26,8,158,192
FaultAction.java,Java,,13,5,146,164
Handler.java,Java,,8,6,73,87
HandlerResolver.java,Java,,4,3,46,53
LogicalHandler.java,Java,,3,2,29,34
LogicalMessageContext.java,Java,,6,4,36,46
MessageContext.java,Java,,43,23,139,205
PortInfo.java,Java,,7,7,52,66
SOAPHandler.java,Java,,8,4,37,49
SOAPMessageContext.java,Java,,13,7,79,99
Holder.java,Java,,11,7,40,58
HTTPBinding.java,Java,,5,5,32,42
HTTPException.java,Java,,11,6,39,56
LogicalMessage.java,Java,,9,7,76,92
ProtocolException.java,Java,,15,5,68,88
Provider.java,Java,,4,3,56,63
RequestWrapper.java,Java,,15,8,49,72
RespectBinding.java,Java,,14,4,50,68
RespectBindingFeature.java,Java,,14,7,96,117
Response.java,Java,,6,3,43,52
ResponseWrapper.java,Java,,15,8,49,72
Service.java,Java,,105,38,617,760
ServiceMode.java,Java,,14,3,36,53
Addressing.java,Java,,21,7,85,113
AddressingFeature.java,Java,,37,17,223,277
MTOM.java,Java,,17,5,53,75
MTOMFeature.java,Java,,35,13,96,144
SOAPBinding.java,Java,,17,16,77,110
SOAPFaultException.java,Java,,12,6,57,75
FactoryFinder.java,Java,,132,23,61,216
HttpContext.java,Java,,12,9,78,99
HttpExchange.java,Java,,40,29,259,328
HttpHandler.java,Java,,6,3,45,54
package-info.java,Java,,1,1,93,95
Invoker.java,Java,,11,7,73,91
Provider.java,Java,,112,29,380,521
ServiceDelegate.java,Java,,46,34,542,622
WebServiceFeatureAnnotation.java,Java,,19,4,63,86
WebEndpoint.java,Java,,12,3,41,56
WebFault.java,Java,,15,8,44,67
WebServiceClient.java,Java,,14,5,44,63
WebServiceContext.java,Java,,13,9,129,151
WebServiceException.java,Java,,15,8,56,79
WebServiceFeature.java,Java,,9,9,63,81
WebServicePermission.java,Java,,11,7,67,85
WebServiceProvider.java,Java,,15,5,42,62
WebServiceRef.java,Java,,19,10,121,150
WebServiceRefs.java,Java,,12,4,67,83
package-info.java,Java,,3,1,24,28
W3CEndpointReference.java,Java,,81,19,64,164
W3CEndpointReferenceBuilder.java,Java,,85,18,253,356
XMLConstants.java,Java,,24,21,347,392
SecuritySupport.java,Java,,116,13,31,160
XPath.java,Java,,26,15,278,319
XPathConstants.java,Java,,11,10,63,84
XPathException.java,Java,,65,17,94,176
XPathExpression.java,Java,,13,7,180,200
XPathExpressionException.java,Java,,10,5,59,74
XPathFactory.java,Java,,78,30,282,390
XPathFactoryConfigurationException.java,Java,,10,5,58,73
XPathFactoryFinder.java,Java,,264,44,136,444
XPathFunction.java,Java,,6,3,47,56
XPathFunctionException.java,Java,,10,5,57,72
XPathFunctionResolver.java,Java,,5,3,58,66
XPathVariableResolver.java,Java,,5,3,50,58
defines.h,h,,45,10,35,90
emessages.h,h,,59,19,29,107
java.c,C/C++/ObjC,,1370,202,509,2081
java.h,h,,146,51,112,309
java_md.c,C/C++/ObjC,,931,155,435,1521
java_md.h,h,,19,8,30,57
jli_util.c,C/C++/ObjC,,67,11,43,121
jli_util.h,h,,68,9,28,105
main.c,C/C++/ObjC,,72,15,47,134
manifest_info.h,h,,94,20,73,187
parse_manifest.c,C/C++/ObjC,,410,37,251,698
splashscreen.h,h,,8,2,24,34
splashscreen_stubs.c,C/C++/ObjC,,41,12,37,90
version_comp.c,C/C++/ObjC,,212,25,120,357
version_comp.h,h,,7,3,27,37
wildcard.c,C/C++/ObjC,,334,41,126,501
wildcard.h,h,,4,3,24,31
ChannelBinding.java,Java,,63,23,126,212
GSSContext.java,Java,,62,45,1240,1347
GSSCredential.java,Java,,21,23,326,370
GSSException.java,Java,,108,60,235,403
GSSManager.java,Java,,38,19,672,729
GSSName.java,Java,,27,19,249,295
MessageProp.java,Java,,67,21,147,235
Oid.java,Java,,83,23,110,216
ACTIVITY_COMPLETED.java,Java,,18,7,61,86
ACTIVITY_REQUIRED.java,Java,,18,7,59,84
Any.java,Java,,81,58,582,721
AnyHolder.java,Java,,21,9,77,107
AnySeqHelper.java,Java,,46,10,45,101
AnySeqHolder.java,Java,,24,9,33,66
ARG_IN.java,Java,,4,3,46,53
ARG_INOUT.java,Java,,4,3,47,54
ARG_OUT.java,Java,,4,3,46,53
BAD_CONTEXT.java,Java,,15,7,64,86
BAD_INV_ORDER.java,Java,,15,8,62,85
BAD_OPERATION.java,Java,,15,7,60,82
BAD_PARAM.java,Java,,15,7,69,91
BAD_POLICY.java,Java,,4,2,33,39
BAD_POLICY_TYPE.java,Java,,4,2,33,39
BAD_POLICY_VALUE.java,Java,,4,2,35,41
BAD_QOS.java,Java,,18,7,58,83
BAD_TYPECODE.java,Java,,15,7,61,83
BooleanHolder.java,Java,,21,9,79,109
BooleanSeqHelper.java,Java,,44,10,45,99
BooleanSeqHolder.java,Java,,24,9,33,66
Bounds.java,Java,,9,5,40,54
ByteHolder.java,Java,,21,10,79,110
CharHolder.java,Java,,21,10,80,111
CharSeqHelper.java,Java,,44,10,45,99
CharSeqHolder.java,Java,,24,9,33,66
CODESET_INCOMPATIBLE.java,Java,,18,7,57,82
COMM_FAILURE.java,Java,,15,7,68,90
CompletionStatus.java,Java,,27,13,102,142
CompletionStatusHelper.java,Java,,37,10,32,79
Context.java,Java,,11,18,215,244
ContextList.java,Java,,7,12,87,106
CTX_RESTRICT_SCOPE.java,Java,,4,3,45,52
Current.java,Java,,4,3,41,48
CurrentHelper.java,Java,,43,11,33,87
CurrentHolder.java,Java,,24,8,33,65
CurrentOperations.java,Java,,4,3,34,41
CustomMarshal.java,Java,,7,3,47,57
DataInputStream.java,Java,,36,33,275,344
DataOutputStream.java,Java,,36,34,213,283
DATA_CONVERSION.java,Java,,15,7,63,85
DefinitionKind.java,Java,,114,113,274,501
DefinitionKindHelper.java,Java,,37,10,33,80
DomainManager.java,Java,,5,3,35,43
DomainManagerOperations.java,Java,,5,3,41,49
DoubleHolder.java,Java,,21,12,76,109
DoubleSeqHelper.java,Java,,44,10,45,99
DoubleSeqHolder.java,Java,,24,9,33,66
DynamicImplementation.java,Java,,12,5,30,47
DynAny.java,Java,,90,66,575,731
Invalid.java,Java,,10,5,36,51
InvalidSeq.java,Java,,10,5,37,52
InvalidValue.java,Java,,10,4,39,53
TypeMismatch.java,Java,,10,5,37,52
DynArray.java,Java,,8,5,43,56
DynEnum.java,Java,,9,6,49,64
DynFixed.java,Java,,8,4,45,57
DynSequence.java,Java,,10,7,56,73
DynStruct.java,Java,,10,6,54,70
DynUnion.java,Java,,13,10,71,94
DynValue.java,Java,,9,6,58,73
Environment.java,Java,,6,10,45,61
ExceptionList.java,Java,,9,11,90,110
FieldNameHelper.java,Java,,40,10,32,82
FixedHolder.java,Java,,21,11,66,98
FloatHolder.java,Java,,21,9,75,105
FloatSeqHelper.java,Java,,44,10,45,99
FloatSeqHolder.java,Java,,24,9,33,66
FREE_MEM.java,Java,,15,6,60,81
IdentifierHelper.java,Java,,40,10,33,83
IDLType.java,Java,,4,3,42,49
IDLTypeHelper.java,Java,,51,11,33,95
IDLTypeOperations.java,Java,,5,4,49,58
IMP_LIMIT.java,Java,,15,7,63,85
INITIALIZE.java,Java,,15,6,66,87
INTERNAL.java,Java,,15,6,66,87
INTF_REPOS.java,Java,,15,6,59,80
IntHolder.java,Java,,21,9,82,112
INVALID_ACTIVITY.java,Java,,18,7,60,85
INVALID_TRANSACTION.java,Java,,15,6,61,82
INV_FLAG.java,Java,,15,6,61,82
INV_IDENT.java,Java,,15,6,62,83
INV_OBJREF.java,Java,,15,6,68,89
INV_POLICY.java,Java,,15,6,59,80
IRObject.java,Java,,5,2,35,42
IRObjectOperations.java,Java,,6,6,71,83
LocalObject.java,Java,,89,32,379,500
LongHolder.java,Java,,21,10,77,108
LongLongSeqHelper.java,Java,,44,10,45,99
LongLongSeqHolder.java,Java,,24,9,33,66
LongSeqHelper.java,Java,,44,10,45,99
LongSeqHolder.java,Java,,24,9,33,66
MARSHAL.java,Java,,15,6,66,87
NamedValue.java,Java,,6,10,109,125
NameValuePair.java,Java,,10,8,45,63
NameValuePairHelper.java,Java,,67,10,32,109
NO_IMPLEMENT.java,Java,,15,6,65,86
NO_MEMORY.java,Java,,15,6,58,79
NO_PERMISSION.java,Java,,15,6,58,79
NO_RESOURCES.java,Java,,15,6,59,80
NO_RESPONSE.java,Java,,15,6,59,80
NVList.java,Java,,9,16,153,178
Object.java,Java,,25,35,222,282
ObjectHelper.java,Java,,37,11,35,83
ObjectHolder.java,Java,,21,9,81,111
OBJECT_NOT_EXIST.java,Java,,15,6,68,89
OBJ_ADAPTER.java,Java,,15,6,63,84
OctetSeqHelper.java,Java,,44,10,45,99
OctetSeqHolder.java,Java,,24,9,33,66
OMGVMCID.java,Java,,4,4,34,42
ORB.java,Java,,313,99,913,1325
InconsistentTypeCode.java,Java,,10,4,38,52
InvalidName.java,Java,,9,4,40,53
ParameterMode.java,Java,,29,8,14,51
ParameterModeHelper.java,Java,,37,11,14,62
ParameterModeHolder.java,Java,,24,9,14,47
PERSIST_STORE.java,Java,,15,6,58,79
Policy.java,Java,,4,3,40,47
PolicyError.java,Java,,15,7,49,71
PolicyErrorCodeHelper.java,Java,,40,11,11,62
PolicyErrorHelper.java,Java,,62,11,12,85
PolicyErrorHolder.java,Java,,24,9,10,43
PolicyHelper.java,Java,,51,11,33,95
PolicyHolder.java,Java,,24,8,33,65
PolicyListHelper.java,Java,,46,10,33,89
PolicyListHolder.java,Java,,24,9,33,66
PolicyOperations.java,Java,,7,6,59,72
PolicyTypeHelper.java,Java,,40,11,34,85
ApplicationException.java,Java,,16,6,42,64
BoxedValueHelper.java,Java,,7,2,30,39
CustomValue.java,Java,,4,4,37,45
Delegate.java,Java,,84,30,294,408
IDLEntity.java,Java,,3,3,31,37
IndirectionException.java,Java,,9,4,55,68
InputStream.java,Java,,68,12,240,320
InvokeHandler.java,Java,,6,3,63,72
ObjectImpl.java,Java,,155,37,342,534
OutputStream.java,Java,,66,11,210,287
RemarshalException.java,Java,,6,2,38,46
ResponseHandler.java,Java,,5,3,46,54
ServantObject.java,Java,,5,4,39,48
Streamable.java,Java,,7,4,49,60
StreamableValue.java,Java,,3,4,34,41
UnknownException.java,Java,,8,1,49,58
ValueBase.java,Java,,4,1,45,50
ValueFactory.java,Java,,5,3,49,57
ValueInputStream.java,Java,,5,4,42,51
ValueOutputStream.java,Java,,5,3,41,49
Principal.java,Java,,12,4,42,58
PrincipalHolder.java,Java,,22,10,61,93
PRIVATE_MEMBER.java,Java,,4,2,40,46
PUBLIC_MEMBER.java,Java,,4,2,41,47
REBIND.java,Java,,18,7,61,86
RepositoryIdHelper.java,Java,,40,10,34,84
Request.java,Java,,25,50,226,301
ServerRequest.java,Java,,39,19,256,314
ServiceDetail.java,Java,,11,5,52,68
ServiceDetailHelper.java,Java,,50,6,29,85
ServiceInformation.java,Java,,13,6,42,61
ServiceInformationHelper.java,Java,,58,7,29,94
ServiceInformationHolder.java,Java,,20,9,81,110
SetOverrideType.java,Java,,25,11,86,122
SetOverrideTypeHelper.java,Java,,37,10,32,79
ShortHolder.java,Java,,21,9,80,110
ShortSeqHelper.java,Java,,44,10,45,99
ShortSeqHolder.java,Java,,24,9,33,66
StringHolder.java,Java,,21,9,79,109
StringSeqHelper.java,Java,,46,11,7,64
StringSeqHolder.java,Java,,24,10,7,41
StringValueHelper.java,Java,,73,14,51,138
StructMember.java,Java,,12,8,69,89
StructMemberHelper.java,Java,,74,10,33,117
SystemException.java,Java,,45,11,63,119
TCKind.java,Java,,149,79,326,554
TIMEOUT.java,Java,,18,7,58,83
TRANSACTION_MODE.java,Java,,15,6,61,82
TRANSACTION_REQUIRED.java,Java,,15,6,58,79
TRANSACTION_ROLLEDBACK.java,Java,,15,6,62,83
TRANSACTION_UNAVAILABLE.java,Java,,16,6,61,83
TRANSIENT.java,Java,,15,6,61,82
TypeCode.java,Java,,29,39,465,533
TypeCodeHolder.java,Java,,21,9,80,110
BadKind.java,Java,,9,4,42,55
Bounds.java,Java,,9,5,41,55
ULongLongSeqHelper.java,Java,,44,10,45,99
ULongLongSeqHolder.java,Java,,24,9,33,66
ULongSeqHelper.java,Java,,44,10,45,99
ULongSeqHolder.java,Java,,24,9,33,66
UnionMember.java,Java,,14,9,72,95
UnionMemberHelper.java,Java,,81,10,33,124
UNKNOWN.java,Java,,15,6,67,88
UnknownUserException.java,Java,,11,6,49,66
UnknownUserExceptionHelper.java,Java,,61,10,35,106
UnknownUserExceptionHolder.java,Java,,24,8,33,65
UNSUPPORTED_POLICY.java,Java,,4,2,34,40
UNSUPPORTED_POLICY_VALUE.java,Java,,4,2,35,41
UserException.java,Java,,9,4,44,57
UShortSeqHelper.java,Java,,44,10,45,99
UShortSeqHolder.java,Java,,24,9,33,66
ValueBaseHelper.java,Java,,37,12,37,86
ValueBaseHolder.java,Java,,21,10,76,107
ValueMember.java,Java,,20,12,89,121
ValueMemberHelper.java,Java,,106,10,33,149
VersionSpecHelper.java,Java,,40,10,33,83
VisibilityHelper.java,Java,,40,11,34,85
VM_ABSTRACT.java,Java,,4,2,33,39
VM_CUSTOM.java,Java,,4,2,33,39
VM_NONE.java,Java,,4,4,36,44
VM_TRUNCATABLE.java,Java,,4,2,35,41
WCharSeqHelper.java,Java,,44,10,45,99
WCharSeqHolder.java,Java,,24,9,33,66
WrongTransaction.java,Java,,9,4,43,56
WrongTransactionHelper.java,Java,,54,9,35,98
WrongTransactionHolder.java,Java,,24,8,33,65
WStringSeqHelper.java,Java,,46,11,7,64
WStringSeqHolder.java,Java,,24,10,7,41
WStringValueHelper.java,Java,,73,16,53,142
_IDLTypeStub.java,Java,,90,13,50,153
_PolicyStub.java,Java,,89,14,61,164
ORB.java,Java,,23,13,53,89
Delegate.java,Java,,6,4,44,54
InputStream.java,Java,,50,18,84,152
ObjectImpl.java,Java,,10,6,43,59
OutputStream.java,Java,,44,13,72,129
Binding.java,Java,,14,7,7,28
BindingHelper.java,Java,,68,10,6,84
BindingHolder.java,Java,,24,8,6,38
BindingIterator.java,Java,,4,4,14,22
BindingIteratorHelper.java,Java,,67,13,14,94
BindingIteratorHolder.java,Java,,24,9,14,47
BindingIteratorOperations.java,Java,,7,7,30,44
BindingIteratorPOA.java,Java,,70,21,32,123
BindingListHelper.java,Java,,46,11,9,66
BindingListHolder.java,Java,,24,10,9,43
BindingType.java,Java,,27,8,10,45
BindingTypeHelper.java,Java,,37,11,10,58
BindingTypeHolder.java,Java,,24,9,10,43
IstringHelper.java,Java,,40,10,6,56
NameComponent.java,Java,,14,6,6,26
NameComponentHelper.java,Java,,68,10,6,84
NameComponentHolder.java,Java,,24,8,6,38
NameHelper.java,Java,,46,11,9,66
NameHolder.java,Java,,24,10,9,43
NamingContext.java,Java,,4,4,15,23
NamingContextExt.java,Java,,4,4,19,27
NamingContextExtHelper.java,Java,,67,13,19,99
NamingContextExtHolder.java,Java,,24,9,19,52
NamingContextExtOperations.java,Java,,8,8,67,83
AddressHelper.java,Java,,40,11,9,60
InvalidAddress.java,Java,,12,7,6,25
InvalidAddressHelper.java,Java,,54,10,8,72
InvalidAddressHolder.java,Java,,24,8,6,38
StringNameHelper.java,Java,,40,11,10,61
URLStringHelper.java,Java,,40,11,10,61
NamingContextExtPOA.java,Java,,294,43,230,567
NamingContextHelper.java,Java,,67,13,15,95
NamingContextHolder.java,Java,,24,9,15,48
NamingContextOperations.java,Java,,14,14,176,204
AlreadyBound.java,Java,,12,7,6,25
AlreadyBoundHelper.java,Java,,54,10,8,72
AlreadyBoundHolder.java,Java,,24,8,6,38
CannotProceed.java,Java,,22,8,6,36
CannotProceedHelper.java,Java,,70,10,8,88
CannotProceedHolder.java,Java,,24,8,6,38
InvalidName.java,Java,,12,7,6,25
InvalidNameHelper.java,Java,,54,10,8,72
InvalidNameHolder.java,Java,,24,8,6,38
NotEmpty.java,Java,,12,7,6,25
NotEmptyHelper.java,Java,,54,10,8,72
NotEmptyHolder.java,Java,,24,8,6,38
NotFound.java,Java,,22,8,6,36
NotFoundHelper.java,Java,,70,10,8,88
NotFoundHolder.java,Java,,24,8,6,38
NotFoundReason.java,Java,,29,8,9,46
NotFoundReasonHelper.java,Java,,37,11,9,57
NotFoundReasonHolder.java,Java,,24,9,9,42
NamingContextPOA.java,Java,,223,35,178,436
_BindingIteratorImplBase.java,Java,,71,3,34,108
_BindingIteratorStub.java,Java,,92,14,31,137
_NamingContextExtStub.java,Java,,377,36,229,642
_NamingContextImplBase.java,Java,,370,3,34,407
_NamingContextStub.java,Java,,281,28,177,486
Parameter.java,Java,,14,6,6,26
AnySeqHelper.java,Java,,46,10,6,62
DynAny.java,Java,,4,4,73,81
DynAnyFactory.java,Java,,4,4,27,35
DynAnyFactoryHelper.java,Java,,67,13,27,107
DynAnyFactoryOperations.java,Java,,6,6,68,80
InconsistentTypeCode.java,Java,,12,7,6,25
InconsistentTypeCodeHelper.java,Java,,54,10,8,72
DynAnyHelper.java,Java,,67,13,73,153
DynAnyOperations.java,Java,,54,54,461,569
InvalidValue.java,Java,,12,7,6,25
InvalidValueHelper.java,Java,,54,10,8,72
TypeMismatch.java,Java,,12,7,6,25
TypeMismatchHelper.java,Java,,54,10,8,72
DynAnySeqHelper.java,Java,,46,10,6,62
DynArray.java,Java,,4,4,11,19
DynArrayHelper.java,Java,,67,13,11,91
DynArrayOperations.java,Java,,8,8,29,45
DynEnum.java,Java,,4,4,10,18
DynEnumHelper.java,Java,,67,13,10,90
DynEnumOperations.java,Java,,8,8,30,46
DynFixed.java,Java,,4,4,11,19
DynFixedHelper.java,Java,,67,13,11,91
DynFixedOperations.java,Java,,6,6,26,38
DynSequence.java,Java,,4,4,9,17
DynSequenceHelper.java,Java,,67,13,9,89
DynSequenceOperations.java,Java,,10,10,57,77
DynStruct.java,Java,,4,4,10,18
DynStructHelper.java,Java,,67,13,10,90
DynStructOperations.java,Java,,10,10,66,86
DynUnion.java,Java,,4,4,16,24
DynUnionHelper.java,Java,,67,13,16,96
DynUnionOperations.java,Java,,13,13,75,101
DynValue.java,Java,,4,4,18,26
DynValueBox.java,Java,,4,4,13,21
DynValueBoxOperations.java,Java,,8,8,37,53
DynValueCommon.java,Java,,4,4,9,17
DynValueCommonOperations.java,Java,,7,7,20,34
DynValueHelper.java,Java,,67,13,18,98
DynValueOperations.java,Java,,10,10,80,100
FieldNameHelper.java,Java,,40,10,6,56
NameDynAnyPair.java,Java,,14,8,12,34
NameDynAnyPairHelper.java,Java,,67,10,6,83
NameDynAnyPairSeqHelper.java,Java,,46,10,6,62
NameValuePair.java,Java,,14,8,12,34
NameValuePairHelper.java,Java,,67,10,6,83
NameValuePairSeqHelper.java,Java,,46,10,6,62
_DynAnyFactoryStub.java,Java,,57,15,69,141
_DynAnyStub.java,Java,,537,159,462,1158
_DynArrayStub.java,Java,,578,171,418,1167
_DynEnumStub.java,Java,,578,171,419,1168
_DynFixedStub.java,Java,,558,165,415,1138
_DynSequenceStub.java,Java,,598,177,446,1221
_DynStructStub.java,Java,,598,177,455,1230
_DynUnionStub.java,Java,,628,186,464,1278
_DynValueStub.java,Java,,629,186,480,1295
Codec.java,Java,,4,4,17,25
CodecFactory.java,Java,,4,4,11,19
CodecFactoryHelper.java,Java,,55,13,11,79
CodecFactoryOperations.java,Java,,5,5,19,29
UnknownEncoding.java,Java,,12,7,6,25
UnknownEncodingHelper.java,Java,,54,10,8,72
CodecOperations.java,Java,,8,8,61,77
FormatMismatch.java,Java,,12,7,6,25
FormatMismatchHelper.java,Java,,54,10,8,72
InvalidTypeForEncoding.java,Java,,12,7,6,25
InvalidTypeForEncodingHelper.java,Java,,54,10,8,72
TypeMismatch.java,Java,,12,7,6,25
TypeMismatchHelper.java,Java,,54,10,8,72
CodeSets.java,Java,,5,4,11,20
ComponentIdHelper.java,Java,,40,11,10,61
Encoding.java,Java,,16,9,15,40
ENCODING_CDR_ENCAPS.java,Java,,5,4,10,19
ExceptionDetailMessage.java,Java,,5,4,26,35
IOR.java,Java,,14,8,11,33
IORHelper.java,Java,,72,10,6,88
IORHolder.java,Java,,24,8,6,38
MultipleComponentProfileHelper.java,Java,,46,11,7,64
MultipleComponentProfileHolder.java,Java,,24,10,7,41
ProfileIdHelper.java,Java,,40,11,7,58
RMICustomMaxStreamFormat.java,Java,,5,4,13,22
ServiceContext.java,Java,,14,8,8,30
ServiceContextHelper.java,Java,,71,10,6,87
ServiceContextHolder.java,Java,,24,8,6,38
ServiceContextListHelper.java,Java,,46,11,7,64
ServiceContextListHolder.java,Java,,24,10,7,41
ServiceIdHelper.java,Java,,40,11,7,58
TaggedComponent.java,Java,,14,8,8,30
TaggedComponentHelper.java,Java,,71,10,6,87
TaggedComponentHolder.java,Java,,24,8,6,38
TaggedProfile.java,Java,,14,8,8,30
TaggedProfileHelper.java,Java,,71,10,6,87
TaggedProfileHolder.java,Java,,24,8,6,38
TAG_ALTERNATE_IIOP_ADDRESS.java,Java,,5,4,32,41
TAG_CODE_SETS.java,Java,,5,4,16,25
TAG_INTERNET_IOP.java,Java,,5,4,31,40
TAG_JAVA_CODEBASE.java,Java,,5,4,19,28
TAG_MULTIPLE_COMPONENTS.java,Java,,5,4,17,26
TAG_ORB_TYPE.java,Java,,5,4,24,33
TAG_POLICIES.java,Java,,5,4,10,19
TAG_RMI_CUSTOM_MAX_STREAM_FORMAT.java,Java,,5,4,15,24
TransactionService.java,Java,,5,4,11,20
SyncScopeHelper.java,Java,,40,11,7,58
SYNC_WITH_TRANSPORT.java,Java,,5,4,10,19
ACTIVE.java,Java,,5,4,8,17
AdapterManagerIdHelper.java,Java,,40,11,12,63
AdapterNameHelper.java,Java,,42,11,9,62
AdapterStateHelper.java,Java,,40,11,9,60
ClientRequestInfo.java,Java,,4,4,220,228
ClientRequestInfoOperations.java,Java,,13,13,319,345
ClientRequestInterceptor.java,Java,,4,4,22,30
ClientRequestInterceptorOperations.java,Java,,9,9,175,193
Current.java,Java,,4,4,23,31
CurrentHelper.java,Java,,55,13,23,91
CurrentOperations.java,Java,,6,6,52,64
DISCARDING.java,Java,,5,4,8,17
ForwardRequest.java,Java,,19,9,9,37
ForwardRequestHelper.java,Java,,61,10,8,79
HOLDING.java,Java,,5,4,9,18
INACTIVE.java,Java,,5,4,9,18
Interceptor.java,Java,,4,4,9,17
InterceptorOperations.java,Java,,6,6,38,50
InvalidSlot.java,Java,,12,7,6,25
InvalidSlotHelper.java,Java,,54,10,8,72
IORInfo.java,Java,,4,4,14,22
IORInfoOperations.java,Java,,12,12,82,106
IORInterceptor.java,Java,,4,4,20,28
IORInterceptorOperations.java,Java,,5,5,40,50
IORInterceptor_3_0.java,Java,,4,3,6,13
IORInterceptor_3_0Helper.java,Java,,55,12,6,73
IORInterceptor_3_0Holder.java,Java,,24,8,6,38
IORInterceptor_3_0Operations.java,Java,,7,6,34,47
LOCATION_FORWARD.java,Java,,5,4,15,24
NON_EXISTENT.java,Java,,5,4,8,17
ObjectIdHelper.java,Java,,42,11,9,62
ObjectReferenceFactory.java,Java,,5,6,13,24
ObjectReferenceFactoryHelper.java,Java,,52,13,9,74
ObjectReferenceFactoryHolder.java,Java,,24,9,9,42
ObjectReferenceTemplate.java,Java,,7,7,13,27
ObjectReferenceTemplateHelper.java,Java,,52,13,13,78
ObjectReferenceTemplateHolder.java,Java,,24,9,13,46
ObjectReferenceTemplateSeqHelper.java,Java,,46,11,9,66
ObjectReferenceTemplateSeqHolder.java,Java,,24,10,9,43
ORBIdHelper.java,Java,,40,11,7,58
ORBInitializer.java,Java,,4,4,116,124
ORBInitializerOperations.java,Java,,6,6,144,156
ORBInitInfo.java,Java,,4,4,19,27
ORBInitInfoOperations.java,Java,,14,14,106,134
DuplicateName.java,Java,,19,9,9,37
DuplicateNameHelper.java,Java,,61,10,8,79
InvalidName.java,Java,,12,7,6,25
InvalidNameHelper.java,Java,,54,10,8,72
ObjectIdHelper.java,Java,,40,11,7,58
PolicyFactory.java,Java,,4,4,19,27
PolicyFactoryOperations.java,Java,,5,5,40,50
RequestInfo.java,Java,,4,4,21,29
RequestInfoOperations.java,Java,,18,18,256,292
ServerIdHelper.java,Java,,40,11,7,58
ServerRequestInfo.java,Java,,4,4,218,226
ServerRequestInfoOperations.java,Java,,15,15,306,336
ServerRequestInterceptor.java,Java,,4,4,22,30
ServerRequestInterceptorOperations.java,Java,,9,9,180,198
SUCCESSFUL.java,Java,,5,4,15,24
SYSTEM_EXCEPTION.java,Java,,5,4,15,24
TRANSPORT_RETRY.java,Java,,5,4,15,24
UNKNOWN.java,Java,,5,4,9,18
USER_EXCEPTION.java,Java,,5,4,15,24
AdapterActivator.java,Java,,4,4,13,21
AdapterActivatorOperations.java,Java,,5,5,26,36
Current.java,Java,,4,4,24,32
CurrentHelper.java,Java,,52,13,48,113
CurrentOperations.java,Java,,6,6,44,56
NoContext.java,Java,,12,7,6,25
NoContextHelper.java,Java,,54,10,8,72
DynamicImplementation.java,Java,,4,2,37,43
ForwardRequest.java,Java,,19,8,6,33
ForwardRequestHelper.java,Java,,61,10,8,79
IdAssignmentPolicy.java,Java,,4,4,11,19
IdAssignmentPolicyOperations.java,Java,,5,5,14,24
IdAssignmentPolicyValue.java,Java,,27,8,15,50
IdUniquenessPolicy.java,Java,,4,4,11,19
IdUniquenessPolicyOperations.java,Java,,5,5,14,24
IdUniquenessPolicyValue.java,Java,,27,8,13,48
ID_ASSIGNMENT_POLICY_ID.java,Java,,5,4,9,18
ID_UNIQUENESS_POLICY_ID.java,Java,,5,4,9,18
ImplicitActivationPolicy.java,Java,,4,4,10,18
ImplicitActivationPolicyOperations.java,Java,,5,5,13,23
ImplicitActivationPolicyValue.java,Java,,27,8,15,50
IMPLICIT_ACTIVATION_POLICY_ID.java,Java,,5,4,9,18
LifespanPolicy.java,Java,,4,4,11,19
LifespanPolicyOperations.java,Java,,5,5,14,24
LifespanPolicyValue.java,Java,,27,8,14,49
LIFESPAN_POLICY_ID.java,Java,,5,4,9,18
POA.java,Java,,4,4,16,24
POAHelper.java,Java,,50,11,40,101
POAManager.java,Java,,4,4,12,20
POAManagerOperations.java,Java,,9,9,60,78
AdapterInactive.java,Java,,12,7,6,25
AdapterInactiveHelper.java,Java,,54,10,8,72
State.java,Java,,31,8,9,48
POAOperations.java,Java,,36,36,395,467
AdapterAlreadyExists.java,Java,,12,7,6,25
AdapterAlreadyExistsHelper.java,Java,,54,10,8,72
AdapterNonExistent.java,Java,,12,7,6,25
AdapterNonExistentHelper.java,Java,,54,10,8,72
InvalidPolicy.java,Java,,19,8,6,33
InvalidPolicyHelper.java,Java,,61,10,8,79
NoServant.java,Java,,12,7,6,25
NoServantHelper.java,Java,,54,10,8,72
ObjectAlreadyActive.java,Java,,12,7,6,25
ObjectAlreadyActiveHelper.java,Java,,54,10,8,72
ObjectNotActive.java,Java,,12,7,6,25
ObjectNotActiveHelper.java,Java,,54,10,8,72
ServantAlreadyActive.java,Java,,12,7,6,25
ServantAlreadyActiveHelper.java,Java,,54,10,8,72
ServantNotActive.java,Java,,12,7,6,25
ServantNotActiveHelper.java,Java,,54,10,8,72
WrongAdapter.java,Java,,12,7,6,25
WrongAdapterHelper.java,Java,,54,10,8,72
WrongPolicy.java,Java,,12,7,6,25
WrongPolicyHelper.java,Java,,54,10,8,72
Delegate.java,Java,,13,10,92,115
RequestProcessingPolicy.java,Java,,4,4,11,19
RequestProcessingPolicyOperations.java,Java,,5,5,14,24
RequestProcessingPolicyValue.java,Java,,29,8,24,61
REQUEST_PROCESSING_POLICY_ID.java,Java,,5,4,9,18
Servant.java,Java,,80,18,168,266
ServantActivator.java,Java,,4,4,10,18
ServantActivatorHelper.java,Java,,67,13,10,90
ServantActivatorOperations.java,Java,,6,6,48,60
ServantActivatorPOA.java,Java,,34,13,12,59
ServantLocator.java,Java,,4,4,24,32
ServantLocatorHelper.java,Java,,67,13,24,104
ServantLocatorOperations.java,Java,,6,6,55,67
CookieHolder.java,Java,,18,8,31,57
ServantLocatorPOA.java,Java,,34,13,26,73
ServantManager.java,Java,,4,4,17,25
ServantManagerOperations.java,Java,,4,4,17,25
ServantRetentionPolicy.java,Java,,4,4,10,18
ServantRetentionPolicyOperations.java,Java,,5,5,13,23
ServantRetentionPolicyValue.java,Java,,27,8,14,49
SERVANT_RETENTION_POLICY_ID.java,Java,,5,4,9,18
ThreadPolicy.java,Java,,4,4,11,19
ThreadPolicyOperations.java,Java,,5,5,14,24
ThreadPolicyValue.java,Java,,27,8,13,48
THREAD_POLICY_ID.java,Java,,5,4,9,18
_ServantActivatorStub.java,Java,,58,15,49,122
_ServantLocatorStub.java,Java,,58,15,56,129
RunTime.java,Java,,4,2,37,43
RunTimeOperations.java,Java,,4,2,37,43
_Remote_Stub.java,Java,,11,6,44,61
Attr.java,Java,,11,9,284,304
DOMImplementationRegistry.java,Java,,209,23,197,429
CDATASection.java,Java,,3,3,77,83
CharacterData.java,Java,,23,10,149,182
Comment.java,Java,,3,3,53,59
Counter.java,Java,,6,6,55,67
CSS2Properties.java,Java,,370,126,1310,1806
CSSCharsetRule.java,Java,,7,5,68,80
CSSFontFaceRule.java,Java,,4,4,49,57
CSSImportRule.java,Java,,7,7,59,73
CSSMediaRule.java,Java,,12,8,85,105
CSSPageRule.java,Java,,8,6,59,73
CSSPrimitiveValue.java,Java,,47,13,265,325
CSSRule.java,Java,,17,9,100,126
CSSRuleList.java,Java,,5,5,62,72
CSSStyleDeclaration.java,Java,,19,13,159,191
CSSStyleRule.java,Java,,8,6,62,76
CSSStyleSheet.java,Java,,12,8,94,114
CSSUnknownRule.java,Java,,3,3,45,51
CSSValue.java,Java,,12,7,81,100
CSSValueList.java,Java,,5,5,65,75
DocumentCSS.java,Java,,7,5,67,79
DOMImplementationCSS.java,Java,,8,5,56,69
ElementCSSInlineStyle.java,Java,,4,4,53,61
Rect.java,Java,,7,7,59,73
RGBColor.java,Java,,6,6,64,76
ViewCSS.java,Java,,7,5,60,72
Document.java,Java,,53,30,761,844
DocumentFragment.java,Java,,3,3,76,82
DocumentType.java,Java,,9,9,94,112
DOMConfiguration.java,Java,,11,7,424,442
DOMError.java,Java,,12,10,94,116
DOMErrorHandler.java,Java,,4,4,66,74
DOMException.java,Java,,26,4,132,162
DOMImplementation.java,Java,,15,7,143,165
DOMImplementationList.java,Java,,5,5,62,72
DOMImplementationSource.java,Java,,5,5,78,88
DOMLocator.java,Java,,9,9,69,87
DOMStringList.java,Java,,6,6,67,79
Element.java,Java,,49,23,396,468
Entity.java,Java,,9,9,101,119
EntityReference.java,Java,,3,3,66,72
DocumentEvent.java,Java,,6,5,74,85
Event.java,Java,,18,14,138,170
EventException.java,Java,,9,4,52,65
EventListener.java,Java,,4,4,62,70
EventTarget.java,Java,,11,6,114,131
MouseEvent.java,Java,,29,15,141,185
MutationEvent.java,Java,,20,11,106,137
UIEvent.java,Java,,11,7,69,87
HTMLAnchorElement.java,Java,,29,17,94,140
HTMLAppletElement.java,Java,,25,14,92,131
HTMLAreaElement.java,Java,,19,11,77,107
HTMLBaseElement.java,Java,,7,5,50,62
HTMLBaseFontElement.java,Java,,9,6,56,71
HTMLBodyElement.java,Java,,15,9,73,97
HTMLBRElement.java,Java,,5,4,47,56
HTMLButtonElement.java,Java,,15,10,70,95
HTMLCollection.java,Java,,7,7,71,85
HTMLDirectoryElement.java,Java,,5,4,48,57
HTMLDivElement.java,Java,,5,4,47,56
HTMLDListElement.java,Java,,5,4,47,56
HTMLDocument.java,Java,,24,20,139,183
HTMLDOMImplementation.java,Java,,5,5,53,63
HTMLElement.java,Java,,14,9,71,94
HTMLFieldSetElement.java,Java,,4,4,48,56
HTMLFontElement.java,Java,,9,6,56,71
HTMLFormElement.java,Java,,19,13,83,115
HTMLFrameElement.java,Java,,21,13,80,114
HTMLFrameSetElement.java,Java,,7,5,51,63
HTMLHeadElement.java,Java,,5,4,47,56
HTMLHeadingElement.java,Java,,5,4,48,57
HTMLHRElement.java,Java,,11,7,60,78
HTMLHtmlElement.java,Java,,5,4,48,57
HTMLIFrameElement.java,Java,,25,15,87,127
HTMLImageElement.java,Java,,29,16,93,138
HTMLInputElement.java,Java,,41,25,159,225
HTMLIsIndexElement.java,Java,,6,5,52,63
HTMLLabelElement.java,Java,,8,6,56,70
HTMLLegendElement.java,Java,,8,6,57,71
HTMLLIElement.java,Java,,7,5,52,64
HTMLLinkElement.java,Java,,21,12,79,112
HTMLMapElement.java,Java,,6,5,50,61
HTMLMenuElement.java,Java,,5,4,48,57
HTMLMetaElement.java,Java,,11,7,59,77
HTMLModElement.java,Java,,7,5,52,64
HTMLObjectElement.java,Java,,40,23,125,188
HTMLOListElement.java,Java,,9,6,55,70
HTMLOptGroupElement.java,Java,,7,5,52,64
HTMLOptionElement.java,Java,,16,11,79,106
HTMLParagraphElement.java,Java,,5,4,47,56
HTMLParamElement.java,Java,,11,7,61,79
HTMLPreElement.java,Java,,5,4,47,56
HTMLQuoteElement.java,Java,,5,4,48,57
HTMLScriptElement.java,Java,,17,10,68,95
HTMLSelectElement.java,Java,,28,19,115,162
HTMLStyleElement.java,Java,,9,6,55,70
HTMLTableCaptionElement.java,Java,,5,4,47,56
HTMLTableCellElement.java,Java,,32,18,104,154
HTMLTableColElement.java,Java,,15,9,67,91
HTMLTableElement.java,Java,,40,26,151,217
HTMLTableRowElement.java,Java,,21,14,96,131
HTMLTableSectionElement.java,Java,,17,11,85,113
HTMLTextAreaElement.java,Java,,26,17,99,142
HTMLTitleElement.java,Java,,5,4,46,55
HTMLUListElement.java,Java,,7,5,51,63
DOMImplementationLS.java,Java,,12,9,130,151
LSException.java,Java,,10,4,62,76
LSInput.java,Java,,19,11,217,247
LSLoadEvent.java,Java,,7,6,51,64
LSOutput.java,Java,,11,7,117,135
LSParser.java,Java,,26,13,456,495
LSParserFilter.java,Java,,12,8,181,201
LSProgressEvent.java,Java,,7,7,63,77
LSResourceResolver.java,Java,,8,4,98,110
LSSerializer.java,Java,,19,10,436,465
LSSerializerFilter.java,Java,,5,5,82,92
NamedNodeMap.java,Java,,18,11,183,212
NameList.java,Java,,9,8,80,97
Node.java,Java,,74,39,840,953
NodeList.java,Java,,5,5,60,70
Notation.java,Java,,5,5,59,69
ProcessingInstruction.java,Java,,7,5,68,80
DocumentRange.java,Java,,4,4,54,62
Range.java,Java,,61,29,355,445
RangeException.java,Java,,10,4,54,68
DocumentStyle.java,Java,,4,4,55,63
LinkStyle.java,Java,,4,4,52,60
MediaList.java,Java,,13,9,92,114
StyleSheet.java,Java,,12,11,109,132
StyleSheetList.java,Java,,5,5,61,71
Text.java,Java,,9,7,171,187
DocumentTraversal.java,Java,,15,6,101,122
NodeFilter.java,Java,,21,7,145,173
NodeIterator.java,Java,,14,11,113,138
TreeWalker.java,Java,,19,16,173,208
TypeInfo.java,Java,,12,7,195,214
UserDataHandler.java,Java,,13,5,83,101
AbstractView.java,Java,,4,4,48,56
DocumentView.java,Java,,4,4,51,59
XPathEvaluator.java,Java,,15,8,139,162
XPathException.java,Java,,10,4,54,68
XPathExpression.java,Java,,9,6,80,95
XPathNamespace.java,Java,,7,7,80,94
XPathNSResolver.java,Java,,4,5,55,64
XPathResult.java,Java,,31,15,195,241
AttributeList.java,Java,,9,22,186,217
Attributes.java,Java,,16,35,230,281
ContentHandler.java,Java,,27,26,390,443
DocumentHandler.java,Java,,18,21,217,256
DTDHandler.java,Java,,12,9,120,141
EntityResolver.java,Java,,7,9,127,143
ErrorHandler.java,Java,,9,12,142,163
Attributes2.java,Java,,11,10,135,156
Attributes2Impl.java,Java,,129,47,156,332
DeclHandler.java,Java,,18,14,138,170
DefaultHandler2.java,Java,,55,25,74,154
EntityResolver2.java,Java,,17,7,197,221
LexicalHandler.java,Java,,20,19,197,236
Locator2.java,Java,,7,6,86,99
Locator2Impl.java,Java,,26,16,83,125
HandlerBase.java,Java,,61,43,289,393
AttributeListImpl.java,Java,,90,44,202,336
AttributesImpl.java,Java,,255,75,311,641
DefaultHandler.java,Java,,86,52,353,491
LocatorImpl.java,Java,,51,37,150,238
NamespaceSupport.java,Java,,280,93,477,850
NewInstance.java,Java,,24,6,57,87
ParserAdapter.java,Java,,452,143,476,1071
ParserFactory.java,Java,,31,11,105,147
SecuritySupport.java,Java,,63,12,33,108
XMLFilterImpl.java,Java,,255,107,375,737
XMLReaderAdapter.java,Java,,178,86,298,562
XMLReaderFactory.java,Java,,88,19,137,244
InputSource.java,Java,,65,37,258,360
Locator.java,Java,,7,14,139,160
Parser.java,Java,,16,20,197,233
SAXException.java,Java,,48,25,115,188
SAXNotRecognizedException.java,Java,,13,9,57,79
SAXNotSupportedException.java,Java,,13,8,58,79
SAXParseException.java,Java,,73,36,204,313
XMLFilter.java,Java,,6,9,74,89
XMLReader.java,Java,,25,41,362,428
