ImageFormatException.java,Java,,10,4,38,52
JPEGCodec.java,Java,,49,13,88,150
JPEGDecodeParam.java,Java,,62,45,262,369
JPEGEncodeParam.java,Java,,27,20,209,256
JPEGHuffmanTable.java,Java,,139,31,71,241
JPEGImageDecoder.java,Java,,23,14,103,140
JPEGImageEncoder.java,Java,,29,23,178,230
JPEGQTable.java,Java,,62,20,68,150
TruncatedFileException.java,Java,,19,8,55,82
MotifBorders.java,Java,,498,125,93,716
MotifButtonListener.java,Java,,14,8,24,46
MotifButtonUI.java,Java,,54,21,33,108
MotifCheckBoxMenuItemUI.java,Java,,72,25,12,109
MotifCheckBoxUI.java,Java,,26,13,23,62
MotifComboBoxRenderer.java,Java,,44,17,33,94
MotifComboBoxUI.java,Java,,269,44,38,351
MotifDesktopIconUI.java,Java,,248,52,28,328
MotifDesktopPaneUI.java,Java,,103,19,24,146
MotifEditorPaneUI.java,Java,,13,7,31,51
MotifFileChooserUI.java,Java,,485,116,58,659
MotifGraphicsUtils.java,Java,,306,61,73,440
MotifIconFactory.java,Java,,355,58,36,449
MotifInternalFrameTitlePane.java,Java,,324,52,18,394
MotifInternalFrameUI.java,Java,,133,29,40,202
MotifLabelUI.java,Java,,11,4,18,33
MotifLookAndFeel.java,Java,,881,124,52,1057
MotifMenuBarUI.java,Java,,23,8,20,51
MotifMenuItemUI.java,Java,,71,23,11,105
MotifMenuMouseListener.java,Java,,17,2,10,29
MotifMenuMouseMotionListener.java,Java,,11,3,10,24
MotifMenuUI.java,Java,,93,25,25,143
MotifOptionPaneUI.java,Java,,49,13,33,95
MotifPasswordFieldUI.java,Java,,13,10,31,54
MotifPopupMenuSeparatorUI.java,Java,,27,9,11,47
MotifPopupMenuUI.java,Java,,62,15,21,98
MotifProgressBarUI.java,Java,,13,6,20,39
MotifRadioButtonMenuItemUI.java,Java,,75,23,18,116
MotifRadioButtonUI.java,Java,,33,15,29,77
MotifScrollBarButton.java,Java,,154,25,14,193
MotifScrollBarUI.java,Java,,54,18,18,90
MotifScrollPaneUI.java,Java,,53,16,17,86
MotifSeparatorUI.java,Java,,16,9,19,44
MotifSliderUI.java,Java,,82,29,30,141
MotifSplitPaneDivider.java,Java,,181,36,59,276
MotifSplitPaneUI.java,Java,,18,6,23,47
MotifTabbedPaneUI.java,Java,,194,34,22,250
MotifTextAreaUI.java,Java,,13,5,33,51
MotifTextFieldUI.java,Java,,13,5,31,49
MotifTextPaneUI.java,Java,,13,7,31,51
MotifTextUI.java,Java,,73,15,76,164
MotifToggleButtonUI.java,Java,,52,18,29,99
MotifTreeCellRenderer.java,Java,,51,16,27,94
MotifTreeUI.java,Java,,74,24,45,143
WindowsBorders.java,Java,,56,18,9,83
WindowsButtonListener.java,Java,,12,8,30,50
WindowsButtonUI.java,Java,,51,16,31,98
WindowsCheckBoxMenuItemUI.java,Java,,5,6,14,25
WindowsCheckBoxUI.java,Java,,28,14,26,68
WindowsComboBoxUI.java,Java,,123,26,22,171
WindowsDesktopIconUI.java,Java,,5,6,14,25
WindowsDesktopManager.java,Java,,81,18,50,149
WindowsDesktopPaneUI.java,Java,,49,12,18,79
WindowsEditorPaneUI.java,Java,,14,7,28,49
WindowsFileChooserUI.java,Java,,770,183,111,1064
WindowsIconFactory.java,Java,,324,63,41,428
WindowsInternalFrameUI.java,Java,,16,8,14,38
WindowsLabelUI.java,Java,,5,6,14,25
WindowsListUI.java,Java,,5,6,4,15
WindowsLookAndFeel.java,Java,,623,78,69,770
WindowsMenuBarUI.java,Java,,5,6,14,25
WindowsMenuItemUI.java,Java,,5,6,14,25
WindowsMenuUI.java,Java,,5,6,14,25
WindowsOptionPaneUI.java,Java,,5,6,14,25
WindowsPasswordFieldUI.java,Java,,13,9,28,50
WindowsPopupMenuUI.java,Java,,5,6,14,25
WindowsProgressBarUI.java,Java,,11,6,17,34
WindowsRadioButtonMenuItemUI.java,Java,,5,6,14,25
WindowsRadioButtonUI.java,Java,,36,14,23,73
WindowsScrollBarUI.java,Java,,5,6,14,25
WindowsScrollPaneUI.java,Java,,5,6,14,25
WindowsSeparatorUI.java,Java,,5,6,4,15
WindowsSliderUI.java,Java,,9,7,14,30
WindowsSpinnerUI.java,Java,,5,6,4,15
WindowsSplitPaneDivider.java,Java,,23,7,23,53
WindowsSplitPaneUI.java,Java,,18,10,20,48
WindowsStandardDialogUI.java,Java,,5,6,4,15
WindowsTabbedPaneUI.java,Java,,5,6,14,25
WindowsTableHeaderUI.java,Java,,5,6,4,15
WindowsTableUI.java,Java,,5,6,4,15
WindowsTextAreaUI.java,Java,,13,8,28,49
WindowsTextFieldUI.java,Java,,36,12,57,105
WindowsTextPaneUI.java,Java,,14,6,28,48
WindowsTextUI.java,Java,,139,15,63,217
WindowsToggleButtonUI.java,Java,,44,18,23,85
WindowsToolBarUI.java,Java,,5,6,4,15
WindowsTreeUI.java,Java,,52,17,37,106
WindowsUtils.java,Java,,9,4,14,27
FactoryEnumeration.java,Java,,49,11,30,90
NamedWeakReference.java,Java,,11,8,10,29
ResourceManager.java,Java,,261,53,226,540
VersionHelper.java,Java,,80,22,49,151
VersionHelper12.java,Java,,174,29,30,233
Applet.java,Java,,128,34,345,507
AppletContext.java,Java,,15,9,97,121
AppletStub.java,Java,,10,7,72,89
AudioClip.java,Java,,6,4,24,34
ActiveEvent.java,Java,,4,3,33,40
Adjustable.java,Java,,21,22,77,120
AlphaComposite.java,Java,,93,36,231,360
AlphaCompositeContext.java,Java,,88,24,31,143
AttributeValue.java,Java,,21,5,6,32
AWTError.java,Java,,7,4,19,30
AWTEvent.java,Java,,196,51,178,425
AWTEventMulticaster.java,Java,,320,76,399,795
AWTException.java,Java,,7,4,21,32
AWTPermission.java,Java,,13,9,118,140
BasicStroke.java,Java,,255,55,254,564
BorderLayout.java,Java,,258,46,377,681
Button.java,Java,[PENDING:  WDW -- need to provide a localized string,195,52,318,565
Canvas.java,Java,,44,15,79,138
CardLayout.java,Java,,220,31,211,462
Checkbox.java,Java,,256,65,378,699
CheckboxGroup.java,Java,,32,9,87,128
CheckboxMenuItem.java,Java,,175,49,295,519
Choice.java,Java,,264,67,346,677
CMMException.java,Java,,6,7,26,39
ColorSpace.java,Java,,107,71,270,448
ICC_ColorSpace.java,Java,,127,54,344,525
ICC_Profile.java,Java,,799,343,710,1852
ICC_ProfileGray.java,Java,,25,18,84,127
ICC_ProfileRGB.java,Java,,73,34,120,227
ProfileDataException.java,Java,,6,4,11,21
Color.java,Java,,452,68,607,1127
ColorPaintContext.java,Java,,35,12,4,51
Component.java,Java,,2495,424,2561,5480
ComponentOrientation.java,Java,,53,16,104,173
Composite.java,Java,,7,5,55,67
CompositeContext.java,Java,,9,8,33,50
Conditional.java,Java,,4,2,12,18
Container.java,Java,,1390,207,941,2538
Cursor.java,Java,,189,64,127,380
Clipboard.java,Java,,22,13,33,68
ClipboardOwner.java,Java,,4,5,17,26
DataFlavor.java,Java,,430,133,394,957
FlavorMap.java,Java,,6,8,57,71
MimeType.java,Java,,168,42,124,334
MimeTypeParameterList.java,Java,,238,55,87,380
MimeTypeParseException.java,Java,,10,6,18,34
StringSelection.java,Java,,38,11,63,112
SystemFlavorMap.java,Java,,166,74,59,299
Transferable.java,Java,,7,8,34,49
UnsupportedFlavorException.java,Java,,7,5,21,33
Dialog.java,Java,,217,49,291,557
Dimension.java,Java,,56,20,127,203
Autoscroll.java,Java,,7,9,45,61
DnDConstants.java,Java,,10,14,42,66
DragGestureEvent.java,Java,,55,49,123,227
DragGestureListener.java,Java,,5,8,26,39
DragGestureRecognizer.java,Java,,75,58,266,399
DragSource.java,Java,,106,76,284,466
DragSourceContext.java,Java,,148,86,203,437
DragSourceDragEvent.java,Java,,23,25,69,117
DragSourceDropEvent.java,Java,,18,23,51,92
DragSourceEvent.java,Java,,9,10,23,42
DragSourceListener.java,Java,,11,21,102,134
DropTarget.java,Java,,261,167,308,736
DropTargetContext.java,Java,,131,85,187,403
DropTargetDragEvent.java,Java,,44,37,88,169
DropTargetDropEvent.java,Java,,60,49,126,235
DropTargetEvent.java,Java,,17,13,32,62
DropTargetListener.java,Java,,12,22,73,107
InvalidDnDOperationException.java,Java,,6,12,21,39
MouseDragGestureRecognizer.java,Java,,34,34,108,176
DragSourceContextPeer.java,Java,,19,15,27,61
DropTargetContextPeer.java,Java,,23,30,47,100
DropTargetPeer.java,Java,,6,8,26,40
ActionEvent.java,Java,,40,19,110,169
ActionListener.java,Java,,5,5,24,34
AdjustmentEvent.java,Java,,64,20,88,172
AdjustmentListener.java,Java,,5,5,14,24
AWTEventListener.java,Java,,6,5,32,43
ComponentAdapter.java,Java,,7,5,42,54
ComponentEvent.java,Java,,45,14,76,135
ComponentListener.java,Java,,8,6,42,56
ContainerAdapter.java,Java,,5,3,36,44
ContainerEvent.java,Java,,36,13,77,126
ContainerListener.java,Java,,6,5,37,48
FocusAdapter.java,Java,,5,3,36,44
FocusEvent.java,Java,,35,14,90,139
FocusListener.java,Java,,6,5,32,43
HierarchyBoundsAdapter.java,Java,,6,3,33,42
HierarchyBoundsListener.java,Java,,6,4,33,43
HierarchyEvent.java,Java,,85,19,163,267
HierarchyListener.java,Java,,5,3,30,38
InputEvent.java,Java,,53,26,109,188
InputMethodEvent.java,Java,,107,27,141,275
InputMethodListener.java,Java,,6,7,24,37
InvocationEvent.java,Java,,59,17,113,189
ItemEvent.java,Java,,51,18,93,162
ItemListener.java,Java,,5,5,28,38
KeyAdapter.java,Java,,6,4,41,51
KeyEvent.java,Java,,525,128,504,1157
KeyListener.java,Java,,7,6,37,50
MouseAdapter.java,Java,,8,6,51,65
MouseEvent.java,Java,,88,25,226,339
MouseListener.java,Java,,9,8,47,64
MouseMotionAdapter.java,Java,,5,3,45,53
MouseMotionListener.java,Java,,6,6,41,53
NativeLibLoader.java,Java,,7,3,29,39
PaintEvent.java,Java,,36,13,58,107
TextEvent.java,Java,,23,13,50,86
TextListener.java,Java,,5,5,28,38
WindowAdapter.java,Java,,10,8,54,72
WindowEvent.java,Java,,50,17,90,157
WindowListener.java,Java,,11,9,61,81
Event.java,Java,,228,106,461,795
EventDispatchThread.java,Java,,116,29,86,231
EventQueue.java,Java,,308,54,210,572
FileDialog.java,Java,,110,27,190,327
FlowLayout.java,Java,,189,37,263,489
FontRenderContext.java,Java,,33,11,76,120
GlyphJustificationInfo.java,Java,,60,23,109,192
GlyphMetrics.java,Java,,48,25,171,244
GlyphVector.java,Java,,35,27,351,413
GraphicAttribute.java,Java,,43,21,107,171
ImageGraphicAttribute.java,Java,,68,36,105,209
LineBreakMeasurer.java,Java,,106,32,345,483
LineMetrics.java,Java,,14,16,96,126
MultipleMaster.java,Java,,15,10,62,87
OpenType.java,Java,,61,64,289,414
ShapeGraphicAttribute.java,Java,,82,35,106,223
TextAttribute.java,Java,,78,72,722,872
TextHitInfo.java,Java,,54,18,155,227
TextJustifier.java,Java,,146,26,48,220
TextLayout.java,Java,,1182,348,1032,2562
TextLine.java,Java,,898,276,138,1312
TextMeasurer.java,Java,,256,87,144,487
TransformAttribute.java,Java,,15,12,32,59
Font.java,Java,,745,152,832,1729
FontFormatException.java,Java,,7,2,16,25
FontMetrics.java,Java,,133,36,392,561
Frame.java,Java,,309,73,427,809
AffineTransform.java,Java,,1678,133,1165,2976
Arc2D.java,Java,,582,111,673,1366
ArcIterator.java,Java,,151,10,62,223
Area.java,Java,,307,37,247,591
CubicCurve2D.java,Java,,674,112,849,1635
CubicIterator.java,Java,,66,9,62,137
Dimension2D.java,Java,,18,7,63,88
Ellipse2D.java,Java,,136,33,236,405
EllipseIterator.java,Java,,100,12,62,174
FlatteningPathIterator.java,Java,,184,36,156,376
GeneralPath.java,Java,,274,37,307,618
GeneralPathIterator.java,Java,,51,10,78,139
IllegalPathStateException.java,Java,,8,4,25,37
Line2D.java,Java,,289,72,633,994
LineIterator.java,Java,,58,9,62,129
NoninvertibleTransformException.java,Java,,6,3,18,27
PathIterator.java,Java,,15,13,167,195
Point2D.java,Java,,112,32,224,368
QuadCurve2D.java,Java,,499,98,679,1276
QuadIterator.java,Java,,62,9,62,133
Rectangle2D.java,Java,,326,65,607,998
RectangularShape.java,Java,,101,28,222,351
RectIterator.java,Java,,66,9,62,137
RoundRectangle2D.java,Java,,213,49,351,613
RoundRectIterator.java,Java,,92,11,67,170
GradientPaint.java,Java,,77,17,126,220
GradientPaintContext.java,Java,,153,20,42,215
Graphics.java,Java,,163,57,952,1172
Graphics2D.java,Java,,98,47,1023,1168
GraphicsCallback.java,Java,,108,13,4,125
GraphicsConfigTemplate.java,Java,,14,11,65,90
GraphicsConfiguration.java,Java,,17,16,188,221
GraphicsDevice.java,Java,,17,12,112,141
GraphicsEnvironment.java,Java,,37,16,114,167
GridBagConstraints.java,Java,,75,34,302,411
GridBagLayout.java,Java,,561,127,643,1331
GridLayout.java,Java,,142,23,249,414
IllegalComponentStateException.java,Java,,10,4,24,38
InputContext.java,Java,,39,18,210,267
InputMethodHighlight.java,Java,,45,21,107,173
InputMethodRequests.java,Java,,15,11,163,189
InputSubset.java,Java,,24,15,56,95
InputMethod.java,Java,,23,22,311,356
InputMethodContext.java,Java,,12,7,57,76
InputMethodDescriptor.java,Java,,11,10,83,104
AffineTransformOp.java,Java,,265,36,218,519
AreaAveragingScaleFilter.java,Java,,151,11,80,242
BandCombineOp.java,Java,,124,15,118,257
BandedSampleModel.java,Java,,279,76,310,665
BufferedImage.java,Java,,688,130,629,1447
BufferedImageFilter.java,Java,,260,15,119,394
BufferedImageOp.java,Java,,12,7,63,82
ByteLookupTable.java,Java,,79,13,99,191
ColorConvertOp.java,Java,,685,84,265,1034
ColorModel.java,Java,,668,83,939,1690
ComponentColorModel.java,Java,,771,74,580,1425
ComponentSampleModel.java,Java,,458,99,372,929
ConvolveOp.java,Java,,134,31,139,304
CropImageFilter.java,Java,,77,8,74,159
DataBuffer.java,Java,,127,40,160,327
DataBufferByte.java,Java,,63,18,120,201
DataBufferInt.java,Java,,63,19,118,200
DataBufferShort.java,Java,,63,19,117,199
DataBufferUShort.java,Java,,94,21,119,234
DirectColorModel.java,Java,,599,53,605,1257
FilteredImageSource.java,Java,,60,10,59,129
ImageConsumer.java,Java,,22,18,134,174
ImageFilter.java,Java,,52,13,143,208
ImageObserver.java,Java,,14,11,126,151
ImageProducer.java,Java,,8,6,67,81
ImagingOpException.java,Java,,6,4,16,26
IndexColorModel.java,Java,,645,77,600,1322
Kernel.java,Java,,59,19,62,140
LookupOp.java,Java,,331,52,122,505
LookupTable.java,Java,,25,10,46,81
MemoryImageSource.java,Java,,215,24,231,470
MultiPixelPackedSampleModel.java,Java,,226,61,312,599
PackedColorModel.java,Java,,222,33,219,474
PixelGrabber.java,Java,,308,28,282,618
PixelInterleavedSampleModel.java,Java,,64,6,75,145
Raster.java,Java,,604,140,674,1418
RasterFormatException.java,Java,,6,4,15,25
RasterOp.java,Java,,11,7,54,72
ContextualRenderedImageFactory.java,Java,,15,9,89,113
ParameterBlock.java,Java,,189,50,303,542
RenderableImage.java,Java,,18,15,135,168
RenderableImageOp.java,Java,,121,29,170,320
RenderableImageProducer.java,Java,,93,19,87,199
RenderContext.java,Java,,61,22,159,242
RenderedImageFactory.java,Java,,7,4,47,58
RenderedImage.java,Java,,27,25,116,168
ReplicateScaleFilter.java,Java,,115,16,101,232
RescaleOp.java,Java,,348,63,193,604
RGBImageFilter.java,Java,,101,13,142,256
SampleModel.java,Java,,402,134,549,1085
ShortLookupTable.java,Java,,79,13,86,178
SinglePixelPackedSampleModel.java,Java,,294,78,295,667
TileObserver.java,Java,,6,4,25,35
WritableRaster.java,Java,,204,36,341,581
WritableRenderedImage.java,Java,,13,13,95,121
Image.java,Java,,32,14,142,188
Insets.java,Java,,45,14,92,151
ItemSelectable.java,Java,,7,7,29,43
JobAttributes.java,Java,,443,68,510,1021
Label.java,Java,,111,33,158,302
LayoutManager.java,Java,,8,5,40,53
LayoutManager2.java,Java,,8,7,53,68
List.java,Java,[FIXME,597,153,981,1731
MediaTracker.java,Java,,390,56,463,909
Menu.java,Java,,236,58,277,571
MenuBar.java,Java,,197,41,221,459
MenuComponent.java,Java,,298,91,521,910
MenuContainer.java,Java,,6,3,14,23
MenuItem.java,Java,[PENDING:  WDW -- need to provide a localized string,271,69,439,779
MenuShortcut.java,Java,,52,12,74,138
PageAttributes.java,Java,,521,52,780,1353
Paint.java,Java,,12,6,40,58
PaintContext.java,Java,,12,7,42,61
Panel.java,Java,,37,13,61,111
ButtonPeer.java,Java,,5,3,11,19
CanvasPeer.java,Java,,4,2,11,17
CheckboxMenuItemPeer.java,Java,,4,1,11,16
CheckboxPeer.java,Java,,7,2,11,20
ChoicePeer.java,Java,,9,3,14,26
ComponentPeer.java,Java,,44,13,32,89
ContainerPeer.java,Java,,8,3,14,25
DialogPeer.java,Java,,6,5,11,22
FileDialogPeer.java,Java,,8,3,11,22
FontPeer.java,Java,,3,2,11,16
FramePeer.java,Java,,10,5,11,26
LabelPeer.java,Java,,7,2,11,20
LightweightPeer.java,Java,,3,3,19,25
ListPeer.java,Java,,19,7,26,52
MenuBarPeer.java,Java,,7,2,11,20
MenuComponentPeer.java,Java,,4,1,11,16
MenuItemPeer.java,Java,,7,4,17,28
MenuPeer.java,Java,,7,2,11,20
PanelPeer.java,Java,,4,2,11,17
PopupMenuPeer.java,Java,,5,2,11,18
RobotPeer.java,Java,,12,5,15,32
ScrollbarPeer.java,Java,,6,1,11,18
ScrollPanePeer.java,Java,,11,2,11,24
TextAreaPeer.java,Java,,12,6,23,41
TextComponentPeer.java,Java,,16,2,11,29
TextFieldPeer.java,Java,,10,5,20,35
WindowPeer.java,Java,,12,5,11,28
Point.java,Java,,54,18,128,200
Polygon.java,Java,,244,51,306,601
PopupMenu.java,Java,,76,18,80,174
Book.java,Java,,66,27,111,204
Pageable.java,Java,,9,7,48,64
PageFormat.java,Java,,141,58,140,339
Paper.java,Java,,53,25,109,187
Printable.java,Java,,8,7,51,66
PrinterAbortException.java,Java,,9,6,20,35
PrinterException.java,Java,,8,6,19,33
PrinterGraphics.java,Java,,4,5,18,27
PrinterIOException.java,Java,,12,8,26,46
PrinterJob.java,Java,,48,26,149,223
PrintGraphics.java,Java,,4,4,14,22
PrintJob.java,Java,,11,9,41,61
Rectangle.java,Java,,243,54,475,772
RenderingHints.java,Java,,203,71,390,664
Robot.java,Java,,189,42,171,402
Scrollbar.java,Java,,296,72,667,1035
ScrollPane.java,Java,,398,92,312,802
Shape.java,Java,,17,12,276,305
Stroke.java,Java,,4,6,43,53
SystemColor.java,Java,,109,64,211,384
TextArea.java,Java,,211,59,327,597
TextComponent.java,Java,,439,88,525,1052
TextField.java,Java,,212,54,370,636
TexturePaint.java,Java,,47,13,61,121
TexturePaintContext.java,Java,,622,39,51,712
Toolkit.java,Java,,595,151,931,1677
Transparency.java,Java,,7,6,27,40
Window.java,Java,,706,119,544,1369
AppletInitializer.java,Java,,7,10,54,71
BeanContext.java,Java,,16,13,85,114
BeanContextChild.java,Java,,13,12,94,119
BeanContextChildComponentProxy.java,Java,,5,6,24,35
BeanContextChildSupport.java,Java,,100,57,169,326
BeanContextContainerProxy.java,Java,,5,5,23,33
BeanContextEvent.java,Java,,19,19,55,93
BeanContextMembershipEvent.java,Java,,28,24,63,115
BeanContextMembershipListener.java,Java,,7,7,28,42
BeanContextProxy.java,Java,,4,4,58,66
BeanContextServiceAvailableEvent.java,Java,,19,17,33,69
BeanContextServiceProvider.java,Java,,7,9,69,85
BeanContextServiceProviderBeanInfo.java,Java,,5,5,17,27
BeanContextServiceRevokedEvent.java,Java,,20,18,46,84
BeanContextServiceRevokedListener.java,Java,,6,7,16,29
BeanContextServices.java,Java,,17,17,105,139
BeanContextServicesListener.java,Java,,7,4,15,26
BeanContextServicesSupport.java,Java,,615,313,280,1208
BeanContextSupport.java,Java,,597,260,519,1376
BeanDescriptor.java,Java,,28,10,40,78
BeanInfo.java,Java,,15,15,121,151
Beans.java,Java,,299,89,243,631
Customizer.java,Java,,6,8,32,46
DesignMode.java,Java,,6,9,55,70
EventSetDescriptor.java,Java,,154,37,147,338
FeatureDescriptor.java,Java,,144,33,136,313
IndexedPropertyDescriptor.java,Java,,246,45,126,417
IntrospectionException.java,Java,,7,4,18,29
Introspector.java,Java,,959,156,351,1466
MethodDescriptor.java,Java,,41,14,46,101
ParameterDescriptor.java,Java,,8,6,19,33
PropertyChangeEvent.java,Java,,29,13,80,122
PropertyChangeListener.java,Java,,4,6,14,24
PropertyChangeSupport.java,Java,,162,39,122,323
PropertyDescriptor.java,Java,,343,61,180,584
PropertyEditor.java,Java,,15,25,144,184
PropertyEditorManager.java,Java,,90,19,78,187
PropertyEditorSupport.java,Java,,81,33,129,243
PropertyVetoException.java,Java,,12,8,24,44
SimpleBeanInfo.java,Java,,54,14,58,126
VetoableChangeListener.java,Java,,5,2,17,24
VetoableChangeSupport.java,Java,,162,40,133,335
Visibility.java,Java,,7,8,32,47
BufferedInputStream.java,Java,,133,25,242,400
BufferedOutputStream.java,Java,,44,9,75,128
BufferedReader.java,Java,,263,37,203,503
BufferedWriter.java,Java,,105,24,119,248
ByteArrayInputStream.java,Java,,76,19,173,268
ByteArrayOutputStream.java,Java,,73,21,130,224
CharArrayReader.java,Java,,96,17,79,192
CharArrayWriter.java,Java,,83,16,74,173
CharConversionException.java,Java,,10,1,19,30
DataInput.java,Java,,19,16,452,487
DataInputStream.java,Java,,184,30,348,562
DataOutput.java,Java,,18,15,298,331
DataOutputStream.java,Java,,135,25,217,377
EOFException.java,Java,,10,3,35,48
Externalizable.java,Java,,7,4,67,78
File.java,Java,,380,82,949,1411
FileDescriptor.java,Java,,21,12,80,113
FileFilter.java,Java,,4,5,21,30
FileInputStream.java,Java,,55,18,174,247
FilenameFilter.java,Java,,5,2,27,34
FileNotFoundException.java,Java,,14,8,40,62
FileOutputStream.java,Java,,68,21,178,267
FilePermission.java,Java,,295,89,343,727
FileReader.java,Java,,12,8,39,59
FileSystem.java,Java,,33,43,120,196
FileWriter.java,Java,,15,9,46,70
FilterInputStream.java,Java,,35,12,174,221
FilterOutputStream.java,Java,,31,9,103,143
FilterReader.java,Java,,32,15,58,105
FilterWriter.java,Java,,23,12,52,87
InputStream.java,Java,,68,20,256,344
InputStreamReader.java,Java,,139,30,109,278
InterruptedIOException.java,Java,,11,4,38,53
InvalidClassException.java,Java,,17,5,37,59
InvalidObjectException.java,Java,,6,2,21,29
IOException.java,Java,,10,3,27,40
LineNumberInputStream.java,Java,,96,19,157,272
LineNumberReader.java,Java,,100,23,103,226
NotActiveException.java,Java,,9,3,19,31
NotSerializableException.java,Java,,9,3,21,33
ObjectInput.java,Java,,11,8,69,88
ObjectInputStream.java,Java,,1350,254,1307,2911
ObjectInputValidation.java,Java,,4,2,20,26
ObjectOutput.java,Java,,10,7,54,71
ObjectOutputStream.java,Java,,1139,226,1125,2490
ObjectStreamClass.java,Java,,916,181,617,1714
ObjectStreamConstants.java,Java,,32,34,138,204
ObjectStreamException.java,Java,,9,3,19,31
ObjectStreamField.java,Java,,141,30,120,291
OptionalDataException.java,Java,,13,4,35,52
OutputStream.java,Java,,24,7,98,129
OutputStreamWriter.java,Java,,124,21,116,261
PipedInputStream.java,Java,,134,20,169,323
PipedOutputStream.java,Java,,53,11,93,157
PipedReader.java,Java,,144,23,136,303
PipedWriter.java,Java,,53,14,90,157
PrintStream.java,Java,,236,46,281,563
PrintWriter.java,Java,,211,48,252,511
PushbackInputStream.java,Java,,106,19,181,306
PushbackReader.java,Java,,102,20,106,228
RandomAccessFile.java,Java,,229,59,660,948
Reader.java,Java,,56,19,143,218
SequenceInputStream.java,Java,,79,14,106,199
Serializable.java,Java,,3,2,97,102
SerializablePermission.java,Java,,16,11,82,109
StreamCorruptedException.java,Java,,9,3,20,32
StreamTokenizer.java,Java,,367,52,382,801
StringBufferInputStream.java,Java,,53,11,88,152
StringReader.java,Java,,77,16,74,167
StringWriter.java,Java,,52,18,65,135
SyncFailedException.java,Java,,6,2,19,27
UnsupportedEncodingException.java,Java,,11,2,18,31
UTFDataFormatException.java,Java,,10,3,30,43
WriteAbortedException.java,Java,,14,4,30,48
Writer.java,Java,,48,17,107,172
AbstractMethodError.java,Java,,10,3,24,37
ArithmeticException.java,Java,,10,3,23,36
ArrayIndexOutOfBoundsException.java,Java,,13,4,29,46
ArrayStoreException.java,Java,,10,4,26,40
Boolean.java,Java,,45,15,116,176
Byte.java,Java,,101,31,180,312
Character.java,Java,,971,70,867,1908
Class.java,Java,,250,105,1049,1404
ClassCastException.java,Java,,10,3,26,39
ClassCircularityError.java,Java,,9,3,20,32
ClassFormatError.java,Java,,10,3,22,35
ClassLoader.java,Java,,662,87,694,1443
ClassNotFoundException.java,Java,,44,12,81,137
Cloneable.java,Java,,3,3,21,27
CloneNotSupportedException.java,Java,,10,4,30,44
Comparable.java,Java,,4,3,100,107
Compiler.java,Java,,40,10,59,109
Double.java,Java,,87,35,454,576
Error.java,Java,,10,3,30,43
Exception.java,Java,,10,3,22,35
ExceptionInInitializerError.java,Java,,43,13,72,128
Float.java,Java,,88,36,437,561
FloatingDecimal.java,Java,,1428,100,718,2246
IllegalAccessError.java,Java,,9,3,25,37
IllegalAccessException.java,Java,,9,3,33,45
IllegalArgumentException.java,Java,,10,3,23,36
IllegalMonitorStateException.java,Java,,10,3,28,41
IllegalStateException.java,Java,,10,3,25,38
IllegalThreadStateException.java,Java,,9,3,26,38
IncompatibleClassChangeError.java,Java,,10,3,23,36
IndexOutOfBoundsException.java,Java,,10,3,24,37
InheritableThreadLocal.java,Java,,19,7,60,86
InstantiationError.java,Java,,10,5,25,40
InstantiationException.java,Java,,10,3,24,37
Integer.java,Java,,286,63,528,877
InternalError.java,Java,,10,3,21,34
InterruptedException.java,Java,,10,3,28,41
LinkageError.java,Java,,10,3,23,36
Long.java,Java,,223,45,525,793
Math.java,Java,,131,43,609,783
NegativeArraySizeException.java,Java,,10,3,21,34
NoClassDefFoundError.java,Java,,10,3,27,40
NoSuchFieldError.java,Java,,10,3,25,38
NoSuchFieldException.java,Java,,9,3,19,31
NoSuchMethodError.java,Java,,10,3,26,39
NoSuchMethodException.java,Java,,10,3,19,32
NullPointerException.java,Java,,10,3,33,46
Number.java,Java,,14,8,70,92
NumberFormatException.java,Java,,10,3,23,36
Object.java,Java,,36,17,413,466
OutOfMemoryError.java,Java,,10,3,22,35
Package.java,Java,,262,35,216,513
Process.java,Java,,11,8,105,124
Finalizer.java,Java,,129,19,29,177
FinalReference.java,Java,,6,6,5,17
PhantomReference.java,Java,,9,7,42,58
Reference.java,Java,,71,29,105,205
ReferenceQueue.java,Java,,61,14,46,121
SoftReference.java,Java,,18,10,65,93
WeakReference.java,Java,,9,7,35,51
AccessibleObject.java,Java,,36,10,89,135
Array.java,Java,,56,29,380,465
Constructor.java,Java,,78,13,146,237
Field.java,Java,,96,31,496,623
InvocationHandler.java,Java,,5,3,68,76
InvocationTargetException.java,Java,,45,13,50,108
Member.java,Java,,9,8,40,57
Method.java,Java,,94,15,169,278
Modifier.java,Java,,71,34,124,229
Proxy.java,Java,,168,38,424,630
ReflectPermission.java,Java,,10,5,59,74
UndeclaredThrowableException.java,Java,,42,10,63,115
Runnable.java,Java,,5,2,42,49
Runtime.java,Java,,147,36,616,799
RuntimeException.java,Java,,10,3,27,40
RuntimePermission.java,Java,,15,8,257,280
SecurityException.java,Java,,9,2,21,32
SecurityManager.java,Java,,359,73,1269,1701
Short.java,Java,,104,30,181,315
Shutdown.java,Java,,136,34,64,234
StackOverflowError.java,Java,,10,3,21,34
StrictMath.java,Java,,101,44,581,726
String.java,Java,,778,115,1303,2196
StringBuffer.java,Java,,306,55,722,1083
StringIndexOutOfBoundsException.java,Java,,13,4,33,50
System.java,Java,,172,41,653,866
Thread.java,Java,,286,77,788,1151
ThreadDeath.java,Java,,2,3,28,33
ThreadGroup.java,Java,,439,43,448,930
ThreadLocal.java,Java,,242,62,274,578
Throwable.java,Java,,44,15,171,230
UnknownError.java,Java,,10,3,21,34
UnsatisfiedLinkError.java,Java,,10,3,22,35
UnsupportedClassVersionError.java,Java,,10,3,21,34
UnsupportedOperationException.java,Java,,8,3,20,31
VerifyError.java,Java,,10,3,21,34
VirtualMachineError.java,Java,,10,3,22,35
Void.java,Java,,6,4,19,29
BigDecimal.java,Java,,297,81,569,947
BigInteger.java,Java,,1532,370,1110,3012
BitSieve.java,Java,,86,20,89,195
MutableBigInteger.java,Java,,838,182,333,1353
SignedMutableBigInteger.java,Java,,44,18,56,118
Authenticator.java,Java,,70,24,125,219
BindException.java,Java,,7,5,21,33
ConnectException.java,Java,,7,3,22,32
ContentHandler.java,Java,,14,6,70,90
ContentHandlerFactory.java,Java,,4,2,29,35
DatagramPacket.java,Java,,81,23,184,288
DatagramSocket.java,Java,,232,33,353,618
DatagramSocketImpl.java,Java,,26,21,102,149
DatagramSocketImplFactory.java,Java,,5,2,20,27
FileNameMap.java,Java,,4,3,18,25
HttpURLConnection.java,Java,,153,75,333,561
InetAddress.java,Java,,354,76,313,743
JarURLConnection.java,Java,,55,25,220,300
MalformedURLException.java,Java,,9,4,22,35
MulticastSocket.java,Java,,106,17,246,369
NetPermission.java,Java,,15,8,91,114
NoRouteToHostException.java,Java,,7,3,22,32
PasswordAuthentication.java,Java,,15,9,39,63
PlainDatagramSocketImpl.java,Java,,95,28,75,198
PlainSocketImpl.java,Java,,401,90,145,636
ProtocolException.java,Java,,10,4,21,35
ServerSocket.java,Java,,104,22,227,353
Socket.java,Java,,212,40,455,707
SocketException.java,Java,,10,4,21,35
SocketImpl.java,Java,,49,24,161,234
SocketImplFactory.java,Java,,5,2,22,29
SocketInputStream.java,Java,,82,16,68,166
SocketOptions.java,Java,,15,26,229,270
SocketOutputStream.java,Java,,48,13,53,114
SocketPermission.java,Java,,510,155,420,1085
UnknownHostException.java,Java,,10,4,21,35
UnknownServiceException.java,Java,,9,4,24,37
URL.java,Java,,379,88,567,1034
URLClassLoader.java,Java,,319,35,210,564
URLConnection.java,Java,,420,90,855,1365
URLDecoder.java,Java,,34,7,35,76
URLEncoder.java,Java,,67,9,40,116
URLStreamHandler.java,Java,,236,36,177,449
URLStreamHandlerFactory.java,Java,,4,2,26,32
AccessException.java,Java,,10,5,36,51
Activatable.java,Java,,161,28,318,507
ActivateFailedException.java,Java,,10,5,28,43
ActivationDesc.java,Java,,99,22,200,321
ActivationException.java,Java,,47,11,58,116
ActivationGroup.java,Java,,179,36,308,523
ActivationGroupDesc.java,Java,,121,31,187,339
ActivationGroupID.java,Java,,26,9,61,96
ActivationID.java,Java,,76,18,102,196
ActivationInstantiator.java,Java,,8,5,44,57
ActivationMonitor.java,Java,,15,9,66,90
ActivationSystem.java,Java,,32,14,157,203
Activator.java,Java,,9,4,81,94
UnknownGroupException.java,Java,,7,4,30,41
UnknownObjectException.java,Java,,7,4,32,43
AlreadyBoundException.java,Java,,10,4,29,43
ConnectException.java,Java,,10,5,28,43
ConnectIOException.java,Java,,10,6,29,45
DGC.java,Java,,9,4,82,95
Lease.java,Java,,19,6,32,57
VMID.java,Java,,83,18,56,157
MarshalException.java,Java,,10,5,37,52
MarshalledObject.java,Java,,106,28,155,289
Naming.java,Java,,127,26,138,291
NoSuchObjectException.java,Java,,7,4,32,43
NotBoundException.java,Java,,10,4,31,45
LocateRegistry.java,Java,,64,15,112,191
Registry.java,Java,,15,8,96,119
RegistryHandler.java,Java,,8,5,38,51
Remote.java,Java,,2,2,27,31
RemoteException.java,Java,,47,11,63,121
RMISecurityException.java,Java,,10,4,29,43
RMISecurityManager.java,Java,,6,4,29,39
ExportException.java,Java,,10,6,33,49
LoaderHandler.java,Java,,11,7,54,72
LogStream.java,Java,,107,25,99,231
ObjID.java,Java,,71,19,92,182
Operation.java,Java,,13,5,32,50
RemoteCall.java,Java,,16,10,79,105
RemoteObject.java,Java,,81,15,111,207
RemoteRef.java,Java,,19,14,152,185
RemoteServer.java,Java,,41,9,48,98
RemoteStub.java,Java,,13,5,36,54
RMIClassLoader.java,Java,,33,9,110,152
RMIClientSocketFactory.java,Java,,7,4,37,48
RMIFailureHandler.java,Java,,4,5,33,42
RMIServerSocketFactory.java,Java,,7,4,37,48
RMISocketFactory.java,Java,,52,12,94,158
ServerCloneException.java,Java,,46,10,56,112
ServerNotActiveException.java,Java,,9,5,28,42
ServerRef.java,Java,,8,6,33,47
Skeleton.java,Java,,7,3,38,48
SkeletonMismatchException.java,Java,,8,6,27,41
SkeletonNotFoundException.java,Java,,11,6,33,50
SocketSecurityException.java,Java,,10,6,35,51
UID.java,Java,,85,17,86,188
UnicastRemoteObject.java,Java,,113,26,137,276
Unreferenced.java,Java,,4,2,20,26
ServerError.java,Java,,7,4,24,35
ServerException.java,Java,,10,5,29,44
ServerRuntimeException.java,Java,,7,4,26,37
StubNotFoundException.java,Java,,10,5,33,48
UnexpectedException.java,Java,,10,5,30,45
UnknownHostException.java,Java,,10,5,28,43
UnmarshalException.java,Java,,10,5,42,57
AccessControlContext.java,Java,,311,96,206,613
AccessControlException.java,Java,,14,8,40,62
AccessController.java,Java,,43,23,331,397
Acl.java,Java,,16,28,190,234
AclEntry.java,Java,,15,15,102,132
AclNotFoundException.java,Java,,5,4,13,22
Group.java,Java,,9,9,49,67
LastOwnerException.java,Java,,5,3,15,23
NotOwnerException.java,Java,,5,3,14,22
Owner.java,Java,,9,7,59,75
Permission.java,Java,,5,6,23,34
AlgorithmParameterGenerator.java,Java,,65,17,157,239
AlgorithmParameterGeneratorSpi.java,Java,,9,7,51,67
AlgorithmParameters.java,Java,,95,20,198,313
AlgorithmParametersSpi.java,Java,,19,11,101,131
AllPermission.java,Java,,67,31,119,217
BasicPermission.java,Java,,136,53,201,390
Certificate.java,Java,,89,19,140,248
CertificateEncodingException.java,Java,,9,4,23,36
CertificateException.java,Java,,10,5,22,37
CertificateExpiredException.java,Java,,9,4,25,38
CertificateFactory.java,Java,,118,19,255,392
CertificateFactorySpi.java,Java,,16,8,156,180
CertificateNotYetValidException.java,Java,,9,4,25,38
CertificateParsingException.java,Java,,9,4,24,37
CRL.java,Java,,12,8,49,69
CRLException.java,Java,,10,5,22,37
X509Certificate.java,Java,,31,22,368,421
X509CRL.java,Java,,67,23,274,364
X509CRLEntry.java,Java,,40,13,83,136
X509Extension.java,Java,,8,8,151,167
Certificate.java,Java,,14,11,109,134
CodeSource.java,Java,,216,42,215,473
DigestException.java,Java,,9,4,22,35
DigestInputStream.java,Java,,41,18,114,173
DigestOutputStream.java,Java,,39,16,101,156
DomainCombiner.java,Java,,5,3,82,90
GeneralSecurityException.java,Java,,9,5,27,41
Guard.java,Java,,4,4,29,37
GuardedObject.java,Java,,24,10,47,81
Identity.java,Java,,178,42,254,474
IdentityScope.java,Java,,67,26,139,232
DSAKey.java,Java,,4,3,24,31
DSAKeyPairGenerator.java,Java,,8,5,77,90
DSAParams.java,Java,,7,6,32,45
DSAPrivateKey.java,Java,,6,8,27,41
DSAPublicKey.java,Java,,6,8,27,41
RSAKey.java,Java,,5,5,20,30
RSAPrivateCrtKey.java,Java,,10,10,44,64
RSAPrivateKey.java,Java,,6,4,18,28
RSAPublicKey.java,Java,,6,4,16,26
InvalidAlgorithmParameterException.java,Java,,10,5,30,45
InvalidKeyException.java,Java,,9,6,23,38
InvalidParameterException.java,Java,,9,5,23,37
Key.java,Java,,7,8,93,108
KeyException.java,Java,,9,5,25,39
KeyFactory.java,Java,,56,16,167,239
KeyFactorySpi.java,Java,,13,9,98,120
KeyManagementException.java,Java,,9,5,33,47
KeyPair.java,Java,,16,8,36,60
KeyPairGenerator.java,Java,,91,25,311,427
KeyPairGeneratorSpi.java,Java,,11,7,69,87
KeyStore.java,Java,,197,31,417,645
KeyStoreException.java,Java,,9,5,25,39
KeyStoreSpi.java,Java,,34,20,213,267
MessageDigest.java,Java,,187,38,241,466
MessageDigestSpi.java,Java,,35,12,105,152
NoSuchAlgorithmException.java,Java,,9,5,24,38
NoSuchProviderException.java,Java,,9,5,23,37
Permission.java,Java,,30,22,159,211
PermissionCollection.java,Java,,29,11,124,164
Permissions.java,Java,,167,60,184,411
Policy.java,Java,,60,18,139,217
Principal.java,Java,,7,6,40,53
PrivateKey.java,Java,,4,3,26,33
PrivilegedAction.java,Java,,4,4,28,36
PrivilegedActionException.java,Java,,40,11,60,111
PrivilegedExceptionAction.java,Java,,4,5,33,42
ProtectionDomain.java,Java,,29,12,54,95
Provider.java,Java,,100,33,220,353
ProviderException.java,Java,,9,5,23,37
PublicKey.java,Java,,4,3,23,30
SecureClassLoader.java,Java,,74,17,92,183
SecureRandom.java,Java,,126,29,299,454
SecureRandomSpi.java,Java,,6,6,36,48
Security.java,Java,,637,121,484,1242
SecurityPermission.java,Java,,15,8,260,283
Signature.java,Java,,239,61,406,706
SignatureException.java,Java,,9,6,22,37
SignatureSpi.java,Java,,53,25,208,286
SignedObject.java,Java,,57,15,166,238
Signer.java,Java,,58,17,86,161
AlgorithmParameterSpec.java,Java,,2,3,20,25
DSAParameterSpec.java,Java,,22,9,39,70
DSAPrivateKeySpec.java,Java,,27,10,50,87
DSAPublicKeySpec.java,Java,,27,10,50,87
EncodedKeySpec.java,Java,,11,7,44,62
InvalidKeySpecException.java,Java,,10,6,27,43
InvalidParameterSpecException.java,Java,,10,6,29,45
KeySpec.java,Java,,2,3,38,43
PKCS8EncodedKeySpec.java,Java,,12,6,54,72
RSAKeyGenParameterSpec.java,Java,,19,10,38,67
RSAPrivateCrtKeySpec.java,Java,,46,14,66,126
RSAPrivateKeySpec.java,Java,,16,8,28,52
RSAPublicKeySpec.java,Java,,16,8,28,52
X509EncodedKeySpec.java,Java,,12,6,44,62
UnrecoverableKeyException.java,Java,,9,5,21,35
UnresolvedPermission.java,Java,,217,37,175,429
UnresolvedPermissionCollection.java,Java,,49,16,43,108
Array.java,Java,,15,16,274,305
BatchUpdateException.java,Java,,29,10,119,158
Blob.java,Java,,8,10,96,114
CallableStatement.java,Java,,40,39,411,490
Clob.java,Java,,9,9,102,120
Connection.java,Java,,37,41,359,437
DatabaseMetaData.java,Java,,222,203,2040,2465
DataTruncation.java,Java,,38,15,73,126
Date.java,Java,,77,25,114,216
Driver.java,Java,,11,12,105,128
DriverManager.java,Java,,247,71,252,570
DriverPropertyInfo.java,Java,,12,9,41,62
PreparedStatement.java,Java,,54,51,504,609
Ref.java,Java,,4,4,40,48
ResultSet.java,Java,,162,164,2050,2376
ResultSetMetaData.java,Java,,27,28,193,248
SQLData.java,Java,,6,6,77,89
SQLException.java,Java,,65,14,78,157
SQLInput.java,Java,,25,29,208,262
SQLOutput.java,Java,,25,29,218,272
SQLPermission.java,Java,,10,9,84,103
SQLWarning.java,Java,,32,11,55,98
Statement.java,Java,,31,35,403,469
Struct.java,Java,,6,8,62,76
Time.java,Java,,77,22,110,209
Timestamp.java,Java,,207,29,136,372
Types.java,Java,,32,39,167,238
Annotation.java,Java,,13,8,42,63
AttributedCharacterIterator.java,Java,,53,28,135,216
AttributedString.java,Java,,638,115,198,951
BreakIterator.java,Java,,82,27,350,459
CharacterBreakData.java,Java,,159,23,136,318
CharacterIterator.java,Java,,15,17,142,174
ChoiceFormat.java,Java,,243,35,286,564
CollationElementIterator.java,Java,,268,43,247,558
CollationKey.java,Java,,45,17,127,189
CollationRules.java,Java,,205,11,37,253
Collator.java,Java,,117,30,336,483
CompactByteArray.java,Java,,196,18,122,336
CompactCharArray.java,Java,,198,23,122,343
CompactIntArray.java,Java,,180,27,117,324
CompactShortArray.java,Java,,244,36,162,442
CompactStringArray.java,Java,,306,13,119,438
DateFormat.java,Java,,191,39,426,656
DateFormatSymbols.java,Java,,231,51,288,570
DecimalFormat.java,Java,,1053,171,1032,2256
DecimalFormatSymbols.java,Java,,200,63,277,540
DigitList.java,Java,,275,55,254,584
EntryPair.java,Java,,15,4,21,40
FieldPosition.java,Java,,43,14,90,147
Format.java,Java,,28,7,171,206
IntHashtable.java,Java,,179,34,94,307
LineBreakData.java,Java,,292,15,195,502
MergeCollation.java,Java,,187,32,105,324
MessageFormat.java,Java,,519,53,395,967
Normalizer.java,Java,,1647,109,268,2024
NumberFormat.java,Java,,218,61,525,804
ParseException.java,Java,,12,6,41,59
ParsePosition.java,Java,,38,12,68,118
PatternEntry.java,Java,,205,29,52,286
RBCollationTables.java,Java,,121,30,118,269
RBTableBuilder.java,Java,,266,55,163,484
DateFormatZoneData.java,Java,,594,16,67,677
DateFormatZoneData_en.java,Java,,9,3,41,53
LocaleData.java,Java,,150,17,60,227
LocaleElements.java,Java,,489,6,44,539
LocaleElements_en.java,Java,,15,6,39,60
LocaleElements_en_US.java,Java,,25,6,34,65
RuleBasedCollator.java,Java,,255,43,458,756
SentenceBreakData.java,Java,,215,33,187,435
SimpleDateFormat.java,Java,,745,89,502,1336
SimpleTextBoundary.java,Java,,199,33,108,340
SpecialMapping.java,Java,,17,6,43,66
StringCharacterIterator.java,Java,,129,26,103,258
TextBoundaryData.java,Java,,259,10,26,295
UnicodeClassMapping.java,Java,,43,8,40,91
Utility.java,Java,,273,31,140,444
WordBreakData.java,Java,,289,40,178,507
WordBreakTable.java,Java,,31,9,51,91
AbstractCollection.java,Java,,122,27,300,449
AbstractList.java,Java,,324,74,445,843
AbstractMap.java,Java,,200,41,328,569
AbstractSequentialList.java,Java,,52,14,187,253
AbstractSet.java,Java,,40,11,91,142
ArrayList.java,Java,,196,52,280,528
Arrays.java,Java,,999,211,1060,2270
BitSet.java,Java,,194,56,248,498
Calendar.java,Java,,467,112,1055,1634
Collection.java,Java,,18,24,306,348
Collections.java,Java,,944,209,795,1948
Comparator.java,Java,,5,4,123,132
ConcurrentModificationException.java,Java,,8,3,40,51
Date.java,Java,,405,47,730,1182
Dictionary.java,Java,,13,9,114,136
EmptyStackException.java,Java,,6,2,17,25
Enumeration.java,Java,,5,3,54,62
EventListener.java,Java,,3,2,8,13
EventObject.java,Java,,15,7,32,54
GregorianCalendar.java,Java,,797,194,987,1978
HashMap.java,Java,,463,97,287,847
HashSet.java,Java,,71,24,149,244
Hashtable.java,Java,,516,107,390,1013
Iterator.java,Java,,6,4,50,60
Attributes.java,Java,,221,57,309,587
JarEntry.java,Java,,26,8,52,86
JarException.java,Java,,9,3,19,31
JarFile.java,Java,,165,26,127,318
JarInputStream.java,Java,,88,16,77,181
JarOutputStream.java,Java,,58,10,60,128
JarVerifier.java,Java,,251,62,86,399
Manifest.java,Java,,241,35,110,386
LinkedList.java,Java,,312,69,303,684
List.java,Java,,28,41,428,497
ListIterator.java,Java,,12,13,132,157
ListResourceBundle.java,Java,,59,13,120,192
Locale.java,Java,,510,113,602,1225
Map.java,Java,,24,27,312,363
MissingResourceException.java,Java,,17,9,48,74
NoSuchElementException.java,Java,,10,3,26,39
Observable.java,Java,,45,15,131,191
Observer.java,Java,,4,1,23,28
Properties.java,Java,,257,39,287,583
PropertyPermission.java,Java,,218,86,248,552
PropertyResourceBundle.java,Java,,46,11,89,146
Random.java,Java,,81,24,328,433
ResourceBundle.java,Java,,400,58,515,973
Set.java,Java,,18,26,228,272
SimpleTimeZone.java,Java,,586,94,772,1452
SortedMap.java,Java,,9,8,201,218
SortedSet.java,Java,,9,8,200,217
Stack.java,Java,,34,13,69,116
StringTokenizer.java,Java,,108,23,180,311
Timer.java,Java,,190,36,335,561
TimerTask.java,Java,,27,14,98,139
TimeZone.java,Java,,960,56,1325,2341
TooManyListenersException.java,Java,,9,8,35,52
TreeMap.java,Java,,891,168,606,1665
TreeSet.java,Java,,107,35,326,468
Vector.java,Java,,322,72,593,987
WeakHashMap.java,Java,,188,66,189,443
Adler32.java,Java,,35,11,36,82
CheckedInputStream.java,Java,,42,8,42,92
CheckedOutputStream.java,Java,,23,7,35,65
Checksum.java,Java,,8,5,28,41
CRC32.java,Java,,34,11,34,79
DataFormatException.java,Java,,10,3,18,31
Deflater.java,Java,,151,32,170,353
DeflaterOutputStream.java,Java,,69,13,66,148
GZIPInputStream.java,Java,,115,18,82,215
GZIPOutputStream.java,Java,,56,13,60,129
Inflater.java,Java,,121,22,146,289
InflaterInputStream.java,Java,,109,18,86,213
ZipConstants.java,Java,,43,7,29,79
ZipEntry.java,Java,,148,33,149,330
ZipException.java,Java,,11,6,22,39
ZipFile.java,Java,,287,43,133,463
ZipInputStream.java,Java,,264,21,109,394
ZipOutputStream.java,Java,,331,24,120,475
Accessible.java,Java,,4,3,24,31
AccessibleAction.java,Java,,6,5,46,57
AccessibleBundle.java,Java,,49,13,61,123
AccessibleComponent.java,Java,,32,30,234,296
AccessibleContext.java,Java,,112,50,456,618
AccessibleHyperlink.java,Java,,15,13,94,122
AccessibleHypertext.java,Java,,10,8,44,62
AccessibleIcon.java,Java,,7,7,48,62
AccessibleRelation.java,Java,,51,21,149,221
AccessibleRelationSet.java,Java,,105,16,92,213
AccessibleResourceBundle.java,Java,,89,5,41,135
AccessibleRole.java,Java,,109,71,352,532
AccessibleSelection.java,Java,,10,9,76,95
AccessibleState.java,Java,,62,32,224,318
AccessibleStateSet.java,Java,,86,14,79,179
AccessibleTable.java,Java,,25,26,149,200
AccessibleTableModelChange.java,Java,,11,10,60,81
AccessibleText.java,Java,,21,19,123,163
AccessibleValue.java,Java,,7,7,59,73
AuthenticationException.java,Java,,10,5,41,56
AuthenticationNotSupportedException.java,Java,,10,5,46,61
BinaryRefAddr.java,Java,,50,13,101,164
Binding.java,Java,,40,15,126,181
CannotProceedException.java,Java,,42,21,204,267
CommunicationException.java,Java,,10,4,33,47
CompositeName.java,Java,,128,34,454,616
CompoundName.java,Java,,121,30,449,600
ConfigurationException.java,Java,,10,4,39,53
Context.java,Java,,51,49,980,1080
ContextNotEmptyException.java,Java,,10,4,39,53
Attribute.java,Java,,26,22,273,321
AttributeInUseException.java,Java,,11,5,32,48
AttributeModificationException.java,Java,,26,12,83,121
Attributes.java,Java,,16,15,133,164
BasicAttribute.java,Java,,269,51,217,537
BasicAttributes.java,Java,,169,45,143,357
DirContext.java,Java,,71,35,908,1014
InitialDirContext.java,Java,,165,38,60,263
InvalidAttributeIdentifierException.java,Java,,11,6,30,47
InvalidAttributesException.java,Java,,11,6,36,53
InvalidAttributeValueException.java,Java,,11,6,34,51
InvalidSearchControlsException.java,Java,,11,6,31,48
InvalidSearchFilterException.java,Java,,11,6,31,48
ModificationItem.java,Java,,37,14,64,115
NoSuchAttributeException.java,Java,,11,7,29,47
SchemaViolationException.java,Java,,11,6,41,58
SearchControls.java,Java,,70,26,221,317
SearchResult.java,Java,,34,14,122,170
EventContext.java,Java,,15,12,203,230
EventDirContext.java,Java,,15,6,119,140
NamespaceChangeListener.java,Java,,6,5,61,72
NamingEvent.java,Java,,52,20,209,281
NamingExceptionEvent.java,Java,,19,9,47,75
NamingListener.java,Java,,4,2,40,46
ObjectChangeListener.java,Java,,4,3,47,54
InitialContext.java,Java,,175,48,262,485
InsufficientResourcesException.java,Java,,10,5,38,53
InterruptedNamingException.java,Java,,10,5,42,57
InvalidNameException.java,Java,,10,5,38,53
Control.java,Java,,8,7,62,77
ControlFactory.java,Java,,27,13,98,138
ExtendedRequest.java,Java,,8,7,114,129
ExtendedResponse.java,Java,,5,6,69,80
HasControls.java,Java,,5,5,41,51
InitialLdapContext.java,Java,,60,19,107,186
LdapContext.java,Java,,17,11,304,332
LdapReferralException.java,Java,,18,9,112,139
UnsolicitedNotification.java,Java,,6,5,34,45
UnsolicitedNotificationEvent.java,Java,,16,8,41,65
UnsolicitedNotificationListener.java,Java,,5,4,40,49
LimitExceededException.java,Java,,11,7,37,55
LinkException.java,Java,,63,23,199,285
LinkLoopException.java,Java,,10,5,33,48
LinkRef.java,Java,,21,7,69,97
MalformedLinkException.java,Java,,10,6,32,48
Name.java,Java,,19,19,211,249
NameAlreadyBoundException.java,Java,,10,5,39,54
NameClassPair.java,Java,,38,16,161,215
NameImpl.java,Java,,518,81,101,700
NameNotFoundException.java,Java,,10,5,31,46
NameParser.java,Java,,4,3,31,38
NamingEnumeration.java,Java,,7,5,116,128
NamingException.java,Java,,125,25,255,405
NamingSecurityException.java,Java,,10,5,37,52
NoInitialContextException.java,Java,,10,4,42,56
NoPermissionException.java,Java,,10,4,31,45
NotContextException.java,Java,,10,5,39,54
OperationNotSupportedException.java,Java,,10,5,33,48
PartialResultException.java,Java,,10,5,32,47
RefAddr.java,Java,,36,12,84,132
Reference.java,Java,,109,29,238,376
Referenceable.java,Java,,4,2,33,39
ReferralException.java,Java,,16,11,156,183
ServiceUnavailableException.java,Java,,10,5,34,49
SizeLimitExceededException.java,Java,,11,6,33,50
ContinuationContext.java,Java,,169,34,12,215
ContinuationDirContext.java,Java,,244,52,18,314
DirectoryManager.java,Java,,119,30,166,315
DirObjectFactory.java,Java,,9,4,99,112
DirStateFactory.java,Java,,19,10,139,168
InitialContextFactory.java,Java,,7,4,42,53
InitialContextFactoryBuilder.java,Java,,7,3,41,51
NamingManager.java,Java,,294,82,469,845
ObjectFactory.java,Java,,7,5,142,154
ObjectFactoryBuilder.java,Java,,7,3,45,55
Resolver.java,Java,,9,7,58,74
ResolveResult.java,Java,,62,12,106,180
StateFactory.java,Java,,8,2,109,119
StringRefAddr.java,Java,,12,5,50,67
TimeLimitExceededException.java,Java,,11,6,33,50
AbstractAction.java,Java,,306,42,177,525
AbstractActionPropertyChangeListener.java,Java,,46,10,23,79
AbstractButton.java,Java,,1145,173,1016,2334
AbstractCellEditor.java,Java,,47,14,72,133
AbstractListModel.java,Java,,56,17,76,149
Action.java,Java,,20,9,153,182
ActionMap.java,Java,,134,21,73,228
AncestorNotifier.java,Java,,142,30,41,213
AppContext.java,Java,,61,16,155,232
Autoscroller.java,Java,,73,17,8,98
AbstractBorder.java,Java,,36,10,36,82
BevelBorder.java,Java,,123,38,114,275
Border.java,Java,,11,4,56,71
CompoundBorder.java,Java,,66,16,71,153
EmptyBorder.java,Java,,38,10,48,96
EtchedBorder.java,Java,,65,22,99,186
LineBorder.java,Java,,68,17,72,157
MatteBorder.java,Java,,126,26,85,237
SoftBevelBorder.java,Java,,64,19,58,141
TitledBorder.java,Java,,379,63,187,629
BorderFactory.java,Java,,127,30,342,499
BoundedRangeModel.java,Java,,18,30,199,247
Box.java,Java,,94,36,281,411
BoxLayout.java,Java,,165,34,204,403
ButtonGroup.java,Java,,55,13,74,142
ButtonModel.java,Java,,27,25,154,206
CellEditor.java,Java,,12,10,87,109
CellRendererPane.java,Java,,87,35,93,215
AbstractColorChooserPanel.java,Java,,52,18,77,147
CenterLayout.java,Java,,41,9,10,60
ColorChooserComponentFactory.java,Java,,14,10,19,43
ColorSelectionModel.java,Java,,10,6,30,46
DefaultColorSelectionModel.java,Java,,43,15,35,93
DefaultHSBChooserPanel.java,Java,,557,159,24,740
DefaultPreviewPanel.java,Java,,139,49,18,206
DefaultRGBChooserPanel.java,Java,,148,48,31,227
DefaultSwatchChooserPanel.java,Java,,489,66,21,576
JIntegerTextField.java,Java,,130,36,10,176
SmartGridLayout.java,Java,,94,48,13,155
SyntheticImage.java,Java,,98,8,33,139
ComboBoxEditor.java,Java,,11,8,18,37
ComboBoxModel.java,Java,,5,4,16,25
ComponentInputMap.java,Java,,43,7,48,98
DebugGraphics.java,Java,,1036,176,234,1446
DebugGraphicsFilter.java,Java,,13,5,9,27
DebugGraphicsInfo.java,Java,,32,9,10,51
DebugGraphicsObserver.java,Java,,19,6,9,34
DefaultBoundedRangeModel.java,Java,,137,48,172,357
DefaultButtonModel.java,Java,,176,55,229,460
DefaultCellEditor.java,Java,,141,43,70,254
DefaultComboBoxModel.java,Java,,96,25,44,165
DefaultDesktopManager.java,Java,,425,114,109,648
DefaultFocusManager.java,Java,,267,52,55,374
DefaultListCellRenderer.java,Java,,76,29,117,222
DefaultListModel.java,Java,,140,42,335,517
DefaultListSelectionModel.java,Java,,314,79,225,618
DefaultPopupFactory.java,Java,,771,149,325,1245
DefaultSingleSelectionModel.java,Java,,48,20,52,120
DesktopManager.java,Java,,19,11,67,97
AncestorEvent.java,Java,,25,7,50,82
AncestorListener.java,Java,,10,8,34,52
CaretEvent.java,Java,,9,7,35,51
CaretListener.java,Java,,5,5,16,26
CellEditorListener.java,Java,,7,7,13,27
ChangeEvent.java,Java,,7,4,24,35
ChangeListener.java,Java,,5,5,15,25
DocumentEvent.java,Java,,28,20,116,164
DocumentListener.java,Java,,7,5,47,59
EventListenerList.java,Java,,112,16,136,264
HyperlinkEvent.java,Java,,40,18,74,132
HyperlinkListener.java,Java,,5,5,15,25
InternalFrameAdapter.java,Java,,10,8,43,61
InternalFrameEvent.java,Java,,49,18,76,143
InternalFrameListener.java,Java,,11,9,48,68
ListDataEvent.java,Java,,20,11,52,83
ListDataListener.java,Java,,7,9,31,47
ListSelectionEvent.java,Java,,29,10,54,93
ListSelectionListener.java,Java,,6,8,17,31
MenuDragMouseEvent.java,Java,,24,7,50,81
MenuDragMouseListener.java,Java,,8,5,34,47
MenuEvent.java,Java,,7,4,26,37
MenuKeyEvent.java,Java,,23,7,46,76
MenuKeyListener.java,Java,,7,7,20,34
MenuListener.java,Java,,7,5,25,37
MouseInputAdapter.java,Java,,11,7,22,40
MouseInputListener.java,Java,,5,5,11,21
PopupMenuEvent.java,Java,,7,2,24,33
PopupMenuListener.java,Java,,7,6,20,33
SwingPropertyChangeSupport.java,Java,,122,26,73,221
TableColumnModelEvent.java,Java,,15,10,41,66
TableColumnModelListener.java,Java,,12,9,20,41
TableModelEvent.java,Java,,38,18,100,156
TableModelListener.java,Java,,6,5,16,27
TreeExpansionEvent.java,Java,,12,5,37,54
TreeExpansionListener.java,Java,,7,5,20,32
TreeModelEvent.java,Java,,75,16,202,293
TreeModelListener.java,Java,,8,8,63,79
TreeSelectionEvent.java,Java,,71,14,82,167
TreeSelectionListener.java,Java,,6,3,22,31
TreeWillExpandListener.java,Java,,7,5,20,32
UndoableEditEvent.java,Java,,12,5,29,46
UndoableEditListener.java,Java,,5,5,14,24
FileFilter.java,Java,,6,4,27,37
FileSystemView.java,Java,,310,67,117,494
FileView.java,Java,,20,8,62,90
FocusManager.java,Java,,59,14,47,120
GraphicsWrapper.java,Java,,10,8,10,28
GrayFilter.java,Java,,31,9,35,75
Icon.java,Java,,9,6,24,39
ImageIcon.java,Java,,227,60,312,599
InputMap.java,Java,,138,24,72,234
InputVerifier.java,Java,,8,11,105,124
JApplet.java,Java,,138,46,246,430
JButton.java,Java,,91,32,171,294
JCheckBox.java,Java,,112,35,198,345
JCheckBoxMenuItem.java,Java,,76,27,164,267
JColorChooser.java,Java,,256,89,282,627
JComboBox.java,Java,,584,127,777,1488
JComponent.java,Java,,2044,407,1745,4196
JDesktopPane.java,Java,,117,42,193,352
JDialog.java,Java,,269,68,422,759
JEditorPane.java,Java,,1047,159,984,2190
JFileChooser.java,Java,,588,167,873,1628
JFrame.java,Java,,211,57,443,711
JInternalFrame.java,Java,,815,180,1038,2033
JLabel.java,Java,,638,116,661,1415
JLayeredPane.java,Java,,287,66,362,715
JList.java,Java,,1080,263,1195,2538
JMenu.java,Java,,782,138,721,1641
JMenuBar.java,Java,,321,75,346,742
JMenuItem.java,Java,,339,69,363,771
JOptionPane.java,Java,,681,141,1231,2053
JPanel.java,Java,,57,22,117,196
JPasswordField.java,Java,,84,30,204,318
JPopupMenu.java,Java,,564,113,538,1215
JProgressBar.java,Java,,282,81,477,840
JRadioButton.java,Java,,95,33,191,319
JRadioButtonMenuItem.java,Java,,65,24,152,241
JRootPane.java,Java,,293,70,421,784
JScrollBar.java,Java,,289,107,448,844
JScrollPane.java,Java,,434,137,751,1322
JSeparator.java,Java,,85,28,161,274
JSlider.java,Java,,455,162,572,1189
JSplitPane.java,Java,,381,165,639,1185
JTabbedPane.java,Java,,708,157,741,1606
JTable.java,Java,,2549,499,2560,5608
JTextArea.java,Java,,287,54,455,796
JTextField.java,Java,,294,62,451,807
JTextPane.java,Java,,153,33,253,439
JToggleButton.java,Java,,132,47,194,373
JToolBar.java,Java,[WDW - need to add orientation from BoxLayout,318,68,376,762
JToolTip.java,Java,,70,28,146,244
JTree.java,Java,,2208,421,1952,4581
JViewport.java,Java,,736,173,699,1608
JWindow.java,Java,,126,43,307,476
KeyboardManager.java,Java,,202,47,77,326
KeyStroke.java,Java,,280,49,228,557
ListCellRenderer.java,Java,,11,4,53,68
ListModel.java,Java,,9,7,32,48
ListSelectionModel.java,Java,,28,36,189,253
LookAndFeel.java,Java,,143,41,190,374
MenuElement.java,Java,,10,10,41,61
MenuSelectionManager.java,Java,,294,50,94,438
MultiUIDefaults.java,Java,,114,30,9,153
MutableComboBoxModel.java,Java,,7,7,27,41
OverlayLayout.java,Java,,113,26,116,255
ActionMapUIResource.java,Java,,6,4,11,21
BasicArrowButton.java,Java,,141,30,22,193
BasicBorders.java,Java,,360,66,49,475
BasicButtonListener.java,Java,,201,39,38,278
BasicButtonUI.java,Java,,239,66,77,382
BasicCheckBoxMenuItemUI.java,Java,,41,16,12,69
BasicCheckBoxUI.java,Java,,16,10,20,46
BasicColorChooserUI.java,Java,,150,56,16,222
BasicComboBoxEditor.java,Java,,46,15,28,89
BasicComboBoxRenderer.java,Java,,62,19,37,118
BasicComboBoxUI.java,Java,,895,181,322,1398
BasicComboPopup.java,Java,,548,120,242,910
BasicDesktopIconUI.java,Java,,174,45,24,243
BasicDesktopPaneUI.java,Java,,450,49,87,586
BasicDirectoryModel.java,Java,,236,52,56,344
BasicEditorPaneUI.java,Java,,75,15,54,144
BasicFileChooserUI.java,Java,,525,127,56,708
BasicGraphicsUtils.java,Java,,190,63,43,296
BasicHTML.java,Java,,190,46,253,489
BasicIconFactory.java,Java,,151,33,18,202
BasicInternalFrameTitlePane.java,Java,,420,92,78,590
BasicInternalFrameUI.java,Java,,904,186,174,1264
BasicLabelUI.java,Java,,284,54,106,444
BasicListUI.java,Java,,753,200,480,1433
BasicLookAndFeel.java,Java,,972,134,92,1198
BasicMenuBarUI.java,Java,,201,41,21,263
BasicMenuItemUI.java,Java,,753,128,129,1010
BasicMenuUI.java,Java,,687,84,52,823
BasicOptionPaneUI.java,Java,,723,144,202,1069
BasicPanelUI.java,Java,,34,11,11,56
BasicPasswordFieldUI.java,Java,,17,12,33,62
BasicPopupMenuSeparatorUI.java,Java,,27,9,11,47
BasicPopupMenuUI.java,Java,,587,99,57,743
BasicProgressBarUI.java,Java,,280,53,113,446
BasicRadioButtonMenuItemUI.java,Java,,42,14,11,67
BasicRadioButtonUI.java,Java,,162,41,44,247
BasicRootPaneUI.java,Java,,113,25,22,160
BasicScrollBarUI.java,Java,,731,179,205,1115
BasicScrollPaneUI.java,Java,,424,93,65,582
BasicSeparatorUI.java,Java,,68,22,12,102
BasicSliderUI.java,Java,,1245,243,133,1621
BasicSplitPaneDivider.java,Java,,563,140,255,958
BasicSplitPaneUI.java,Java,,1170,264,633,2067
BasicTabbedPaneUI.java,Java,,1495,238,194,1927
BasicTableHeaderUI.java,Java,,284,72,95,451
BasicTableUI.java,Java,,689,148,159,996
BasicTextAreaUI.java,Java,,162,31,99,292
BasicTextFieldUI.java,Java,,173,30,176,379
BasicTextPaneUI.java,Java,,55,9,54,118
BasicTextUI.java,Java,,806,156,854,1816
BasicToggleButtonUI.java,Java,,117,36,26,179
BasicToolBarSeparatorUI.java,Java,,49,16,12,77
BasicToolBarUI.java,Java,,666,129,80,875
BasicToolTipUI.java,Java,,131,26,22,179
BasicTreeUI.java,Java,,2324,454,668,3446
BasicViewportUI.java,Java,,31,11,11,53
CenterLayout.java,Java,,41,9,10,60
ComboPopup.java,Java,,15,11,44,70
DefaultMenuLayout.java,Java,,9,5,13,27
BorderUIResource.java,Java,,152,43,29,224
ButtonUI.java,Java,,5,3,10,18
ColorChooserUI.java,Java,,6,6,11,23
ColorUIResource.java,Java,,18,7,20,45
ComboBoxUI.java,Java,,7,6,20,33
ComponentInputMapUIResource.java,Java,,8,4,11,23
ComponentUI.java,Java,,45,16,33,94
DesktopIconUI.java,Java,,3,4,10,17
DesktopPaneUI.java,Java,,3,4,10,17
DimensionUIResource.java,Java,,9,4,21,34
FileChooserUI.java,Java,,14,7,10,31
FontUIResource.java,Java,,12,5,21,38
IconUIResource.java,Java,,25,8,29,62
InputMapUIResource.java,Java,,6,4,11,21
InsetsUIResource.java,Java,,9,4,21,34
InternalFrameUI.java,Java,,3,3,10,16
LabelUI.java,Java,,3,2,10,15
ListUI.java,Java,,10,9,35,54
MenuBarUI.java,Java,,5,5,11,21
MenuItemUI.java,Java,,5,3,12,20
DefaultMetalTheme.java,Java,,84,17,26,127
MetalBorders.java,Java,,373,120,56,549
MetalBumps.java,Java,,155,40,12,207
MetalButtonUI.java,Java,,95,30,37,162
MetalCheckBoxIcon.java,Java,,55,14,17,86
MetalCheckBoxUI.java,Java,,29,14,27,70
MetalComboBoxButton.java,Java,,123,27,22,172
MetalComboBoxEditor.java,Java,,42,13,32,87
MetalComboBoxIcon.java,Java,,24,11,20,55
MetalComboBoxUI.java,Java,,273,53,42,368
MetalDesktopIconUI.java,Java,,67,19,10,96
MetalFileChooserUI.java,Java,,768,184,111,1063
MetalIconFactory.java,Java,,1467,326,254,2047
MetalInternalFrameTitlePane.java,Java,,267,62,31,360
MetalInternalFrameUI.java,Java,,132,33,13,178
MetalLabelUI.java,Java,,23,10,19,52
MetalLookAndFeel.java,Java,,934,101,71,1106
MetalPopupMenuSeparatorUI.java,Java,,29,13,11,53
MetalProgressBarUI.java,Java,,58,11,36,105
MetalRadioButtonUI.java,Java,,124,32,36,192
MetalScrollBarUI.java,Java,,282,134,33,449
MetalScrollButton.java,Java,,236,57,41,334
MetalScrollPaneUI.java,Java,,54,19,17,90
MetalSeparatorUI.java,Java,,45,15,18,78
MetalSliderUI.java,Java,,256,56,36,348
MetalSplitPaneDivider.java,Java,,255,38,79,372
MetalSplitPaneUI.java,Java,,13,6,23,42
MetalTabbedPaneUI.java,Java,,637,157,145,939
MetalTextFieldUI.java,Java,,37,8,17,62
MetalTheme.java,Java,,57,18,12,87
MetalToggleButtonUI.java,Java,,86,24,34,144
MetalToolBarUI.java,Java,,297,76,15,388
MetalToolTipUI.java,Java,,99,24,26,149
MetalTreeUI.java,Java,,127,40,36,203
MetalUtils.java,Java,,76,21,35,132
MultiButtonUI.java,Java,,88,18,79,185
MultiColorChooserUI.java,Java,,88,18,79,185
MultiComboBoxUI.java,Java,,110,21,92,223
MultiDesktopIconUI.java,Java,,88,18,79,185
MultiDesktopPaneUI.java,Java,,88,18,79,185
MultiFileChooserUI.java,Java,,135,24,105,264
MultiInternalFrameUI.java,Java,,88,18,79,185
MultiLabelUI.java,Java,,88,18,79,185
MultiListUI.java,Java,,115,21,94,230
MultiLookAndFeel.java,Java,,117,16,44,177
MultiMenuBarUI.java,Java,,88,18,79,185
MultiMenuItemUI.java,Java,,89,19,82,190
MultiOptionPaneUI.java,Java,,102,20,87,209
MultiPanelUI.java,Java,,88,18,79,185
MultiPopupMenuUI.java,Java,,88,18,79,185
MultiProgressBarUI.java,Java,,88,18,79,185
MultiScrollBarUI.java,Java,,88,18,79,185
MultiScrollPaneUI.java,Java,,88,18,79,185
MultiSeparatorUI.java,Java,,88,18,79,185
MultiSliderUI.java,Java,,88,18,79,185
MultiSplitPaneUI.java,Java,,128,24,103,255
MultiTabbedPaneUI.java,Java,,114,21,94,229
MultiTableHeaderUI.java,Java,,88,18,79,185
MultiTableUI.java,Java,,88,18,79,185
MultiTextUI.java,Java,,171,26,149,346
MultiToolBarUI.java,Java,,88,18,79,185
MultiToolTipUI.java,Java,,88,18,79,185
MultiTreeUI.java,Java,,165,28,125,318
MultiViewportUI.java,Java,,88,18,79,185
OptionPaneUI.java,Java,,7,5,18,30
PanelUI.java,Java,,3,4,10,17
PopupMenuUI.java,Java,,8,5,11,24
ProgressBarUI.java,Java,,3,3,10,16
RootPaneUI.java,Java,,3,2,10,15
ScrollBarUI.java,Java,,3,2,10,15
ScrollPaneUI.java,Java,,3,4,10,17
SeparatorUI.java,Java,,3,4,11,18
SliderUI.java,Java,,3,3,10,16
SplitPaneUI.java,Java,,12,8,30,50
TabbedPaneUI.java,Java,,8,3,11,22
TableHeaderUI.java,Java,,3,2,10,15
TableUI.java,Java,,3,2,10,15
TextUI.java,Java,,25,12,98,135
ToolBarUI.java,Java,,5,5,10,20
ToolTipUI.java,Java,,3,2,10,15
TreeUI.java,Java,,18,12,56,86
UIResource.java,Java,,3,4,41,48
ViewportUI.java,Java,,3,4,10,17
Popup.java,Java,,15,7,9,31
PopupFactory.java,Java,,14,8,5,27
ProgressMonitor.java,Java,,199,51,145,395
ProgressMonitorInputStream.java,Java,,73,25,71,169
Renderer.java,Java,,6,3,23,32
RepaintManager.java,Java,,334,88,175,597
RootPaneContainer.java,Java,,13,18,106,137
Scrollable.java,Java,,11,11,84,106
ScrollPaneConstants.java,Java,,25,8,66,99
ScrollPaneLayout.java,Java,,504,136,387,1027
SingleSelectionModel.java,Java,,10,8,40,58
SizeRequirements.java,Java,,131,25,193,349
SizeSequence.java,Java,,126,22,192,340
SwingConstants.java,Java,,20,7,79,106
SwingGraphics.java,Java,,449,86,46,581
SwingUtilities.java,Java,,920,150,486,1556
SystemEventQueueUtilities.java,Java,,449,91,275,815
AbstractTableModel.java,Java,,70,23,181,274
DefaultTableCellRenderer.java,Java,,86,35,148,269
DefaultTableColumnModel.java,Java,,264,71,329,664
DefaultTableModel.java,Java,,228,74,412,714
JTableHeader.java,Java,,763,152,491,1406
TableCellEditor.java,Java,,9,7,38,54
TableCellRenderer.java,Java,,8,5,36,49
TableColumn.java,Java,,216,74,456,746
TableColumnModel.java,Java,,27,26,154,207
TableModel.java,Java,,15,13,97,125
AbstractDocument.java,Java,,1137,277,1337,2751
AbstractWriter.java,Java,,328,53,314,695
AsyncBoxView.java,Java,,610,104,588,1302
AttributeSet.java,Java,,23,18,118,159
BadLocationException.java,Java,,12,3,29,44
Bidi.java,Java,,740,130,193,1063
BoxView.java,Java,,517,58,352,927
Caret.java,Java,,24,21,138,183
ChangedCharSetException.java,Java,,16,7,11,34
ComponentView.java,Java,,194,31,172,397
CompositeView.java,Java,,427,48,354,829
DefaultCaret.java,Java,,586,102,520,1208
DefaultEditorKit.java,Java,,992,197,830,2019
DefaultHighlighter.java,Java,,294,43,154,491
DefaultStyledDocument.java,Java,,1429,197,784,2410
DefaultTextUI.java,Java,,4,5,13,22
Document.java,Java,,23,23,370,416
EditorKit.java,Java,,34,16,139,189
Element.java,Java,,13,14,79,106
ElementIterator.java,Java,,167,42,153,362
FieldView.java,Java,,136,19,124,279
FlowView.java,Java,,327,59,387,773
GapContent.java,Java,,511,93,294,898
GapVector.java,Java,,117,32,123,272
GlyphPainter1.java,Java,,100,20,79,199
GlyphPainter2.java,Java,,203,28,120,351
GlyphView.java,Java,,487,75,476,1038
Highlighter.java,Java,,22,20,92,134
BlockView.java,Java,,164,30,143,337
BRView.java,Java,,17,5,20,42
CommentView.java,Java,,87,13,17,117
CSS.java,Java,,1957,300,753,3010
CSSParser.java,Java,,583,77,171,831
EditableView.java,Java,,63,11,28,102
FormView.java,Java,,297,49,184,530
FrameSetView.java,Java,,178,33,104,315
FrameView.java,Java,,211,43,109,363
HiddenTagView.java,Java,,252,39,49,340
HRuleView.java,Java,,167,25,92,284
HTML.java,Java,,384,44,115,543
HTMLDocument.java,Java,,2136,306,1302,3744
HTMLEditorKit.java,Java,,972,127,674,1773
HTMLFrameHyperlinkEvent.java,Java,,38,12,58,108
HTMLWriter.java,Java,,766,102,323,1191
ImageView.java,Java,,479,82,186,747
InlineView.java,Java,,87,14,78,179
IsindexView.java,Java,,52,15,29,96
LineView.java,Java,,62,11,92,165
ListView.java,Java,,53,8,42,103
Map.java,Java,,341,47,88,476
MinimalHTMLWriter.java,Java,,348,82,277,707
NoFramesView.java,Java,,57,15,80,152
ObjectView.java,Java,,74,11,80,165
Option.java,Java,,38,12,44,94
OptionComboBoxModel.java,Java,,13,7,24,44
OptionListModel.java,Java,,301,73,166,540
ParagraphView.java,Java,,131,21,106,258
AttributeList.java,Java,,83,19,51,153
ContentModel.java,Java,,144,26,55,225
ContentModelState.java,Java,,169,27,59,255
DocumentParser.java,Java,,141,20,91,252
DTD.java,Java,,251,33,85,369
DTDConstants.java,Java,,39,6,18,63
Element.java,Java,,79,22,55,156
Entity.java,Java,,53,15,33,101
Parser.java,Java,,1433,231,403,2067
ParserDelegator.java,Java,,70,15,26,111
ResourceLoader.java,Java,,16,7,18,41
TagElement.java,Java,,33,15,11,59
TagStack.java,Java,,123,29,51,203
ResourceLoader.java,Java,,16,7,18,41
StyleSheet.java,Java,,2054,230,1006,3290
TableView.java,Java,,892,151,588,1631
TextAreaDocument.java,Java,,20,12,21,53
IconView.java,Java,,58,13,90,161
JTextComponent.java,Java,,1498,252,1289,3039
Keymap.java,Java,,18,16,92,126
LabelView.java,Java,,89,24,88,201
LayeredHighlighter.java,Java,,14,4,26,44
LayoutQueue.java,Java,,54,15,33,102
MutableAttributeSet.java,Java,,10,20,53,83
ParagraphView.java,Java,,414,52,311,777
PasswordView.java,Java,,89,11,82,182
PlainDocument.java,Java,,152,15,94,261
PlainView.java,Java,,336,43,225,604
Position.java,Java,,15,8,37,60
RLEUtilities.java,Java,,110,25,66,201
AbstractFilter.java,Java,,108,27,75,210
Constants.java,Java,,28,10,20,58
MockAttributeSet.java,Java,,78,22,6,106
RTFAttribute.java,Java,,26,7,14,47
RTFAttributes.java,Java,,324,64,14,402
RTFEditorKit.java,Java,,46,14,87,147
RTFGenerator.java,Java,,764,130,95,989
RTFParser.java,Java,,228,35,51,314
RTFReader.java,Java,,1115,227,281,1623
Segment.java,Java,,90,24,107,221
SimpleAttributeSet.java,Java,,183,33,149,365
StateInvariantError.java,Java,,7,2,17,26
StringContent.java,Java,,264,40,167,471
Style.java,Java,,11,10,34,55
StyleConstants.java,Java,,308,131,548,987
StyleContext.java,Java,,714,143,720,1577
StyledDocument.java,Java,,17,16,125,158
StyledEditorKit.java,Java,,338,64,372,774
TabableView.java,Java,,5,4,43,52
TabExpander.java,Java,,4,4,20,28
TableView.java,Java,,425,75,392,892
TabSet.java,Java,,66,15,50,131
TabStop.java,Java,,76,15,62,153
TextAction.java,Java,,43,7,64,114
TextLayoutStrategy.java,Java,,292,51,190,533
Utilities.java,Java,,409,42,223,674
View.java,Java,,339,62,826,1227
ViewFactory.java,Java,,5,4,20,29
WrappedPlainView.java,Java,,361,57,307,725
ZoneView.java,Java,,263,49,382,694
Timer.java,Java,,127,62,151,340
TimerQueue.java,Java,,171,60,38,269
ToolTipManager.java,Java,,446,69,157,672
AbstractLayoutCache.java,Java,,140,56,235,431
DefaultMutableTreeNode.java,Java,,646,227,612,1485
DefaultTreeCellEditor.java,Java,,317,85,208,610
DefaultTreeCellRenderer.java,Java,,214,63,214,491
DefaultTreeModel.java,Java,,247,55,260,562
DefaultTreeSelectionModel.java,Java,,688,117,331,1136
ExpandVetoException.java,Java,,12,6,26,44
FixedHeightLayoutCache.java,Java,,950,182,426,1558
MutableTreeNode.java,Java,,10,8,36,54
RowMapper.java,Java,,6,3,18,27
TreeCellEditor.java,Java,,10,4,32,46
TreeCellRenderer.java,Java,,8,4,29,41
TreeModel.java,Java,,13,15,76,104
TreeNode.java,Java,,12,10,44,66
TreePath.java,Java,,138,33,143,314
TreeSelectionModel.java,Java,,36,33,223,292
VariableHeightLayoutCache.java,Java,,1043,191,462,1696
UIDefaults.java,Java,,319,58,391,768
UIManager.java,Java,,452,118,378,948
AbstractUndoableEdit.java,Java,,73,24,114,211
CannotRedoException.java,Java,,3,2,17,22
CannotUndoException.java,Java,,3,3,17,23
CompoundEdit.java,Java,,110,21,94,225
StateEdit.java,Java,,59,27,88,174
StateEditable.java,Java,,7,8,19,34
UndoableEdit.java,Java,,15,14,83,112
UndoableEditSupport.java,Java,,66,16,65,147
UndoManager.java,Java,,210,44,200,454
UnsupportedLookAndFeelException.java,Java,,7,1,22,30
ViewportLayout.java,Java,,71,19,79,169
WindowConstants.java,Java,,7,6,30,43
java.c,C/C++/ObjC,,735,91,127,953
java.h,h,,26,12,16,54
java_md.c,C/C++/ObjC,,222,41,45,308
java_md.h,h,,19,8,12,39
Any.java,Java,,76,91,532,699
AnyHolder.java,Java,,21,9,55,85
AnySeqHelper.java,Java,,49,11,10,70
AnySeqHolder.java,Java,,24,9,10,43
ARG_IN.java,Java,,4,4,27,35
ARG_INOUT.java,Java,,4,7,28,39
ARG_OUT.java,Java,,4,6,27,37
BAD_CONTEXT.java,Java,,15,7,45,67
BAD_INV_ORDER.java,Java,,15,8,41,64
BAD_OPERATION.java,Java,,15,7,41,63
BAD_PARAM.java,Java,,15,7,45,67
BAD_POLICY.java,Java,,4,2,14,20
BAD_POLICY_TYPE.java,Java,,4,2,14,20
BAD_POLICY_VALUE.java,Java,,4,2,16,22
BAD_TYPECODE.java,Java,,15,7,42,64
BooleanHolder.java,Java,,21,9,57,87
BooleanSeqHelper.java,Java,,47,11,10,68
BooleanSeqHolder.java,Java,,24,9,10,43
Bounds.java,Java,,9,5,20,34
ByteHolder.java,Java,,21,10,57,88
CharHolder.java,Java,,21,10,58,89
CharSeqHelper.java,Java,,47,11,10,68
CharSeqHolder.java,Java,,24,9,10,43
COMM_FAILURE.java,Java,,15,7,48,70
CompletionStatus.java,Java,,27,13,83,123
CompletionStatusHelper.java,Java,,37,10,9,56
Context.java,Java,,11,19,194,224
ContextList.java,Java,,7,12,68,87
CTX_RESTRICT_SCOPE.java,Java,,4,4,26,34
Current.java,Java,,4,3,10,17
CurrentHelper.java,Java,,43,11,10,64
CurrentHolder.java,Java,,24,8,10,42
CurrentOperations.java,Java,,4,3,10,17
CustomMarshal.java,Java,,7,3,28,38
DataInputStream.java,Java,,36,34,256,326
DataOutputStream.java,Java,,36,34,194,264
DATA_CONVERSION.java,Java,,15,7,41,63
DefinitionKind.java,Java,,112,110,246,468
DefinitionKindHelper.java,Java,,37,10,10,57
DomainManager.java,Java,,5,4,12,21
DomainManagerOperations.java,Java,,5,4,15,24
DoubleHolder.java,Java,,21,12,54,87
DoubleSeqHelper.java,Java,,47,11,10,68
DoubleSeqHolder.java,Java,,24,9,10,43
DynamicImplementation.java,Java,,6,6,25,37
DynAny.java,Java,,89,68,554,711
Invalid.java,Java,,10,5,16,31
InvalidSeq.java,Java,,10,5,17,32
InvalidValue.java,Java,,10,5,20,35
TypeMismatch.java,Java,,10,5,17,32
DynArray.java,Java,,7,6,22,35
DynEnum.java,Java,,8,7,28,43
DynFixed.java,Java,,7,5,24,36
DynSequence.java,Java,,9,7,35,51
DynStruct.java,Java,,9,7,33,49
DynUnion.java,Java,,12,11,50,73
DynValue.java,Java,,8,6,37,51
Environment.java,Java,,6,10,26,42
ExceptionList.java,Java,,9,11,71,91
FieldNameHelper.java,Java,,40,10,9,59
FixedHolder.java,Java,,21,11,44,76
FloatHolder.java,Java,,21,9,53,83
FloatSeqHelper.java,Java,,47,11,10,68
FloatSeqHolder.java,Java,,24,9,10,43
FREE_MEM.java,Java,,15,6,40,61
IdentifierHelper.java,Java,,40,10,10,60
IDLType.java,Java,,4,6,22,32
IDLTypeHelper.java,Java,,51,11,10,72
IDLTypeOperations.java,Java,,5,4,24,33
IMP_LIMIT.java,Java,,15,7,40,62
INITIALIZE.java,Java,,15,6,45,66
Initializer.java,Java,,12,7,61,80
INTERNAL.java,Java,,15,6,46,67
INTF_REPOS.java,Java,,15,6,38,59
IntHolder.java,Java,,21,9,60,90
INVALID_TRANSACTION.java,Java,,15,6,40,61
INV_FLAG.java,Java,,15,6,41,62
INV_IDENT.java,Java,,15,6,41,62
INV_OBJREF.java,Java,,15,6,44,65
INV_POLICY.java,Java,,15,6,40,61
IRObject.java,Java,,5,2,15,22
IRObjectOperations.java,Java,,6,5,44,55
LongHolder.java,Java,,21,10,55,86
LongLongSeqHelper.java,Java,,47,11,10,68
LongLongSeqHolder.java,Java,,24,9,10,43
LongSeqHelper.java,Java,,47,11,10,68
LongSeqHolder.java,Java,,24,9,10,43
MARSHAL.java,Java,,15,6,40,61
NamedValue.java,Java,,6,10,90,106
NameValuePair.java,Java,,10,8,25,43
NameValuePairHelper.java,Java,,67,10,9,86
NO_IMPLEMENT.java,Java,,15,6,41,62
NO_MEMORY.java,Java,,15,7,40,62
NO_PERMISSION.java,Java,,15,6,39,60
NO_RESOURCES.java,Java,,15,6,40,61
NO_RESPONSE.java,Java,,15,6,39,60
NVList.java,Java,,9,16,135,160
Object.java,Java,,25,35,202,262
ObjectHelper.java,Java,,37,9,12,58
ObjectHolder.java,Java,,21,9,59,89
OBJECT_NOT_EXIST.java,Java,,15,6,42,63
OBJ_ADAPTER.java,Java,,15,6,42,63
OctetSeqHelper.java,Java,,47,11,10,68
OctetSeqHolder.java,Java,,24,9,10,43
OMGVMCID.java,Java,,4,5,14,23
ORB.java,Java,,292,105,792,1189
InconsistentTypeCode.java,Java,,10,4,18,32
InvalidName.java,Java,,9,4,21,34
PERSIST_STORE.java,Java,,15,6,38,59
Policy.java,Java,,4,3,10,17
PolicyError.java,Java,,15,7,28,50
PolicyHelper.java,Java,,51,11,10,72
PolicyHolder.java,Java,,24,8,10,42
PolicyListHelper.java,Java,,46,10,10,66
PolicyListHolder.java,Java,,24,9,10,43
PolicyOperations.java,Java,,7,6,27,40
PolicyTypeHelper.java,Java,,40,11,11,62
ApplicationException.java,Java,,16,6,22,44
BoxedValueHelper.java,Java,,7,2,12,21
CustomValue.java,Java,,4,6,14,24
Delegate.java,Java,,86,30,264,380
IDLEntity.java,Java,,3,3,11,17
IndirectionException.java,Java,,9,4,37,50
InputStream.java,Java,,53,12,182,247
InvokeHandler.java,Java,,6,4,43,53
ObjectImpl.java,Java,,155,37,322,514
OutputStream.java,Java,,63,11,190,264
RemarshalException.java,Java,,6,2,18,26
ResponseHandler.java,Java,,5,3,26,34
ServantObject.java,Java,,5,4,20,29
Streamable.java,Java,,7,4,30,41
StreamableValue.java,Java,,3,5,15,23
UnknownException.java,Java,,8,1,31,40
ValueBase.java,Java,,4,2,27,33
ValueFactory.java,Java,,5,3,31,39
Principal.java,Java,,5,6,22,33
PrincipalHolder.java,Java,,21,11,39,71
PRIVATE_MEMBER.java,Java,,4,2,20,26
PUBLIC_MEMBER.java,Java,,4,2,20,26
Repository.java,Java,,4,1,10,15
RepositoryIdHelper.java,Java,,40,10,10,60
Request.java,Java,,25,50,207,282
ServerRequest.java,Java,,35,19,228,282
ServiceDetail.java,Java,,11,5,32,48
ServiceDetailHelper.java,Java,,51,6,5,62
ServiceInformation.java,Java,,13,7,9,29
ServiceInformationHelper.java,Java,,59,7,5,71
ServiceInformationHolder.java,Java,,20,10,58,88
SetOverrideType.java,Java,,25,10,62,97
SetOverrideTypeHelper.java,Java,,37,10,9,56
ShortHolder.java,Java,,21,9,58,88
ShortSeqHelper.java,Java,,47,11,10,68
ShortSeqHolder.java,Java,,24,9,10,43
StringHolder.java,Java,,21,9,57,87
StringValueHelper.java,Java,,76,15,18,109
StructMember.java,Java,,12,8,37,57
StructMemberHelper.java,Java,,74,10,10,94
SystemException.java,Java,,31,11,39,81
TCKind.java,Java,,148,79,308,535
TRANSACTION_REQUIRED.java,Java,,15,6,41,62
TRANSACTION_ROLLEDBACK.java,Java,,15,6,41,62
TRANSIENT.java,Java,,15,6,39,60
TypeCode.java,Java,,44,39,451,534
TypeCodeHolder.java,Java,,21,9,58,88
BadKind.java,Java,,9,4,23,36
Bounds.java,Java,,9,5,22,36
ULongLongSeqHelper.java,Java,,47,11,10,68
ULongLongSeqHolder.java,Java,,24,9,10,43
ULongSeqHelper.java,Java,,47,11,10,68
ULongSeqHolder.java,Java,,24,9,10,43
UnionMember.java,Java,,14,9,43,66
UnionMemberHelper.java,Java,,81,10,10,101
UNKNOWN.java,Java,,15,6,41,62
UnknownUserException.java,Java,,11,7,26,44
UNSUPPORTED_POLICY.java,Java,,4,2,17,23
UNSUPPORTED_POLICY_VALUE.java,Java,,4,2,18,24
UserException.java,Java,,9,5,22,36
UShortSeqHelper.java,Java,,47,11,10,68
UShortSeqHolder.java,Java,,24,9,10,43
ValueBaseHelper.java,Java,,37,10,12,59
ValueBaseHolder.java,Java,,21,10,53,84
ValueMember.java,Java,,20,12,58,90
ValueMemberHelper.java,Java,,106,10,10,126
VersionSpecHelper.java,Java,,40,10,10,60
VisibilityHelper.java,Java,,40,11,11,62
VM_ABSTRACT.java,Java,,4,2,4,10
VM_CUSTOM.java,Java,,4,2,14,20
VM_NONE.java,Java,,4,4,17,25
VM_TRUNCATABLE.java,Java,,4,2,16,22
WCharSeqHelper.java,Java,,47,11,10,68
WCharSeqHolder.java,Java,,24,9,10,43
WrongTransaction.java,Java,,9,4,23,36
WStringValueHelper.java,Java,,76,15,19,110
_IDLTypeStub.java,Java,,90,13,25,128
_PolicyStub.java,Java,,89,14,38,141
ORB.java,Java,,23,13,38,74
Delegate.java,Java,,6,4,27,37
InputStream.java,Java,,24,11,58,93
ObjectImpl.java,Java,,10,6,26,42
OutputStream.java,Java,,18,9,47,74
Binding.java,Java,,10,1,12,23
BindingHelper.java,Java,,55,3,11,69
BindingHolder.java,Java,,20,4,12,36
BindingIterator.java,Java,,4,4,17,25
BindingIteratorHelper.java,Java,,41,2,11,54
BindingIteratorHolder.java,Java,,20,4,12,36
BindingIteratorOperations.java,Java,,7,5,23,35
BindingListHelper.java,Java,,42,2,11,55
BindingListHolder.java,Java,,21,3,12,36
BindingType.java,Java,,24,1,10,35
BindingTypeHelper.java,Java,,33,2,11,46
BindingTypeHolder.java,Java,,20,4,12,36
IstringHelper.java,Java,,31,2,11,44
NameComponent.java,Java,,10,1,12,23
NameComponentHelper.java,Java,,44,3,11,58
NameComponentHolder.java,Java,,20,4,12,36
NameHelper.java,Java,,42,2,11,55
NameHolder.java,Java,,21,3,12,36
NamingContext.java,Java,,4,5,17,26
NamingContextHelper.java,Java,,41,2,11,54
NamingContextHolder.java,Java,,20,4,12,36
NamingContextOperations.java,Java,,14,3,128,145
AlreadyBound.java,Java,,7,1,11,19
AlreadyBoundHelper.java,Java,,34,2,12,48
AlreadyBoundHolder.java,Java,,20,4,12,36
CannotProceed.java,Java,,14,1,12,27
CannotProceedHelper.java,Java,,57,5,12,74
CannotProceedHolder.java,Java,,20,4,12,36
InvalidName.java,Java,,7,1,11,19
InvalidNameHelper.java,Java,,34,2,12,48
InvalidNameHolder.java,Java,,20,4,12,36
NotEmpty.java,Java,,7,1,11,19
NotEmptyHelper.java,Java,,34,2,12,48
NotEmptyHolder.java,Java,,20,4,12,36
NotFound.java,Java,,14,1,12,27
NotFoundHelper.java,Java,,57,5,12,74
NotFoundHolder.java,Java,,20,4,12,36
NotFoundReason.java,Java,,28,1,10,39
NotFoundReasonHelper.java,Java,,34,2,11,47
NotFoundReasonHolder.java,Java,,20,4,12,36
_BindingIteratorImplBase.java,Java,,71,3,13,87
_BindingIteratorStub.java,Java,,44,6,14,64
_NamingContextImplBase.java,Java,,370,3,13,386
_NamingContextStub.java,Java,,237,6,21,264
RunTime.java,Java,,4,4,18,26
RunTimeOperations.java,Java,,4,4,18,26
_Remote_Stub.java,Java,,11,6,26,43
TTY.java,Java,,1555,155,105,1815
Serializable.java,Java,,3,3,28,34
EventListener.java,Java,,3,3,28,34
EventObject.java,Java,,6,5,28,39
