ImageFormatException.java,Java,,10,4,40,54
JPEGCodec.java,Java,,48,13,90,151
JPEGDecodeParam.java,Java,,62,45,264,371
JPEGEncodeParam.java,Java,,27,20,211,258
JPEGHuffmanTable.java,Java,,139,31,70,240
JPEGImageDecoder.java,Java,,23,14,105,142
JPEGImageEncoder.java,Java,,29,23,180,232
JPEGQTable.java,Java,,62,20,70,152
TruncatedFileException.java,Java,,19,8,57,84
MotifBorders.java,Java,,427,104,70,601
MotifButtonListener.java,Java,,35,10,17,62
MotifButtonUI.java,Java,,54,21,35,110
MotifCheckBoxMenuItemUI.java,Java,,72,25,14,111
MotifCheckBoxUI.java,Java,,26,13,25,64
MotifComboBoxRenderer.java,Java,,44,17,35,96
MotifComboBoxUI.java,Java,,278,50,40,368
MotifDesktopIconUI.java,Java,,247,52,26,325
MotifDesktopPaneUI.java,Java,,103,19,26,148
MotifEditorPaneUI.java,Java,,13,7,33,53
MotifFileChooserUI.java,Java,,472,114,66,652
MotifGraphicsUtils.java,Java,,296,57,76,429
MotifIconFactory.java,Java,,348,54,36,438
MotifInternalFrameTitlePane.java,Java,,312,50,19,381
MotifInternalFrameUI.java,Java,,123,33,27,183
MotifLabelUI.java,Java,,11,4,20,35
MotifLookAndFeel.java,Java,,660,122,48,830
MotifMenuBarUI.java,Java,,23,8,22,53
MotifMenuItemUI.java,Java,,71,23,13,107
MotifMenuMouseListener.java,Java,,17,2,12,31
MotifMenuMouseMotionListener.java,Java,,11,3,12,26
MotifMenuUI.java,Java,,93,25,27,145
MotifOptionPaneUI.java,Java,,49,13,35,97
MotifPasswordFieldUI.java,Java,,13,10,33,56
MotifPopupMenuSeparatorUI.java,Java,,27,9,13,49
MotifPopupMenuUI.java,Java,,149,37,57,243
MotifProgressBarUI.java,Java,,13,6,22,41
MotifRadioButtonMenuItemUI.java,Java,,75,23,20,118
MotifRadioButtonUI.java,Java,,33,15,31,79
MotifScrollBarButton.java,Java,,154,25,16,195
MotifScrollBarUI.java,Java,,54,18,20,92
MotifScrollPaneUI.java,Java,,45,16,19,80
MotifSeparatorUI.java,Java,,16,9,21,46
MotifSliderUI.java,Java,,103,33,32,168
MotifSplitPaneDivider.java,Java,,84,26,39,149
MotifSplitPaneUI.java,Java,,18,6,25,49
MotifTabbedPaneUI.java,Java,,194,34,24,252
MotifTextAreaUI.java,Java,,13,5,35,53
MotifTextFieldUI.java,Java,,13,5,33,51
MotifTextPaneUI.java,Java,,13,7,33,53
MotifTextUI.java,Java,,69,13,76,158
MotifToggleButtonUI.java,Java,,50,18,32,100
MotifTreeCellRenderer.java,Java,,50,16,29,95
MotifTreeUI.java,Java,,74,24,47,145
WindowsBorders.java,Java,,56,18,11,85
WindowsButtonListener.java,Java,,20,8,21,49
WindowsButtonUI.java,Java,,51,16,33,100
WindowsCheckBoxMenuItemUI.java,Java,,5,6,16,27
WindowsCheckBoxUI.java,Java,,28,14,28,70
WindowsComboBoxUI.java,Java,,127,29,31,187
WindowsDesktopIconUI.java,Java,,5,6,16,27
WindowsDesktopManager.java,Java,,83,18,53,154
WindowsDesktopPaneUI.java,Java,,56,11,20,87
WindowsEditorPaneUI.java,Java,,14,7,30,51
WindowsFileChooserUI.java,Java,,652,153,124,929
WindowsIconFactory.java,Java,,313,62,43,418
WindowsInternalFrameUI.java,Java,,16,8,16,40
WindowsLabelUI.java,Java,,5,6,16,27
WindowsListUI.java,Java,,5,6,6,17
WindowsLookAndFeel.java,Java,,304,67,57,428
WindowsMenuBarUI.java,Java,,5,6,16,27
WindowsMenuItemUI.java,Java,,5,6,16,27
WindowsMenuUI.java,Java,,5,6,16,27
WindowsOptionPaneUI.java,Java,,5,6,16,27
WindowsPasswordFieldUI.java,Java,,13,9,30,52
WindowsPopupMenuUI.java,Java,,5,6,16,27
WindowsProgressBarUI.java,Java,,11,6,19,36
WindowsRadioButtonMenuItemUI.java,Java,,5,6,16,27
WindowsRadioButtonUI.java,Java,,36,14,25,75
WindowsScrollBarUI.java,Java,,5,6,16,27
WindowsScrollPaneUI.java,Java,,5,6,16,27
WindowsSeparatorUI.java,Java,,5,6,6,17
WindowsSliderUI.java,Java,,9,7,16,32
WindowsSpinnerUI.java,Java,,5,6,6,17
WindowsSplitPaneDivider.java,Java,,23,7,25,55
WindowsSplitPaneUI.java,Java,,18,10,22,50
WindowsStandardDialogUI.java,Java,,5,6,6,17
WindowsTabbedPaneUI.java,Java,,5,6,16,27
WindowsTableHeaderUI.java,Java,,5,6,6,17
WindowsTableUI.java,Java,,5,6,6,17
WindowsTextAreaUI.java,Java,,13,8,30,51
WindowsTextFieldUI.java,Java,,67,15,80,162
WindowsTextPaneUI.java,Java,,14,6,30,50
WindowsTextUI.java,Java,,139,15,65,219
WindowsToggleButtonUI.java,Java,,44,18,25,87
WindowsToolBarUI.java,Java,,5,6,6,17
WindowsTreeUI.java,Java,,52,17,39,108
WindowsUtils.java,Java,,9,4,20,33
Applet.java,Java,,104,27,302,433
AppletContext.java,Java,,15,9,99,123
AppletStub.java,Java,,10,7,62,79
AudioClip.java,Java,,6,4,26,36
ActiveEvent.java,Java,,4,3,34,41
Adjustable.java,Java,,21,22,79,122
AlphaComposite.java,Java,,93,36,233,362
AlphaCompositeContext.java,Java,,88,24,33,145
AWTError.java,Java,,7,4,21,32
AWTEvent.java,Java,,198,48,160,406
AWTEventMulticaster.java,Java,,264,66,358,688
AWTException.java,Java,,7,4,23,34
AWTPermission.java,Java,,13,9,112,134
BasicStroke.java,Java,,255,55,162,472
BorderLayout.java,Java,,258,47,394,699
Button.java,Java,,122,37,215,374
Canvas.java,Java,,33,11,64,108
CardLayout.java,Java,,211,31,212,454
Checkbox.java,Java,,181,43,270,494
CheckboxGroup.java,Java,,32,9,89,130
CheckboxMenuItem.java,Java,,117,31,190,338
Choice.java,Java,,225,54,273,552
CMMException.java,Java,,6,7,28,41
ColorSpace.java,Java,,104,68,214,386
ICC_ColorSpace.java,Java,,91,51,93,235
ICC_Profile.java,Java,,716,314,582,1612
ICC_ProfileGray.java,Java,,25,18,86,129
ICC_ProfileRGB.java,Java,,73,34,122,229
ProfileDataException.java,Java,,6,4,13,23
Color.java,Java,,452,68,514,1034
ColorPaintContext.java,Java,,35,12,6,53
Component.java,Java,,1764,332,2049,4145
ComponentOrientation.java,Java,,53,16,111,180
Composite.java,Java,,7,5,57,69
CompositeContext.java,Java,,9,8,35,52
Conditional.java,Java,,4,2,14,20
Container.java,Java,,1174,188,836,2198
Cursor.java,Java,,187,62,124,373
Clipboard.java,Java,,22,13,35,70
ClipboardOwner.java,Java,,4,5,19,28
DataFlavor.java,Java,,256,118,286,660
FlavorMap.java,Java,,6,8,59,73
MimeType.java,Java,,149,39,114,302
MimeTypeParameterList.java,Java,,196,52,79,327
MimeTypeParseException.java,Java,,9,6,17,32
StringSelection.java,Java,,29,12,29,70
SystemFlavorMap.java,Java,,166,74,61,301
Transferable.java,Java,,7,8,36,51
UnsupportedFlavorException.java,Java,,7,5,20,32
Dialog.java,Java,,196,44,266,506
Dimension.java,Java,,52,19,124,195
Autoscroll.java,Java,,7,9,47,63
DnDConstants.java,Java,,10,14,44,68
DragGestureEvent.java,Java,,55,49,125,229
DragGestureListener.java,Java,,5,8,28,41
DragGestureRecognizer.java,Java,,75,58,268,401
DragSource.java,Java,,106,76,286,468
DragSourceContext.java,Java,,144,99,207,450
DragSourceDragEvent.java,Java,,23,25,71,119
DragSourceDropEvent.java,Java,,18,23,53,94
DragSourceEvent.java,Java,,9,10,25,44
DragSourceListener.java,Java,,11,21,104,136
DropTarget.java,Java,,258,167,305,730
DropTargetContext.java,Java,,131,85,189,405
DropTargetDragEvent.java,Java,,44,37,90,171
DropTargetDropEvent.java,Java,,60,49,128,237
DropTargetEvent.java,Java,,17,13,34,64
DropTargetListener.java,Java,,12,22,75,109
InvalidDnDOperationException.java,Java,,6,12,23,41
MouseDragGestureRecognizer.java,Java,,34,34,110,178
DragSourceContextPeer.java,Java,,19,15,29,63
DropTargetContextPeer.java,Java,,23,30,49,102
DropTargetPeer.java,Java,,6,8,28,42
ActionEvent.java,Java,,40,19,111,170
ActionListener.java,Java,,5,5,25,35
AdjustmentEvent.java,Java,,64,20,89,173
AdjustmentListener.java,Java,,5,5,15,25
AWTEventListener.java,Java,,6,5,33,44
ComponentAdapter.java,Java,,7,5,43,55
ComponentEvent.java,Java,,45,14,77,136
ComponentListener.java,Java,,8,6,43,57
ContainerAdapter.java,Java,,5,3,37,45
ContainerEvent.java,Java,,36,13,78,127
ContainerListener.java,Java,,6,5,38,49
FocusAdapter.java,Java,,5,3,37,45
FocusEvent.java,Java,,35,14,91,140
FocusListener.java,Java,,6,5,33,44
InputEvent.java,Java,,53,26,109,188
InputMethodEvent.java,Java,,107,27,141,275
InputMethodListener.java,Java,,6,7,26,39
InvocationEvent.java,Java,,59,17,113,189
ItemEvent.java,Java,,51,18,93,162
ItemListener.java,Java,,5,5,28,38
KeyAdapter.java,Java,,6,4,41,51
KeyEvent.java,Java,,516,114,313,943
KeyListener.java,Java,,7,6,37,50
MouseAdapter.java,Java,,8,6,51,65
MouseEvent.java,Java,,88,25,226,339
MouseListener.java,Java,,9,8,47,64
MouseMotionAdapter.java,Java,,5,3,45,53
MouseMotionListener.java,Java,,6,6,41,53
NativeLibLoader.java,Java,,7,3,31,41
PaintEvent.java,Java,,36,13,59,108
TextEvent.java,Java,,23,13,50,86
TextListener.java,Java,,5,5,28,38
WindowAdapter.java,Java,,10,8,55,73
WindowEvent.java,Java,,50,17,90,157
WindowListener.java,Java,,11,9,61,81
Event.java,Java,,228,106,463,797
EventDispatchThread.java,Java,,115,28,76,219
EventQueue.java,Java,,284,52,192,528
FileDialog.java,Java,,110,27,189,326
FlowLayout.java,Java,,186,37,265,488
FontRenderContext.java,Java,,31,11,70,112
GlyphJustificationInfo.java,Java,,36,18,111,165
GlyphMetrics.java,Java,,48,25,173,246
GlyphVector.java,Java,,35,27,355,417
GraphicAttribute.java,Java,,43,21,109,173
ImageGraphicAttribute.java,Java,,68,36,107,211
LineBreakMeasurer.java,Java,,105,33,332,470
LineMetrics.java,Java,,14,16,98,128
MultipleMaster.java,Java,,15,10,64,89
OpenType.java,Java,,61,64,291,416
ShapeGraphicAttribute.java,Java,,82,35,108,225
TextAttribute.java,Java,,70,65,676,811
TextHitInfo.java,Java,,54,18,157,229
TextJustifier.java,Java,,146,26,50,222
TextLayout.java,Java,,1161,338,1015,2514
TextLine.java,Java,,877,272,139,1288
TextMeasurer.java,Java,,292,80,115,487
TransformAttribute.java,Java,,15,12,34,61
Font.java,Java,,707,144,770,1621
FontMetrics.java,Java,,133,36,367,536
Frame.java,Java,,282,65,322,669
AffineTransform.java,Java,,1678,133,1167,2978
Arc2D.java,Java,,582,111,675,1368
ArcIterator.java,Java,,154,10,64,228
Area.java,Java,,302,37,230,569
CubicCurve2D.java,Java,,671,112,851,1634
CubicIterator.java,Java,,66,9,64,139
Dimension2D.java,Java,,18,7,65,90
Ellipse2D.java,Java,,136,33,238,407
EllipseIterator.java,Java,,100,12,64,176
FlatteningPathIterator.java,Java,,184,36,158,378
GeneralPath.java,Java,,274,37,309,620
GeneralPathIterator.java,Java,,51,10,80,141
IllegalPathStateException.java,Java,,8,4,27,39
Line2D.java,Java,,289,72,569,930
LineIterator.java,Java,,58,9,64,131
NoninvertibleTransformException.java,Java,,6,3,20,29
PathIterator.java,Java,,15,13,169,197
Point2D.java,Java,,112,32,226,370
QuadCurve2D.java,Java,,499,98,681,1278
QuadIterator.java,Java,,62,9,64,135
Rectangle2D.java,Java,,326,65,609,1000
RectangularShape.java,Java,,101,28,224,353
RectIterator.java,Java,,66,9,64,139
RoundRectangle2D.java,Java,,213,49,353,615
RoundRectIterator.java,Java,,92,11,69,172
GradientPaint.java,Java,,77,17,128,222
GradientPaintContext.java,Java,,153,20,44,217
Graphics.java,Java,,162,57,954,1173
Graphics2D.java,Java,,98,47,1004,1149
GraphicsConfigTemplate.java,Java,,14,11,67,92
GraphicsConfiguration.java,Java,,16,15,135,166
GraphicsDevice.java,Java,,17,12,72,101
GraphicsEnvironment.java,Java,,37,16,116,169
GridBagConstraints.java,Java,,75,34,304,413
GridBagLayout.java,Java,,561,127,647,1335
GridLayout.java,Java,,142,23,251,416
IllegalComponentStateException.java,Java,,10,4,26,40
InputContext.java,Java,,30,14,132,176
InputMethodHighlight.java,Java,,36,18,73,127
InputMethodRequests.java,Java,,15,11,165,191
InputSubset.java,Java,,20,13,48,81
AffineTransformOp.java,Java,,252,35,188,475
AreaAveragingScaleFilter.java,Java,,151,11,61,223
BandCombineOp.java,Java,,124,15,120,259
BandedSampleModel.java,Java,,246,68,244,558
BufferedImage.java,Java,,672,129,629,1430
BufferedImageFilter.java,Java,,244,15,86,345
BufferedImageOp.java,Java,,12,7,65,84
ByteLookupTable.java,Java,,79,13,101,193
ColorConvertOp.java,Java,,681,84,267,1032
ColorModel.java,Java,,438,62,794,1294
ComponentColorModel.java,Java,,802,80,521,1403
ComponentSampleModel.java,Java,,407,83,307,797
ConvolveOp.java,Java,,130,31,141,302
CropImageFilter.java,Java,,77,8,48,133
DataBuffer.java,Java,,127,40,162,329
DataBufferByte.java,Java,,63,18,122,203
DataBufferInt.java,Java,,63,19,120,202
DataBufferShort.java,Java,,63,19,119,201
DataBufferUShort.java,Java,,63,19,121,203
DirectColorModel.java,Java,,563,51,336,950
FilteredImageSource.java,Java,,60,10,61,131
ImageConsumer.java,Java,,22,18,136,176
ImageFilter.java,Java,,52,13,97,162
ImageObserver.java,Java,,14,11,114,139
ImageProducer.java,Java,,8,6,69,83
ImagingOpException.java,Java,,6,4,18,28
IndexColorModel.java,Java,,551,64,347,962
Kernel.java,Java,,59,19,64,142
LookupOp.java,Java,,331,52,124,507
LookupTable.java,Java,,25,10,48,83
MemoryImageSource.java,Java,,215,24,233,472
MultiPixelPackedSampleModel.java,Java,,214,61,300,575
PackedColorModel.java,Java,,222,34,140,396
PixelGrabber.java,Java,,308,28,266,602
PixelInterleavedSampleModel.java,Java,,63,6,62,131
Raster.java,Java,,587,137,595,1319
RasterFormatException.java,Java,,6,4,17,27
RasterOp.java,Java,,11,7,56,74
ContextualRenderedImageFactory.java,Java,,15,9,91,115
ParameterBlock.java,Java,,189,50,239,478
RenderableImage.java,Java,,18,15,137,170
RenderableImageOp.java,Java,,121,29,172,322
RenderableImageProducer.java,Java,,93,19,89,201
RenderContext.java,Java,,55,20,131,206
RenderedImageFactory.java,Java,,7,4,49,60
RenderedImage.java,Java,,27,25,118,170
ReplicateScaleFilter.java,Java,,115,10,48,173
RescaleOp.java,Java,,348,63,195,606
RGBImageFilter.java,Java,,101,11,114,226
SampleModel.java,Java,,399,132,541,1072
ShortLookupTable.java,Java,,79,13,88,180
SinglePixelPackedSampleModel.java,Java,,281,78,279,638
TileObserver.java,Java,,6,4,27,37
WritableRaster.java,Java,,178,34,342,554
WritableRenderedImage.java,Java,,13,13,97,123
Image.java,Java,,32,14,144,190
Insets.java,Java,,37,13,89,139
ItemSelectable.java,Java,,7,7,31,45
Label.java,Java,,85,23,130,238
LayoutManager.java,Java,,8,5,42,55
LayoutManager2.java,Java,,8,7,55,70
List.java,Java,,388,85,554,1027
MediaTracker.java,Java,,390,56,465,911
Menu.java,Java,,224,52,248,524
MenuBar.java,Java,,186,34,193,413
MenuComponent.java,Java,,145,32,154,331
MenuContainer.java,Java,,6,3,16,25
MenuItem.java,Java,,197,50,330,577
MenuShortcut.java,Java,,52,12,76,140
Paint.java,Java,,12,6,42,60
PaintContext.java,Java,,12,7,44,63
Panel.java,Java,,25,9,40,74
ButtonPeer.java,Java,,5,3,13,21
CanvasPeer.java,Java,,4,2,13,19
CheckboxMenuItemPeer.java,Java,,4,1,13,18
CheckboxPeer.java,Java,,7,2,13,22
ChoicePeer.java,Java,,8,3,16,27
ComponentPeer.java,Java,,40,13,34,87
ContainerPeer.java,Java,,8,3,16,27
DialogPeer.java,Java,,6,5,13,24
FileDialogPeer.java,Java,,8,3,13,24
FontPeer.java,Java,,3,2,13,18
FramePeer.java,Java,,10,5,13,28
LabelPeer.java,Java,,7,2,13,22
LightweightPeer.java,Java,,3,3,21,27
ListPeer.java,Java,,19,7,28,54
MenuBarPeer.java,Java,,7,2,13,22
MenuComponentPeer.java,Java,,4,1,13,18
MenuItemPeer.java,Java,,7,4,19,30
MenuPeer.java,Java,,7,2,13,22
PanelPeer.java,Java,,4,2,13,19
PopupMenuPeer.java,Java,,5,2,13,20
ScrollbarPeer.java,Java,,6,1,13,20
ScrollPanePeer.java,Java,,11,2,13,26
TextAreaPeer.java,Java,,12,6,25,43
TextComponentPeer.java,Java,,11,1,13,25
TextFieldPeer.java,Java,,10,5,22,37
WindowPeer.java,Java,,12,5,13,30
Point.java,Java,,54,18,129,201
Polygon.java,Java,,244,50,284,578
PopupMenu.java,Java,,64,11,54,129
Book.java,Java,,66,27,113,206
Pageable.java,Java,,9,7,50,66
PageFormat.java,Java,,141,58,133,332
Paper.java,Java,,53,25,98,176
Printable.java,Java,,8,7,53,68
PrinterAbortException.java,Java,,9,6,22,37
PrinterException.java,Java,,8,6,21,35
PrinterGraphics.java,Java,,4,5,20,29
PrinterIOException.java,Java,,12,8,28,48
PrinterJob.java,Java,,48,26,147,221
PrintGraphics.java,Java,,4,4,16,24
PrintJob.java,Java,,11,9,43,63
Rectangle.java,Java,,234,54,475,763
RenderingHints.java,Java,,195,68,380,643
Scrollbar.java,Java,,226,58,597,881
ScrollPane.java,Java,,386,85,289,760
Shape.java,Java,,17,12,278,307
Stroke.java,Java,,4,6,45,55
SystemColor.java,Java,,109,64,213,386
TextArea.java,Java,,197,52,305,554
TextComponent.java,Java,,234,48,298,580
TextField.java,Java,,188,48,334,570
TexturePaint.java,Java,,47,13,63,123
TexturePaintContext.java,Java,,405,30,26,461
Toolkit.java,Java,,487,144,794,1425
Transparency.java,Java,,7,6,29,42
Window.java,Java,,605,104,403,1112
AppletInitializer.java,Java,,7,10,56,73
BeanContext.java,Java,,16,19,50,85
BeanContextChild.java,Java,,13,19,70,102
BeanContextChildComponentProxy.java,Java,,5,6,22,33
BeanContextChildSupport.java,Java,,100,68,109,277
BeanContextContainerProxy.java,Java,,5,6,22,33
BeanContextEvent.java,Java,,19,17,37,73
BeanContextMembershipEvent.java,Java,,24,22,47,93
BeanContextMembershipListener.java,Java,,7,9,23,39
BeanContextProxy.java,Java,,4,5,54,63
BeanContextServiceAvailableEvent.java,Java,,19,17,27,63
BeanContextServiceProvider.java,Java,,7,10,40,57
BeanContextServiceProviderBeanInfo.java,Java,,5,6,17,28
BeanContextServiceRevokedEvent.java,Java,,20,18,30,68
BeanContextServiceRevokedListener.java,Java,,6,6,10,22
BeanContextServices.java,Java,,17,27,39,83
BeanContextServicesListener.java,Java,,7,6,10,23
BeanContextServicesSupport.java,Java,,610,316,253,1179
BeanContextSupport.java,Java,,596,302,400,1298
BeanDescriptor.java,Java,,28,10,42,80
BeanInfo.java,Java,,15,15,123,153
Beans.java,Java,,299,89,245,633
Customizer.java,Java,,6,8,34,48
DesignMode.java,Java,,6,9,68,83
EventSetDescriptor.java,Java,,154,37,149,340
FeatureDescriptor.java,Java,,106,24,124,254
IndexedPropertyDescriptor.java,Java,,114,20,112,246
IntrospectionException.java,Java,,7,4,20,31
Introspector.java,Java,,709,137,285,1131
MethodDescriptor.java,Java,,41,14,48,103
ParameterDescriptor.java,Java,,8,6,21,35
PropertyChangeEvent.java,Java,,29,13,82,124
PropertyChangeListener.java,Java,,4,6,16,26
PropertyChangeSupport.java,Java,,162,39,124,325
PropertyDescriptor.java,Java,,163,29,143,335
PropertyEditor.java,Java,,15,25,146,186
PropertyEditorManager.java,Java,,90,19,80,189
PropertyEditorSupport.java,Java,,81,33,131,245
PropertyVetoException.java,Java,,12,8,26,46
SimpleBeanInfo.java,Java,,54,14,60,128
VetoableChangeListener.java,Java,,5,2,19,26
VetoableChangeSupport.java,Java,,162,40,135,337
Visibility.java,Java,,7,8,34,49
BufferedInputStream.java,Java,,134,25,244,403
BufferedOutputStream.java,Java,,44,9,77,130
BufferedReader.java,Java,,215,32,194,441
BufferedWriter.java,Java,,105,24,121,250
ByteArrayInputStream.java,Java,,76,19,175,270
ByteArrayOutputStream.java,Java,,73,21,126,220
CharArrayReader.java,Java,,96,17,81,194
CharArrayWriter.java,Java,,83,16,69,168
CharConversionException.java,Java,,10,1,19,30
DataInput.java,Java,,19,16,452,487
DataInputStream.java,Java,,180,28,349,557
DataOutput.java,Java,,18,15,300,333
DataOutputStream.java,Java,,130,22,200,352
EOFException.java,Java,,10,3,37,50
Externalizable.java,Java,,7,4,65,76
File.java,Java,,380,83,945,1408
FileDescriptor.java,Java,,21,12,84,117
FileFilter.java,Java,,4,5,23,32
FileInputStream.java,Java,,54,18,174,246
FilenameFilter.java,Java,,5,2,29,36
FileNotFoundException.java,Java,,14,8,42,64
FileOutputStream.java,Java,,64,19,173,256
FilePermission.java,Java,,292,88,333,713
FileReader.java,Java,,12,8,19,39
FileSystem.java,Java,,33,43,122,198
FileWriter.java,Java,,15,9,19,43
FilterInputStream.java,Java,,35,12,176,223
FilterOutputStream.java,Java,,29,8,105,142
FilterReader.java,Java,,32,15,58,105
FilterWriter.java,Java,,23,12,52,87
InputStream.java,Java,,68,20,258,346
InputStreamReader.java,Java,,139,30,97,266
InterruptedIOException.java,Java,,11,4,40,55
InvalidClassException.java,Java,,17,5,31,53
InvalidObjectException.java,Java,,6,2,23,31
IOException.java,Java,,10,3,29,42
LineNumberInputStream.java,Java,,96,19,157,272
LineNumberReader.java,Java,,98,23,94,215
NotActiveException.java,Java,,9,3,19,31
NotSerializableException.java,Java,,9,3,20,32
ObjectInput.java,Java,,11,8,69,88
ObjectInputStream.java,Java,,1168,197,892,2257
ObjectInputValidation.java,Java,,4,2,21,27
ObjectOutput.java,Java,,10,7,55,72
ObjectOutputStream.java,Java,,950,191,792,1933
ObjectStreamClass.java,Java,,816,162,492,1470
ObjectStreamConstants.java,Java,,30,29,128,187
ObjectStreamException.java,Java,,9,3,19,31
ObjectStreamField.java,Java,,141,30,103,274
OptionalDataException.java,Java,,13,4,37,54
OutputStream.java,Java,,24,7,100,131
OutputStreamWriter.java,Java,,122,20,110,252
PipedInputStream.java,Java,,134,20,171,325
PipedOutputStream.java,Java,,53,11,95,159
PipedReader.java,Java,,144,23,138,305
PipedWriter.java,Java,,47,12,88,147
PrintStream.java,Java,,236,46,261,543
PrintWriter.java,Java,,211,48,236,495
PushbackInputStream.java,Java,,106,19,183,308
PushbackReader.java,Java,,102,20,108,230
RandomAccessFile.java,Java,,254,62,665,981
Reader.java,Java,,56,19,138,213
SequenceInputStream.java,Java,,79,14,107,200
Serializable.java,Java,,3,2,99,104
SerializablePermission.java,Java,,16,11,82,109
StreamCorruptedException.java,Java,,9,3,20,32
StreamTokenizer.java,Java,,362,51,370,783
StringBufferInputStream.java,Java,,53,11,90,154
StringReader.java,Java,,77,16,74,167
StringWriter.java,Java,,52,18,63,133
SyncFailedException.java,Java,,6,2,19,27
UnsupportedEncodingException.java,Java,,11,1,20,32
UTFDataFormatException.java,Java,,10,3,32,45
WriteAbortedException.java,Java,,14,4,27,45
Writer.java,Java,,48,17,106,171
AbstractMethodError.java,Java,,10,3,26,39
ArithmeticException.java,Java,,10,3,25,38
ArrayIndexOutOfBoundsException.java,Java,,13,4,31,48
ArrayStoreException.java,Java,,10,4,28,42
Boolean.java,Java,,39,15,116,170
Byte.java,Java,,82,28,153,263
Character.java,Java,,971,70,869,1910
Class.java,Java,,248,102,997,1347
ClassCastException.java,Java,,10,3,28,41
ClassCircularityError.java,Java,,9,3,22,34
ClassFormatError.java,Java,,10,3,24,37
ClassLoader.java,Java,,632,81,670,1383
ClassNotFoundException.java,Java,,44,12,82,138
Cloneable.java,Java,,3,3,23,29
CloneNotSupportedException.java,Java,,10,4,32,46
Comparable.java,Java,,4,3,102,109
Compiler.java,Java,,37,10,61,108
Double.java,Java,,87,34,422,543
Error.java,Java,,10,3,32,45
Exception.java,Java,,10,3,24,37
ExceptionInInitializerError.java,Java,,43,13,74,130
Float.java,Java,,88,35,406,529
FloatingDecimal.java,Java,,1426,100,714,2240
IllegalAccessError.java,Java,,9,3,27,39
IllegalAccessException.java,Java,,10,3,43,56
IllegalArgumentException.java,Java,,10,3,25,38
IllegalMonitorStateException.java,Java,,10,3,30,43
IllegalStateException.java,Java,,10,3,27,40
IllegalThreadStateException.java,Java,,9,3,28,40
IncompatibleClassChangeError.java,Java,,10,3,25,38
IndexOutOfBoundsException.java,Java,,10,3,26,39
InheritableThreadLocal.java,Java,,14,7,48,69
InstantiationError.java,Java,,10,5,27,42
InstantiationException.java,Java,,10,3,26,39
Integer.java,Java,,274,57,533,864
InternalError.java,Java,,10,3,23,36
InterruptedException.java,Java,,10,3,30,43
LinkageError.java,Java,,10,3,25,38
Long.java,Java,,218,45,526,789
Math.java,Java,,98,43,378,519
NegativeArraySizeException.java,Java,,10,3,23,36
NoClassDefFoundError.java,Java,,10,3,29,42
NoSuchFieldError.java,Java,,10,3,27,40
NoSuchFieldException.java,Java,,9,3,19,31
NoSuchMethodError.java,Java,,10,3,28,41
NoSuchMethodException.java,Java,,10,3,21,34
NullPointerException.java,Java,,10,3,35,48
Number.java,Java,,14,8,72,94
NumberFormatException.java,Java,,10,3,25,38
Object.java,Java,,36,17,413,466
OutOfMemoryError.java,Java,,10,3,24,37
Package.java,Java,,262,35,217,514
Process.java,Java,,11,8,107,126
Finalizer.java,Java,,134,21,32,187
FinalReference.java,Java,,6,6,7,19
PhantomReference.java,Java,,9,7,44,60
Reference.java,Java,,71,29,107,207
ReferenceQueue.java,Java,,61,14,48,123
SoftReference.java,Java,,18,10,67,95
WeakReference.java,Java,,9,7,37,53
AccessibleObject.java,Java,,24,9,70,103
Array.java,Java,,56,29,382,467
Constructor.java,Java,,78,13,148,239
Field.java,Java,,96,31,498,625
InvocationTargetException.java,Java,,45,13,52,110
Member.java,Java,,9,8,42,59
Method.java,Java,,94,15,171,280
Modifier.java,Java,,71,34,126,231
ReflectPermission.java,Java,,10,5,61,76
Runnable.java,Java,,5,2,44,51
Runtime.java,Java,,119,32,369,520
RuntimeException.java,Java,,10,3,29,42
RuntimePermission.java,Java,,15,8,252,275
SecurityException.java,Java,,9,2,23,34
SecurityManager.java,Java,,336,69,1194,1599
Short.java,Java,,104,30,175,309
StackOverflowError.java,Java,,10,3,23,36
String.java,Java,,698,109,1283,2090
StringBuffer.java,Java,,301,55,720,1076
StringIndexOutOfBoundsException.java,Java,,13,4,35,52
System.java,Java,,148,41,631,820
Thread.java,Java,,282,77,783,1142
ThreadDeath.java,Java,,2,3,30,35
ThreadGroup.java,Java,,439,43,443,925
ThreadLocal.java,Java,,244,64,277,585
Throwable.java,Java,,44,15,169,228
UnknownError.java,Java,,10,3,23,36
UnsatisfiedLinkError.java,Java,,10,3,24,37
UnsupportedClassVersionError.java,Java,,10,3,23,36
UnsupportedOperationException.java,Java,,8,3,20,31
VerifyError.java,Java,,10,3,23,36
VirtualMachineError.java,Java,,10,3,24,37
Void.java,Java,,6,4,21,31
BigDecimal.java,Java,,267,78,537,882
BigInteger.java,Java,,748,208,780,1736
Authenticator.java,Java,,70,18,116,204
BindException.java,Java,,7,5,23,35
ConnectException.java,Java,,7,3,24,34
ContentHandler.java,Java,,5,3,42,50
ContentHandlerFactory.java,Java,,4,2,31,37
DatagramPacket.java,Java,,81,23,168,272
DatagramSocket.java,Java,,214,31,309,554
DatagramSocketImpl.java,Java,,26,20,68,114
FileNameMap.java,Java,,4,2,16,22
HttpURLConnection.java,Java,,110,29,126,265
InetAddress.java,Java,,357,76,315,748
JarURLConnection.java,Java,,55,24,216,295
MalformedURLException.java,Java,,9,4,24,37
MulticastSocket.java,Java,,102,17,217,336
NetPermission.java,Java,,15,8,93,116
NoRouteToHostException.java,Java,,7,3,24,34
PasswordAuthentication.java,Java,,15,9,41,65
PlainDatagramSocketImpl.java,Java,,95,28,77,200
PlainSocketImpl.java,Java,,281,70,116,467
ProtocolException.java,Java,,10,4,23,37
ServerSocket.java,Java,,104,22,217,343
Socket.java,Java,,198,36,354,588
SocketException.java,Java,,10,4,23,37
SocketImpl.java,Java,,43,22,134,199
SocketImplFactory.java,Java,,5,2,24,31
SocketInputStream.java,Java,,68,16,70,154
SocketOptions.java,Java,,14,27,207,248
SocketOutputStream.java,Java,,32,13,55,100
SocketPermission.java,Java,,510,156,412,1078
UnknownHostException.java,Java,,10,4,23,37
UnknownServiceException.java,Java,,9,4,26,39
URL.java,Java,,324,72,569,965
URLClassLoader.java,Java,,310,35,210,555
URLConnection.java,Java,,401,89,803,1293
URLDecoder.java,Java,,31,7,30,68
URLEncoder.java,Java,,67,9,41,117
URLStreamHandler.java,Java,,91,7,93,191
URLStreamHandlerFactory.java,Java,,4,2,28,34
AccessException.java,Java,,10,5,38,53
Activatable.java,Java,,161,28,308,497
ActivateFailedException.java,Java,,10,5,30,45
ActivationDesc.java,Java,,99,22,181,302
ActivationException.java,Java,,47,11,60,118
ActivationGroup.java,Java,,174,34,297,505
ActivationGroupDesc.java,Java,,121,32,180,333
ActivationGroupID.java,Java,,26,9,63,98
ActivationID.java,Java,,76,18,104,198
ActivationInstantiator.java,Java,,8,5,46,59
ActivationMonitor.java,Java,,15,9,68,92
ActivationSystem.java,Java,,32,14,157,203
Activator.java,Java,,9,4,83,96
UnknownGroupException.java,Java,,7,4,32,43
UnknownObjectException.java,Java,,7,4,34,45
AlreadyBoundException.java,Java,,10,4,31,45
ConnectException.java,Java,,10,5,30,45
ConnectIOException.java,Java,,10,6,31,47
DGC.java,Java,,9,4,72,85
Lease.java,Java,,19,6,30,55
VMID.java,Java,,83,18,57,158
MarshalException.java,Java,,10,5,39,54
MarshalledObject.java,Java,,106,28,157,291
Naming.java,Java,,97,24,130,251
NoSuchObjectException.java,Java,,7,4,34,45
NotBoundException.java,Java,,10,4,33,47
LocateRegistry.java,Java,,64,15,114,193
Registry.java,Java,,15,8,99,122
RegistryHandler.java,Java,,8,5,30,43
Remote.java,Java,,2,2,29,33
RemoteException.java,Java,,47,11,65,123
RMISecurityException.java,Java,,10,4,31,45
RMISecurityManager.java,Java,,6,4,31,41
ExportException.java,Java,,10,6,35,51
LoaderHandler.java,Java,,11,7,56,74
LogStream.java,Java,,107,25,92,224
ObjID.java,Java,,70,19,88,177
Operation.java,Java,,13,5,32,50
RemoteCall.java,Java,,16,10,78,104
RemoteObject.java,Java,,81,15,111,207
RemoteRef.java,Java,,19,14,141,174
RemoteServer.java,Java,,50,9,49,108
RemoteStub.java,Java,,13,5,38,56
RMIClassLoader.java,Java,,28,8,84,120
RMIClientSocketFactory.java,Java,,7,4,39,50
RMIFailureHandler.java,Java,,4,5,35,44
RMIServerSocketFactory.java,Java,,7,4,39,50
RMISocketFactory.java,Java,,52,12,96,160
ServerCloneException.java,Java,,46,10,58,114
ServerNotActiveException.java,Java,,9,5,30,44
ServerRef.java,Java,,8,6,35,49
Skeleton.java,Java,,7,3,35,45
SkeletonMismatchException.java,Java,,8,6,29,43
SkeletonNotFoundException.java,Java,,11,6,35,52
SocketSecurityException.java,Java,,10,6,37,53
UID.java,Java,,85,17,87,189
UnicastRemoteObject.java,Java,,113,26,133,272
Unreferenced.java,Java,,4,2,22,28
ServerError.java,Java,,7,4,26,37
ServerException.java,Java,,10,5,31,46
ServerRuntimeException.java,Java,,7,4,28,39
StubNotFoundException.java,Java,,10,5,36,51
UnexpectedException.java,Java,,10,5,32,47
UnknownHostException.java,Java,,10,5,30,45
UnmarshalException.java,Java,,10,5,44,59
AccessControlContext.java,Java,,247,73,151,471
AccessControlException.java,Java,,14,8,42,64
AccessController.java,Java,,43,23,333,399
Acl.java,Java,,16,28,192,236
AclEntry.java,Java,,15,15,104,134
AclNotFoundException.java,Java,,5,4,15,24
Group.java,Java,,9,9,51,69
LastOwnerException.java,Java,,5,3,17,25
NotOwnerException.java,Java,,5,3,16,24
Owner.java,Java,,9,7,61,77
Permission.java,Java,,5,6,25,36
AlgorithmParameterGenerator.java,Java,,65,17,159,241
AlgorithmParameterGeneratorSpi.java,Java,,9,7,53,69
AlgorithmParameters.java,Java,,95,20,200,315
AlgorithmParametersSpi.java,Java,,19,11,103,133
AllPermission.java,Java,,64,30,110,204
BasicPermission.java,Java,,131,52,187,370
Certificate.java,Java,,57,15,109,181
CertificateEncodingException.java,Java,,9,4,25,38
CertificateException.java,Java,,10,5,24,39
CertificateExpiredException.java,Java,,9,4,27,40
CertificateFactory.java,Java,,118,19,257,394
CertificateFactorySpi.java,Java,,16,8,157,181
CertificateNotYetValidException.java,Java,,9,4,27,40
CertificateParsingException.java,Java,,9,4,26,39
CRL.java,Java,,12,8,51,71
CRLException.java,Java,,10,5,24,39
X509Certificate.java,Java,,31,22,361,414
X509CRL.java,Java,,67,23,273,363
X509CRLEntry.java,Java,,40,13,84,137
X509Extension.java,Java,,8,8,151,167
Certificate.java,Java,,14,11,111,136
CodeSource.java,Java,,216,42,217,475
DigestException.java,Java,,9,4,24,37
DigestInputStream.java,Java,,41,18,114,173
DigestOutputStream.java,Java,,39,16,101,156
GeneralSecurityException.java,Java,,9,5,29,43
Guard.java,Java,,4,4,31,39
GuardedObject.java,Java,,24,10,49,83
Identity.java,Java,,172,39,256,467
IdentityScope.java,Java,,67,26,141,234
DSAKey.java,Java,,4,3,26,33
DSAKeyPairGenerator.java,Java,,8,5,79,92
DSAParams.java,Java,,7,6,34,47
DSAPrivateKey.java,Java,,6,7,24,37
DSAPublicKey.java,Java,,6,7,24,37
RSAPrivateCrtKey.java,Java,,10,10,46,66
RSAPrivateKey.java,Java,,6,6,25,37
RSAPublicKey.java,Java,,6,6,23,35
InvalidAlgorithmParameterException.java,Java,,10,5,32,47
InvalidKeyException.java,Java,,9,6,25,40
InvalidParameterException.java,Java,,9,5,25,39
Key.java,Java,,7,7,90,104
KeyException.java,Java,,9,5,27,41
KeyFactory.java,Java,,56,16,163,235
KeyFactorySpi.java,Java,,13,9,100,122
KeyManagementException.java,Java,,9,5,35,49
KeyPair.java,Java,,16,8,38,62
KeyPairGenerator.java,Java,,88,26,274,388
KeyPairGeneratorSpi.java,Java,,11,7,66,84
KeyStore.java,Java,,197,31,410,638
KeyStoreException.java,Java,,9,5,27,41
KeyStoreSpi.java,Java,,34,20,211,265
MessageDigest.java,Java,,187,38,241,466
MessageDigestSpi.java,Java,,35,12,107,154
NoSuchAlgorithmException.java,Java,,9,5,26,40
NoSuchProviderException.java,Java,,9,5,25,39
Permission.java,Java,,25,22,161,208
PermissionCollection.java,Java,,29,12,123,164
Permissions.java,Java,,167,60,182,409
Policy.java,Java,,60,18,131,209
Principal.java,Java,,7,6,42,55
PrivateKey.java,Java,,4,3,28,35
PrivilegedAction.java,Java,,4,4,30,38
PrivilegedActionException.java,Java,,36,9,54,99
PrivilegedExceptionAction.java,Java,,4,5,35,44
ProtectionDomain.java,Java,,29,12,56,97
Provider.java,Java,,100,33,218,351
ProviderException.java,Java,,9,5,25,39
PublicKey.java,Java,,4,3,25,32
SecureClassLoader.java,Java,,74,17,83,174
SecureRandom.java,Java,,126,29,298,453
SecureRandomSpi.java,Java,,6,6,38,50
Security.java,Java,,390,70,305,765
SecurityPermission.java,Java,,15,8,244,267
Signature.java,Java,,225,58,386,669
SignatureException.java,Java,,9,6,24,39
SignatureSpi.java,Java,,53,25,210,288
SignedObject.java,Java,,57,15,165,237
Signer.java,Java,,58,17,88,163
AlgorithmParameterSpec.java,Java,,2,3,22,27
DSAParameterSpec.java,Java,,22,9,41,72
DSAPrivateKeySpec.java,Java,,27,10,52,89
DSAPublicKeySpec.java,Java,,27,10,52,89
EncodedKeySpec.java,Java,,11,7,46,64
InvalidKeySpecException.java,Java,,10,6,29,45
InvalidParameterSpecException.java,Java,,10,6,31,47
KeySpec.java,Java,,2,3,40,45
PKCS8EncodedKeySpec.java,Java,,12,6,39,57
RSAPrivateCrtKeySpec.java,Java,,46,12,52,110
RSAPrivateKeySpec.java,Java,,16,8,30,54
RSAPublicKeySpec.java,Java,,16,8,30,54
X509EncodedKeySpec.java,Java,,12,6,39,57
UnrecoverableKeyException.java,Java,,9,5,23,37
UnresolvedPermission.java,Java,,217,37,177,431
UnresolvedPermissionCollection.java,Java,,49,16,43,108
Array.java,Java,,15,16,192,223
BatchUpdateException.java,Java,,29,10,72,111
Blob.java,Java,,8,10,88,106
CallableStatement.java,Java,,40,39,401,480
Clob.java,Java,,9,9,89,107
Connection.java,Java,,37,41,357,435
DatabaseMetaData.java,Java,,222,201,2028,2451
DataTruncation.java,Java,,38,15,75,128
Date.java,Java,,68,24,103,195
Driver.java,Java,,11,12,107,130
DriverManager.java,Java,,237,65,206,508
DriverPropertyInfo.java,Java,,12,9,43,64
PreparedStatement.java,Java,,54,51,469,574
Ref.java,Java,,4,5,21,30
ResultSet.java,Java,,162,164,1670,1996
ResultSetMetaData.java,Java,,27,28,179,234
SQLData.java,Java,,6,7,64,77
SQLException.java,Java,,65,14,79,158
SQLInput.java,Java,,25,29,182,236
SQLOutput.java,Java,,25,29,184,238
SQLWarning.java,Java,,32,11,57,100
Statement.java,Java,,31,35,339,405
Struct.java,Java,,6,8,62,76
Time.java,Java,,77,22,102,201
Timestamp.java,Java,,207,29,138,374
Types.java,Java,,32,23,55,110
Annotation.java,Java,,13,8,44,65
AttributedCharacterIterator.java,Java,,53,28,137,218
AttributedString.java,Java,,638,115,200,953
BreakIterator.java,Java,,82,27,370,479
CharacterBreakData.java,Java,,159,20,87,266
CharacterIterator.java,Java,,15,17,162,194
ChoiceFormat.java,Java,,233,30,283,546
CollationElementIterator.java,Java,,217,33,207,457
CollationKey.java,Java,,45,17,146,208
CollationRules.java,Java,,205,11,56,272
Collator.java,Java,,118,31,356,505
CompactByteArray.java,Java,,196,18,141,355
CompactCharArray.java,Java,,198,23,141,362
CompactIntArray.java,Java,,180,27,136,343
CompactShortArray.java,Java,,244,36,168,448
CompactStringArray.java,Java,,306,13,138,457
DateFormat.java,Java,,178,39,436,653
DateFormatSymbols.java,Java,,205,49,297,551
DecimalFormat.java,Java,,928,164,839,1931
DecimalFormatSymbols.java,Java,,200,64,262,526
DigitList.java,Java,,265,59,272,596
EntryPair.java,Java,,15,4,40,59
FieldPosition.java,Java,,43,14,109,166
Format.java,Java,,28,7,188,223
IntHashtable.java,Java,,166,30,88,284
LineBreakData.java,Java,,289,14,115,418
MergeCollation.java,Java,,176,30,118,324
MessageFormat.java,Java,,493,50,401,944
Normalizer.java,Java,,1631,105,286,2022
NumberFormat.java,Java,,212,61,516,789
ParseException.java,Java,,12,6,61,79
ParsePosition.java,Java,,38,12,88,138
PatternEntry.java,Java,,202,27,71,300
DateFormatZoneData.java,Java,,32,4,65,101
DateFormatZoneData_en.java,Java,,72,4,199,275
DateFormatZoneData_en_US.java,Java,,108,4,197,309
LocaleData.java,Java,,150,17,80,247
LocaleElements.java,Java,,489,6,64,559
LocaleElements_en.java,Java,,15,6,59,80
LocaleElements_en_US.java,Java,,25,6,54,85
RuleBasedCollator.java,Java,,542,93,619,1254
SentenceBreakData.java,Java,,223,35,111,369
SimpleDateFormat.java,Java,,727,88,521,1336
SimpleTextBoundary.java,Java,,199,33,128,360
SpecialMapping.java,Java,,17,6,63,86
StringCharacterIterator.java,Java,,129,26,123,278
TextBoundaryData.java,Java,,257,10,46,313
UnicodeClassMapping.java,Java,,43,8,60,111
Utility.java,Java,,273,30,160,463
WordBreakData.java,Java,,286,38,113,437
WordBreakTable.java,Java,,31,9,71,111
AbstractCollection.java,Java,,122,27,301,450
AbstractList.java,Java,,330,76,446,852
AbstractMap.java,Java,,200,41,330,571
AbstractSequentialList.java,Java,,53,14,189,256
AbstractSet.java,Java,,25,8,65,98
ArrayList.java,Java,,193,52,280,525
Arrays.java,Java,,989,210,1000,2199
BitSet.java,Java,,194,56,250,500
Calendar.java,Java,,414,105,968,1487
Collection.java,Java,,18,24,308,350
Collections.java,Java,,815,162,702,1679
Comparator.java,Java,,5,4,123,132
ConcurrentModificationException.java,Java,,8,3,40,51
Date.java,Java,,405,47,732,1184
Dictionary.java,Java,,13,9,116,138
EmptyStackException.java,Java,,6,2,19,27
Enumeration.java,Java,,5,3,56,64
EventListener.java,Java,,3,2,9,14
EventObject.java,Java,,15,7,33,55
GregorianCalendar.java,Java,,777,190,963,1930
HashMap.java,Java,,429,88,285,802
HashSet.java,Java,,71,24,148,243
Hashtable.java,Java,,461,93,373,927
Iterator.java,Java,,6,4,52,62
Attributes.java,Java,,220,52,266,538
JarEntry.java,Java,,26,8,46,80
JarException.java,Java,,9,3,21,33
JarFile.java,Java,,162,24,93,279
JarInputStream.java,Java,,88,16,73,177
JarOutputStream.java,Java,,58,10,62,130
JarVerifier.java,Java,,250,62,88,400
Manifest.java,Java,,240,35,104,379
LinkedList.java,Java,,300,66,299,665
List.java,Java,,28,41,432,501
ListIterator.java,Java,,12,13,131,156
ListResourceBundle.java,Java,,59,12,139,210
Locale.java,Java,,505,113,606,1224
Map.java,Java,,24,27,313,364
MissingResourceException.java,Java,,17,9,67,93
NoSuchElementException.java,Java,,10,3,28,41
Observable.java,Java,,45,15,133,193
Observer.java,Java,,4,1,25,30
Properties.java,Java,,252,34,263,549
PropertyPermission.java,Java,,216,86,239,541
PropertyResourceBundle.java,Java,,46,10,106,162
Random.java,Java,,81,24,330,435
ResourceBundle.java,Java,,259,48,393,700
Set.java,Java,,18,26,229,273
SimpleTimeZone.java,Java,,493,79,739,1311
SortedMap.java,Java,,9,8,192,209
SortedSet.java,Java,,9,8,190,207
Stack.java,Java,,34,13,71,118
StringTokenizer.java,Java,,85,19,160,264
TimeZone.java,Java,,765,55,1167,1987
TooManyListenersException.java,Java,,9,8,36,53
TreeMap.java,Java,,866,164,583,1613
TreeSet.java,Java,,99,33,309,441
Vector.java,Java,,320,71,588,979
WeakHashMap.java,Java,,184,66,180,430
Adler32.java,Java,,35,11,36,82
CheckedInputStream.java,Java,,42,8,43,93
CheckedOutputStream.java,Java,,23,7,36,66
Checksum.java,Java,,8,5,24,37
CRC32.java,Java,,34,11,34,79
DataFormatException.java,Java,,10,3,20,33
Deflater.java,Java,,150,32,165,347
DeflaterOutputStream.java,Java,,60,12,66,138
GZIPInputStream.java,Java,,115,18,84,217
GZIPOutputStream.java,Java,,55,13,62,130
Inflater.java,Java,,120,22,140,282
InflaterInputStream.java,Java,,103,17,87,207
ZipConstants.java,Java,,43,7,31,81
ZipEntry.java,Java,,146,33,124,303
ZipException.java,Java,,11,6,24,41
ZipFile.java,Java,,211,32,84,327
ZipInputStream.java,Java,,264,21,109,394
ZipOutputStream.java,Java,,332,24,122,478
Accessible.java,Java,,4,3,26,33
AccessibleAction.java,Java,,6,5,48,59
AccessibleBundle.java,Java,,37,10,61,108
AccessibleComponent.java,Java,,32,30,236,298
AccessibleContext.java,Java,,85,38,381,504
AccessibleHyperlink.java,Java,,15,13,96,124
AccessibleHypertext.java,Java,,10,8,46,64
AccessibleResourceBundle.java,Java,,82,5,41,128
AccessibleRole.java,Java,,103,70,338,511
AccessibleSelection.java,Java,,10,9,78,97
AccessibleState.java,Java,,62,32,226,320
AccessibleStateSet.java,Java,,86,14,81,181
AccessibleText.java,Java,,21,19,125,165
AccessibleValue.java,Java,,7,7,61,75
AbstractAction.java,Java,,223,31,155,409
AbstractButton.java,Java,[PENDING:  WDW -- need to provide a localized string,702,134,600,1436
AbstractListModel.java,Java,,52,16,69,137
Action.java,Java,,17,6,138,161
AncestorNotifier.java,Java,,142,30,43,215
AppContext.java,Java,,61,16,157,234
Autoscroller.java,Java,,73,17,10,100
AbstractBorder.java,Java,,33,9,34,76
BevelBorder.java,Java,,106,34,80,220
Border.java,Java,,11,4,54,69
CompoundBorder.java,Java,,66,16,73,155
EmptyBorder.java,Java,,35,9,47,91
EtchedBorder.java,Java,,59,20,83,162
LineBorder.java,Java,,63,16,70,149
MatteBorder.java,Java,,106,20,64,190
SoftBevelBorder.java,Java,,62,19,60,141
TitledBorder.java,Java,,356,62,184,602
BorderFactory.java,Java,,108,28,255,391
BoundedRangeModel.java,Java,,18,30,194,242
Box.java,Java,,345,104,708,1157
BoxLayout.java,Java,,149,33,201,383
ButtonGroup.java,Java,,48,12,57,117
ButtonModel.java,Java,,27,25,156,208
CellEditor.java,Java,,12,10,105,127
CellRendererPane.java,Java,,199,70,299,568
AbstractColorChooserPanel.java,Java,,52,16,41,109
CenterLayout.java,Java,,41,9,12,62
ColorChooserComponentFactory.java,Java,,14,10,21,45
ColorSelectionModel.java,Java,,10,6,32,48
DefaultColorSelectionModel.java,Java,,43,15,37,95
DefaultHSBChooserPanel.java,Java,,557,159,26,742
DefaultPreviewPanel.java,Java,,139,49,20,208
DefaultRGBChooserPanel.java,Java,,148,48,33,229
DefaultSwatchChooserPanel.java,Java,,489,66,23,578
JIntegerTextField.java,Java,,122,38,12,172
SmartGridLayout.java,Java,,94,48,15,157
SyntheticImage.java,Java,,98,21,35,154
ComboBoxEditor.java,Java,,11,8,20,39
ComboBoxModel.java,Java,,5,4,18,27
DebugGraphics.java,Java,,1041,191,237,1469
DebugGraphicsFilter.java,Java,,13,5,11,29
DebugGraphicsInfo.java,Java,,32,9,12,53
DebugGraphicsObserver.java,Java,,19,6,11,36
DefaultBoundedRangeModel.java,Java,,133,51,165,349
DefaultButtonModel.java,Java,,168,52,214,434
DefaultCellEditor.java,Java,,166,48,118,332
DefaultComboBoxModel.java,Java,,96,25,46,167
DefaultDesktopManager.java,Java,,378,107,99,584
DefaultFocusManager.java,Java,,260,47,56,363
DefaultListCellRenderer.java,Java,,49,18,37,104
DefaultListModel.java,Java,,140,42,337,519
DefaultListSelectionModel.java,Java,,309,77,192,578
DefaultSingleSelectionModel.java,Java,,44,19,45,108
DesktopManager.java,Java,,19,11,69,99
AncestorEvent.java,Java,,25,7,52,84
AncestorListener.java,Java,,10,8,36,54
CaretEvent.java,Java,,9,7,37,53
CaretListener.java,Java,,5,5,18,28
CellEditorListener.java,Java,,7,7,15,29
ChangeEvent.java,Java,,7,4,26,37
ChangeListener.java,Java,,5,5,17,27
DocumentEvent.java,Java,,28,20,118,166
DocumentListener.java,Java,,7,5,49,61
EventListenerList.java,Java,,98,15,130,243
HyperlinkEvent.java,Java,,40,18,68,126
HyperlinkListener.java,Java,,5,5,17,27
InternalFrameAdapter.java,Java,,10,8,45,63
InternalFrameEvent.java,Java,,46,13,72,131
InternalFrameListener.java,Java,,11,9,50,70
ListDataEvent.java,Java,,20,11,54,85
ListDataListener.java,Java,,7,9,33,49
ListSelectionEvent.java,Java,,29,10,56,95
ListSelectionListener.java,Java,,6,8,19,33
MenuDragMouseEvent.java,Java,,24,7,52,83
MenuDragMouseListener.java,Java,,8,5,36,49
MenuEvent.java,Java,,7,4,28,39
MenuKeyEvent.java,Java,,23,7,48,78
MenuKeyListener.java,Java,,7,7,22,36
MenuListener.java,Java,,7,5,27,39
MouseInputAdapter.java,Java,,11,7,24,42
MouseInputListener.java,Java,,5,5,13,23
PopupMenuEvent.java,Java,,7,2,26,35
PopupMenuListener.java,Java,,7,6,22,35
SwingPropertyChangeSupport.java,Java,,147,30,76,253
TableColumnModelEvent.java,Java,,15,10,43,68
TableColumnModelListener.java,Java,,12,9,22,43
TableModelEvent.java,Java,,38,18,102,158
TableModelListener.java,Java,,6,5,18,29
TreeExpansionEvent.java,Java,,12,5,34,51
TreeExpansionListener.java,Java,,7,5,18,30
TreeModelEvent.java,Java,,75,16,193,284
TreeModelListener.java,Java,,8,8,54,70
TreeSelectionEvent.java,Java,,65,13,75,153
TreeSelectionListener.java,Java,,6,3,20,29
TreeWillExpandListener.java,Java,,7,5,19,31
UndoableEditEvent.java,Java,,12,5,31,48
UndoableEditListener.java,Java,,5,5,16,26
FileFilter.java,Java,,6,4,33,43
FileSystemView.java,Java,,297,69,119,485
FileView.java,Java,,10,8,61,79
FocusManager.java,Java,,59,14,49,122
GraphicsWrapper.java,Java,,10,8,12,30
GrayFilter.java,Java,,31,9,37,77
Icon.java,Java,,9,6,26,41
ImageIcon.java,Java,,153,37,141,331
JApplet.java,Java,,254,82,471,807
JButton.java,Java,,71,30,146,247
JCheckBox.java,Java,,62,27,141,230
JCheckBoxMenuItem.java,Java,,72,26,148,246
JColorChooser.java,Java,,250,89,270,609
JComboBox.java,Java,[PENDING:  WDW -- need to provide a localized string,460,110,525,1095
JComponent.java,Java,,1933,463,1673,4069
JDesktopPane.java,Java,,100,32,141,273
JDialog.java,Java,,385,112,603,1100
JEditorPane.java,Java,,843,126,839,1808
JFileChooser.java,Java,,567,161,697,1425
JFrame.java,Java,,335,89,576,1000
JInternalFrame.java,Java,,744,161,889,1794
JLabel.java,Java,,323,89,549,961
JLayeredPane.java,Java,,287,66,354,707
JList.java,Java,,1062,262,1055,2379
JMenu.java,Java,,754,137,579,1470
JMenuBar.java,Java,,321,77,310,708
JMenuItem.java,Java,,276,68,315,659
JOptionPane.java,Java,,685,141,1122,1948
JPanel.java,Java,,57,22,111,190
JPasswordField.java,Java,,84,30,194,308
JPopupMenu.java,Java,,1224,229,695,2148
JProgressBar.java,Java,,277,79,458,814
JRadioButton.java,Java,,60,30,149,239
JRadioButtonMenuItem.java,Java,,61,23,131,215
JRootPane.java,Java,,316,64,383,763
JScrollBar.java,Java,,285,106,432,823
JScrollPane.java,Java,,428,138,620,1186
JSeparator.java,Java,,85,28,133,246
JSlider.java,Java,,455,162,546,1163
JSplitPane.java,Java,,364,156,524,1044
JTabbedPane.java,Java,,663,152,580,1395
JTable.java,Java,,2027,433,2046,4506
JTextArea.java,Java,,280,54,423,757
JTextField.java,Java,,201,54,373,628
JTextPane.java,Java,,156,36,252,444
JToggleButton.java,Java,,128,46,173,347
JToolBar.java,Java,[WDW - need to add orientation from BoxLayout,353,71,282,706
JToolTip.java,Java,,70,28,131,229
JTree.java,Java,,2070,399,1754,4223
JViewport.java,Java,,660,153,533,1346
JWindow.java,Java,,237,78,471,786
KeyboardManager.java,Java,,217,49,87,353
KeyStroke.java,Java,,266,46,192,504
ListCellRenderer.java,Java,,11,4,55,70
ListModel.java,Java,,9,7,34,50
ListSelectionModel.java,Java,,28,36,191,255
LookAndFeel.java,Java,,167,53,182,402
MenuElement.java,Java,,10,10,43,63
MenuSelectionManager.java,Java,,284,48,97,429
MultiUIDefaults.java,Java,,114,30,11,155
MutableComboBoxModel.java,Java,,7,7,24,38
OverlayLayout.java,Java,,113,26,118,257
BasicArrowButton.java,Java,,141,30,24,195
BasicBorders.java,Java,,224,48,24,296
BasicButtonListener.java,Java,,180,47,33,260
BasicButtonUI.java,Java,,227,64,80,371
BasicCheckBoxMenuItemUI.java,Java,,41,16,14,71
BasicCheckBoxUI.java,Java,,16,10,22,48
BasicColorChooserUI.java,Java,,150,56,18,224
BasicComboBoxEditor.java,Java,,46,15,30,91
BasicComboBoxRenderer.java,Java,,53,19,39,111
BasicComboBoxUI.java,Java,,787,167,316,1270
BasicComboPopup.java,Java,,567,116,234,917
BasicDesktopIconUI.java,Java,,174,45,26,245
BasicDesktopPaneUI.java,Java,,170,33,24,227
BasicDirectoryModel.java,Java,,231,52,57,340
BasicEditorPaneUI.java,Java,,25,10,42,77
BasicFileChooserUI.java,Java,,477,119,57,653
BasicGraphicsUtils.java,Java,,190,69,45,304
BasicHTML.java,Java,,158,45,238,441
BasicIconFactory.java,Java,,151,33,20,204
BasicInternalFrameTitlePane.java,Java,,351,82,78,511
BasicInternalFrameUI.java,Java,,868,185,156,1209
BasicLabelUI.java,Java,,249,58,102,409
BasicListUI.java,Java,,800,211,501,1512
BasicLookAndFeel.java,Java,,635,133,90,858
BasicMenuBarUI.java,Java,,180,36,23,239
BasicMenuItemUI.java,Java,,648,107,105,860
BasicMenuUI.java,Java,,643,77,17,737
BasicOptionPaneUI.java,Java,,684,135,198,1017
BasicPanelUI.java,Java,,34,11,13,58
BasicPasswordFieldUI.java,Java,,17,12,35,64
BasicPopupMenuSeparatorUI.java,Java,,27,9,13,49
BasicPopupMenuUI.java,Java,,248,60,41,349
BasicProgressBarUI.java,Java,,267,49,111,427
BasicRadioButtonMenuItemUI.java,Java,,42,14,13,69
BasicRadioButtonUI.java,Java,,153,40,46,239
BasicScrollBarUI.java,Java,,619,163,194,976
BasicScrollPaneUI.java,Java,,370,88,81,539
BasicSeparatorUI.java,Java,,68,22,14,104
BasicSliderUI.java,Java,,1131,236,124,1491
BasicSplitPaneDivider.java,Java,,517,125,233,875
BasicSplitPaneUI.java,Java,,1062,264,475,1801
BasicTabbedPaneUI.java,Java,,1526,257,169,1952
BasicTableHeaderUI.java,Java,,306,78,93,477
BasicTableUI.java,Java,,689,162,172,1023
BasicTextAreaUI.java,Java,,39,8,55,102
BasicTextFieldUI.java,Java,,32,11,51,94
BasicTextPaneUI.java,Java,,55,9,56,120
BasicTextUI.java,Java,,586,126,717,1429
BasicToggleButtonUI.java,Java,,102,34,28,164
BasicToolBarSeparatorUI.java,Java,,49,16,14,79
BasicToolBarUI.java,Java,,677,138,54,869
BasicToolTipUI.java,Java,,131,26,24,181
BasicTreeUI.java,Java,,2221,424,657,3302
BasicViewportUI.java,Java,,31,11,13,55
CenterLayout.java,Java,,41,9,12,62
ComboPopup.java,Java,,15,11,46,72
DefaultMenuLayout.java,Java,,9,5,15,29
BorderUIResource.java,Java,,152,43,31,226
ButtonUI.java,Java,,5,3,12,20
ColorChooserUI.java,Java,,6,6,13,25
ColorUIResource.java,Java,,18,7,22,47
ComboBoxUI.java,Java,,7,6,22,35
ComponentUI.java,Java,,45,16,27,88
DesktopIconUI.java,Java,,3,4,12,19
DesktopPaneUI.java,Java,,3,4,12,19
DimensionUIResource.java,Java,,9,4,23,36
FileChooserUI.java,Java,,14,7,12,33
FontUIResource.java,Java,,12,5,23,40
IconUIResource.java,Java,,25,8,31,64
InsetsUIResource.java,Java,,9,4,23,36
InternalFrameUI.java,Java,,3,3,12,18
LabelUI.java,Java,,3,2,12,17
ListUI.java,Java,,10,9,37,56
MenuBarUI.java,Java,,5,5,13,23
MenuItemUI.java,Java,,5,3,14,22
DefaultMetalTheme.java,Java,,42,12,26,80
MetalBorders.java,Java,,296,97,28,421
MetalBumps.java,Java,,154,42,37,233
MetalButtonUI.java,Java,,95,30,39,164
MetalCheckBoxIcon.java,Java,,43,14,19,76
MetalCheckBoxUI.java,Java,,29,14,29,72
MetalComboBoxButton.java,Java,,110,26,24,160
MetalComboBoxEditor.java,Java,,37,13,34,84
MetalComboBoxIcon.java,Java,,24,11,22,57
MetalComboBoxUI.java,Java,,337,69,44,450
MetalDesktopIconUI.java,Java,,67,19,12,98
MetalFileChooserUI.java,Java,,645,152,124,921
MetalIconFactory.java,Java,,1379,335,249,1963
MetalInternalFrameTitlePane.java,Java,,310,98,25,433
MetalInternalFrameUI.java,Java,,104,34,15,153
MetalLabelUI.java,Java,,18,11,21,50
MetalLookAndFeel.java,Java,,597,102,69,768
MetalPopupMenuSeparatorUI.java,Java,,29,13,13,55
MetalProgressBarUI.java,Java,,49,11,37,97
MetalRadioButtonUI.java,Java,,115,32,38,185
MetalScrollBarUI.java,Java,,260,131,35,426
MetalScrollButton.java,Java,,211,57,43,311
MetalScrollPaneUI.java,Java,,54,19,19,92
MetalSeparatorUI.java,Java,,45,15,20,80
MetalSliderUI.java,Java,,220,51,38,309
MetalSplitPaneDivider.java,Java,,232,36,81,349
MetalSplitPaneUI.java,Java,,13,6,25,44
MetalTabbedPaneUI.java,Java,,454,135,107,696
MetalTextFieldUI.java,Java,,36,9,19,64
MetalTheme.java,Java,,57,18,14,89
MetalToggleButtonUI.java,Java,,86,24,36,146
MetalToolBarUI.java,Java,,297,76,17,390
MetalToolTipUI.java,Java,,73,16,19,108
MetalTreeUI.java,Java,,127,40,38,205
MetalUtils.java,Java,,94,31,37,162
MultiButtonUI.java,Java,,88,18,81,187
MultiColorChooserUI.java,Java,,88,18,81,187
MultiComboBoxUI.java,Java,,110,21,94,225
MultiDesktopIconUI.java,Java,,88,18,81,187
MultiDesktopPaneUI.java,Java,,88,18,81,187
MultiFileChooserUI.java,Java,,135,24,107,266
MultiInternalFrameUI.java,Java,,88,18,81,187
MultiLabelUI.java,Java,,88,18,81,187
MultiListUI.java,Java,,115,21,96,232
MultiLookAndFeel.java,Java,,117,16,46,179
MultiMenuBarUI.java,Java,,88,18,81,187
MultiMenuItemUI.java,Java,,89,19,84,192
MultiOptionPaneUI.java,Java,,102,20,89,211
MultiPanelUI.java,Java,,88,18,81,187
MultiPopupMenuUI.java,Java,,88,18,81,187
MultiProgressBarUI.java,Java,,88,18,81,187
MultiScrollBarUI.java,Java,,88,18,81,187
MultiScrollPaneUI.java,Java,,88,18,81,187
MultiSeparatorUI.java,Java,,88,18,81,187
MultiSliderUI.java,Java,,88,18,81,187
MultiSplitPaneUI.java,Java,,128,24,105,257
MultiTabbedPaneUI.java,Java,,114,21,96,231
MultiTableHeaderUI.java,Java,,88,18,81,187
MultiTableUI.java,Java,,88,18,81,187
MultiTextUI.java,Java,,171,26,151,348
MultiToolBarUI.java,Java,,88,18,81,187
MultiToolTipUI.java,Java,,88,18,81,187
MultiTreeUI.java,Java,,165,28,127,320
MultiViewportUI.java,Java,,88,18,81,187
OptionPaneUI.java,Java,,7,5,20,32
PanelUI.java,Java,,3,4,12,19
PopupMenuUI.java,Java,,5,5,13,23
ProgressBarUI.java,Java,,3,3,12,18
ScrollBarUI.java,Java,,3,2,12,17
ScrollPaneUI.java,Java,,3,4,12,19
SeparatorUI.java,Java,,3,4,13,20
SliderUI.java,Java,,3,3,12,18
SplitPaneUI.java,Java,,12,8,32,52
TabbedPaneUI.java,Java,,8,3,13,24
TableHeaderUI.java,Java,,3,2,12,17
TableUI.java,Java,,3,2,12,17
TextUI.java,Java,,25,12,100,137
ToolBarUI.java,Java,,5,5,12,22
ToolTipUI.java,Java,,3,2,12,17
TreeUI.java,Java,,18,12,58,88
UIResource.java,Java,,3,4,43,50
ViewportUI.java,Java,,3,4,12,19
ProgressMonitor.java,Java,,198,51,140,389
ProgressMonitorInputStream.java,Java,,73,25,66,164
Renderer.java,Java,,6,3,25,34
RepaintManager.java,Java,,317,84,161,562
RootPaneContainer.java,Java,,13,18,108,139
Scrollable.java,Java,,11,11,86,108
ScrollPaneConstants.java,Java,,21,7,56,84
ScrollPaneLayout.java,Java,,415,127,358,900
SingleSelectionModel.java,Java,,10,8,42,60
SizeRequirements.java,Java,,131,25,195,351
SwingConstants.java,Java,,20,7,81,108
SwingGraphics.java,Java,,454,147,50,651
SwingUtilities.java,Java,,1015,235,410,1660
SystemEventQueueUtilities.java,Java,,460,185,275,920
AbstractTableModel.java,Java,,66,24,130,220
DefaultTableCellRenderer.java,Java,,65,23,57,145
DefaultTableColumnModel.java,Java,,258,77,243,578
DefaultTableModel.java,Java,,217,72,354,643
JTableHeader.java,Java,,700,142,347,1189
TableCellEditor.java,Java,,9,7,37,53
TableCellRenderer.java,Java,,8,5,32,45
TableColumn.java,Java,,218,74,373,665
TableColumnModel.java,Java,,27,25,134,186
TableModel.java,Java,,15,13,95,123
AbstractDocument.java,Java,,1039,269,1308,2616
AbstractWriter.java,Java,,140,30,165,335
ArabicLigaturizer.java,Java,,57,14,40,111
AttributeSet.java,Java,,23,18,121,162
BadLocationException.java,Java,,12,3,31,46
Bidi.java,Java,,740,130,197,1067
BigBoxView.java,Java,,238,46,309,593
BoxView.java,Java,,490,55,335,880
Caret.java,Java,,24,21,126,171
ChangedCharSetException.java,Java,,16,7,13,36
CharBasedLigaturizer.java,Java,,166,33,95,294
ComponentView.java,Java,,228,35,183,446
CompositeView.java,Java,,525,58,521,1104
DefaultCaret.java,Java,,557,101,503,1161
DefaultEditorKit.java,Java,,914,186,852,1952
DefaultHighlighter.java,Java,,289,43,155,487
DefaultStyledDocument.java,Java,,1383,190,777,2350
DefaultTextUI.java,Java,,4,5,15,24
Document.java,Java,,23,23,372,418
EditorKit.java,Java,,26,16,154,196
Element.java,Java,,13,14,75,102
ElementIterator.java,Java,,147,42,150,339
ExtendedTextLabel.java,Java,,22,19,58,99
FieldView.java,Java,,119,17,126,262
GapContent.java,Java,,510,93,315,918
GapVector.java,Java,,117,32,144,293
Highlighter.java,Java,,22,20,94,136
BlockView.java,Java,,98,14,71,183
BRView.java,Java,,17,5,22,44
CommentView.java,Java,,85,13,15,113
CSS.java,Java,,1090,202,505,1797
EditableView.java,Java,,63,11,30,104
FormView.java,Java,,300,49,179,528
FrameSetView.java,Java,,178,33,106,317
FrameView.java,Java,,188,42,110,340
HiddenTagView.java,Java,,204,34,27,265
HRuleView.java,Java,,121,22,80,223
HTML.java,Java,,362,41,116,519
HTMLDocument.java,Java,,1866,305,1125,3296
HTMLEditorKit.java,Java,,732,99,549,1380
HTMLFrameHyperlinkEvent.java,Java,,38,12,60,110
HTMLWriter.java,Java,,961,116,408,1485
ImageView.java,Java,,481,82,191,754
InlineView.java,Java,,73,13,42,128
IsindexView.java,Java,,52,15,31,98
LineView.java,Java,,62,11,94,167
ListView.java,Java,,55,8,44,107
Map.java,Java,,341,47,90,478
MinimalHTMLWriter.java,Java,,280,76,247,603
NoFramesView.java,Java,,57,15,82,154
ObjectView.java,Java,,74,11,82,167
Option.java,Java,,38,12,46,96
OptionComboBoxModel.java,Java,,13,7,26,46
OptionListModel.java,Java,,301,73,168,542
ParagraphView.java,Java,,132,22,118,272
AttributeList.java,Java,,83,19,53,155
ContentModel.java,Java,,144,26,57,227
ContentModelState.java,Java,,169,27,61,257
DocumentParser.java,Java,,137,24,35,196
DTD.java,Java,,251,33,87,371
DTDConstants.java,Java,,39,6,21,66
Element.java,Java,,79,22,57,158
Entity.java,Java,,53,15,35,103
Parser.java,Java,,1405,229,373,2007
ParserDelegator.java,Java,,61,15,28,104
ResourceLoader.java,Java,,16,7,20,43
TagElement.java,Java,,33,15,13,61
TagStack.java,Java,,123,29,53,205
ResourceLoader.java,Java,,16,7,20,43
StyleSheet.java,Java,,2017,221,937,3175
TableView.java,Java,,170,39,214,423
TextAreaDocument.java,Java,,20,12,23,55
IconView.java,Java,,58,13,92,163
JTextComponent.java,Java,,1352,246,1574,3172
Keymap.java,Java,,18,16,94,128
LabelView.java,Java,,688,117,592,1397
LayeredHighlighter.java,Java,,14,4,28,46
Ligaturizer.java,Java,,8,5,32,45
MutableAttributeSet.java,Java,,10,20,55,85
NewArabicShaping.java,Java,,91,29,80,200
ParagraphView.java,Java,,732,90,496,1318
PasswordView.java,Java,,78,11,84,173
PlainDocument.java,Java,,150,15,96,261
PlainView.java,Java,,341,44,235,620
Position.java,Java,,15,8,39,62
RLEUtilities.java,Java,,110,25,68,203
AbstractFilter.java,Java,,108,27,77,212
Constants.java,Java,,28,10,22,60
MockAttributeSet.java,Java,,78,22,8,108
RTFAttribute.java,Java,,26,7,16,49
RTFAttributes.java,Java,,324,64,16,404
RTFEditorKit.java,Java,,46,14,89,149
RTFGenerator.java,Java,,764,130,97,991
RTFParser.java,Java,,228,35,53,316
RTFReader.java,Java,,1114,228,286,1628
Segment.java,Java,,22,10,42,74
SimpleAttributeSet.java,Java,,178,33,152,363
StandardExtendedTextLabel.java,Java,,349,81,258,688
StateInvariantError.java,Java,,7,2,19,28
StringContent.java,Java,,264,40,169,473
Style.java,Java,,11,10,36,57
StyleConstants.java,Java,,316,130,550,996
StyleContext.java,Java,,685,140,714,1539
StyledDocument.java,Java,,17,16,127,160
StyledEditorKit.java,Java,,338,64,373,775
TabableView.java,Java,,5,4,45,54
TabExpander.java,Java,,4,4,22,30
TableView.java,Java,,412,74,393,879
TabSet.java,Java,,66,15,52,133
TabStop.java,Java,,76,15,64,155
TextAction.java,Java,,43,7,66,116
TextLabel.java,Java,,26,14,54,94
Utilities.java,Java,,358,77,210,645
View.java,Java,,187,49,624,860
ViewFactory.java,Java,,5,4,22,31
WrappedPlainView.java,Java,,361,57,309,727
Timer.java,Java,,124,62,137,323
TimerQueue.java,Java,,167,60,40,267
ToolTipManager.java,Java,,517,92,160,769
AbstractLayoutCache.java,Java,,132,56,237,425
DefaultMutableTreeNode.java,Java,,646,227,605,1478
DefaultTreeCellEditor.java,Java,,316,85,207,608
DefaultTreeCellRenderer.java,Java,,187,49,120,356
DefaultTreeModel.java,Java,,244,54,250,548
DefaultTreeSelectionModel.java,Java,,680,113,258,1051
ExpandVetoException.java,Java,,12,6,24,42
FixedHeightLayoutCache.java,Java,,974,186,430,1590
MutableTreeNode.java,Java,,10,8,35,53
RowMapper.java,Java,,6,3,20,29
TreeCellEditor.java,Java,,10,4,32,46
TreeCellRenderer.java,Java,,8,4,26,38
TreeModel.java,Java,,13,15,73,101
TreeNode.java,Java,,12,10,39,61
TreePath.java,Java,,138,33,120,291
TreeSelectionModel.java,Java,,36,33,148,217
VariableHeightLayoutCache.java,Java,,1061,191,458,1710
UIDefaults.java,Java,,215,51,246,512
UIManager.java,Java,,454,115,377,946
AbstractUndoableEdit.java,Java,,70,24,112,206
CannotRedoException.java,Java,,3,2,19,24
CannotUndoException.java,Java,,3,3,19,25
CompoundEdit.java,Java,,110,21,96,227
StateEdit.java,Java,,59,27,90,176
StateEditable.java,Java,,7,8,21,36
UndoableEdit.java,Java,,15,14,85,114
UndoableEditSupport.java,Java,,66,16,67,149
UndoManager.java,Java,,208,44,200,452
UnsupportedLookAndFeelException.java,Java,,7,1,24,32
ViewportLayout.java,Java,,71,19,78,168
WindowConstants.java,Java,,7,6,30,43
java.c,C/C++/ObjC,,615,78,120,813
java.h,h,,13,6,18,37
java_md.c,C/C++/ObjC,,178,30,38,246
java_md.h,h,,18,7,14,39
Any.java,Java,,76,90,525,691
AnyHolder.java,Java,,21,9,57,87
ARG_IN.java,Java,,4,5,29,38
ARG_INOUT.java,Java,,4,7,26,37
ARG_OUT.java,Java,,4,6,26,36
BAD_CONTEXT.java,Java,,15,7,47,69
BAD_INV_ORDER.java,Java,,15,8,43,66
BAD_OPERATION.java,Java,,15,7,43,65
BAD_PARAM.java,Java,,15,7,47,69
BAD_POLICY.java,Java,,4,2,6,12
BAD_POLICY_TYPE.java,Java,,4,2,6,12
BAD_POLICY_VALUE.java,Java,,4,2,6,12
BAD_TYPECODE.java,Java,,15,7,44,66
BooleanHolder.java,Java,,21,9,59,89
Bounds.java,Java,,9,5,22,36
ByteHolder.java,Java,,21,10,59,90
CharHolder.java,Java,,21,10,60,91
COMM_FAILURE.java,Java,,15,7,50,72
CompletionStatus.java,Java,,27,13,73,113
Context.java,Java,,11,19,195,225
ContextList.java,Java,,7,12,70,89
CTX_RESTRICT_SCOPE.java,Java,,4,3,24,31
Current.java,Java,,4,3,34,41
DATA_CONVERSION.java,Java,,15,7,43,65
DefinitionKind.java,Java,,112,4,30,146
DomainManager.java,Java,,5,5,17,27
DoubleHolder.java,Java,,21,12,56,89
DynamicImplementation.java,Java,,6,6,27,39
DynAny.java,Java,,89,69,675,833
Invalid.java,Java,,10,4,11,25
InvalidSeq.java,Java,,10,4,11,25
InvalidValue.java,Java,,10,3,7,20
TypeMismatch.java,Java,,10,4,12,26
DynArray.java,Java,,7,6,21,34
DynEnum.java,Java,,8,7,30,45
DynFixed.java,Java,,7,5,21,33
DynSequence.java,Java,,9,7,32,48
DynStruct.java,Java,,9,7,29,45
DynUnion.java,Java,,12,11,52,75
DynValue.java,Java,,8,6,30,44
Environment.java,Java,,6,10,28,44
ExceptionList.java,Java,,9,11,73,93
FixedHolder.java,Java,,21,11,46,78
FloatHolder.java,Java,,21,9,55,85
FREE_MEM.java,Java,,15,6,42,63
IDLType.java,Java,,6,2,22,30
IMP_LIMIT.java,Java,,15,7,42,64
INITIALIZE.java,Java,,15,6,47,68
INTERNAL.java,Java,,15,6,48,69
INTF_REPOS.java,Java,,15,6,40,61
IntHolder.java,Java,,21,9,62,92
INVALID_TRANSACTION.java,Java,,15,6,42,63
INV_FLAG.java,Java,,15,6,43,64
INV_IDENT.java,Java,,15,6,43,64
INV_OBJREF.java,Java,,15,6,46,67
INV_POLICY.java,Java,,15,6,42,63
IRObject.java,Java,,7,1,33,41
LongHolder.java,Java,,21,10,57,88
MARSHAL.java,Java,,15,6,42,63
NamedValue.java,Java,,6,10,92,108
NameValuePair.java,Java,,10,8,27,45
NO_IMPLEMENT.java,Java,,15,6,43,64
NO_MEMORY.java,Java,,15,7,42,64
NO_PERMISSION.java,Java,,15,6,41,62
NO_RESOURCES.java,Java,,15,6,42,63
NO_RESPONSE.java,Java,,15,6,41,62
NVList.java,Java,,9,16,137,162
Object.java,Java,,25,35,191,251
ObjectHolder.java,Java,,21,9,61,91
OBJECT_NOT_EXIST.java,Java,,15,6,44,65
OBJ_ADAPTER.java,Java,,15,6,44,65
ORB.java,Java,,286,114,775,1175
InconsistentTypeCode.java,Java,,10,4,20,34
InvalidName.java,Java,,9,4,23,36
PERSIST_STORE.java,Java,,15,6,40,61
Policy.java,Java,,7,7,25,39
PolicyError.java,Java,,15,7,30,52
ApplicationException.java,Java,,16,6,24,46
Delegate.java,Java,,86,29,220,335
IDLEntity.java,Java,,3,3,13,19
InputStream.java,Java,,53,12,49,114
InvokeHandler.java,Java,,6,4,44,54
ObjectImpl.java,Java,,155,37,85,277
OutputStream.java,Java,,63,12,36,111
RemarshalException.java,Java,,6,2,20,28
ResponseHandler.java,Java,,5,3,28,36
ServantObject.java,Java,,5,4,22,31
Streamable.java,Java,,7,4,32,43
Principal.java,Java,,5,6,24,35
PrincipalHolder.java,Java,,21,11,41,73
PRIVATE_MEMBER.java,Java,,4,1,12,17
PUBLIC_MEMBER.java,Java,,4,1,12,17
Request.java,Java,,25,50,209,284
ServerRequest.java,Java,,35,19,230,284
ServiceDetail.java,Java,,11,4,6,21
ServiceDetailHelper.java,Java,,51,6,7,64
ServiceInformation.java,Java,,13,7,11,31
ServiceInformationHelper.java,Java,,59,7,7,73
ServiceInformationHolder.java,Java,,20,10,60,90
SetOverrideType.java,Java,,25,9,36,70
ShortHolder.java,Java,,21,9,60,90
StringHolder.java,Java,,21,9,59,89
StructMember.java,Java,,12,8,39,59
SystemException.java,Java,,31,11,41,83
TCKind.java,Java,,148,79,298,525
TRANSACTION_REQUIRED.java,Java,,15,6,43,64
TRANSACTION_ROLLEDBACK.java,Java,,15,6,43,64
TRANSIENT.java,Java,,15,6,41,62
TypeCode.java,Java,,42,39,409,490
TypeCodeHolder.java,Java,,21,9,60,90
BadKind.java,Java,,9,4,25,38
Bounds.java,Java,,9,5,24,38
UnionMember.java,Java,,14,9,45,68
UNKNOWN.java,Java,,15,6,43,64
UnknownUserException.java,Java,,11,7,28,46
UNSUPPORTED_POLICY.java,Java,,4,2,6,12
UNSUPPORTED_POLICY_VALUE.java,Java,,4,2,6,12
UserException.java,Java,,9,5,24,38
ValueMember.java,Java,,20,12,60,92
VM_ABSTRACT.java,Java,,4,2,6,12
VM_CUSTOM.java,Java,,4,2,6,12
VM_NONE.java,Java,,4,2,6,12
VM_TRUNCATABLE.java,Java,,4,2,6,12
WrongTransaction.java,Java,,9,4,25,38
Binding.java,Java,,10,1,14,25
BindingHelper.java,Java,,55,3,13,71
BindingHolder.java,Java,,20,4,14,38
BindingIterator.java,Java,,9,1,32,42
BindingIteratorHelper.java,Java,,41,2,13,56
BindingIteratorHolder.java,Java,,20,4,14,38
BindingListHelper.java,Java,,42,2,13,57
BindingListHolder.java,Java,,21,3,14,38
BindingType.java,Java,,24,1,12,37
BindingTypeHelper.java,Java,,33,2,13,48
BindingTypeHolder.java,Java,,20,4,14,38
IstringHelper.java,Java,,31,2,13,46
NameComponent.java,Java,,10,1,14,25
NameComponentHelper.java,Java,,44,3,13,60
NameComponentHolder.java,Java,,20,4,14,38
NameHelper.java,Java,,42,2,13,57
NameHolder.java,Java,,21,3,14,38
NamingContext.java,Java,,23,1,137,161
NamingContextHelper.java,Java,,41,2,13,56
NamingContextHolder.java,Java,,20,4,14,38
AlreadyBound.java,Java,,7,1,13,21
AlreadyBoundHelper.java,Java,,34,2,14,50
AlreadyBoundHolder.java,Java,,20,4,14,38
CannotProceed.java,Java,,14,1,14,29
CannotProceedHelper.java,Java,,57,5,14,76
CannotProceedHolder.java,Java,,20,4,14,38
InvalidName.java,Java,,7,1,13,21
InvalidNameHelper.java,Java,,34,2,14,50
InvalidNameHolder.java,Java,,20,4,14,38
NotEmpty.java,Java,,7,1,13,21
NotEmptyHelper.java,Java,,34,2,14,50
NotEmptyHolder.java,Java,,20,4,14,38
NotFound.java,Java,,14,1,14,29
NotFoundHelper.java,Java,,57,5,14,76
NotFoundHolder.java,Java,,20,4,14,38
NotFoundReason.java,Java,,28,1,12,41
NotFoundReasonHelper.java,Java,,34,2,13,49
NotFoundReasonHolder.java,Java,,20,4,14,38
_BindingIteratorImplBase.java,Java,,71,3,15,89
_BindingIteratorStub.java,Java,,44,6,16,66
_NamingContextImplBase.java,Java,,370,3,15,388
_NamingContextStub.java,Java,,237,6,23,266
TTY.java,Java,,1555,154,107,1816
Serializable.java,Java,,3,3,30,36
EventListener.java,Java,,3,3,30,36
EventObject.java,Java,,6,5,30,41
