CommandHandler.java,Java,,13,8,11,32
NameServiceStartThread.java,Java,,29,7,9,45
ORBD.java,Java,,244,50,56,350
ProcessMonitorThread.java,Java,,55,12,21,88
RepositoryImpl.java,Java,,348,78,46,472
ServerMain.java,Java,,247,71,60,378
ServerManagerImpl.java,Java,,467,109,52,628
ServerTableEntry.java,Java,,380,91,55,526
ServerTool.java,Java,,729,166,61,956
CopierManagerImpl.java,Java,,38,12,6,56
FallbackObjectCopierImpl.java,Java,,22,5,10,37
JavaStreamObjectCopierImpl.java,Java,,39,13,8,60
ORBStreamObjectCopierImpl.java,Java,,27,10,8,45
ReferenceObjectCopierImpl.java,Java,,9,4,6,19
AnyImpl.java,Java,,817,136,366,1319
AnyImplHelper.java,Java,,37,9,17,63
AsynchInvoke.java,Java,,25,15,36,76
ContextImpl.java,Java,,53,16,14,83
ContextListImpl.java,Java,,43,10,15,68
CORBAObjectImpl.java,Java,,8,2,17,27
EnvironmentImpl.java,Java,,22,9,14,45
ExceptionListImpl.java,Java,,40,14,14,68
NamedValueImpl.java,Java,,38,9,16,63
NVListImpl.java,Java,,65,16,16,97
PrincipalImpl.java,Java,,13,5,14,32
RequestImpl.java,Java,,249,49,60,358
ServerRequestImpl.java,Java,,139,41,61,241
TCUtility.java,Java,,233,55,25,313
TypeCodeFactory.java,Java,,7,5,6,18
TypeCodeImpl.java,Java,,1745,288,364,2397
TypeCodeImplHelper.java,Java,,41,10,14,65
DynAnyBasicImpl.java,Java,,535,58,25,618
DynAnyCollectionImpl.java,Java,,117,25,45,187
DynAnyComplexImpl.java,Java,,278,40,85,403
DynAnyConstructedImpl.java,Java,,790,72,57,919
DynAnyFactoryImpl.java,Java,,36,15,16,67
DynAnyImpl.java,Java,,118,27,35,180
DynAnyUtil.java,Java,,214,17,89,320
DynArrayImpl.java,Java,,65,18,37,120
DynEnumImpl.java,Java,,110,21,41,172
DynFixedImpl.java,Java,,122,11,59,192
DynSequenceImpl.java,Java,,129,25,85,239
DynStructImpl.java,Java,,40,10,19,69
DynUnionImpl.java,Java,,249,32,86,367
DynValueBoxImpl.java,Java,,88,15,12,115
DynValueCommonImpl.java,Java,,79,18,32,129
DynValueImpl.java,Java,,25,7,9,41
BufferManagerFactory.java,Java,,92,14,19,125
BufferManagerRead.java,Java,,15,13,49,77
BufferManagerReadGrow.java,Java,,48,18,15,81
BufferManagerReadStream.java,Java,,237,50,52,339
BufferManagerWrite.java,Java,,29,20,84,133
BufferManagerWriteCollect.java,Java,,128,39,46,213
BufferManagerWriteGrow.java,Java,,38,17,19,74
BufferManagerWriteStream.java,Java,,61,25,30,116
BufferQueue.java,Java,,24,6,12,42
ByteBufferWithInfo.java,Java,,153,36,50,239
CachedCodeBase.java,Java,,109,41,43,193
CDRInputObject.java,Java,,136,46,67,249
CDRInputStream.java,Java,,349,109,66,524
CDRInputStreamBase.java,Java,,111,31,41,183
CDRInputStream_1_0.java,Java,,1487,445,500,2432
CDRInputStream_1_1.java,Java,,75,45,51,171
CDRInputStream_1_2.java,Java,,56,25,45,126
CDROutputObject.java,Java,,195,42,68,305
CDROutputStream.java,Java,,312,67,39,418
CDROutputStreamBase.java,Java,,101,31,27,159
CDROutputStream_1_0.java,Java,,1240,377,296,1913
CDROutputStream_1_1.java,Java,,54,30,48,132
CDROutputStream_1_2.java,Java,,138,69,134,341
CodeSetCache.java,Java,,33,15,43,91
CodeSetComponentInfo.java,Java,,197,60,68,325
CodeSetConversion.java,Java,,314,113,262,689
EncapsInputStream.java,Java,,92,26,49,167
EncapsOutputStream.java,Java,,59,20,46,125
IDLJavaSerializationInputStream.java,Java,,748,161,156,1065
IDLJavaSerializationOutputStream.java,Java,,557,129,94,780
MarkAndResetHandler.java,Java,,7,4,10,21
MarshalInputStream.java,Java,,44,10,30,84
MarshalOutputStream.java,Java,,46,13,12,71
OSFCodeSetRegistry.java,Java,,104,21,87,212
RestorableInputStream.java,Java,,6,2,11,19
TypeCodeInputStream.java,Java,,117,21,35,173
TypeCodeOutputStream.java,Java,,132,26,84,242
TypeCodeReader.java,Java,,44,7,8,59
WrapperInputStream.java,Java,,154,21,18,193
CDREncapsCodec.java,Java,,94,29,75,198
ClientRequestInfoImpl.java,Java,,498,135,327,960
CodecFactoryImpl.java,Java,,51,16,37,104
InterceptorInvoker.java,Java,,335,74,235,644
InterceptorList.java,Java,,130,30,83,243
IORInfoImpl.java,Java,,151,53,96,300
ORBInitInfoImpl.java,Java,,175,50,138,363
PICurrent.java,Java,,69,25,61,155
PIHandlerImpl.java,Java,,567,150,259,976
PINoOpHandlerImpl.java,Java,,121,48,12,181
RequestInfoImpl.java,Java,,394,120,393,907
ServerRequestInfoImpl.java,Java,,452,138,299,889
SlotTable.java,Java,,44,13,33,90
SlotTableStack.java,Java,,78,25,67,170
FVDCodeBaseImpl.java,Java,,103,28,35,166
IIOPInputStream.java,Java,,1720,372,627,2719
IIOPOutputStream.java,Java,,534,127,141,802
InputStreamHook.java,Java,,267,85,101,453
JavaCorbaAccess.java,Java,,4,2,4,10
ObjectStreamClass.java,Java,,1022,220,565,1807
ObjectStreamClassCorbaExt.java,Java,,51,14,29,94
ObjectStreamField.java,Java,,154,36,65,255
OptionalDataException.java,Java,,13,6,41,60
OutputStreamHook.java,Java,,141,66,89,296
SharedSecrets.java,Java,,15,6,15,36
TypeMismatchException.java,Java,,12,3,14,29
ValueHandlerImpl.java,Java,,630,134,145,909
ValueUtility.java,Java,,329,66,65,460
ByteBuffer.java,Java,,80,18,92,190
EncapsulationUtility.java,Java,,72,18,31,121
FreezableList.java,Java,,85,24,15,124
GenericIdentifiable.java,Java,,54,16,10,80
GenericTaggedComponent.java,Java,,23,8,14,45
GenericTaggedProfile.java,Java,,58,17,10,85
IdentifiableFactoryFinderBase.java,Java,,45,14,6,65
AlternateIIOPAddressComponentImpl.java,Java,,43,15,9,67
CodeSetsComponentImpl.java,Java,,57,18,10,85
IIOPAddressBase.java,Java,,42,12,15,69
IIOPAddressClosureImpl.java,Java,,24,8,9,41
IIOPAddressImpl.java,Java,,38,13,9,60
IIOPProfileImpl.java,Java,,228,65,37,330
IIOPProfileTemplateImpl.java,Java,,101,33,19,153
JavaCodebaseComponentImpl.java,Java,,43,16,9,68
JavaSerializationComponent.java,Java,,42,13,15,70
MaxStreamFormatVersionComponentImpl.java,Java,,51,19,11,81
ORBTypeComponentImpl.java,Java,,41,15,9,65
RequestPartitioningComponentImpl.java,Java,,56,16,3,75
IORImpl.java,Java,,202,65,51,318
IORTemplateImpl.java,Java,,81,25,14,120
IORTemplateListImpl.java,Java,,84,17,10,111
JIDLObjectKeyTemplate.java,Java,,37,14,14,65
NewObjectKeyTemplateBase.java,Java,,37,12,7,56
ObjectAdapterIdArray.java,Java,,28,8,8,44
ObjectAdapterIdBase.java,Java,,57,17,6,80
ObjectAdapterIdNumber.java,Java,,15,5,12,32
ObjectIdImpl.java,Java,,35,10,9,54
ObjectKeyFactoryImpl.java,Java,,119,35,66,220
ObjectKeyImpl.java,Java,,54,18,9,81
ObjectKeyTemplateBase.java,Java,,128,38,13,179
ObjectReferenceFactoryImpl.java,Java,,75,25,24,124
ObjectReferenceProducerBase.java,Java,,26,13,6,45
ObjectReferenceTemplateImpl.java,Java,,95,28,24,147
OldJIDLObjectKeyTemplate.java,Java,,52,20,29,101
OldObjectKeyTemplateBase.java,Java,,21,7,10,38
OldPOAObjectKeyTemplate.java,Java,,49,13,14,76
POAObjectKeyTemplate.java,Java,,43,16,14,73
StubIORImpl.java,Java,,172,37,42,251
TaggedComponentFactoryFinderImpl.java,Java,,33,11,10,54
TaggedProfileFactoryFinderImpl.java,Java,,17,7,9,33
TaggedProfileTemplateFactoryFinderImpl.java,Java,,18,8,9,35
WireObjectKeyTemplate.java,Java,,91,27,19,137
StubDelegateImpl.java,Java,,92,31,67,190
Util.java,Java,,469,81,209,759
PortableRemoteObject.java,Java,,181,54,111,346
DefaultSocketFactory.java,Java,,88,17,8,113
EndPointInfoImpl.java,Java,,76,16,7,99
LegacyServerSocketManagerImpl.java,Java,,121,23,26,170
SocketFactoryAcceptorImpl.java,Java,,46,12,18,76
SocketFactoryConnectionImpl.java,Java,,72,13,17,102
SocketFactoryContactInfoImpl.java,Java,,56,16,22,94
SocketFactoryContactInfoListImpl.java,Java,,23,8,15,46
SocketFactoryContactInfoListIteratorImpl.java,Java,,66,15,18,99
USLPort.java,Java,,14,6,7,27
ActivationSystemException.java,Java,,186,66,13,265
InterceptorsSystemException.java,Java,,702,238,25,965
IORSystemException.java,Java,,360,123,16,499
NamingSystemException.java,Java,,523,179,16,718
OMGSystemException.java,Java,,2814,951,64,3829
ORBUtilSystemException.java,Java,,6787,2227,49,9063
POASystemException.java,Java,,1539,521,34,2094
UtilSystemException.java,Java,,686,224,25,935
MonitoredAttributeInfoFactoryImpl.java,Java,,14,3,6,23
MonitoredAttributeInfoImpl.java,Java,,27,10,6,43
MonitoredObjectFactoryImpl.java,Java,,10,5,6,21
MonitoredObjectImpl.java,Java,,91,27,15,133
MonitoringManagerFactoryImpl.java,Java,,21,7,6,34
MonitoringManagerImpl.java,Java,,26,12,6,44
BindingIteratorImpl.java,Java,,57,18,92,167
InternalBindingKey.java,Java,,52,8,24,84
InternalBindingValue.java,Java,,15,5,13,33
InterOperableNamingImpl.java,Java,,297,22,77,396
NamingContextDataStore.java,Java,,25,11,61,97
NamingContextImpl.java,Java,,502,66,442,1010
NamingUtils.java,Java,,52,15,47,114
TransientBindingIterator.java,Java,,57,10,49,116
TransientNameServer.java,Java,,132,32,54,218
TransientNameService.java,Java,,68,19,53,140
TransientNamingContext.java,Java,,178,30,132,340
CorbalocURL.java,Java,,140,18,112,270
CorbanameURL.java,Java,,55,10,38,103
IIOPEndpointInfo.java,Java,,41,14,20,75
INSURL.java,Java,,9,9,17,35
INSURLBase.java,Java,,32,11,16,59
INSURLHandler.java,Java,,25,9,13,47
NamingConstants.java,Java,,7,5,11,23
Utility.java,Java,,48,12,25,85
InternalBindingKey.java,Java,,79,13,41,133
InternalBindingValue.java,Java,,25,8,33,66
NameServer.java,Java,,48,17,21,86
NameService.java,Java,,129,24,79,232
NamingContextImpl.java,Java,,632,118,553,1303
PersistentBindingIterator.java,Java,,66,12,61,139
ServantManagerImpl.java,Java,,180,49,30,259
NullServantImpl.java,Java,,15,6,6,27
ActiveObjectMap.java,Java,,187,44,17,248
AOMEntry.java,Java,,169,36,24,229
BadServerIdHandler.java,Java,,6,3,28,37
DelegateImpl.java,Java,,101,19,9,129
IdAssignmentPolicyImpl.java,Java,,30,10,6,46
IdUniquenessPolicyImpl.java,Java,,29,10,6,45
ImplicitActivationPolicyImpl.java,Java,,31,10,6,47
LifespanPolicyImpl.java,Java,,29,10,6,45
POACurrent.java,Java,,115,25,24,164
POAFactory.java,Java,,169,43,18,230
POAImpl.java,Java,,1055,261,358,1674
POAManagerImpl.java,Java,,364,80,85,529
POAPolicyMediator.java,Java,,30,19,58,107
POAPolicyMediatorBase.java,Java,,92,25,14,131
POAPolicyMediatorBase_R.java,Java,,131,41,14,186
POAPolicyMediatorFactory.java,Java,,23,2,9,34
POAPolicyMediatorImpl_NR_UDS.java,Java,,81,23,13,117
POAPolicyMediatorImpl_NR_USM.java,Java,,109,28,13,150
POAPolicyMediatorImpl_R_AOM.java,Java,,60,14,16,90
POAPolicyMediatorImpl_R_UDS.java,Java,,69,19,12,100
POAPolicyMediatorImpl_R_USM.java,Java,,260,53,49,362
Policies.java,Java,,243,43,48,334
RequestProcessingPolicyImpl.java,Java,,40,11,6,57
ServantRetentionPolicyImpl.java,Java,,29,10,6,45
ThreadPolicyImpl.java,Java,,29,10,6,45
TOA.java,Java,,6,5,17,28
TOAFactory.java,Java,,63,22,11,96
TOAImpl.java,Java,,126,32,52,210
TransientObjectManager.java,Java,,132,37,21,190
AppletDataCollector.java,Java,,23,9,8,40
DataCollectorBase.java,Java,,306,81,68,455
DataCollectorFactory.java,Java,,32,10,6,48
NormalDataCollector.java,Java,,26,9,6,41
NormalParserAction.java,Java,,18,6,10,34
NormalParserData.java,Java,,22,7,6,35
ORBConfiguratorImpl.java,Java,,441,89,80,610
ORBDataParserImpl.java,Java,,299,56,46,401
ORBImpl.java,Java,,1352,283,478,2113
ORBSingleton.java,Java,,557,142,58,757
ORBVersionImpl.java,Java,,51,19,10,80
ParserAction.java,Java,,8,6,16,30
ParserActionBase.java,Java,,51,16,6,73
ParserActionFactory.java,Java,,15,5,6,26
ParserDataBase.java,Java,,25,5,6,36
ParserTable.java,Java,,842,113,102,1057
PrefixParserAction.java,Java,,72,15,17,104
PrefixParserData.java,Java,,32,10,6,48
PropertyOnlyDataCollector.java,Java,,22,8,0,30
CacheTable.java,Java,,124,6,15,145
Constant.java,Java,,13,6,6,25
Future.java,Java,,21,6,6,33
CondVar.java,Java,,112,28,176,316
DebugMutex.java,Java,,68,12,108,188
Mutex.java,Java,,54,10,105,169
ReentrantMutex.java,Java,,180,33,113,326
Sync.java,Java,,13,21,306,340
SyncUtil.java,Java,,17,4,10,31
CorbaResourceUtil.java,Java,,57,14,6,77
DenseIntMapImpl.java,Java,,34,9,17,60
GuardedAction.java,Java,,38,9,6,53
NameBase.java,Java,,43,10,7,60
StateEngineImpl.java,Java,,221,55,35,311
GetPropertyAction.java,Java,,16,6,48,70
Graph.java,Java,,7,4,6,17
GraphImpl.java,Java,,112,29,28,169
Node.java,Java,,6,3,10,19
NodeData.java,Java,,31,8,13,52
HexOutputStream.java,Java,,30,10,23,63
LegacyHookGetFields.java,Java,,73,24,41,138
LegacyHookPutFields.java,Java,,37,13,42,92
LogKeywords.java,Java,,48,14,23,85
ObjectStreamClassUtil_1_3.java,Java,,370,71,112,553
ObjectStreamClass_1_3_1.java,Java,,707,161,392,1260
ObjectStreamField.java,Java,,139,34,81,254
ObjectUtility.java,Java,,46,12,11,69
ObjectWriter.java,Java,,145,36,17,198
ORBClassLoader.java,Java,,15,2,12,29
ORBConstants.java,Java,,196,95,162,453
ORBUtility.java,Java,,558,94,176,828
RepIdDelegator.java,Java,,108,33,18,159
RepositoryIdFactory.java,Java,,16,5,10,31
RepositoryIdInterface.java,Java,,14,6,10,30
RepositoryIdStrings.java,Java,,16,9,10,35
RepositoryIdUtility.java,Java,,20,6,15,41
StackImpl.java,Java,,35,9,17,61
ThreadPoolImpl.java,Java,,331,82,115,528
ThreadPoolManagerImpl.java,Java,,104,35,78,217
TimeoutException.java,Java,,4,4,5,13
WorkQueueImpl.java,Java,,122,36,21,179
DynamicAccessPermission.java,Java,,12,6,27,45
DynamicMethodMarshallerImpl.java,Java,,361,67,19,447
DynamicStubImpl.java,Java,,106,27,9,142
ExceptionHandler.java,Java,,10,6,23,39
ExceptionHandlerImpl.java,Java,,192,50,36,278
IDLNameTranslatorImpl.java,Java,,510,172,232,914
IDLType.java,Java,,56,21,29,106
IDLTypeException.java,Java,,7,5,10,22
IDLTypesUtil.java,Java,,390,93,97,580
InvocationHandlerFactoryImpl.java,Java,,82,23,35,140
JNDIStateFactoryImpl.java,Java,,72,25,55,152
PresentationManagerImpl.java,Java,,225,59,23,307
ReflectiveTie.java,Java,,117,29,12,158
StubConnectImpl.java,Java,,58,20,20,98
StubFactoryBase.java,Java,,30,10,6,46
StubFactoryDynamicBase.java,Java,,25,8,8,41
StubFactoryFactoryBase.java,Java,,11,4,11,26
StubFactoryFactoryDynamicBase.java,Java,,58,18,7,83
StubFactoryFactoryProxyImpl.java,Java,,11,3,6,20
StubFactoryFactoryStaticImpl.java,Java,,87,23,21,131
StubFactoryProxyImpl.java,Java,,25,6,8,39
StubFactoryStaticImpl.java,Java,,24,6,6,36
StubInvocationHandlerImpl.java,Java,,141,32,22,195
AddressingDispositionException.java,Java,,11,6,21,38
BootstrapServerRequestDispatcher.java,Java,,73,21,37,131
CorbaClientDelegateImpl.java,Java,,295,65,66,426
CorbaClientRequestDispatcherImpl.java,Java,,670,170,195,1035
CorbaInvocationInfo.java,Java,,68,21,11,100
CorbaMessageMediatorImpl.java,Java,,1651,312,393,2356
CorbaServerRequestDispatcherImpl.java,Java,,578,130,162,870
FullServantCacheLocalCRDImpl.java,Java,,39,15,9,63
AddressingDispositionHelper.java,Java,,40,11,12,63
CancelRequestMessage.java,Java,,5,3,12,20
CancelRequestMessage_1_0.java,Java,,28,15,16,59
CancelRequestMessage_1_1.java,Java,,28,15,16,59
CancelRequestMessage_1_2.java,Java,,28,15,16,59
FragmentMessage.java,Java,,5,3,12,20
FragmentMessage_1_1.java,Java,,29,13,20,62
FragmentMessage_1_2.java,Java,,55,16,20,91
IORAddressingInfo.java,Java,,14,7,12,33
IORAddressingInfoHelper.java,Java,,66,11,12,89
KeyAddr.java,Java,,5,4,12,21
LocateReplyMessage.java,Java,,11,5,12,28
LocateReplyMessage_1_0.java,Java,,76,27,20,123
LocateReplyMessage_1_1.java,Java,,77,26,20,123
LocateReplyMessage_1_2.java,Java,,115,33,30,178
LocateReplyOrReplyMessage.java,Java,,10,6,7,23
LocateRequestMessage.java,Java,,6,4,12,22
LocateRequestMessage_1_0.java,Java,,48,18,17,83
LocateRequestMessage_1_1.java,Java,,49,19,17,85
LocateRequestMessage_1_2.java,Java,,46,18,17,81
Message.java,Java,,42,20,18,80
MessageBase.java,Java,,702,107,139,948
MessageHandler.java,Java,,21,10,24,55
Message_1_0.java,Java,,71,24,31,126
Message_1_1.java,Java,,96,32,51,179
Message_1_2.java,Java,,42,11,11,64
ProfileAddr.java,Java,,5,4,12,21
ReferenceAddr.java,Java,,5,4,12,21
ReplyMessage.java,Java,,15,6,14,35
ReplyMessage_1_0.java,Java,,131,32,22,185
ReplyMessage_1_1.java,Java,,132,31,22,185
ReplyMessage_1_2.java,Java,,141,37,37,215
RequestMessage.java,Java,,15,9,13,37
RequestMessage_1_0.java,Java,,97,26,21,144
RequestMessage_1_1.java,Java,,118,23,17,158
RequestMessage_1_2.java,Java,,116,28,39,183
TargetAddress.java,Java,,77,17,12,106
TargetAddressHelper.java,Java,,108,14,15,137
InfoOnlyServantCacheLocalCRDImpl.java,Java,,29,12,9,50
INSServerRequestDispatcher.java,Java,,40,11,32,83
JIDLLocalCRDImpl.java,Java,,41,16,15,72
LocalClientRequestDispatcherBase.java,Java,,66,21,35,122
MinimalServantCacheLocalCRDImpl.java,Java,,27,10,6,43
NotLocalLocalCRDImpl.java,Java,,25,9,15,49
POALocalCRDImpl.java,Java,,91,24,30,145
RequestCanceledException.java,Java,,10,5,9,24
RequestDispatcherRegistryImpl.java,Java,,111,29,25,165
ServantCacheLocalCRDBase.java,Java,,49,18,11,78
SharedCDRClientRequestDispatcherImpl.java,Java,,132,29,43,204
SpecialMethod.java,Java,,119,25,7,151
BootstrapResolverImpl.java,Java,,85,30,25,140
CompositeResolverImpl.java,Java,,27,6,0,33
FileResolverImpl.java,Java,,65,16,11,92
INSURLOperationImpl.java,Java,,210,35,64,309
LocalResolverImpl.java,Java,,21,7,6,34
ORBDefaultInitRefResolverImpl.java,Java,,29,9,6,44
ORBInitRefResolverImpl.java,Java,,31,9,0,40
SplitLocalResolverImpl.java,Java,,27,9,6,42
ByteBufferPoolImpl.java,Java,,93,25,71,189
CorbaConnectionCacheBase.java,Java,,166,36,48,250
CorbaContactInfoBase.java,Java,,189,43,42,274
CorbaContactInfoListImpl.java,Java,,139,30,53,222
CorbaContactInfoListIteratorImpl.java,Java,,147,37,57,241
CorbaInboundConnectionCacheImpl.java,Java,,133,25,26,184
CorbaOutboundConnectionCacheImpl.java,Java,,143,24,25,192
CorbaResponseWaitingRoomImpl.java,Java,,211,53,53,317
CorbaTransportManagerImpl.java,Java,,176,27,31,234
DefaultIORToSocketInfoImpl.java,Java,,47,10,12,69
DefaultSocketFactoryImpl.java,Java,,59,15,9,83
EventHandlerBase.java,Java,,95,19,18,132
ListenerThreadImpl.java,Java,,85,24,20,129
ReaderThreadImpl.java,Java,,90,24,21,135
ReadTCPTimeoutsImpl.java,Java,,23,6,11,40
SelectorImpl.java,Java,,429,52,50,531
SharedCDRContactInfoImpl.java,Java,,110,25,34,169
SocketOrChannelAcceptorImpl.java,Java,,450,80,97,627
SocketOrChannelConnectionImpl.java,Java,,1112,215,334,1661
SocketOrChannelContactInfoImpl.java,Java,,134,30,35,199
IdentityHashtable.java,Java,,162,33,172,367
IdentityHashtableEnumerator.java,Java,,37,7,18,62
JDKBridge.java,Java,,91,20,71,182
JDKClassLoader.java,Java,,86,25,65,176
ORBProperties.java,Java,,29,11,16,56
PackagePrefixChecker.java,Java,,35,14,11,60
RepositoryId.java,Java,,677,176,125,978
RepositoryIdCache.java,Java,,41,18,35,94
SUNVMCID.java,Java,,4,4,15,23
Utility.java,Java,,643,118,225,986
Version.java,Java,,16,5,14,35
ORBSingleton.java,Java,,8,4,11,23
BootstrapServer.java,Java,,59,21,35,115
ORB.java,Java,,9,2,9,20
PIORB.java,Java,,9,4,11,24
IIOPInputStream.java,Java,,26,5,17,48
IIOPOutputStream.java,Java,,14,6,13,33
LibraryManager.java,Java,,7,4,14,25
ObjectStreamClass.java,Java,,4,4,7,15
POAORB.java,Java,,8,2,9,19
ORB.java,Java,,11,3,25,39
Broker.java,Java,,10,5,10,25
InputObject.java,Java,,9,8,29,46
OutputObject.java,Java,,9,7,31,47
ClientDelegate.java,Java,,8,5,28,41
ClientInvocationInfo.java,Java,,18,14,10,42
ClientRequestDispatcher.java,Java,,20,6,61,87
MessageMediator.java,Java,,21,15,77,113
ProtocolHandler.java,Java,,6,4,25,35
ServerRequestDispatcher.java,Java,,6,4,20,30
Acceptor.java,Java,,28,21,145,194
ByteBufferPool.java,Java,,8,4,10,22
Connection.java,Java,,29,30,154,213
ConnectionCache.java,Java,,11,10,14,35
ContactInfo.java,Java,,33,20,162,215
ContactInfoList.java,Java,,6,4,24,34
ContactInfoListIterator.java,Java,,12,7,46,65
EventHandler.java,Java,,20,21,16,57
InboundConnectionCache.java,Java,,8,5,10,23
ListenerThread.java,Java,,6,11,10,27
OutboundConnectionCache.java,Java,,8,5,10,23
ReaderThread.java,Java,,5,11,10,26
ResponseWaitingRoom.java,Java,,11,9,11,31
Selector.java,Java,,10,11,10,31
TransportManager.java,Java,,20,14,10,44
Activator.java,Java,,4,3,6,13
ActivatorHelper.java,Java,,67,12,6,85
ActivatorHolder.java,Java,,24,8,6,38
ActivatorOperations.java,Java,,16,15,42,73
BadServerDefinition.java,Java,,19,8,6,33
BadServerDefinitionHelper.java,Java,,61,10,8,79
BadServerDefinitionHolder.java,Java,,24,8,6,38
EndPointInfo.java,Java,,14,6,6,26
EndPointInfoHelper.java,Java,,67,10,6,83
EndPointInfoHolder.java,Java,,24,8,6,38
EndpointInfoListHelper.java,Java,,46,11,8,65
EndpointInfoListHolder.java,Java,,24,10,8,42
IIOP_CLEAR_TEXT.java,Java,,5,4,11,20
InitialNameService.java,Java,,4,4,9,17
InitialNameServiceHelper.java,Java,,67,13,9,89
InitialNameServiceHolder.java,Java,,24,9,9,42
InitialNameServiceOperations.java,Java,,5,5,11,21
NameAlreadyBound.java,Java,,12,7,6,25
NameAlreadyBoundHelper.java,Java,,54,10,8,72
NameAlreadyBoundHolder.java,Java,,24,8,6,38
InvalidORBid.java,Java,,12,7,6,25
InvalidORBidHelper.java,Java,,54,10,8,72
InvalidORBidHolder.java,Java,,24,8,6,38
Locator.java,Java,,4,3,6,13
LocatorHelper.java,Java,,67,12,6,85
LocatorHolder.java,Java,,24,8,6,38
LocatorOperations.java,Java,,8,7,19,34
ServerLocationPerORB.java,Java,,14,6,6,26
ServerLocationPerORBHelper.java,Java,,68,10,6,84
ServerLocationPerORBHolder.java,Java,,24,8,6,38
ServerLocationPerType.java,Java,,14,6,6,26
ServerLocationPerTypeHelper.java,Java,,68,10,6,84
ServerLocationPerTypeHolder.java,Java,,24,8,6,38
NoSuchEndPoint.java,Java,,12,7,6,25
NoSuchEndPointHelper.java,Java,,54,10,8,72
NoSuchEndPointHolder.java,Java,,24,8,6,38
ORBAlreadyRegistered.java,Java,,19,8,6,33
ORBAlreadyRegisteredHelper.java,Java,,62,10,8,80
ORBAlreadyRegisteredHolder.java,Java,,24,8,6,38
ORBidListHelper.java,Java,,47,11,8,66
ORBidListHolder.java,Java,,24,10,8,42
ORBPortInfo.java,Java,,14,6,6,26
ORBPortInfoHelper.java,Java,,68,10,6,84
ORBPortInfoHolder.java,Java,,24,8,6,38
ORBPortInfoListHelper.java,Java,,46,11,8,65
ORBPortInfoListHolder.java,Java,,24,10,8,42
ORBProxy.java,Java,,4,4,8,16
ORBProxyHelper.java,Java,,67,13,8,88
ORBProxyHolder.java,Java,,24,9,8,41
ORBProxyOperations.java,Java,,5,5,14,24
Repository.java,Java,,4,3,6,13
RepositoryHelper.java,Java,,67,12,6,85
RepositoryHolder.java,Java,,24,8,6,38
RepositoryOperations.java,Java,,13,12,29,54
AppNamesHelper.java,Java,,46,11,8,65
AppNamesHolder.java,Java,,24,10,8,42
ServerDef.java,Java,,22,11,11,44
ServerDefHelper.java,Java,,94,10,6,110
ServerDefHolder.java,Java,,24,8,6,38
ServerAlreadyActive.java,Java,,19,8,6,33
ServerAlreadyActiveHelper.java,Java,,62,10,8,80
ServerAlreadyActiveHolder.java,Java,,24,8,6,38
ServerAlreadyInstalled.java,Java,,19,8,6,33
ServerAlreadyInstalledHelper.java,Java,,62,10,8,80
ServerAlreadyInstalledHolder.java,Java,,24,8,6,38
ServerAlreadyRegistered.java,Java,,19,8,6,33
ServerAlreadyRegisteredHelper.java,Java,,62,10,8,80
ServerAlreadyRegisteredHolder.java,Java,,24,8,6,38
ServerAlreadyUninstalled.java,Java,,19,8,6,33
ServerAlreadyUninstalledHelper.java,Java,,62,10,8,80
ServerAlreadyUninstalledHolder.java,Java,,24,8,6,38
ServerHeldDown.java,Java,,19,8,6,33
ServerHeldDownHelper.java,Java,,62,10,8,80
ServerHeldDownHolder.java,Java,,24,8,6,38
ServerIdsHelper.java,Java,,47,11,8,66
ServerIdsHolder.java,Java,,24,10,8,42
ServerManager.java,Java,,4,4,10,18
ServerManagerHelper.java,Java,,67,13,10,90
ServerManagerHolder.java,Java,,24,9,10,43
ServerManagerOperations.java,Java,,4,4,10,18
ServerNotActive.java,Java,,19,8,6,33
ServerNotActiveHelper.java,Java,,62,10,8,80
ServerNotActiveHolder.java,Java,,24,8,6,38
ServerNotRegistered.java,Java,,19,8,6,33
ServerNotRegisteredHelper.java,Java,,62,10,8,80
ServerNotRegisteredHolder.java,Java,,24,8,6,38
ServerProxy.java,Java,,4,4,8,16
ServerProxyHelper.java,Java,,67,13,8,88
ServerProxyHolder.java,Java,,24,9,8,41
ServerProxyOperations.java,Java,,7,7,16,30
TCPPortHelper.java,Java,,40,11,11,62
_ActivatorImplBase.java,Java,,208,36,44,288
_ActivatorStub.java,Java,,304,31,43,378
_InitialNameServiceImplBase.java,Java,,48,15,13,76
_InitialNameServiceStub.java,Java,,59,10,12,81
_LocatorImplBase.java,Java,,108,20,21,149
_LocatorStub.java,Java,,135,15,20,170
_ORBProxyImplBase.java,Java,,43,15,16,74
_ORBProxyStub.java,Java,,55,10,15,80
_RepositoryImplBase.java,Java,,159,30,31,220
_RepositoryStub.java,Java,,229,25,30,284
_ServerManagerImplBase.java,Java,,285,45,61,391
_ServerManagerStub.java,Java,,405,40,60,505
_ServerProxyImplBase.java,Java,,54,19,18,91
_ServerProxyStub.java,Java,,87,14,17,118
Activator.java,Java,,4,3,6,13
ActivatorHelper.java,Java,,67,12,6,85
ActivatorHolder.java,Java,,24,8,6,38
ActivatorOperations.java,Java,,12,11,14,37
BadServerDefinition.java,Java,,19,8,6,33
BadServerDefinitionHelper.java,Java,,61,10,8,79
BadServerDefinitionHolder.java,Java,,24,8,6,38
EndPointInfo.java,Java,,14,6,6,26
EndPointInfoHelper.java,Java,,67,10,6,83
EndPointInfoHolder.java,Java,,24,8,6,38
EndpointInfoListHelper.java,Java,,46,10,6,62
EndpointInfoListHolder.java,Java,,24,9,6,39
IIOP_CLEAR_TEXT.java,Java,,5,4,7,16
InitialNameService.java,Java,,4,3,6,13
InitialNameServiceHelper.java,Java,,67,12,6,85
InitialNameServiceHolder.java,Java,,24,8,6,38
InitialNameServiceOperations.java,Java,,5,4,7,16
NameAlreadyBound.java,Java,,12,7,6,25
NameAlreadyBoundHelper.java,Java,,54,10,8,72
NameAlreadyBoundHolder.java,Java,,24,8,6,38
InvalidORBid.java,Java,,12,7,6,25
InvalidORBidHelper.java,Java,,54,10,8,72
InvalidORBidHolder.java,Java,,24,8,6,38
Locator.java,Java,,4,3,6,13
LocatorHelper.java,Java,,67,12,6,85
LocatorHolder.java,Java,,24,8,6,38
LocatorOperations.java,Java,,8,7,10,25
ServerLocation.java,Java,,14,6,6,26
ServerLocationHelper.java,Java,,68,10,6,84
ServerLocationHolder.java,Java,,24,8,6,38
ServerLocationPerORB.java,Java,,14,6,6,26
ServerLocationPerORBHelper.java,Java,,68,10,6,84
ServerLocationPerORBHolder.java,Java,,24,8,6,38
NoSuchEndPoint.java,Java,,12,7,6,25
NoSuchEndPointHelper.java,Java,,54,10,8,72
NoSuchEndPointHolder.java,Java,,24,8,6,38
ORBAlreadyRegistered.java,Java,,19,8,6,33
ORBAlreadyRegisteredHelper.java,Java,,62,10,8,80
ORBAlreadyRegisteredHolder.java,Java,,24,8,6,38
ORBidHelper.java,Java,,40,11,7,58
ORBidListHelper.java,Java,,47,10,6,63
ORBidListHolder.java,Java,,24,9,6,39
ORBPortInfo.java,Java,,14,6,6,26
ORBPortInfoHelper.java,Java,,68,10,6,84
ORBPortInfoHolder.java,Java,,24,8,6,38
ORBPortInfoListHelper.java,Java,,46,10,6,62
ORBPortInfoListHolder.java,Java,,24,9,6,39
POANameHelper.java,Java,,46,10,6,62
POANameHolder.java,Java,,24,9,6,39
Repository.java,Java,,4,3,6,13
RepositoryHelper.java,Java,,67,12,6,85
RepositoryHolder.java,Java,,24,8,6,38
RepositoryOperations.java,Java,,13,12,15,40
ServerDef.java,Java,,20,9,9,38
ServerDefHelper.java,Java,,87,10,6,103
ServerDefHolder.java,Java,,24,8,6,38
StringSeqHelper.java,Java,,46,10,6,62
StringSeqHolder.java,Java,,24,9,6,39
Server.java,Java,,4,4,8,16
ServerAlreadyActive.java,Java,,19,8,6,33
ServerAlreadyActiveHelper.java,Java,,62,10,8,80
ServerAlreadyActiveHolder.java,Java,,24,8,6,38
ServerAlreadyInstalled.java,Java,,19,8,6,33
ServerAlreadyInstalledHelper.java,Java,,62,10,8,80
ServerAlreadyInstalledHolder.java,Java,,24,8,6,38
ServerAlreadyRegistered.java,Java,,19,8,6,33
ServerAlreadyRegisteredHelper.java,Java,,62,10,8,80
ServerAlreadyRegisteredHolder.java,Java,,24,8,6,38
ServerAlreadyUninstalled.java,Java,,19,8,6,33
ServerAlreadyUninstalledHelper.java,Java,,62,10,8,80
ServerAlreadyUninstalledHolder.java,Java,,24,8,6,38
ServerHeldDown.java,Java,,19,8,6,33
ServerHeldDownHelper.java,Java,,62,10,8,80
ServerHeldDownHolder.java,Java,,24,8,6,38
ServerHelper.java,Java,,67,13,8,88
ServerHolder.java,Java,,24,9,8,41
ServerIdHelper.java,Java,,40,10,6,56
ServerIdsHelper.java,Java,,47,10,6,63
ServerIdsHolder.java,Java,,24,9,6,39
ServerManager.java,Java,,4,3,6,13
ServerManagerHelper.java,Java,,67,12,6,85
ServerManagerHolder.java,Java,,24,8,6,38
ServerManagerOperations.java,Java,,4,3,6,13
ServerNotActive.java,Java,,19,8,6,33
ServerNotActiveHelper.java,Java,,62,10,8,80
ServerNotActiveHolder.java,Java,,24,8,6,38
ServerNotRegistered.java,Java,,19,8,6,33
ServerNotRegisteredHelper.java,Java,,62,10,8,80
ServerNotRegisteredHolder.java,Java,,24,8,6,38
ServerOperations.java,Java,,7,7,16,30
TCPPortHelper.java,Java,,40,10,6,56
_ActivatorImplBase.java,Java,,165,28,16,209
_ActivatorStub.java,Java,,223,23,15,261
_InitialNameServiceImplBase.java,Java,,48,14,9,71
_InitialNameServiceStub.java,Java,,59,9,8,76
_LocatorImplBase.java,Java,,108,20,12,140
_LocatorStub.java,Java,,135,15,11,161
_RepositoryImplBase.java,Java,,159,30,17,206
_RepositoryStub.java,Java,,229,25,16,270
_ServerImplBase.java,Java,,54,19,18,91
_ServerManagerImplBase.java,Java,,242,36,20,298
_ServerManagerStub.java,Java,,324,31,19,374
_ServerStub.java,Java,,87,14,17,118
CopierManager.java,Java,,9,6,19,34
CopyobjectDefaults.java,Java,,52,10,20,82
ObjectCopier.java,Java,,4,2,14,20
ObjectCopierFactory.java,Java,,5,3,10,18
ReflectiveCopyException.java,Java,,15,3,6,24
CorbaInputObject.java,Java,,8,3,6,17
CorbaOutputObject.java,Java,,22,7,6,35
CopyObjectPolicy.java,Java,,31,9,9,49
RequestPartitioningPolicy.java,Java,,45,11,10,66
ServantCachingPolicy.java,Java,,73,22,48,143
ZeroPortPolicy.java,Java,,36,11,9,56
EncapsulationFactoryBase.java,Java,,20,8,6,34
Identifiable.java,Java,,5,4,15,24
IdentifiableBase.java,Java,,14,5,16,35
IdentifiableContainerBase.java,Java,,44,11,18,73
IdentifiableFactory.java,Java,,7,5,14,26
IdentifiableFactoryFinder.java,Java,,7,4,20,31
AlternateIIOPAddressComponent.java,Java,,7,3,9,19
CodeSetsComponent.java,Java,,7,4,9,20
GIOPVersion.java,Java,,134,43,24,201
IIOPAddress.java,Java,,7,4,9,20
IIOPFactories.java,Java,,182,30,11,223
IIOPProfile.java,Java,,12,8,22,42
IIOPProfileTemplate.java,Java,,12,7,16,35
JavaCodebaseComponent.java,Java,,6,3,9,18
MaxStreamFormatVersionComponent.java,Java,,6,2,8,16
ORBTypeComponent.java,Java,,6,3,9,18
RequestPartitioningComponent.java,Java,,6,2,6,14
IOR.java,Java,,19,14,35,68
IORFactories.java,Java,,114,31,40,185
IORFactory.java,Java,,6,4,17,27
IORTemplate.java,Java,,7,4,12,23
IORTemplateList.java,Java,,4,4,12,20
MakeImmutable.java,Java,,4,2,6,12
ObjectAdapterId.java,Java,,7,5,17,29
ObjectId.java,Java,,5,2,9,16
ObjectKey.java,Java,,10,7,17,34
ObjectKeyFactory.java,Java,,9,5,14,28
ObjectKeyTemplate.java,Java,,16,12,28,56
TaggedComponent.java,Java,,7,3,12,22
TaggedComponentBase.java,Java,,16,6,10,32
TaggedComponentFactoryFinder.java,Java,,6,2,9,17
TaggedProfile.java,Java,,12,9,27,48
TaggedProfileTemplate.java,Java,,19,10,31,60
TaggedProfileTemplateBase.java,Java,,32,10,6,48
Writeable.java,Java,,6,3,11,20
WriteContents.java,Java,,5,3,6,14
Connection.java,Java,,5,3,9,17
GetEndPointInfoAgainException.java,Java,,15,6,13,34
LegacyServerSocketEndPointInfo.java,Java,,13,10,24,47
LegacyServerSocketManager.java,Java,,12,7,10,29
ORBSocketFactory.java,Java,,20,15,307,342
IORInfoExt.java,Java,,9,5,7,21
ORBInitInfoExt.java,Java,,6,3,14,23
RequestInfoExt.java,Java,,6,4,17,27
UnknownType.java,Java,,14,3,6,23
CORBALogDomains.java,Java,,29,27,87,143
LogWrapperBase.java,Java,,49,12,13,74
LogWrapperFactory.java,Java,,6,4,6,16
LongMonitoredAttributeBase.java,Java,,12,10,33,55
MonitoredAttribute.java,Java,,10,7,78,95
MonitoredAttributeBase.java,Java,,34,15,51,100
MonitoredAttributeInfo.java,Java,,8,5,56,69
MonitoredAttributeInfoFactory.java,Java,,5,2,22,29
MonitoredObject.java,Java,,19,8,146,173
MonitoredObjectFactory.java,Java,,4,1,20,25
MonitoringConstants.java,Java,,72,12,13,97
MonitoringFactories.java,Java,,24,7,62,93
MonitoringManager.java,Java,,9,5,37,51
MonitoringManagerFactory.java,Java,,6,2,19,27
StatisticMonitoredAttribute.java,Java,,31,18,66,115
StatisticsAccumulator.java,Java,,88,32,87,207
StringMonitoredAttributeBase.java,Java,,14,10,34,58
NullServant.java,Java,,6,3,18,27
OADefault.java,Java,,18,4,10,32
OADestroyed.java,Java,,3,1,9,13
OAInvocationInfo.java,Java,,51,18,23,92
ObjectAdapter.java,Java,,25,25,181,231
ObjectAdapterBase.java,Java,,129,38,18,185
ObjectAdapterFactory.java,Java,,10,8,14,32
DataCollector.java,Java,,10,5,32,47
Operation.java,Java,,4,1,11,16
OperationFactory.java,Java,,406,99,42,547
ORB.java,Java,,319,99,117,535
ORBConfigurator.java,Java,,4,2,13,19
ORBData.java,Java,,65,48,27,140
ORBVersion.java,Java,,14,6,6,26
ORBVersionFactory.java,Java,,53,14,28,95
ParserData.java,Java,,11,9,6,26
ParserDataFactory.java,Java,,19,3,6,28
ParserImplBase.java,Java,,80,20,18,118
ParserImplTableBase.java,Java,,113,25,17,155
PropertyParser.java,Java,,46,11,10,67
StringPair.java,Java,,32,10,6,48
Closure.java,Java,,4,2,6,12
ClosureFactory.java,Java,,14,5,6,25
Action.java,Java,,5,4,30,39
ActionBase.java,Java,,5,3,6,14
FSM.java,Java,,6,5,29,40
FSMImpl.java,Java,,44,14,40,98
FSMTest.java,Java,,172,31,6,209
Guard.java,Java,,44,14,28,86
GuardBase.java,Java,,5,3,6,14
Input.java,Java,,4,3,17,24
InputImpl.java,Java,,5,3,6,14
State.java,Java,,6,4,29,39
StateEngine.java,Java,,17,12,65,94
StateEngineFactory.java,Java,,9,4,12,25
StateImpl.java,Java,,54,17,10,81
CompositeInvocationHandler.java,Java,,9,3,5,17
CompositeInvocationHandlerImpl.java,Java,,42,11,3,56
DelegateInvocationHandlerImpl.java,Java,,31,6,10,47
InvocationHandlerFactory.java,Java,,7,6,11,24
LinkedInvocationHandler.java,Java,,8,5,10,23
NoSuchThreadPoolException.java,Java,,4,4,5,13
NoSuchWorkQueueException.java,Java,,4,4,5,13
ThreadPool.java,Java,,17,17,64,98
ThreadPoolChooser.java,Java,,7,5,21,33
ThreadPoolManager.java,Java,,14,12,51,77
Work.java,Java,,8,9,19,36
WorkQueue.java,Java,,11,10,27,48
DynamicMethodMarshaller.java,Java,,20,15,42,77
DynamicStub.java,Java,,15,12,25,52
IDLNameTranslator.java,Java,,9,7,23,39
PresentationDefaults.java,Java,,28,11,6,45
PresentationManager.java,Java,,38,23,91,152
StubAdapter.java,Java,,134,25,32,191
StubWrapper.java,Java,,108,27,9,144
ClientDelegateFactory.java,Java,,6,4,8,18
CorbaClientDelegate.java,Java,,6,3,7,16
CorbaMessageMediator.java,Java,,80,25,24,129
CorbaProtocolHandler.java,Java,,39,11,10,60
CorbaServerRequestDispatcher.java,Java,,9,7,19,35
ForwardException.java,Java,,38,15,13,66
InitialServerRequestDispatcher.java,Java,,7,4,14,25
LocalClientRequestDispatcher.java,Java,,12,8,35,55
LocalClientRequestDispatcherFactory.java,Java,,5,4,6,15
PIHandler.java,Java,,56,41,191,288
RequestDispatcherDefault.java,Java,,74,16,7,97
RequestDispatcherRegistry.java,Java,,19,17,42,78
RetryType.java,Java,,13,6,15,34
LocalResolver.java,Java,,5,3,12,20
Resolver.java,Java,,5,3,18,26
ResolverDefault.java,Java,,52,13,22,87
CodeSetServiceContext.java,Java,,35,9,7,51
MaxStreamFormatVersionServiceContext.java,Java,,41,17,11,69
ORBVersionServiceContext.java,Java,,39,14,12,65
SendingContextServiceContext.java,Java,,35,9,7,51
ServiceContext.java,Java,,39,11,52,102
ServiceContextData.java,Java,,109,22,13,144
ServiceContextRegistry.java,Java,,49,13,17,79
ServiceContexts.java,Java,,209,81,104,394
UEInfoServiceContext.java,Java,,38,12,7,57
UnknownServiceContext.java,Java,,37,11,6,54
CorbaAcceptor.java,Java,,14,6,11,31
CorbaConnection.java,Java,,75,40,40,155
CorbaConnectionCache.java,Java,,5,3,10,18
CorbaContactInfo.java,Java,,15,5,10,30
CorbaContactInfoList.java,Java,,15,9,10,34
CorbaContactInfoListFactory.java,Java,,8,5,19,32
CorbaContactInfoListIterator.java,Java,,11,8,8,27
CorbaResponseWaitingRoom.java,Java,,11,5,10,26
CorbaTransportManager.java,Java,,20,8,12,40
IIOPPrimaryToContactInfo.java,Java,,13,9,45,67
IORToSocketInfo.java,Java,,7,5,15,27
IORTransformer.java,Java,,8,4,10,22
ORBSocketFactory.java,Java,,22,10,10,42
ReadTimeouts.java,Java,,7,3,7,17
ReadTimeoutsFactory.java,Java,,8,2,1,11
SocketInfo.java,Java,,8,7,10,25
SocketOrChannelAcceptor.java,Java,,6,4,10,20
TransportDefault.java,Java,,57,9,11,77
ImageFormatException.java,Java,,10,4,40,54
JPEGCodec.java,Java,,49,13,90,152
JPEGDecodeParam.java,Java,,62,45,265,372
JPEGEncodeParam.java,Java,,27,20,211,258
JPEGHuffmanTable.java,Java,,139,31,73,243
JPEGImageDecoder.java,Java,,23,14,105,142
JPEGImageEncoder.java,Java,,29,23,180,232
JPEGQTable.java,Java,,62,20,70,152
TruncatedFileException.java,Java,,19,8,57,84
XmlChars.java,Java,,177,38,212,427
XmlNames.java,Java,,72,23,135,230
BMPConstants.java,Java,,21,5,9,35
BMPImageReader.java,Java,,1383,267,153,1803
BMPImageReaderSpi.java,Java,,58,13,6,77
BMPImageWriter.java,Java,,1114,183,204,1501
BMPImageWriterSpi.java,Java,,66,16,6,88
BMPMetadata.java,Java,,221,51,17,289
BMPMetadataFormat.java,Java,,156,22,12,190
BMPMetadataFormatResources.java,Java,,34,10,7,51
BitFile.java,Java,,73,10,22,105
BogusColorSpace.java,Java,,61,23,34,118
I18N.java,Java,,7,2,6,15
I18NImpl.java,Java,,17,4,23,44
ImageUtil.java,Java,,838,122,193,1153
InputStreamAdapter.java,Java,,17,8,9,34
LZWCompressor.java,Java,,73,20,35,128
LZWStringTable.java,Java,,110,29,61,200
PaletteBuilder.java,Java,,306,66,94,466
ReaderUtil.java,Java,,84,12,87,183
StandardMetadataFormat.java,Java,,363,61,57,481
StandardMetadataFormatResources.java,Java,,129,55,8,192
SubImageInputStream.java,Java,,42,11,11,64
GIFImageMetadata.java,Java,,313,72,46,431
GIFImageMetadataFormat.java,Java,,122,16,15,153
GIFImageMetadataFormatResources.java,Java,,70,8,8,86
GIFImageReader.java,Java,,745,158,110,1013
GIFImageReaderSpi.java,Java,,58,17,9,84
GIFImageWriter.java,Java,,920,196,171,1287
GIFImageWriterSpi.java,Java,,63,17,6,86
GIFMetadata.java,Java,,234,35,33,302
GIFStreamMetadata.java,Java,,210,56,39,305
GIFStreamMetadataFormat.java,Java,,67,11,10,88
GIFStreamMetadataFormatResources.java,Java,,37,8,8,53
GIFWritableImageMetadata.java,Java,,315,51,18,384
GIFWritableStreamMetadata.java,Java,,203,28,18,249
AdobeMarkerSegment.java,Java,,90,15,14,119
COMMarkerSegment.java,Java,,57,13,46,116
DHTMarkerSegment.java,Java,,177,30,35,242
DQTMarkerSegment.java,Java,,218,26,48,292
DRIMarkerSegment.java,Java,,37,12,17,66
JFIFMarkerSegment.java,Java,,1201,131,215,1547
JPEG.java,Java,,204,50,100,354
JPEGBuffer.java,Java,,134,20,83,237
JPEGImageMetadataFormat.java,Java,,302,37,9,348
JPEGImageMetadataFormatResources.java,Java,,106,7,12,125
JPEGImageReader.java,Java,,1234,209,339,1782
JPEGImageReaderResources.java,Java,,15,7,6,28
JPEGImageReaderSpi.java,Java,,53,9,8,70
JPEGImageWriter.java,Java,,1467,194,224,1885
JPEGImageWriterResources.java,Java,,51,7,6,64
JPEGImageWriterSpi.java,Java,,59,13,8,80
JPEGMetadata.java,Java,,1788,186,424,2398
JPEGMetadataFormat.java,Java,,105,17,17,139
JPEGMetadataFormatResources.java,Java,,30,5,8,43
JPEGStreamMetadataFormat.java,Java,,17,6,6,29
JPEGStreamMetadataFormatResources.java,Java,,14,5,9,28
MarkerSegment.java,Java,,139,21,47,207
SOFMarkerSegment.java,Java,,219,25,22,266
SOSMarkerSegment.java,Java,,179,24,20,223
PNGImageReader.java,Java,,1208,229,138,1575
PNGImageReaderSpi.java,Java,,63,16,9,88
PNGImageWriter.java,Java,,897,181,81,1159
PNGImageWriterSpi.java,Java,,76,19,16,111
PNGMetadata.java,Java,,1595,242,159,1996
PNGMetadataFormat.java,Java,,323,118,41,482
PNGMetadataFormatResources.java,Java,,169,24,8,201
RowFilter.java,Java,,132,33,12,177
WBMPImageReader.java,Java,,223,57,34,314
WBMPImageReaderSpi.java,Java,,60,14,7,81
WBMPImageWriter.java,Java,,222,44,31,297
WBMPImageWriterSpi.java,Java,,57,12,6,75
WBMPMetadata.java,Java,,82,27,7,116
WBMPMetadataFormat.java,Java,,33,12,7,52
FileImageInputStreamSpi.java,Java,,30,9,6,45
FileImageOutputStreamSpi.java,Java,,31,9,6,46
InputStreamImageInputStreamSpi.java,Java,,41,12,6,59
OutputStreamImageOutputStreamSpi.java,Java,,41,11,6,58
RAFImageInputStreamSpi.java,Java,,32,9,6,47
RAFImageOutputStreamSpi.java,Java,,33,9,6,48
CloseableDisposerRecord.java,Java,,20,5,11,36
StreamCloser.java,Java,,76,13,27,116
StreamFinalizer.java,Java,,18,5,31,54
Painter.java,Java,,5,2,80,87
GTKColorChooserPanel.java,Java,,857,148,278,1283
GTKColorType.java,Java,,108,14,28,150
GTKConstants.java,Java,,76,11,41,128
GTKDefaultEngine.java,Java,,979,114,83,1176
GTKDefaultStyle.java,Java,,198,26,53,277
GTKEngine.java,Java,,84,24,35,143
GTKFileChooserUI.java,Java,,1054,212,105,1371
GTKGraphicsUtils.java,Java,,79,9,29,117
GTKIconFactory.java,Java,,271,54,30,355
GTKLookAndFeel.java,Java,,1339,172,168,1679
GTKNativeEngine.java,Java,,419,59,51,529
GTKNativeStyle.java,Java,,119,32,77,228
GTKPainter.java,Java,,1084,137,187,1408
GTKRegion.java,Java,,9,3,13,25
GTKStyle.java,Java,,780,115,242,1137
GTKStyleFactory.java,Java,,121,18,40,179
Metacity.java,Java,,1819,238,39,2096
PangoFonts.java,Java,,83,21,108,212
gtk.java,Java,,55,2,0,57
gtk_de.java,Java,,55,2,0,57
gtk_es.java,Java,,55,2,0,57
gtk_fr.java,Java,,55,2,0,57
gtk_it.java,Java,,55,2,0,57
gtk_ja.java,Java,,55,2,0,57
gtk_ko.java,Java,,55,2,0,57
gtk_pt_BR.java,Java,,55,2,0,57
gtk_sv.java,Java,,55,2,0,57
gtk_zh_CN.java,Java,,55,2,0,57
gtk_zh_HK.java,Java,,55,2,0,57
gtk_zh_TW.java,Java,,55,2,0,57
XColors.java,Java,,788,16,10,814
MotifBorders.java,Java,,524,130,95,749
MotifButtonListener.java,Java,,14,7,13,34
MotifButtonUI.java,Java,,75,24,36,135
MotifCheckBoxMenuItemUI.java,Java,,62,23,14,99
MotifCheckBoxUI.java,Java,,34,14,25,73
MotifComboBoxUI.java,Java,,264,43,38,345
MotifDesktopIconUI.java,Java,,262,54,32,348
MotifDesktopPaneUI.java,Java,,177,31,42,250
MotifEditorPaneUI.java,Java,,13,7,33,53
MotifFileChooserUI.java,Java,,648,122,54,824
MotifGraphicsUtils.java,Java,,317,62,80,459
MotifIconFactory.java,Java,,350,56,36,442
MotifInternalFrameTitlePane.java,Java,,289,50,18,357
MotifInternalFrameUI.java,Java,,137,27,42,206
MotifLabelUI.java,Java,,19,5,20,44
MotifLookAndFeel.java,Java,,1094,128,47,1269
MotifMenuBarUI.java,Java,,23,8,22,53
MotifMenuItemUI.java,Java,,63,22,13,98
MotifMenuMouseListener.java,Java,,17,2,12,31
MotifMenuMouseMotionListener.java,Java,,11,3,12,26
MotifMenuUI.java,Java,,89,23,27,139
MotifOptionPaneUI.java,Java,,49,13,35,97
MotifPasswordFieldUI.java,Java,,13,10,33,56
MotifPopupMenuSeparatorUI.java,Java,,27,9,13,49
MotifPopupMenuUI.java,Java,,63,15,23,101
MotifProgressBarUI.java,Java,,13,6,22,41
MotifRadioButtonMenuItemUI.java,Java,,62,22,20,104
MotifRadioButtonUI.java,Java,,40,16,31,87
MotifScrollBarButton.java,Java,,154,25,16,195
MotifScrollBarUI.java,Java,,53,18,20,91
MotifScrollPaneUI.java,Java,,86,20,21,127
MotifSeparatorUI.java,Java,,16,9,21,46
MotifSliderUI.java,Java,,82,29,32,143
MotifSplitPaneDivider.java,Java,,181,36,61,278
MotifSplitPaneUI.java,Java,,18,6,25,49
MotifTabbedPaneUI.java,Java,,218,33,38,289
MotifTextAreaUI.java,Java,,13,5,35,53
MotifTextFieldUI.java,Java,,13,5,33,51
MotifTextPaneUI.java,Java,,13,7,33,53
MotifTextUI.java,Java,,69,13,76,158
MotifToggleButtonUI.java,Java,,60,19,31,110
MotifTreeCellRenderer.java,Java,,51,16,29,96
MotifTreeUI.java,Java,,78,24,47,149
motif.java,Java,,27,2,0,29
motif_de.java,Java,,27,2,0,29
motif_es.java,Java,,27,2,0,29
motif_fr.java,Java,,27,2,0,29
motif_it.java,Java,,27,2,0,29
motif_ja.java,Java,,27,2,0,29
motif_ko.java,Java,,27,2,0,29
motif_pt_BR.java,Java,,27,2,0,29
motif_sv.java,Java,,27,2,0,29
motif_zh_CN.java,Java,,27,2,0,29
motif_zh_HK.java,Java,,27,2,0,29
motif_zh_TW.java,Java,,27,2,0,29
AbstractRegionPainter.java,Java,,351,44,322,717
ArrowButtonPainter.java,Java,,56,25,20,101
ButtonPainter.java,Java,,554,61,20,635
CheckBoxMenuItemPainter.java,Java,,93,32,20,145
CheckBoxPainter.java,Java,,529,69,20,618
ComboBoxComboBoxArrowButtonEditableState.java,Java,,12,5,8,25
ComboBoxComboBoxArrowButtonPainter.java,Java,,382,57,20,459
ComboBoxComboBoxTextFieldPainter.java,Java,,182,35,20,237
ComboBoxEditableState.java,Java,,11,5,8,24
ComboBoxPainter.java,Java,,628,68,20,716
DerivedColor.java,Java,,110,16,38,164
DesktopIconPainter.java,Java,,95,27,20,142
DesktopPanePainter.java,Java,,274,39,20,333
DropShadowEffect.java,Java,,65,5,41,111
EditorPanePainter.java,Java,,60,27,20,107
Effect.java,Java,,58,14,44,116
EffectUtils.java,Java,,220,37,152,409
FileChooserPainter.java,Java,,2035,176,20,2231
FormattedTextFieldPainter.java,Java,,296,48,20,364
ImageCache.java,Java,,125,15,60,200
ImageScalingHelper.java,Java,,164,22,77,263
InnerGlowEffect.java,Java,,8,2,12,22
InnerShadowEffect.java,Java,,68,5,41,114
InternalFrameInternalFrameTitlePaneInternalFrameTitlePaneCloseButtonPainter.java,Java,,377,49,20,446
InternalFrameInternalFrameTitlePaneInternalFrameTitlePaneCloseButtonWindowNotFocusedState.java,Java,,21,5,8,34
InternalFrameInternalFrameTitlePaneInternalFrameTitlePaneIconifyButtonPainter.java,Java,,518,51,20,589
InternalFrameInternalFrameTitlePaneInternalFrameTitlePaneIconifyButtonWindowNotFocusedState.java,Java,,21,5,8,34
InternalFrameInternalFrameTitlePaneInternalFrameTitlePaneMaximizeButtonPainter.java,Java,,927,81,20,1028
InternalFrameInternalFrameTitlePaneInternalFrameTitlePaneMaximizeButtonWindowMaximizedState.java,Java,,21,5,8,34
InternalFrameInternalFrameTitlePaneInternalFrameTitlePaneMaximizeButtonWindowNotFocusedState.java,Java,,21,5,8,34
InternalFrameInternalFrameTitlePaneInternalFrameTitlePaneMenuButtonPainter.java,Java,,427,53,20,500
InternalFrameInternalFrameTitlePaneInternalFrameTitlePaneMenuButtonWindowNotFocusedState.java,Java,,21,5,8,34
InternalFrameInternalFrameTitlePanePainter.java,Java,,31,20,20,71
InternalFrameInternalFrameTitlePaneWindowFocusedState.java,Java,,11,5,8,24
InternalFramePainter.java,Java,,323,42,20,385
InternalFrameWindowFocusedState.java,Java,,11,5,8,24
LoweredBorder.java,Java,,94,13,77,184
MenuBarMenuPainter.java,Java,,47,23,20,90
MenuBarPainter.java,Java,,87,28,20,135
MenuItemPainter.java,Java,,47,23,20,90
MenuPainter.java,Java,,89,31,20,140
NimbusDefaults.java,Java,,1283,125,335,1743
NimbusIcon.java,Java,,158,10,38,206
NimbusLookAndFeel.java,Java,,268,38,201,507
NimbusStyle.java,Java,,588,89,573,1250
OptionPaneOptionPaneMessageAreaOptionPaneLabelPainter.java,Java,,45,23,20,88
OptionPaneOptionPaneMessageAreaPainter.java,Java,,31,20,20,71
OptionPanePainter.java,Java,,491,55,20,566
OuterGlowEffect.java,Java,,8,2,12,22
PasswordFieldPainter.java,Java,,296,48,20,364
PopupMenuPainter.java,Java,,97,29,20,146
PopupMenuSeparatorPainter.java,Java,,45,23,20,88
ProgressBarFinishedState.java,Java,,11,6,8,25
ProgressBarIndeterminateState.java,Java,,11,6,8,25
ProgressBarPainter.java,Java,,515,60,20,595
RadioButtonMenuItemPainter.java,Java,,101,33,20,154
RadioButtonPainter.java,Java,,595,72,20,687
ScrollBarPainter.java,Java,,30,20,20,70
ScrollBarScrollBarButtonPainter.java,Java,,302,41,20,363
ScrollBarScrollBarThumbPainter.java,Java,,301,41,20,362
ScrollBarScrollBarTrackPainter.java,Java,,203,35,20,258
ScrollPanePainter.java,Java,,112,29,20,161
SeparatorPainter.java,Java,,45,23,20,88
ShadowEffect.java,Java,,52,15,19,86
SliderArrowShapeState.java,Java,,11,4,8,23
SliderPainter.java,Java,,30,20,20,70
SliderSliderThumbArrowShapeState.java,Java,,11,4,8,23
SliderSliderThumbPainter.java,Java,,544,73,20,637
SliderSliderTrackArrowShapeState.java,Java,,11,4,8,23
SliderSliderTrackPainter.java,Java,,159,33,20,212
SpinnerPainter.java,Java,,31,20,20,71
SpinnerPanelSpinnerFormattedTextFieldPainter.java,Java,,242,41,20,303
SpinnerSpinnerNextButtonPainter.java,Java,,474,71,20,565
SpinnerSpinnerPreviousButtonPainter.java,Java,,402,65,20,487
SplitPanePainter.java,Java,,31,20,20,71
SplitPaneSplitPaneDividerPainter.java,Java,,213,39,20,272
SplitPaneSplitPaneDividerVerticalState.java,Java,,11,5,8,24
SplitPaneVerticalState.java,Java,,11,5,8,24
State.java,Java,,81,16,98,195
SynthPainterImpl.java,Java,,961,149,1678,2788
TabbedPanePainter.java,Java,,35,20,20,75
TabbedPaneTabbedPaneTabAreaPainter.java,Java,,149,34,20,203
TabbedPaneTabbedPaneTabPainter.java,Java,,570,70,20,660
TableEditorPainter.java,Java,,71,26,20,117
TableHeaderPainter.java,Java,,76,27,20,123
TableHeaderTableHeaderRendererPainter.java,Java,,297,46,20,363
TableHeaderTableHeaderRendererSortedState.java,Java,,12,5,8,25
TableScrollPaneCorner.java,Java,,28,4,18,50
TextAreaNotInScrollPaneState.java,Java,,11,5,8,24
TextAreaPainter.java,Java,,321,53,20,394
TextFieldPainter.java,Java,,296,48,20,364
TextPanePainter.java,Java,,60,27,20,107
ToggleButtonPainter.java,Java,,601,67,20,688
ToolBarButtonPainter.java,Java,,213,38,20,271
ToolBarEastState.java,Java,,12,6,8,26
ToolBarNorthState.java,Java,,12,6,8,26
ToolBarPainter.java,Java,,137,37,20,194
ToolBarSeparatorPainter.java,Java,,25,6,25,56
ToolBarSouthState.java,Java,,12,6,8,26
ToolBarToggleButtonPainter.java,Java,,435,63,20,518
ToolBarWestState.java,Java,,12,6,8,26
ToolTipPainter.java,Java,,86,27,20,133
TreeCellEditorPainter.java,Java,,80,26,20,126
TreePainter.java,Java,,553,62,20,635
TreeTreeCellPainter.java,Java,,80,28,20,128
AnimationController.java,Java,,305,44,61,410
DesktopProperty.java,Java,,129,29,106,264
windows.java,Java,,33,2,0,35
windows_de.java,Java,,33,2,0,35
windows_es.java,Java,,33,2,0,35
windows_fr.java,Java,,33,2,0,35
windows_it.java,Java,,33,2,0,35
windows_ja.java,Java,,33,2,0,35
windows_ko.java,Java,,33,2,0,35
windows_pt_BR.java,Java,,33,2,0,35
windows_sv.java,Java,,33,2,0,35
windows_zh_CN.java,Java,,33,2,0,35
windows_zh_HK.java,Java,,33,2,0,35
windows_zh_TW.java,Java,,33,2,0,35
TMSchema.java,Java,,400,94,54,548
WindowsBorders.java,Java,,234,44,47,325
WindowsButtonListener.java,Java,,9,7,23,39
WindowsButtonUI.java,Java,,204,37,63,304
WindowsCheckBoxMenuItemUI.java,Java,,48,14,25,87
WindowsCheckBoxUI.java,Java,,36,15,28,79
WindowsClassicLookAndFeel.java,Java,,3,2,19,24
WindowsComboBoxUI.java,Java,,383,51,112,546
WindowsDesktopIconUI.java,Java,,42,14,24,80
WindowsDesktopManager.java,Java,,48,8,30,86
WindowsDesktopPaneUI.java,Java,,27,7,20,54
WindowsEditorPaneUI.java,Java,,14,7,30,51
WindowsFileChooserUI.java,Java,,937,196,140,1273
WindowsGraphicsUtils.java,Java,,129,21,45,195
WindowsIconFactory.java,Java,,738,85,64,887
WindowsInternalFrameTitlePane.java,Java,,422,57,41,520
WindowsInternalFrameUI.java,Java,,74,24,22,120
WindowsLabelUI.java,Java,,59,15,21,95
WindowsLookAndFeel.java,Java,,2035,244,368,2647
WindowsMenuBarUI.java,Java,,129,13,27,169
WindowsMenuItemUI.java,Java,,106,21,34,161
WindowsMenuItemUIAccessor.java,Java,,11,5,13,29
WindowsMenuUI.java,Java,,187,40,51,278
WindowsOptionPaneUI.java,Java,,8,6,16,30
WindowsPasswordFieldUI.java,Java,,13,9,30,52
WindowsPopupMenuSeparatorUI.java,Java,,47,12,18,77
WindowsPopupMenuUI.java,Java,,120,17,64,201
WindowsPopupWindow.java,Java,,34,10,34,78
WindowsProgressBarUI.java,Java,,270,48,66,384
WindowsRadioButtonMenuItemUI.java,Java,,47,14,25,86
WindowsRadioButtonUI.java,Java,,59,20,34,113
WindowsRootPaneUI.java,Java,,140,20,16,176
WindowsScrollBarUI.java,Java,,355,46,60,461
WindowsScrollPaneUI.java,Java,,5,6,16,27
WindowsSeparatorUI.java,Java,,3,3,12,18
WindowsSliderUI.java,Java,,160,34,23,217
WindowsSpinnerUI.java,Java,,63,13,10,86
WindowsSplitPaneDivider.java,Java,,23,7,25,55
WindowsSplitPaneUI.java,Java,,18,10,22,50
WindowsTabbedPaneUI.java,Java,,151,26,33,210
WindowsTableHeaderUI.java,Java,,184,17,28,229
WindowsTextAreaUI.java,Java,,13,8,30,51
WindowsTextFieldUI.java,Java,,68,17,72,157
WindowsTextPaneUI.java,Java,,14,6,30,50
WindowsTextUI.java,Java,,139,15,65,219
WindowsToggleButtonUI.java,Java,,103,28,34,165
WindowsToolBarSeparatorUI.java,Java,,75,20,13,108
WindowsToolBarUI.java,Java,,56,16,10,82
WindowsTreeUI.java,Java,,132,29,56,217
XPStyle.java,Java,,475,98,187,760
SwingUtilities3.java,Java,,133,20,54,207
AnnotationDesc.java,Java,,9,9,45,63
AnnotationTypeDoc.java,Java,,4,4,19,27
AnnotationTypeElementDoc.java,Java,,4,4,19,27
AnnotationValue.java,Java,,5,5,32,42
ClassDoc.java,Java,,30,31,263,324
ConstructorDoc.java,Java,,3,2,12,17
Doc.java,Java,,29,27,191,247
DocErrorReporter.java,Java,,9,8,48,65
Doclet.java,Java,,16,7,71,94
ExecutableMemberDoc.java,Java,,15,14,93,122
FieldDoc.java,Java,,9,8,44,61
LanguageVersion.java,Java,,5,5,20,30
MemberDoc.java,Java,,4,3,22,29
MethodDoc.java,Java,,9,9,59,77
PackageDoc.java,Java,,13,12,86,111
Parameter.java,Java,,8,9,41,58
ParameterizedType.java,Java,,8,8,76,92
ParamTag.java,Java,,6,5,38,49
ProgramElementDoc.java,Java,,15,13,79,107
RootDoc.java,Java,,9,8,74,91
SeeTag.java,Java,,9,8,92,109
SerialFieldTag.java,Java,,8,7,54,69
SourcePosition.java,Java,,8,6,23,37
Tag.java,Java,,13,11,116,140
ThrowsTag.java,Java,,7,6,48,61
Type.java,Java,,14,13,108,135
TypeVariable.java,Java,,5,5,32,42
WildcardType.java,Java,,5,5,35,45
lr_parser.java,Java,,490,203,535,1228
Scanner.java,Java,,4,2,15,21
Symbol.java,Java,,38,25,48,111
virtual_parse_stack.java,Java,,49,32,64,145
JmxProperties.java,Java,,14,13,68,95
ServiceName.java,Java,,14,11,54,79
DefaultMBeanServerInterceptor.java,Java,,1208,243,422,1873
MBeanServerInterceptor.java,Java,,106,35,543,684
ClassLoaderRepositorySupport.java,Java,,182,46,82,310
ConvertingMethod.java,Java,,151,24,27,202
DescriptorCache.java,Java,,35,8,6,49
DynamicMBean2.java,Java,,11,6,42,59
GetPropertyAction.java,Java,,11,5,12,28
Introspector.java,Java,,253,41,185,479
JmxMBeanServer.java,Java,,469,123,906,1498
JmxMBeanServerBuilder.java,Java,,15,5,77,97
MBeanAnalyzer.java,Java,,154,29,68,251
MBeanInstantiator.java,Java,,417,93,246,756
MBeanIntrospector.java,Java,,255,43,142,440
MBeanServerDelegateImpl.java,Java,,184,36,107,327
MBeanSupport.java,Java,,160,24,104,288
ModifiableClassLoaderRepository.java,Java,,11,9,33,53
MXBeanIntrospector.java,Java,,236,34,50,320
MXBeanLookup.java,Java,,82,10,54,146
MXBeanProxy.java,Java,,114,23,16,153
MXBeanSupport.java,Java,,94,14,51,159
NamedObject.java,Java,,37,17,51,105
ObjectInputStreamWithLoader.java,Java,,24,12,18,54
OpenConverter.java,Java,,1146,165,208,1519
PerInterface.java,Java,,196,25,41,262
Repository.java,Java,,338,78,229,645
SecureClassLoaderRepository.java,Java,,23,3,20,46
StandardMBeanIntrospector.java,Java,,129,24,21,174
StandardMBeanSupport.java,Java,,74,9,33,116
SunJmxMBeanServer.java,Java,,12,10,53,75
Util.java,Java,,54,14,15,83
WeakIdentityHashMap.java,Java,,64,19,36,119
ArrayNotificationBuffer.java,Java,,538,90,190,818
ArrayQueue.java,Java,,63,9,7,79
ClientCommunicatorAdmin.java,Java,,149,44,39,232
ClientListenerInfo.java,Java,,57,19,12,88
ClientNotifForwarder.java,Java,,576,137,148,861
NotificationBuffer.java,Java,,13,4,37,54
NotificationBufferFilter.java,Java,,9,3,10,22
ProxyInputStream.java,Java,,152,49,6,207
ProxyRef.java,Java,,50,15,6,71
RMIExporter.java,Java,,18,5,18,41
ServerCommunicatorAdmin.java,Java,,135,38,41,214
ServerNotifForwarder.java,Java,,363,56,56,475
Unmarshal.java,Java,,7,3,6,16
ClientProvider.java,Java,,19,5,6,30
ServerProvider.java,Java,,21,6,6,33
ClientProvider.java,Java,,19,5,6,30
ServerProvider.java,Java,,21,6,6,33
FileLoginModule.java,Java,,287,65,193,545
JMXPluggableAuthenticator.java,Java,,187,37,104,328
JMXSubjectDomainCombiner.java,Java,,42,9,37,88
MBeanServerAccessController.java,Java,,374,51,219,644
MBeanServerFileAccessController.java,Java,,297,36,192,525
NotificationAccessController.java,Java,,19,6,67,92
SubjectDelegator.java,Java,,78,15,37,130
CacheMap.java,Java,,46,10,44,100
ClassLoaderWithRepository.java,Java,,24,7,6,37
ClassLogger.java,Java,,171,44,13,228
EnvHelp.java,Java,,374,75,244,693
OrderClassLoaders.java,Java,,19,5,6,30
Service.java,Java,,150,23,157,330
SnmpEntryOid.java,Java,,11,2,21,34
SnmpErrorHandlerAgent.java,Java,,71,43,88,202
SnmpGenericMetaServer.java,Java,,15,10,93,118
SnmpGenericObjectServer.java,Java,,260,54,244,558
SnmpIndex.java,Java,,66,21,90,177
SnmpMib.java,Java,,429,143,418,990
SnmpMibAgent.java,Java,,293,68,391,752
SnmpMibAgentMBean.java,Java,,38,30,237,305
SnmpMibEntry.java,Java,,31,13,137,181
SnmpMibGroup.java,Java,,155,61,290,506
SnmpMibHandler.java,Java,,17,13,113,143
SnmpMibNode.java,Java,,116,44,242,402
SnmpMibOid.java,Java,,266,80,200,546
SnmpMibRequest.java,Java,,23,12,125,160
SnmpMibRequestImpl.java,Java,,79,25,123,227
SnmpMibSubRequest.java,Java,,22,12,162,196
SnmpMibTable.java,Java,,813,224,1475,2512
SnmpRequestTree.java,Java,,534,163,359,1056
SnmpStandardMetaServer.java,Java,,11,6,87,104
SnmpStandardObjectServer.java,Java,,54,14,180,248
SnmpTableCallbackHandler.java,Java,,13,3,45,61
SnmpTableEntryFactory.java,Java,,10,6,61,77
SnmpTableEntryNotification.java,Java,,25,18,86,129
SnmpTableSupport.java,Java,,125,51,380,556
SnmpUserDataFactory.java,Java,,10,4,95,109
BerDecoder.java,Java,,380,121,246,747
BerEncoder.java,Java,,196,94,177,467
BerException.java,Java,,17,13,20,50
ClientHandler.java,Java,,78,27,41,146
CommunicationException.java,Java,,20,10,35,65
CommunicatorServer.java,Java,,610,140,622,1372
CommunicatorServerMBean.java,Java,,13,16,130,159
SnmpAdaptorServer.java,Java,,1171,269,1174,2614
SnmpAdaptorServerMBean.java,Java,,98,73,515,686
SnmpInformHandler.java,Java,,8,7,51,66
SnmpInformRequest.java,Java,,693,156,354,1203
SnmpMibTree.java,Java,,158,46,50,254
SnmpQManager.java,Java,,251,64,35,350
SnmpRequestCounter.java,Java,,10,6,25,41
SnmpRequestHandler.java,Java,,759,135,257,1151
SnmpResponseHandler.java,Java,,90,28,30,148
SnmpSendServer.java,Java,,143,34,38,215
SnmpSession.java,Java,,289,65,157,511
SnmpSocket.java,Java,,182,53,94,329
SnmpSubBulkRequestHandler.java,Java,,190,42,81,313
SnmpSubNextRequestHandler.java,Java,,143,26,80,249
SnmpSubRequestHandler.java,Java,,342,96,207,645
SnmpTimerServer.java,Java,,92,26,27,145
DefaultPaths.java,Java,,105,20,105,230
SnmpProperties.java,Java,,32,19,114,165
Enumerated.java,Java,,60,39,107,206
EnumRowStatus.java,Java,,89,31,171,291
InetAddressAcl.java,Java,,15,14,85,114
SnmpAccessControlModel.java,Java,,25,3,50,78
SnmpAccessControlSubSystem.java,Java,,21,2,39,62
SnmpDecryptedPdu.java,Java,,7,1,28,36
SnmpEngineImpl.java,Java,,200,53,182,435
SnmpIncomingRequest.java,Java,,36,9,105,150
SnmpIncomingResponse.java,Java,,29,9,70,108
SnmpLcd.java,Java,,54,15,50,119
SnmpModel.java,Java,,5,1,24,30
SnmpModelLcd.java,Java,,3,2,12,17
SnmpMsgProcessingModel.java,Java,,38,9,86,133
SnmpMsgProcessingSubSystem.java,Java,,51,9,90,150
SnmpOutgoingRequest.java,Java,,21,5,48,74
SnmpSecurityCache.java,Java,,3,1,16,20
SnmpSecurityModel.java,Java,,64,4,94,162
SnmpSecuritySubSystem.java,Java,,66,5,95,166
SnmpSubSystem.java,Java,,12,6,41,59
SnmpTools.java,Java,,67,7,37,111
AclEntryImpl.java,Java,,94,39,125,258
AclImpl.java,Java,,87,30,161,278
ASCII_CharStream.java,Java,,306,56,22,384
GroupImpl.java,Java,,43,21,67,131
Host.java,Java,,128,30,28,186
JDMAccess.java,Java,,25,10,19,54
JDMAclBlock.java,Java,,18,10,23,51
JDMAclItem.java,Java,,23,10,15,48
JDMCommunities.java,Java,,19,9,15,43
JDMCommunity.java,Java,,19,9,15,43
JDMEnterprise.java,Java,,16,8,15,39
JDMHost.java,Java,,15,11,15,41
JDMHostInform.java,Java,,16,7,10,33
JDMHostName.java,Java,,24,11,15,50
JDMHostTrap.java,Java,,16,8,15,39
JDMInformBlock.java,Java,,18,9,18,45
JDMInformCommunity.java,Java,,19,7,10,36
JDMInformInterestedHost.java,Java,,15,6,10,31
JDMInformItem.java,Java,,19,7,10,36
JDMIpAddress.java,Java,,25,11,15,51
JDMIpMask.java,Java,,25,12,15,52
JDMIpV6Address.java,Java,,9,5,11,25
JDMManagers.java,Java,,15,7,15,37
JDMNetMask.java,Java,,25,6,11,42
JDMNetMaskV6.java,Java,,14,5,11,30
JDMSecurityDefs.java,Java,,15,7,15,37
JDMTrapBlock.java,Java,,18,10,19,47
JDMTrapCommunity.java,Java,,19,8,15,42
JDMTrapInterestedHost.java,Java,,15,7,15,37
JDMTrapItem.java,Java,,19,9,15,43
JDMTrapNum.java,Java,,17,8,15,40
JJTParserState.java,Java,,81,20,29,130
NetMaskImpl.java,Java,,166,37,70,273
Node.java,Java,,10,11,25,46
OwnerImpl.java,Java,,44,18,61,123
ParseError.java,Java,,8,3,11,22
ParseException.java,Java,,109,14,75,198
Parser.java,Java,,1174,57,35,1266
ParserConstants.java,Java,,80,6,7,93
ParserTokenManager.java,Java,,1481,8,7,1496
ParserTreeConstants.java,Java,,58,5,7,70
PermissionImpl.java,Java,,24,14,38,76
PrincipalImpl.java,Java,,49,18,68,135
SimpleNode.java,Java,,85,24,35,144
SnmpAcl.java,Java,,251,49,187,487
Token.java,Java,,19,12,62,93
TokenMgrError.java,Java,,72,14,54,140
SnmpMsgTranslator.java,Java,,19,1,58,78
ServiceName.java,Java,,24,23,108,155
SnmpAckPdu.java,Java,,4,0,21,25
SnmpBadSecurityLevelException.java,Java,,6,0,16,22
SnmpCounter.java,Java,,19,12,55,86
SnmpCounter64.java,Java,,70,23,108,201
SnmpDataTypeEnums.java,Java,,25,33,92,150
SnmpDefinitions.java,Java,,82,80,349,511
SnmpEngine.java,Java,,7,3,46,56
SnmpEngineFactory.java,Java,,6,2,36,44
SnmpEngineId.java,Java,,238,48,187,473
SnmpEngineParameters.java,Java,,35,11,54,100
SnmpGauge.java,Java,,19,12,55,86
SnmpInt.java,Java,,98,29,142,269
SnmpIpAddress.java,Java,,91,22,91,204
SnmpMessage.java,Java,,224,39,126,389
SnmpMsg.java,Java,,273,36,156,465
SnmpNull.java,Java,,64,22,82,168
SnmpOid.java,Java,,324,62,256,642
SnmpOidDatabase.java,Java,,13,13,53,79
SnmpOidDatabaseSupport.java,Java,,67,16,61,144
SnmpOidRecord.java,Java,,20,11,65,96
SnmpOidTable.java,Java,,9,11,52,72
SnmpOidTableSupport.java,Java,,87,30,87,204
SnmpOpaque.java,Java,,26,12,49,87
SnmpParameters.java,Java,,89,24,120,233
SnmpParams.java,Java,,16,5,41,62
SnmpPdu.java,Java,,34,10,66,110
SnmpPduBulk.java,Java,,30,16,62,108
SnmpPduBulkType.java,Java,,7,5,32,44
SnmpPduFactory.java,Java,,6,9,67,82
SnmpPduFactoryBER.java,Java,,34,10,72,116
SnmpPduPacket.java,Java,,6,7,38,51
SnmpPduRequest.java,Java,,26,16,58,100
SnmpPduRequestType.java,Java,,7,1,38,46
SnmpPduTrap.java,Java,,12,19,54,85
SnmpPeer.java,Java,,139,57,251,447
SnmpScopedPduBulk.java,Java,,36,10,49,95
SnmpScopedPduPacket.java,Java,,17,12,62,91
SnmpScopedPduRequest.java,Java,,32,10,43,85
SnmpSecurityException.java,Java,,12,1,38,51
SnmpSecurityParameters.java,Java,,8,2,30,40
SnmpStatusException.java,Java,,32,30,78,140
SnmpString.java,Java,,117,27,121,265
SnmpStringFixed.java,Java,,75,16,90,181
SnmpTimeticks.java,Java,,45,17,76,138
SnmpTooBigException.java,Java,,13,15,47,75
SnmpUnknownAccContrModelException.java,Java,,7,2,22,31
SnmpUnknownModelException.java,Java,,6,0,20,26
SnmpUnknownModelLcdException.java,Java,,6,0,20,26
SnmpUnknownMsgProcModelException.java,Java,,7,2,20,29
SnmpUnknownSecModelException.java,Java,,7,2,20,29
SnmpUnknownSubSystemException.java,Java,,6,0,20,26
SnmpUnsignedInt.java,Java,,32,15,66,113
SnmpUsmKeyHandler.java,Java,,10,8,66,84
SnmpV3Message.java,Java,,283,48,159,490
SnmpValue.java,Java,,19,14,51,84
SnmpVarBind.java,Java,,270,84,391,745
SnmpVarBindList.java,Java,,244,53,260,557
Task.java,Java,,4,1,47,52
TaskServer.java,Java,,4,4,34,42
ThreadService.java,Java,,142,44,56,242
ThreadContext.java,Java,,80,22,211,313
Timestamp.java,Java,,41,22,75,138
UserAcl.java,Java,,11,11,61,83
Trace.java,Java,,85,19,94,198
TraceDestination.java,Java,,16,7,52,75
TraceImplementation.java,Java,,135,34,88,257
TraceManager.java,Java,,95,14,170,279
TraceTags.java,Java,,16,16,54,86
AnnotationProcessor.java,Java,,6,7,34,47
AnnotationProcessorEnvironment.java,Java,,20,22,118,160
AnnotationProcessorFactory.java,Java,,10,10,66,86
AnnotationProcessorListener.java,Java,,2,2,14,18
AnnotationProcessors.java,Java,,31,15,56,102
Filer.java,Java,,17,12,104,133
Messager.java,Java,,10,12,49,71
RoundCompleteEvent.java,Java,,15,5,31,51
RoundCompleteListener.java,Java,,4,2,19,25
RoundState.java,Java,,7,5,30,42
AnnotationMirror.java,Java,,9,8,47,64
AnnotationTypeDeclaration.java,Java,,5,7,22,34
AnnotationTypeElementDeclaration.java,Java,,5,6,23,34
AnnotationValue.java,Java,,7,7,45,59
ClassDeclaration.java,Java,,8,10,48,66
ConstructorDeclaration.java,Java,,3,4,14,21
Declaration.java,Java,,15,15,116,146
EnumConstantDeclaration.java,Java,,4,4,17,25
EnumDeclaration.java,Java,,5,7,20,32
ExecutableDeclaration.java,Java,,9,11,42,62
FieldDeclaration.java,Java,,7,9,40,56
InterfaceDeclaration.java,Java,,4,6,24,34
MemberDeclaration.java,Java,,4,5,25,34
MethodDeclaration.java,Java,,6,7,23,36
Modifier.java,Java,,21,9,25,55
PackageDeclaration.java,Java,,9,11,58,78
ParameterDeclaration.java,Java,,5,7,19,31
TypeDeclaration.java,Java,,12,14,97,123
TypeParameterDeclaration.java,Java,,7,9,30,46
AnnotationType.java,Java,,5,7,17,29
ArrayType.java,Java,,4,5,21,30
ClassType.java,Java,,6,8,37,51
DeclaredType.java,Java,,9,11,68,88
EnumType.java,Java,,5,7,17,29
InterfaceType.java,Java,,5,7,24,36
MirroredTypeException.java,Java,,19,11,33,63
MirroredTypesException.java,Java,,27,11,34,72
PrimitiveType.java,Java,,14,6,24,44
ReferenceType.java,Java,,3,4,15,22
TypeMirror.java,Java,,9,9,44,62
TypeVariable.java,Java,,5,7,22,34
VoidType.java,Java,,4,6,16,26
WildcardType.java,Java,,6,8,37,51
DeclarationFilter.java,Java,,106,39,151,296
Declarations.java,Java,,6,8,32,46
DeclarationScanner.java,Java,,103,38,103,244
DeclarationVisitor.java,Java,,21,21,84,126
DeclarationVisitors.java,Java,,13,5,62,80
SimpleDeclarationVisitor.java,Java,,53,23,117,193
SimpleTypeVisitor.java,Java,,40,19,93,152
SourceOrderDeclScanner.java,Java,,144,50,36,230
SourcePosition.java,Java,,7,9,33,49
Types.java,Java,,20,17,129,166
TypeVisitor.java,Java,,16,18,80,114
FactoryEnumeration.java,Java,,50,10,33,93
NamedWeakReference.java,Java,,11,8,12,31
ResourceManager.java,Java,,263,53,228,544
VersionHelper.java,Java,,65,21,52,138
VersionHelper12.java,Java,,174,29,36,239
AccessFlags.java,Java,,74,22,75,171
Attribute.java,Java,,111,40,151,302
AttributeReader.java,Java,,7,2,88,97
ClassFormatException.java,Java,,5,3,61,69
ClassParser.java,Java,,120,41,167,328
Code.java,Java,,152,50,171,373
CodeException.java,Java,,74,21,134,229
Constant.java,Java,,43,13,92,148
ConstantClass.java,Java,,39,14,101,154
ConstantCP.java,Java,,40,12,102,154
ConstantDouble.java,Java,,36,8,98,142
ConstantFieldref.java,Java,,19,6,79,104
ConstantFloat.java,Java,,36,6,99,141
ConstantInteger.java,Java,,36,14,98,148
ConstantInterfaceMethodref.java,Java,,19,6,79,104
ConstantLong.java,Java,,36,5,98,139
ConstantMethodref.java,Java,,19,6,79,104
ConstantNameAndType.java,Java,,48,15,108,171
ConstantObject.java,Java,,4,2,63,69
ConstantPool.java,Java,,160,42,170,372
ConstantString.java,Java,,41,6,100,147
ConstantUtf8.java,Java,,37,14,96,147
ConstantValue.java,Java,,58,14,106,178
Deprecated.java,Java,,48,16,105,169
DescendingVisitor.java,Java,,224,56,77,357
EmptyVisitor.java,Java,,38,4,63,105
ExceptionTable.java,Java,,70,17,115,202
Field.java,Java,,51,16,98,165
FieldOrMethod.java,Java,,83,25,115,223
InnerClass.java,Java,,84,15,122,221
InnerClasses.java,Java,,56,17,108,181
JavaClass.java,Java,,420,121,280,821
LineNumber.java,Java,,44,15,105,164
LineNumberTable.java,Java,,91,28,121,240
LocalVariable.java,Java,,89,28,142,259
LocalVariableTable.java,Java,,70,22,104,196
Method.java,Java,,84,26,118,228
Node.java,Java,,4,2,59,65
PMGClass.java,Java,,56,16,117,189
Signature.java,Java,,134,44,118,296
SourceFile.java,Java,,44,13,116,173
StackMap.java,Java,,56,22,107,185
StackMapEntry.java,Java,,90,26,93,209
StackMapType.java,Java,,59,18,95,172
Synthetic.java,Java,,51,14,111,176
Unknown.java,Java,,73,21,119,213
Utility.java,Java,,780,215,399,1394
Visitor.java,Java,,35,2,64,101
Constants.java,Java,,628,35,122,785
ExceptionConstants.java,Java,,36,12,75,123
AALOAD.java,Java,,13,4,70,87
AASTORE.java,Java,,13,4,70,87
ACONST_NULL.java,Java,,16,5,73,94
AllocationInstruction.java,Java,,2,3,59,64
ALOAD.java,Java,,13,4,75,92
ANEWARRAY.java,Java,,33,9,72,114
ARETURN.java,Java,,13,4,71,88
ArithmeticInstruction.java,Java,,31,7,68,106
ArrayInstruction.java,Java,,32,6,68,106
ARRAYLENGTH.java,Java,,15,5,72,92
ArrayType.java,Java,,53,17,86,156
ASTORE.java,Java,,13,4,75,92
ATHROW.java,Java,,14,5,73,92
BALOAD.java,Java,,13,4,70,87
BasicType.java,Java,,28,6,67,101
BASTORE.java,Java,,13,4,70,87
BIPUSH.java,Java,,34,11,86,131
BranchHandle.java,Java,,48,18,85,151
BranchInstruction.java,Java,,87,26,133,246
BREAKPOINT.java,Java,,9,3,67,79
CALOAD.java,Java,,13,4,70,87
CASTORE.java,Java,,13,4,70,87
CHECKCAST.java,Java,,32,8,77,117
ClassGen.java,Java,,224,69,158,451
ClassGenException.java,Java,,5,3,60,68
ClassObserver.java,Java,,4,3,60,67
CodeExceptionGen.java,Java,,72,20,110,202
CompoundInstruction.java,Java,,4,3,69,76
ConstantPoolGen.java,Java,,374,152,260,786
ConstantPushInstruction.java,Java,,4,3,63,70
ConversionInstruction.java,Java,,29,5,68,102
CPInstruction.java,Java,,48,17,101,166
D2F.java,Java,,13,4,70,87
D2I.java,Java,,13,4,70,87
D2L.java,Java,,13,4,70,87
DADD.java,Java,,13,4,71,88
DALOAD.java,Java,,13,4,70,87
DASTORE.java,Java,,13,4,70,87
DCMPG.java,Java,,16,6,71,93
DCMPL.java,Java,,16,5,71,92
DCONST.java,Java,,27,9,75,111
DDIV.java,Java,,13,4,71,88
DLOAD.java,Java,,13,4,75,92
DMUL.java,Java,,13,4,71,88
DNEG.java,Java,,13,4,68,85
DREM.java,Java,,13,4,71,88
DRETURN.java,Java,,13,4,70,87
DSTORE.java,Java,,13,4,75,92
DSUB.java,Java,,13,4,71,88
DUP.java,Java,,12,4,68,84
DUP2.java,Java,,12,4,68,84
DUP2_X1.java,Java,,10,4,68,82
DUP2_X2.java,Java,,10,4,68,82
DUP_X1.java,Java,,10,4,68,82
DUP_X2.java,Java,,10,4,68,82
EmptyVisitor.java,Java,,183,2,59,244
ExceptionThrower.java,Java,,4,2,73,79
F2D.java,Java,,13,4,70,87
F2I.java,Java,,13,4,70,87
F2L.java,Java,,13,4,70,87
FADD.java,Java,,13,4,70,87
FALOAD.java,Java,,13,4,70,87
FASTORE.java,Java,,13,4,70,87
FCMPG.java,Java,,16,5,70,91
FCMPL.java,Java,,16,5,70,91
FCONST.java,Java,,29,9,75,113
FDIV.java,Java,,13,4,70,87
FieldGen.java,Java,,154,53,103,310
FieldGenOrMethodGen.java,Java,,40,14,81,135
FieldInstruction.java,Java,,29,10,77,116
FieldObserver.java,Java,,4,3,60,67
FieldOrMethod.java,Java,,31,9,77,117
FLOAD.java,Java,,13,4,75,92
FMUL.java,Java,,13,4,70,87
FNEG.java,Java,,13,4,68,85
FREM.java,Java,,13,4,70,87
FRETURN.java,Java,,13,4,70,87
FSTORE.java,Java,,13,4,75,92
FSUB.java,Java,,13,4,70,87
GETFIELD.java,Java,,32,11,74,117
GETSTATIC.java,Java,,29,10,74,113
GOTO.java,Java,,35,9,78,122
GotoInstruction.java,Java,,9,3,63,75
GOTO_W.java,Java,,26,6,78,110
I2B.java,Java,,13,4,70,87
I2C.java,Java,,13,4,70,87
I2D.java,Java,,13,4,70,87
I2F.java,Java,,13,4,70,87
I2L.java,Java,,13,4,70,87
I2S.java,Java,,13,4,68,85
IADD.java,Java,,13,4,70,87
IALOAD.java,Java,,13,4,71,88
IAND.java,Java,,13,4,68,85
IASTORE.java,Java,,13,4,71,88
ICONST.java,Java,,26,8,75,109
IDIV.java,Java,,17,5,72,94
IFEQ.java,Java,,16,6,76,98
IFGE.java,Java,,16,6,76,98
IFGT.java,Java,,16,6,76,98
IfInstruction.java,Java,,8,5,69,82
IFLE.java,Java,,16,6,76,98
IFLT.java,Java,,16,6,76,98
IFNE.java,Java,,16,6,76,98
IFNONNULL.java,Java,,16,5,76,97
IFNULL.java,Java,,16,6,76,98
IF_ACMPEQ.java,Java,,16,5,76,97
IF_ACMPNE.java,Java,,16,6,76,98
IF_ICMPEQ.java,Java,,16,6,76,98
IF_ICMPGE.java,Java,,16,6,76,98
IF_ICMPGT.java,Java,,16,6,76,98
IF_ICMPLE.java,Java,,16,6,76,98
IF_ICMPLT.java,Java,,16,6,76,98
IF_ICMPNE.java,Java,,16,6,76,98
IINC.java,Java,,68,19,96,183
ILOAD.java,Java,,13,4,75,92
IMPDEP1.java,Java,,9,4,67,80
IMPDEP2.java,Java,,9,4,67,80
IMUL.java,Java,,13,4,70,87
IndexedInstruction.java,Java,,5,3,60,68
INEG.java,Java,,13,4,68,85
INSTANCEOF.java,Java,,26,8,72,106
Instruction.java,Java,,108,39,158,305
InstructionComparator.java,Java,,37,6,66,109
InstructionConstants.java,Java,,237,8,81,326
InstructionFactory.java,Java,,421,66,136,623
InstructionHandle.java,Java,,110,35,139,284
InstructionList.java,Java,,612,195,480,1287
InstructionListObserver.java,Java,,4,3,60,67
InstructionTargeter.java,Java,,5,2,63,70
InvokeInstruction.java,Java,,45,14,87,146
INVOKEINTERFACE.java,Java,,59,18,86,163
INVOKESPECIAL.java,Java,,30,9,74,113
INVOKESTATIC.java,Java,,28,9,73,110
INVOKEVIRTUAL.java,Java,,30,9,73,112
IOR.java,Java,,13,4,68,85
IREM.java,Java,,17,5,72,94
IRETURN.java,Java,,13,4,70,87
ISHL.java,Java,,13,4,68,85
ISHR.java,Java,,13,4,68,85
ISTORE.java,Java,,13,4,75,92
ISUB.java,Java,,13,4,70,87
IUSHR.java,Java,,13,4,68,85
IXOR.java,Java,,13,4,68,85
JSR.java,Java,,35,9,75,119
JsrInstruction.java,Java,,26,10,79,115
JSR_W.java,Java,,26,6,78,110
L2D.java,Java,,13,4,68,85
L2F.java,Java,,13,4,68,85
L2I.java,Java,,13,4,68,85
LADD.java,Java,,13,4,69,86
LALOAD.java,Java,,13,4,70,87
LAND.java,Java,,13,4,69,86
LASTORE.java,Java,,13,4,70,87
LCMP.java,Java,,17,4,71,92
LCONST.java,Java,,27,9,75,111
LDC.java,Java,,72,16,84,172
LDC2_W.java,Java,,34,9,73,116
LDC_W.java,Java,,15,4,69,88
LDIV.java,Java,,17,5,69,91
LineNumberGen.java,Java,,40,11,80,131
LLOAD.java,Java,,13,4,72,89
LMUL.java,Java,,13,4,69,86
LNEG.java,Java,,13,4,68,85
LoadClass.java,Java,,5,3,78,86
LoadInstruction.java,Java,,18,5,78,101
LocalVariableGen.java,Java,,82,22,100,204
LocalVariableInstruction.java,Java,,99,21,106,226
LOOKUPSWITCH.java,Java,,40,12,81,133
LOR.java,Java,,13,4,68,85
LREM.java,Java,,15,5,68,88
LRETURN.java,Java,,13,4,68,85
LSHL.java,Java,,13,4,68,85
LSHR.java,Java,,13,4,68,85
LSTORE.java,Java,,13,4,72,89
LSUB.java,Java,,13,4,69,86
LUSHR.java,Java,,13,4,68,85
LXOR.java,Java,,13,4,68,85
MethodGen.java,Java,,530,149,296,975
MethodObserver.java,Java,,4,3,60,67
MONITORENTER.java,Java,,15,5,68,88
MONITOREXIT.java,Java,,15,5,68,88
MULTIANEWARRAY.java,Java,,59,20,93,172
NamedAndTyped.java,Java,,7,4,60,71
NEW.java,Java,,30,9,72,111
NEWARRAY.java,Java,,40,11,89,140
NOP.java,Java,,9,4,67,80
ObjectType.java,Java,,45,12,79,136
POP.java,Java,,12,4,69,85
POP2.java,Java,,12,4,69,85
PopInstruction.java,Java,,3,3,62,68
PUSH.java,Java,,80,15,101,196
PushInstruction.java,Java,,3,3,67,73
PUTFIELD.java,Java,,33,11,74,118
PUTSTATIC.java,Java,,30,10,74,114
ReferenceType.java,Java,,140,40,169,349
RET.java,Java,,54,16,91,161
RETURN.java,Java,,13,4,68,85
ReturnaddressType.java,Java,,22,8,72,102
ReturnInstruction.java,Java,,28,8,68,104
SALOAD.java,Java,,13,4,68,85
SASTORE.java,Java,,13,4,68,85
Select.java,Java,,96,36,122,254
SIPUSH.java,Java,,34,10,84,128
StackConsumer.java,Java,,4,3,61,68
StackInstruction.java,Java,,10,5,68,83
StackProducer.java,Java,,4,3,62,69
StoreInstruction.java,Java,,18,5,78,101
SWAP.java,Java,,12,4,68,84
SWITCH.java,Java,,79,22,82,183
TABLESWITCH.java,Java,,44,16,87,147
TargetLostException.java,Java,,9,4,87,100
Type.java,Java,,147,33,107,287
TypedInstruction.java,Java,,4,3,60,67
UnconditionalBranch.java,Java,,2,3,62,67
VariableLengthInstruction.java,Java,,2,3,65,70
Visitor.java,Java,,183,2,62,247
Repository.java,Java,,85,26,137,248
AttributeHTML.java,Java,,138,47,70,255
BCELFactory.java,Java,,231,64,62,357
BCELifier.java,Java,,183,51,70,304
ByteSequence.java,Java,,16,5,61,82
Class2HTML.java,Java,,138,31,93,262
ClassLoader.java,Java,,91,26,104,221
ClassLoaderRepository.java,Java,,56,19,80,155
ClassPath.java,Java,,188,68,125,381
ClassQueue.java,Java,,14,6,61,81
ClassSet.java,Java,,26,8,62,96
ClassStack.java,Java,,10,3,60,73
ClassVector.java,Java,,14,4,61,79
CodeHTML.java,Java,,381,100,137,618
ConstantHTML.java,Java,,151,39,72,262
InstructionFinder.java,Java,,203,59,178,440
JavaWrapper.java,Java,,54,17,81,152
MethodHTML.java,Java,,94,27,78,199
Repository.java,Java,,12,11,82,105
SecuritySupport.java,Java,,147,21,55,223
SyntheticRepository.java,Java,,82,28,94,204
CharacterArrayCharacterIterator.java,Java,,37,7,29,73
CharacterIterator.java,Java,,8,5,26,39
RE.java,Java,,895,166,696,1757
ReaderCharacterIterator.java,Java,,112,17,32,161
recompile.java,Java,,56,11,67,134
RECompiler.java,Java,,993,181,343,1517
REDebugCompiler.java,Java,,103,25,94,222
REProgram.java,Java,,73,15,67,155
RESyntaxException.java,Java,,8,2,30,40
RETest.java,Java,,640,82,158,880
REUtil.java,Java,,17,4,37,58
StreamCharacterIterator.java,Java,,109,17,32,158
StringCharacterIterator.java,Java,,25,7,27,59
ExpressionContext.java,Java,,17,11,63,91
ExsltBase.java,Java,,43,4,35,82
ExsltCommon.java,Java,,31,4,69,104
ExsltDatetime.java,Java,,564,81,473,1118
ExsltDynamic.java,Java,,296,70,246,612
ExsltMath.java,Java,,157,36,194,387
ExsltSets.java,Java,,103,28,106,237
ExsltStrings.java,Java,,156,34,163,353
Extensions.java,Java,,187,44,185,416
NodeInfo.java,Java,,105,24,117,246
XSLMessages.java,Java,,31,8,50,89
XSLTErrorResources.java,Java,,966,283,196,1445
XSLTErrorResources_de.java,Java,,910,646,853,2409
XSLTErrorResources_en.java,Java,,4,2,23,29
XSLTErrorResources_es.java,Java,,910,646,853,2409
XSLTErrorResources_fr.java,Java,,910,646,853,2409
XSLTErrorResources_it.java,Java,,910,646,853,2409
XSLTErrorResources_ja.java,Java,,910,646,853,2409
XSLTErrorResources_ko.java,Java,,910,646,853,2409
XSLTErrorResources_pt_BR.java,Java,,966,284,196,1446
XSLTErrorResources_sv.java,Java,,1130,972,595,2697
XSLTErrorResources_zh_CN.java,Java,,910,646,853,2409
XSLTErrorResources_zh_TW.java,Java,,910,646,853,2409
Constants.java,Java,,278,36,83,397
ConfigurationError.java,Java,,12,9,76,97
FactoryImpl.java,Java,,23,6,43,72
ObjectFactory.java,Java,,332,51,315,698
SecuritySupport.java,Java,,137,21,84,242
Version.java,Java,,46,11,94,151
XalanConstants.java,Java,,7,6,67,80
EnvironmentCheck.java,Java,,708,168,407,1283
Process.java,Java,,796,116,310,1222
Compile.java,Java,,111,17,39,167
GetOpt.java,Java,,144,19,92,255
GetOptsException.java,Java,,7,2,21,30
IllegalArgumentException.java,Java,,7,3,18,28
MissingOptArgException.java,Java,,7,3,21,31
Transform.java,Java,,224,30,39,293
CollatorFactory.java,Java,,7,4,22,33
AbsoluteLocationPath.java,Java,,77,13,34,124
AbsolutePathPattern.java,Java,,94,17,27,138
AlternativePattern.java,Java,,54,15,29,98
AncestorPattern.java,Java,,121,26,33,180
ApplyImports.java,Java,,83,22,52,157
ApplyTemplates.java,Java,,141,22,37,200
ArgumentList.java,Java,,14,4,22,40
Attribute.java,Java,,14,5,24,43
AttributeSet.java,Java,,118,29,62,209
AttributeValue.java,Java,,19,5,22,46
AttributeValueTemplate.java,Java,,201,19,39,259
BinOpExpr.java,Java,,85,14,29,128
BooleanCall.java,Java,,25,8,22,55
BooleanExpr.java,Java,,43,10,24,77
CallTemplate.java,Java,,143,29,67,239
CastCall.java,Java,,48,13,37,98
CastExpr.java,Java,,160,28,47,235
CeilingCall.java,Java,,19,5,22,46
Choose.java,Java,,100,19,45,164
Closure.java,Java,,7,6,35,48
Comment.java,Java,,68,12,34,114
CompilerException.java,Java,,23,8,21,52
ConcatCall.java,Java,,59,11,23,93
Constants.java,Java,,429,41,34,504
ContainsCall.java,Java,,50,14,41,105
Copy.java,Java,,103,15,37,155
CopyOf.java,Java,,97,15,27,139
CurrentCall.java,Java,,11,4,22,37
DecimalFormatting.java,Java,,170,28,56,254
DocumentCall.java,Java,,88,23,43,154
ElementAvailableCall.java,Java,,44,9,38,91
EqualityExpr.java,Java,,273,42,42,357
Expression.java,Java,,121,26,73,220
Fallback.java,Java,,32,10,35,77
FilteredAbsoluteLocationPath.java,Java,,77,14,32,123
FilterExpr.java,Java,,117,26,61,204
FilterParentPath.java,Java,,100,19,45,164
FloorCall.java,Java,,17,5,22,44
FlowList.java,Java,,72,14,29,115
ForEach.java,Java,,114,28,52,194
FormatNumberCall.java,Java,,75,13,24,112
FunctionAvailableCall.java,Java,,111,25,56,192
FunctionCall.java,Java,,772,143,172,1087
GenerateIdCall.java,Java,,25,5,23,53
IdKeyPattern.java,Java,,73,21,32,126
IdPattern.java,Java,,6,5,22,33
If.java,Java,,53,11,44,108
IllegalCharException.java,Java,,7,2,22,31
Import.java,Java,,103,20,29,152
Include.java,Java,,102,20,30,152
Instruction.java,Java,,16,4,28,48
IntExpr.java,Java,,25,7,22,54
Key.java,Java,,169,51,79,299
KeyCall.java,Java,,111,26,97,234
KeyPattern.java,Java,,6,4,22,32
LangCall.java,Java,,45,9,35,89
LastCall.java,Java,,37,8,22,67
LiteralAttribute.java,Java,,84,21,50,155
LiteralElement.java,Java,,357,59,138,554
LiteralExpr.java,Java,,40,12,31,83
LocalNameCall.java,Java,,31,9,32,72
LocationPathPattern.java,Java,,58,15,32,105
LogicalExpr.java,Java,,115,33,83,231
Message.java,Java,,98,22,39,159
Mode.java,Java,,967,209,347,1523
NameBase.java,Java,,69,16,41,126
NameCall.java,Java,,24,8,32,64
NamespaceAlias.java,Java,,19,7,27,53
NamespaceUriCall.java,Java,,25,8,32,65
NodeTest.java,Java,,13,5,23,41
NotCall.java,Java,,28,6,22,56
Number.java,Java,,447,76,84,607
NumberCall.java,Java,,35,9,22,66
Otherwise.java,Java,,24,5,22,51
Output.java,Java,,289,53,75,417
Param.java,Java,,153,24,77,254
ParameterRef.java,Java,,64,12,33,109
ParentLocationPath.java,Java,,162,37,49,248
ParentPattern.java,Java,,95,23,26,144
Parser.java,Java,,1007,150,239,1396
Pattern.java,Java,,11,5,42,58
PositionCall.java,Java,,34,8,23,65
Predicate.java,Java,,356,78,185,619
ProcessingInstruction.java,Java,,85,19,33,137
ProcessingInstructionPattern.java,Java,,97,19,40,156
QName.java,Java,,45,14,23,82
RealExpr.java,Java,,25,7,22,54
RelationalExpr.java,Java,,203,36,40,279
RelativeLocationPath.java,Java,,5,2,22,29
RelativePathPattern.java,Java,,2,2,22,26
RoundCall.java,Java,,19,7,23,49
SimpleAttributeValue.java,Java,,28,9,36,73
Sort.java,Java,,509,109,133,751
SourceLoader.java,Java,,5,5,30,40
StartsWithCall.java,Java,,42,12,35,89
Step.java,Java,,327,54,147,528
StepPattern.java,Java,,374,78,71,523
StringCall.java,Java,,41,9,22,72
StringLengthCall.java,Java,,26,5,22,53
Stylesheet.java,Java,,874,202,334,1410
sym.java,Java,,57,4,6,67
SymbolTable.java,Java,,160,38,64,262
SyntaxTreeNode.java,Java,,458,96,358,912
Template.java,Java,,233,58,48,339
TestSeq.java,Java,,135,39,111,285
Text.java,Java,,148,27,68,243
TopLevelElement.java,Java,,44,12,40,96
TransletOutput.java,Java,,76,23,46,145
UnaryOpExpr.java,Java,,45,13,29,87
UnionPathExpr.java,Java,,97,17,30,144
UnparsedEntityUriCall.java,Java,,35,7,26,68
UnresolvedRef.java,Java,,62,14,24,100
UnsupportedElement.java,Java,,79,16,53,148
UseAttributeSets.java,Java,,58,12,44,114
AttributeSetMethodGenerator.java,Java,,44,10,21,75
BooleanType.java,Java,,137,22,62,221
ClassGenerator.java,Java,,74,16,43,133
CompareGenerator.java,Java,,76,17,23,116
ErrorMessages.java,Java,,258,115,579,952
ErrorMessages_ca.java,Java,,199,104,546,849
ErrorMessages_cs.java,Java,,199,104,546,849
ErrorMessages_de.java,Java,,199,104,546,849
ErrorMessages_es.java,Java,,199,104,546,849
ErrorMessages_fr.java,Java,,199,104,546,849
ErrorMessages_it.java,Java,,199,104,546,849
ErrorMessages_ja.java,Java,,199,104,546,849
ErrorMessages_ko.java,Java,,199,104,546,849
ErrorMessages_pt_BR.java,Java,,217,114,579,910
ErrorMessages_sk.java,Java,,199,104,546,849
ErrorMessages_zh_CN.java,Java,,199,104,546,849
ErrorMessages_zh_TW.java,Java,,199,104,546,849
ErrorMsg.java,Java,,232,33,47,312
FilterGenerator.java,Java,,22,7,33,62
IntType.java,Java,,196,29,73,298
MatchGenerator.java,Java,,51,15,34,100
MethodGenerator.java,Java,,232,59,45,336
MethodType.java,Java,,126,17,26,169
MultiHashtable.java,Java,,27,4,22,53
NamedMethodGenerator.java,Java,,30,8,25,63
NodeCounterGenerator.java,Java,,25,7,39,71
NodeSetType.java,Java,,194,30,103,327
NodeSortRecordFactGenerator.java,Java,,14,5,26,45
NodeSortRecordGenerator.java,Java,,22,7,32,61
NodeType.java,Java,,201,33,87,321
NumberType.java,Java,,9,5,22,36
ObjectType.java,Java,,101,22,52,175
RealType.java,Java,,225,34,81,340
ReferenceType.java,Java,,257,32,87,376
ResultTreeType.java,Java,,272,46,143,461
RtMethodGenerator.java,Java,,33,9,24,66
SlotAllocator.java,Java,,63,13,22,98
StringStack.java,Java,,14,5,22,41
StringType.java,Java,,129,23,75,227
TestGenerator.java,Java,,72,17,24,113
Type.java,Java,,164,38,92,294
TypeCheckError.java,Java,,41,12,22,75
Util.java,Java,,126,30,45,201
VoidType.java,Java,,47,11,38,96
ValueOf.java,Java,,81,14,41,136
Variable.java,Java,,115,18,54,187
VariableBase.java,Java,,159,33,100,292
VariableRef.java,Java,,59,10,26,95
VariableRefBase.java,Java,,75,21,60,156
When.java,Java,,50,14,39,103
Whitespace.java,Java,,346,65,128,539
WithParam.java,Java,,104,22,81,207
XPathLexer.java,Java,,1557,19,39,1615
XPathParser.java,Java,,2639,260,249,3148
XslAttribute.java,Java,,183,41,66,290
XslElement.java,Java,,188,40,62,290
XSLTC.java,Java,,525,107,279,911
AbsoluteIterator.java,Java,,50,12,35,97
AdaptiveResultTreeImpl.java,Java,,1108,153,80,1341
AnyNodeCounter.java,Java,,82,9,36,127
BitArray.java,Java,,159,33,72,264
CachedNodeListIterator.java,Java,,66,16,29,111
ClonedNodeListIterator.java,Java,,37,14,28,79
CollatorFactoryBase.java,Java,,19,8,21,48
CurrentNodeListFilter.java,Java,,7,3,23,33
CurrentNodeListIterator.java,Java,,117,28,52,197
DocumentCache.java,Java,,213,48,76,337
DOMAdapter.java,Java,,357,71,36,464
DOMBuilder.java,Java,,2,2,21,25
DOMWSFilter.java,Java,,62,14,52,128
DupFilterIterator.java,Java,,82,20,53,155
EmptyFilter.java,Java,,6,2,22,30
ExtendedSAX.java,Java,,9,2,21,32
Filter.java,Java,,4,2,22,28
FilteredStepIterator.java,Java,,20,7,25,52
FilterIterator.java,Java,,62,18,36,116
ForwardPositionIterator.java,Java,,41,11,53,105
KeyIndex.java,Java,,381,116,400,897
LoadDocument.java,Java,,186,34,71,291
MatchingIterator.java,Java,,61,18,46,125
MultiDOM.java,Java,,504,102,61,667
MultipleNodeCounter.java,Java,,75,14,27,116
MultiValuedNodeHeapIterator.java,Java,,165,35,92,292
NodeCounter.java,Java,,232,47,82,361
NodeIteratorBase.java,Java,,65,19,84,168
NodeSortRecord.java,Java,,136,30,82,248
NodeSortRecordFactory.java,Java,,92,21,49,162
NthIterator.java,Java,,61,13,39,113
SAXImpl.java,Java,,1182,238,483,1903
SimpleResultTreeImpl.java,Java,,733,175,108,1016
SingleNodeCounter.java,Java,,109,19,27,155
SingletonIterator.java,Java,,53,11,26,90
SortingIterator.java,Java,,99,18,30,147
SortSettings.java,Java,,39,16,81,136
StepIterator.java,Java,,68,16,52,136
StripWhitespaceFilter.java,Java,,5,3,22,30
UnionIterator.java,Java,,53,14,29,96
XSLTCDTMManager.java,Java,,249,49,183,481
DOM.java,Java,,66,11,26,103
DOMCache.java,Java,,4,5,45,54
DOMEnhancedForDTM.java,Java,,12,1,30,43
NodeIterator.java,Java,,15,14,53,82
ProcessorVersion.java,Java,,10,4,33,47
AbstractTranslet.java,Java,,440,106,221,767
AttributeList.java,Java,,118,24,84,226
Attributes.java,Java,,29,10,22,61
BasisLibrary.java,Java,,1136,157,292,1585
Constants.java,Java,,19,6,24,49
ErrorMessages.java,Java,,57,32,194,283
ErrorMessages_ca.java,Java,,43,23,163,229
ErrorMessages_cs.java,Java,,43,23,163,229
ErrorMessages_de.java,Java,,43,23,163,229
ErrorMessages_es.java,Java,,43,23,163,229
ErrorMessages_fr.java,Java,,43,23,163,229
ErrorMessages_it.java,Java,,43,23,163,229
ErrorMessages_ja.java,Java,,43,23,163,229
ErrorMessages_ko.java,Java,,43,23,163,229
ErrorMessages_pt_BR.java,Java,,57,32,194,283
ErrorMessages_sk.java,Java,,43,23,163,229
ErrorMessages_zh_CN.java,Java,,43,23,163,229
ErrorMessages_zh_TW.java,Java,,43,23,163,229
Hashtable.java,Java,,198,42,101,341
MessageHandler.java,Java,,6,2,21,29
Node.java,Java,,9,3,24,36
Operators.java,Java,,26,7,23,56
OutputBuffer.java,Java,,7,6,21,34
StringOutputBuffer.java,Java,,22,9,21,52
TransletOutputHandlerFactory.java,Java,,199,46,23,268
WriterOutputBuffer.java,Java,,55,12,28,95
Parameter.java,Java,,16,5,23,44
StringValueHandler.java,Java,,76,18,29,123
StripFilter.java,Java,,4,3,22,29
Translet.java,Java,,24,7,22,53
TransletException.java,Java,,15,6,23,44
DOM2SAX.java,Java,,307,56,118,481
DOM2TO.java,Java,,260,58,114,432
OutputSettings.java,Java,,17,7,21,45
SAX2DOM.java,Java,,216,45,71,332
SAX2StAXBaseWriter.java,Java,,155,51,45,251
SAX2StAXEventWriter.java,Java,,223,152,47,422
SAX2StAXStreamWriter.java,Java,,139,111,54,304
SmartTransformerFactoryImpl.java,Java,,289,35,127,451
StAXEvent2SAX.java,Java,,372,77,154,603
StAXStream2SAX.java,Java,,325,79,148,552
TemplatesHandlerImpl.java,Java,,159,46,127,332
TemplatesImpl.java,Java,,225,55,167,447
TransformerFactoryImpl.java,Java,,855,147,447,1449
TransformerHandlerImpl.java,Java,,271,55,157,483
TransformerImpl.java,Java,,851,132,412,1395
TrAXFilter.java,Java,,99,20,25,144
Util.java,Java,,146,34,41,221
XSLTCSource.java,Java,,75,19,44,138
IntegerArray.java,Java,,158,33,33,224
AttributeMap.java,Java,,334,66,166,566
AttrImpl.java,Java,,573,159,503,1235
AttrNSImpl.java,Java,,182,34,132,348
CDATASectionImpl.java,Java,,17,11,58,86
CharacterDataImpl.java,Java,,163,75,184,422
ChildNode.java,Java,,35,24,88,147
CommentImpl.java,Java,,18,11,39,68
CoreDocumentImpl.java,Java,,1317,331,1114,2762
CoreDOMImplementationImpl.java,Java,,257,24,203,484
DeepNodeListImpl.java,Java,,113,31,100,244
DeferredAttrImpl.java,Java,,32,20,90,142
DeferredAttrNSImpl.java,Java,,40,24,63,127
DeferredCDATASectionImpl.java,Java,,21,18,67,106
DeferredCommentImpl.java,Java,,21,18,48,87
DeferredDocumentImpl.java,Java,,1295,371,478,2144
DeferredDocumentTypeImpl.java,Java,,75,34,75,184
DeferredDOMImplementationImpl.java,Java,,9,8,38,55
DeferredElementDefinitionImpl.java,Java,,39,26,58,123
DeferredElementImpl.java,Java,,40,25,70,135
DeferredElementNSImpl.java,Java,,51,28,65,144
DeferredEntityImpl.java,Java,,40,27,83,150
DeferredEntityReferenceImpl.java,Java,,31,22,99,152
DeferredNode.java,Java,,6,8,26,40
DeferredNotationImpl.java,Java,,27,20,67,114
DeferredProcessingInstructionImpl.java,Java,,23,18,50,91
DeferredTextImpl.java,Java,,22,20,62,104
DocumentFragmentImpl.java,Java,,48,17,87,152
DocumentImpl.java,Java,,643,124,534,1301
DocumentTypeImpl.java,Java,,231,73,178,482
DOMConfigurationImpl.java,Java,,632,135,305,1072
DOMErrorImpl.java,Java,,47,27,59,133
DOMImplementationImpl.java,Java,,51,19,78,148
DOMImplementationListImpl.java,Java,,23,8,40,71
DOMImplementationSourceImpl.java,Java,,73,10,50,133
DOMInputImpl.java,Java,,96,45,247,388
DOMLocatorImpl.java,Java,,57,29,73,159
DOMMessageFormatter.java,Java,,82,11,47,140
DOMNormalizer.java,Java,,1171,251,622,2044
DOMOutputImpl.java,Java,,35,24,110,169
DOMStringListImpl.java,Java,,28,12,46,86
DOMXSImplementationSourceImpl.java,Java,,39,9,49,97
ElementDefinitionImpl.java,Java,,35,20,63,118
ElementImpl.java,Java,,577,144,454,1175
ElementNSImpl.java,Java,,263,58,164,485
EntityImpl.java,Java,,136,66,163,365
EntityReferenceImpl.java,Java,,139,41,219,399
EventImpl.java,Java,,56,15,61,132
MutationEventImpl.java,Java,,49,12,48,109
LCount.java,Java,,13,4,37,54
NamedNodeMapImpl.java,Java,,298,82,219,599
NodeImpl.java,Java,,878,214,929,2021
NodeIteratorImpl.java,Java,,179,68,124,371
NodeListCache.java,Java,,13,11,32,56
NotationImpl.java,Java,,81,33,95,209
ParentNode.java,Java,,505,120,408,1033
ProcessingInstructionImpl.java,Java,,44,24,90,158
PSVIAttrNSImpl.java,Java,,91,38,121,250
PSVIDocumentImpl.java,Java,,55,21,71,147
PSVIDOMImplementationImpl.java,Java,,32,13,76,121
PSVIElementNSImpl.java,Java,,105,44,142,291
RangeExceptionImpl.java,Java,,8,5,21,34
RangeImpl.java,Java,,1273,181,628,2082
TextImpl.java,Java,,318,92,252,662
TreeWalkerImpl.java,Java,,279,93,132,504
Constants.java,Java,,280,184,287,751
DTDGrammar.java,Java,,1488,411,868,2767
DTDGrammarBucket.java,Java,,35,17,96,148
CMAny.java,Java,,63,26,101,190
CMBinOp.java,Java,,71,16,102,189
CMLeaf.java,Java,,66,27,92,185
CMNode.java,Java,,53,18,118,189
CMStateSet.java,Java,,189,27,124,340
CMUniOp.java,Java,,36,15,90,141
ContentModelValidator.java,Java,,5,6,74,85
DFAContentModel.java,Java,,370,117,543,1030
MixedContentModel.java,Java,,91,26,139,256
SimpleContentModel.java,Java,,92,35,191,318
XML11DTDProcessor.java,Java,,29,13,70,112
XML11DTDValidator.java,Java,,33,13,76,122
XML11NSDTDValidator.java,Java,,130,23,109,262
XMLAttributeDecl.java,Java,,17,11,79,107
XMLContentSpec.java,Java,,72,44,218,334
XMLDTDDescription.java,Java,,92,18,99,209
XMLDTDLoader.java,Java,,200,41,188,429
XMLDTDProcessor.java,Java,,737,226,734,1697
XMLDTDValidator.java,Java,,1090,287,715,2092
XMLDTDValidatorFilter.java,Java,,7,7,76,90
XMLElementDecl.java,Java,,29,19,90,138
XMLEntityDecl.java,Java,,38,17,100,155
XMLNotationDecl.java,Java,,19,11,79,109
XMLNSDTDValidator.java,Java,,133,29,110,272
XMLSimpleType.java,Java,,69,34,106,209
DatatypeException.java,Java,,41,12,53,106
DatatypeValidator.java,Java,,6,5,31,42
DTDDVFactoryImpl.java,Java,,31,12,36,79
ENTITYDatatypeValidator.java,Java,,10,8,47,65
IDDatatypeValidator.java,Java,,23,9,49,81
IDREFDatatypeValidator.java,Java,,20,9,46,75
ListDatatypeValidator.java,Java,,19,9,38,66
NMTOKENDatatypeValidator.java,Java,,12,6,36,54
NOTATIONDatatypeValidator.java,Java,,8,6,38,52
StringDatatypeValidator.java,Java,,8,6,43,57
XML11DTDDVFactoryImpl.java,Java,,31,11,38,80
XML11IDDatatypeValidator.java,Java,,24,10,50,84
XML11IDREFDatatypeValidator.java,Java,,21,10,47,78
XML11NMTOKENDatatypeValidator.java,Java,,13,7,37,57
DTDDVFactory.java,Java,,20,11,54,85
DVFactoryException.java,Java,,10,5,24,39
InvalidDatatypeFacetException.java,Java,,7,5,33,45
InvalidDatatypeValueException.java,Java,,7,5,73,85
SchemaDVFactory.java,Java,,29,16,100,145
Base64.java,Java,,198,52,54,304
ByteListImpl.java,Java,,28,11,48,87
HexBin.java,Java,,67,8,37,112
ValidatedInfo.java,Java,,22,11,62,95
ValidationContext.java,Java,,14,10,33,57
AbstractDateTimeDV.java,Java,,637,107,264,1008
AnyAtomicDV.java,Java,,11,6,24,41
AnySimpleDV.java,Java,,11,6,26,43
AnyURIDV.java,Java,,105,14,49,168
Base64BinaryDV.java,Java,,43,10,29,82
BaseDVFactory.java,Java,,138,30,78,246
BooleanDV.java,Java,,19,8,25,52
DateDV.java,Java,,40,13,36,89
DateTimeDV.java,Java,,37,15,38,90
DayDV.java,Java,,53,18,43,114
DayTimeDurationDV.java,Java,,29,6,24,59
DecimalDV.java,Java,,262,42,57,361
DoubleDV.java,Java,,152,24,71,247
DurationDV.java,Java,,247,55,80,382
EntityDV.java,Java,,20,8,25,53
FloatDV.java,Java,,141,25,66,232
FullDVFactory.java,Java,,94,25,46,165
HexBinaryDV.java,Java,,43,11,26,80
IDDV.java,Java,,21,6,25,52
IDREFDV.java,Java,,18,8,25,51
IntegerDV.java,Java,,12,5,24,41
ListDV.java,Java,,67,13,29,109
MonthDayDV.java,Java,,58,19,49,126
MonthDV.java,Java,,52,14,98,164
PrecisionDecimalDV.java,Java,,224,57,77,358
QNameDV.java,Java,,56,16,36,108
SchemaDateTimeException.java,Java,,10,5,21,36
SchemaDVFactoryImpl.java,Java,,244,55,78,377
StringDV.java,Java,,12,6,25,43
TimeDV.java,Java,,44,15,50,109
TypeValidator.java,Java,,35,16,56,107
UnionDV.java,Java,,11,6,27,44
XSSimpleTypeDecl.java,Java,,2270,341,647,3258
YearDV.java,Java,,49,16,49,114
YearMonthDurationDV.java,Java,,30,6,24,60
YearMonthDV.java,Java,,40,15,42,97
XSFacets.java,Java,,46,21,66,133
XSSimpleType.java,Java,,39,14,147,200
ExternalSubsetResolver.java,Java,,11,7,45,63
ASCIIReader.java,Java,,78,24,142,244
MalformedByteSequenceException.java,Java,,38,19,79,136
UCSReader.java,Java,,131,25,152,308
UTF8Reader.java,Java,,436,67,200,703
XMLMessageFormatter.java,Java,,54,12,51,117
PropertyManager.java,Java,,92,25,56,173
RevalidationHandler.java,Java,,6,5,70,81
EntityState.java,Java,,5,4,37,46
ValidationManager.java,Java,,32,13,37,82
ValidationState.java,Java,,108,28,55,191
Version.java,Java,,11,10,77,98
XML11DocumentScannerImpl.java,Java,,345,36,207,588
XML11DTDScannerImpl.java,Java,,115,26,163,304
XML11EntityScanner.java,Java,,1062,93,369,1524
XML11NamespaceBinder.java,Java,,8,10,85,103
XML11NSDocumentScannerImpl.java,Java,,530,106,287,923
XMLDocumentFragmentScannerImpl.java,Java,aa,1612,437,1216,3265
XMLDocumentScannerImpl.java,Java,,781,233,510,1524
XMLDTDScannerImpl.java,Java,,1309,205,642,2156
XMLEntityDescription.java,Java,,6,6,35,47
XMLEntityHandler.java,Java,,11,7,98,116
XMLEntityManager.java,Java,,1703,368,993,3064
XMLEntityScanner.java,Java,,1349,189,628,2166
XMLErrorReporter.java,Java,,196,72,337,605
XMLNamespaceBinder.java,Java,,355,108,427,890
XMLNSDocumentScannerImpl.java,Java,,345,93,223,661
XMLScanner.java,Java,,864,166,435,1465
XMLStreamFilterImpl.java,Java,,223,62,255,540
XMLStreamReaderImpl.java,Java,,799,141,429,1369
XMLVersionDetector.java,Java,,116,34,122,272
BMPattern.java,Java,,170,13,52,235
Match.java,Java,,98,14,71,183
Op.java,Java,,211,11,29,251
ParseException.java,Java,,12,6,34,52
ParserForXMLSchema.java,Java,,409,27,49,485
RangeToken.java,Java,,492,29,99,620
RegexParser.java,Java,,925,70,96,1091
RegularExpression.java,Java,,2127,244,782,3153
REUtil.java,Java,,260,25,47,332
Token.java,Java,,1280,157,113,1550
XPath.java,Java,,1355,157,507,2019
XPathException.java,Java,,17,9,32,58
AttributePSVImpl.java,Java,,78,31,110,219
ElementPSVImpl.java,Java,,98,39,137,274
Field.java,Java,,116,37,91,244
FieldActivator.java,Java,,9,10,66,85
IdentityConstraint.java,Java,,120,38,89,247
KeyRef.java,Java,,18,11,40,69
Selector.java,Java,,106,42,104,252
UniqueOrKey.java,Java,,9,6,33,48
ValueStore.java,Java,,6,9,52,67
XPathMatcher.java,Java,,275,59,185,519
CMBuilder.java,Java,,180,31,111,322
CMNodeFactory.java,Java,,73,27,54,154
XSAllCM.java,Java,,98,37,86,221
XSCMBinOp.java,Java,,60,16,63,139
XSCMLeaf.java,Java,,54,27,53,134
XSCMUniOp.java,Java,,36,16,57,109
XSCMValidator.java,Java,,16,16,75,107
XSDFACM.java,Java,,450,127,463,1040
XSEmptyCM.java,Java,,38,24,75,137
AttrImpl.java,Java,,40,20,81,141
DefaultDocument.java,Java,,115,63,110,288
DefaultElement.java,Java,,75,45,28,148
DefaultNode.java,Java,,121,66,29,216
DefaultText.java,Java,,54,16,165,235
DefaultXMLDocumentHandler.java,Java,,174,69,625,868
ElementImpl.java,Java,,166,54,32,252
NamedNodeMapImpl.java,Java,,48,15,22,85
NodeImpl.java,Java,,39,22,23,84
SchemaDOM.java,Java,,304,56,89,449
SchemaDOMParser.java,Java,,275,69,255,599
SchemaParsingConfig.java,Java,,332,119,258,709
TextImpl.java,Java,,50,16,61,127
SchemaGrammar.java,Java,,710,157,334,1201
SchemaNamespaceSupport.java,Java,,50,8,51,109
SchemaSymbols.java,Java,,164,14,36,214
SubstitutionGroupHandler.java,Java,,174,37,114,325
SchemaContentHandler.java,Java,,255,36,88,379
XSAnnotationInfo.java,Java,,30,9,30,69
XSAttributeChecker.java,Java,,1287,133,473,1893
XSDAbstractIDConstraintTraverser.java,Java,,124,19,40,183
XSDAbstractParticleTraverser.java,Java,,212,45,107,364
XSDAbstractTraverser.java,Java,,638,56,113,807
XSDAttributeGroupTraverser.java,Java,,88,33,47,168
XSDAttributeTraverser.java,Java,,250,59,102,411
XSDComplexTypeTraverser.java,Java,,867,141,211,1219
XSDElementTraverser.java,Java,,304,62,135,501
XSDGroupTraverser.java,Java,,136,28,48,212
XSDHandler.java,Java,,1857,228,623,2708
XSDKeyrefTraverser.java,Java,,53,14,35,102
XSDNotationTraverser.java,Java,,53,13,36,102
XSDocumentInfo.java,Java,,132,39,77,248
XSDSimpleTypeTraverser.java,Java,,339,31,125,495
XSDUniqueOrKeyTraverser.java,Java,,33,13,33,79
XSDWildcardTraverser.java,Java,,84,22,82,188
NSItemListImpl.java,Java,,28,10,38,76
ShortListImpl.java,Java,,41,12,44,97
SimpleLocator.java,Java,,73,24,47,144
StringListImpl.java,Java,,55,12,49,116
XInt.java,Java,,19,9,21,49
XIntPool.java,Java,,15,4,21,40
XSGrammarPool.java,Java,,24,7,29,60
XSNamedMap4Types.java,Java,,58,10,70,138
XSNamedMapImpl.java,Java,,84,12,88,184
XSObjectListImpl.java,Java,,50,15,49,114
XMLSchemaException.java,Java,,16,7,27,50
XMLSchemaLoader.java,Java,,891,133,307,1331
XMLSchemaValidator.java,Java,,2505,565,1199,4269
XSAnnotationImpl.java,Java,,74,17,73,164
XSAttributeDecl.java,Java,,89,21,76,186
XSAttributeGroupDecl.java,Java,,204,48,108,360
XSAttributeUseImpl.java,Java,,61,17,60,138
XSComplexTypeDecl.java,Java,,371,97,230,698
XSConstraints.java,Java,,967,199,278,1444
XSDDescription.java,Java,,103,23,133,259
XSDeclarationPool.java,Java,,213,52,43,308
XSElementDecl.java,Java,,186,39,141,366
XSGrammarBucket.java,Java,,72,15,77,164
XSGroupDecl.java,Java,,26,11,50,87
XSImplementationImpl.java,Java,,41,17,58,116
XSLoaderImpl.java,Java,,181,32,112,325
XSMessageFormatter.java,Java,,36,11,44,91
XSModelGroupImpl.java,Java,,129,27,75,231
XSModelImpl.java,Java,,293,41,146,480
XSNotationDecl.java,Java,,33,13,54,100
XSParticleDecl.java,Java,,127,25,79,231
XSWildcardDecl.java,Java,,306,81,201,588
DatatypeFactoryImpl.java,Java,,133,34,481,648
DurationDayTimeImpl.java,Java,,69,19,81,169
DurationImpl.java,Java,,838,185,994,2017
DurationYearMonthImpl.java,Java,,51,19,107,177
XMLGregorianCalendarImpl.java,Java,,1342,268,1444,3054
DefaultValidationErrorHandler.java,Java,,28,6,21,55
DocumentBuilderFactoryImpl.java,Java,,136,21,55,212
DocumentBuilderImpl.java,Java,,241,43,72,356
JAXPConstants.java,Java,,9,4,25,38
JAXPValidatorComponent.java,Java,,364,85,147,596
SAXParserFactoryImpl.java,Java,,121,28,54,203
SAXParserImpl.java,Java,,420,59,133,612
SchemaValidatorConfiguration.java,Java,,66,20,65,151
TeeXMLDocumentFilterImpl.java,Java,,106,30,37,173
UnparsedEntityHandler.java,Java,,177,39,36,252
AbstractXMLSchema.java,Java,,24,14,46,84
DOMDocumentHandler.java,Java,,18,12,56,86
DOMResultAugmentor.java,Java,,183,41,31,255
DOMResultBuilder.java,Java,,274,49,47,370
DOMValidatorHelper.java,Java,,413,70,127,610
DraconianErrorHandler.java,Java,,20,10,29,59
EmptyXMLSchema.java,Java,,24,16,30,70
ErrorHandlerAdaptor.java,Java,,35,8,75,118
JAXPValidationMessageFormatter.java,Java,,51,8,39,98
ReadOnlyGrammarPool.java,Java,,24,12,26,62
SimpleXMLSchema.java,Java,,32,17,29,78
SoftReferenceGrammarPool.java,Java,,221,41,170,432
StAXValidatorHelper.java,Java,,61,14,33,108
StreamValidatorHelper.java,Java,,112,29,42,183
Util.java,Java,,36,9,29,74
ValidatorHandlerImpl.java,Java,,748,140,169,1057
ValidatorHelper.java,Java,,9,6,22,37
ValidatorImpl.java,Java,,189,31,47,267
WeakReferenceXMLSchema.java,Java,,18,10,31,59
WrappedSAXException.java,Java,,8,3,72,83
XMLSchema.java,Java,,14,9,40,63
XMLSchemaFactory.java,Java,,339,55,78,472
XMLSchemaValidatorComponentManager.java,Java,,263,70,147,480
XSGrammarPoolContainer.java,Java,,7,7,41,55
AbstractDOMParser.java,Java,,1535,299,736,2570
AbstractSAXParser.java,Java,,1118,284,1013,2415
AbstractXMLDocumentParser.java,Java,,170,73,566,809
BasicParserConfiguration.java,Java,,208,82,296,586
CachingParserPool.java,Java,,117,56,254,427
DOMParser.java,Java,,325,67,210,602
DOMParserImpl.java,Java,,921,147,232,1300
DTDConfiguration.java,Java,,414,124,310,848
DTDParser.java,Java,,100,40,338,478
IntegratedParserConfiguration.java,Java,,111,32,106,249
NonValidatingConfiguration.java,Java,,370,122,283,775
SAXParser.java,Java,,45,21,53,119
SecurityConfiguration.java,Java,,27,13,71,111
StandardParserConfiguration.java,Java,,134,59,168,361
XIncludeAwareParserConfiguration.java,Java,,176,34,82,292
XIncludeParserConfiguration.java,Java,,119,31,67,217
XML11Configurable.java,Java,,2,3,23,28
XML11Configuration.java,Java,,801,217,493,1511
XML11DTDConfiguration.java,Java,,675,190,472,1337
XML11NonValidatingConfiguration.java,Java,,611,185,436,1232
XMLDocumentParser.java,Java,,24,9,42,75
XMLGrammarCachingConfiguration.java,Java,,119,46,183,348
XMLGrammarParser.java,Java,,12,8,30,50
XMLGrammarPreparser.java,Java,,155,38,144,337
XMLParser.java,Java,,34,26,73,133
XPointerParserConfiguration.java,Java,,127,43,69,239
AttributesProxy.java,Java,,110,33,46,189
AugmentationsImpl.java,Java,,175,56,55,286
DatatypeMessageFormatter.java,Java,,52,9,39,100
DefaultErrorHandler.java,Java,,48,18,47,113
DOMEntityResolverWrapper.java,Java,,79,25,63,167
DOMErrorHandlerWrapper.java,Java,,254,49,114,417
DOMInputSource.java,Java,,37,11,25,73
DOMUtil.java,Java,,520,139,172,831
DraconianErrorHandler.java,Java,,17,4,65,86
EncodingMap.java,Java,,447,39,541,1027
EntityResolver2Wrapper.java,Java,,91,32,89,212
EntityResolverWrapper.java,Java,,59,20,59,138
ErrorHandlerProxy.java,Java,,35,7,35,77
ErrorHandlerWrapper.java,Java,,96,28,105,229
HTTPInputSource.java,Java,,46,20,126,192
IntStack.java,Java,,52,17,44,113
LocatorProxy.java,Java,,28,16,41,85
LocatorWrapper.java,Java,,20,8,78,106
MessageFormatter.java,Java,,7,6,44,57
NamespaceContextWrapper.java,Java,,35,11,46,92
NamespaceSupport.java,Java,,216,71,194,481
ParserConfigurationSettings.java,Java,,95,50,142,287
SAX2XNI.java,Java,,138,33,81,252
SAXInputSource.java,Java,,88,18,55,161
SAXLocatorWrapper.java,Java,,63,19,26,108
SAXMessageFormatter.java,Java,,51,7,40,98
SecurityManager.java,Java,,75,23,125,223
ShadowedSymbolTable.java,Java,,26,18,74,118
SymbolHash.java,Java,,90,27,90,207
SymbolTable.java,Java,,114,46,184,344
SynchronizedSymbolTable.java,Java,,34,23,69,126
TeeXMLDocumentFilterImpl.java,Java,,106,29,78,213
TypeInfoImpl.java,Java,,42,11,77,130
URI.java,Java,,1162,208,817,2187
XML11Char.java,Java,,208,37,165,410
XMLAttributesImpl.java,Java,,472,110,606,1188
XMLAttributesIteratorImpl.java,Java,,33,15,56,104
XMLCatalogResolver.java,Java,,228,59,296,583
XMLChar.java,Java,,760,49,213,1022
XMLDocumentFilterImpl.java,Java,,83,28,67,178
XMLEntityDescriptionImpl.java,Java,,69,19,90,178
XMLErrorCode.java,Java,,22,9,50,81
XMLGrammarPoolImpl.java,Java,,157,32,174,363
XMLInputSourceAdaptor.java,Java,,22,6,75,103
XMLResourceIdentifierImpl.java,Java,,116,32,79,227
XMLStringBuffer.java,Java,,77,23,127,227
XMLSymbols.java,Java,,21,25,54,100
ConfigurationError.java,Java,,12,9,71,92
ObjectFactory.java,Java,,209,44,217,470
SecuritySupport.java,Java,,136,18,79,233
MultipleScopeNamespaceSupport.java,Java,,109,21,63,193
XInclude11TextReader.java,Java,,14,5,40,59
XIncludeHandler.java,Java,,1996,289,734,3019
XIncludeMessageFormatter.java,Java,,36,10,40,86
XIncludeNamespaceSupport.java,Java,,30,9,53,92
XIncludeTextReader.java,Java,,301,44,168,513
XPointerElementHandler.java,Java,,455,123,181,759
XPointerFramework.java,Java,,122,23,60,205
XPointerSchema.java,Java,,13,12,20,45
Augmentations.java,Java,,9,15,62,86
Grammar.java,Java,,4,5,44,53
XMLDTDDescription.java,Java,,4,4,26,34
XMLGrammarDescription.java,Java,,7,8,41,56
XMLGrammarLoader.java,Java,,28,19,98,145
XMLGrammarPool.java,Java,,9,10,84,103
XMLSchemaDescription.java,Java,,19,11,105,135
XSGrammar.java,Java,,6,6,40,52
NamespaceContext.java,Java,,16,20,140,176
XMLComponent.java,Java,,13,11,99,123
XMLComponentManager.java,Java,,7,6,47,60
XMLConfigurationException.java,Java,,27,17,69,113
XMLDocumentFilter.java,Java,,5,5,23,33
XMLDocumentScanner.java,Java,,10,7,55,72
XMLDocumentSource.java,Java,,6,7,33,46
XMLDTDContentModelFilter.java,Java,,5,4,23,32
XMLDTDContentModelSource.java,Java,,6,7,74,87
XMLDTDFilter.java,Java,,5,4,23,32
XMLDTDScanner.java,Java,,12,8,75,95
XMLDTDSource.java,Java,,6,7,33,46
XMLEntityResolver.java,Java,,8,7,43,58
XMLErrorHandler.java,Java,,10,8,85,103
XMLInputSource.java,Java,,77,31,143,251
XMLParseException.java,Java,,96,28,54,178
XMLParserConfiguration.java,Java,,34,29,187,250
XMLPullParserConfiguration.java,Java,,10,10,74,94
QName.java,Java,,87,24,120,231
XMLAttributes.java,Java,,33,40,363,436
XMLDocumentFragmentHandler.java,Java,,35,18,203,256
XMLDocumentHandler.java,Java,,33,25,235,293
XMLDTDContentModelHandler.java,Java,,25,25,220,270
XMLDTDHandler.java,Java,,59,30,286,375
XMLLocator.java,Java,,12,14,50,76
XMLResourceIdentifier.java,Java,,13,14,34,61
XMLString.java,Java,,58,22,108,188
XNIException.java,Java,,20,12,57,89
ElementSchemePointer.java,Java,,430,131,314,875
ShortHandPointer.java,Java,,121,38,134,293
XPointerErrorHandler.java,Java,,47,17,48,112
XPointerHandler.java,Java,,656,152,437,1245
XPointerMessageFormatter.java,Java,,40,10,43,93
XPointerPart.java,Java,,19,14,96,129
XPointerProcessor.java,Java,,15,11,75,101
AttributePSVI.java,Java,,4,3,22,29
ByteList.java,Java,,7,6,45,58
ObjectList.java,Java,,6,5,45,56
XSDateTime.java,Java,,19,16,255,290
XSDecimal.java,Java,,11,8,45,64
XSDouble.java,Java,,4,3,25,32
XSFloat.java,Java,,4,3,25,32
XSQName.java,Java,,5,4,26,35
ElementPSVI.java,Java,,7,6,33,46
ItemPSVI.java,Java,,24,14,147,185
LSInputList.java,Java,,6,5,33,44
PSVIProvider.java,Java,,7,5,77,89
ShortList.java,Java,,7,5,41,53
StringList.java,Java,,6,5,40,51
XSAnnotation.java,Java,,9,5,45,59
XSAttributeDeclaration.java,Java,,15,11,76,102
XSAttributeGroupDefinition.java,Java,,6,5,28,39
XSAttributeUse.java,Java,,13,9,69,91
XSComplexTypeDefinition.java,Java,,17,13,83,113
XSConstants.java,Java,,84,7,250,341
XSElementDeclaration.java,Java,,23,19,129,171
XSException.java,Java,,11,5,36,52
XSFacet.java,Java,,7,6,32,45
XSIDCDefinition.java,Java,,11,8,50,69
XSImplementation.java,Java,,6,5,36,47
XSLoader.java,Java,,10,8,71,89
XSModel.java,Java,,21,13,110,144
XSModelGroup.java,Java,,9,6,42,57
XSModelGroupDefinition.java,Java,,5,4,24,33
XSMultiValueFacet.java,Java,,6,5,29,40
XSNamedMap.java,Java,,7,5,51,63
XSNamespaceItem.java,Java,,13,12,81,106
XSNamespaceItemList.java,Java,,5,4,33,42
XSNotationDeclaration.java,Java,,6,5,29,40
XSObject.java,Java,,7,6,41,54
XSObjectList.java,Java,,5,4,33,42
XSParticle.java,Java,,7,6,34,47
XSSimpleTypeDefinition.java,Java,,42,23,174,239
XSTerm.java,Java,,3,2,21,26
XSTypeDefinition.java,Java,,15,9,77,101
XSWildcard.java,Java,,13,8,60,81
Axis.java,Java,,74,29,115,218
DTM.java,Java,,95,95,775,965
DTMAxisIterator.java,Java,,17,15,76,108
DTMAxisTraverser.java,Java,,14,5,95,114
DTMConfigurationException.java,Java,,26,8,63,97
DTMDOMException.java,Java,,13,2,37,52
DTMException.java,Java,,175,64,142,381
DTMFilter.java,Java,,21,20,145,186
DTMIterator.java,Java,,32,33,277,342
DTMManager.java,Java,,127,52,317,496
DTMWSFilter.java,Java,,8,5,41,54
ChunkedIntArray.java,Java,,146,22,136,304
CoroutineManager.java,Java,,91,23,228,342
CoroutineParser.java,Java,,14,13,111,138
CustomStringPool.java,Java,,32,6,48,86
DOM2DTM.java,Java,,904,192,667,1763
DOM2DTMdefaultNamespaceDeclarationNode.java,Java,,219,43,415,677
DTMAxisIteratorBase.java,Java,,101,40,138,279
DTMAxisIterNodeList.java,Java,,57,10,73,140
DTMChildIterNodeList.java,Java,,32,8,77,117
DTMDefaultBase.java,Java,,1028,291,1050,2369
DTMDefaultBaseIterators.java,Java,,1140,326,724,2190
DTMDefaultBaseTraversers.java,Java,,744,212,787,1743
DTMDocumentImpl.java,Java,,728,238,1443,2409
DTMManagerDefault.java,Java,,388,104,365,857
DTMNamedNodeMap.java,Java,,101,26,171,298
DTMNodeIterator.java,Java,,66,20,98,184
DTMNodeList.java,Java,,40,8,77,125
DTMNodeListBase.java,Java,,12,4,63,79
DTMNodeProxy.java,Java,,834,204,1275,2313
DTMSafeStringPool.java,Java,,60,14,34,108
DTMStringPool.java,Java,,100,25,64,189
DTMTreeWalker.java,Java,,237,56,109,402
EmptyIterator.java,Java,,21,18,21,60
ExpandedNameTable.java,Java,,168,50,171,389
ExtendedType.java,Java,,65,11,67,143
IncrementalSAXSource.java,Java,,12,11,64,87
IncrementalSAXSource_Filter.java,Java,,428,63,318,809
IncrementalSAXSource_Xerces.java,Java,,263,46,144,453
NodeLocator.java,Java,,39,9,60,108
SAX2DTM.java,Java,,1110,358,1051,2519
SAX2DTM2.java,Java,,1937,494,950,3381
SAX2RTFDTM.java,Java,,135,41,184,360
XMLErrorResources.java,Java,,249,95,113,457
XMLErrorResources_ca.java,Java,,238,91,109,438
XMLErrorResources_cs.java,Java,,238,91,109,438
XMLErrorResources_de.java,Java,,238,91,109,438
XMLErrorResources_en.java,Java,,4,2,23,29
XMLErrorResources_es.java,Java,,238,91,109,438
XMLErrorResources_fr.java,Java,,238,91,109,438
XMLErrorResources_it.java,Java,,238,91,109,438
XMLErrorResources_ja.java,Java,,238,91,109,438
XMLErrorResources_ko.java,Java,,238,91,109,438
XMLErrorResources_pt_BR.java,Java,,249,95,113,457
XMLErrorResources_sk.java,Java,,238,91,109,438
XMLErrorResources_sv.java,Java,,202,256,166,624
XMLErrorResources_tr.java,Java,,238,91,109,438
XMLErrorResources_zh_CN.java,Java,,238,91,109,438
XMLErrorResources_zh_HK.java,Java,,4,3,66,73
XMLErrorResources_zh_TW.java,Java,,238,91,109,438
XMLMessages.java,Java,,72,22,61,155
Catalog.java,Java,,1119,289,804,2212
CatalogEntry.java,Java,,87,27,135,249
CatalogException.java,Java,,58,13,94,165
CatalogManager.java,Java,,388,111,346,845
BootstrapResolver.java,Java,,111,29,60,200
Debug.java,Java,,29,9,70,108
FileURL.java,Java,,11,5,73,89
Namespaces.java,Java,,39,13,59,111
PublicId.java,Java,,63,20,75,158
CatalogReader.java,Java,,12,6,60,78
DOMCatalogParser.java,Java,,6,4,40,50
DOMCatalogReader.java,Java,,99,23,121,243
ExtendedXMLCatalogReader.java,Java,,108,27,49,184
OASISXMLCatalogReader.java,Java,,389,78,71,538
SAXCatalogParser.java,Java,,6,4,32,42
SAXCatalogReader.java,Java,,315,59,129,503
SAXParserHandler.java,Java,,96,21,30,147
TextCatalogReader.java,Java,,179,36,85,300
TR9401CatalogReader.java,Java,,70,17,53,140
XCatalogReader.java,Java,,102,26,57,185
Resolver.java,Java,,355,70,269,694
CatalogResolver.java,Java,,172,37,130,339
ResolvingParser.java,Java,,263,58,122,443
ResolvingXMLFilter.java,Java,,188,43,119,350
ResolvingXMLReader.java,Java,,35,10,49,94
Algorithm.java,Java,,27,13,43,83
IntegrityHmac.java,Java,,266,86,237,589
SignatureBaseRSA.java,Java,,195,60,113,368
SignatureDSA.java,Java,,199,70,107,376
JCEMapper.java,Java,,62,28,71,161
MessageDigestAlgorithm.java,Java,,93,32,127,252
SignatureAlgorithm.java,Java,,178,58,168,404
SignatureAlgorithmSpi.java,Java,,44,25,129,198
CanonicalizationException.java,Java,,21,12,52,85
Canonicalizer.java,Java,,125,48,177,350
CanonicalizerSpi.java,Java,,50,25,120,195
AttrCompare.java,Java,,52,25,62,139
C14nHelper.java,Java,,64,23,73,160
Canonicalizer20010315.java,Java,,187,46,130,363
Canonicalizer20010315Excl.java,Java,,183,26,112,321
Canonicalizer20010315ExclOmitComments.java,Java,,14,6,25,45
Canonicalizer20010315ExclWithComments.java,Java,,14,8,27,49
Canonicalizer20010315OmitComments.java,Java,,13,8,26,47
Canonicalizer20010315WithComments.java,Java,,13,6,26,45
CanonicalizerBase.java,Java,,605,83,187,875
NameSpaceSymbTable.java,Java,,261,36,120,417
InvalidCanonicalizerException.java,Java,,22,12,51,85
AgreementMethod.java,Java,,16,14,123,153
CipherData.java,Java,,11,8,71,90
CipherReference.java,Java,,8,7,75,90
CipherValue.java,Java,,5,3,35,43
EncryptedData.java,Java,,3,3,35,41
EncryptedKey.java,Java,,9,9,91,109
EncryptedType.java,Java,,19,19,154,192
EncryptionMethod.java,Java,,13,12,80,105
EncryptionProperties.java,Java,,9,9,64,82
EncryptionProperty.java,Java,,14,11,90,115
Reference.java,Java,,10,8,70,88
ReferenceList.java,Java,,13,11,79,103
Transforms.java,Java,,4,9,58,71
XMLCipher.java,Java,,2128,486,1420,4034
XMLCipherInput.java,Java,,90,38,61,189
XMLCipherParameters.java,Java,,41,22,38,101
XMLEncryptionException.java,Java,,22,2,46,70
AlgorithmAlreadyRegisteredException.java,Java,,21,9,55,85
Base64DecodingException.java,Java,,21,9,52,82
XMLSecurityException.java,Java,,88,46,111,245
XMLSecurityRuntimeException.java,Java,,89,40,95,224
Init.java,Java,,262,71,87,420
KeyInfoContent.java,Java,,3,6,21,30
KeyName.java,Java,,23,12,40,75
KeyValue.java,Java,,69,36,64,169
DSAKeyValue.java,Java,,77,20,46,143
KeyValueContent.java,Java,,7,7,30,44
RSAKeyValue.java,Java,,67,21,45,133
MgmtData.java,Java,,24,12,40,76
PGPData.java,Java,,15,8,30,53
RetrievalMethod.java,Java,,64,21,65,150
SPKIData.java,Java,,16,8,30,54
XMLX509Certificate.java,Java,,75,29,63,167
XMLX509CRL.java,Java,,25,12,45,82
XMLX509DataContent.java,Java,,3,6,21,30
XMLX509IssuerSerial.java,Java,,73,28,75,176
XMLX509SKI.java,Java,,102,34,87,223
XMLX509SubjectName.java,Java,,43,19,48,110
X509Data.java,Java,,244,75,221,540
ContentHandlerAlreadyRegisteredException.java,Java,,24,12,51,87
KeyInfo.java,Java,,617,194,414,1225
DSAKeyValueResolver.java,Java,,60,26,35,121
EncryptedKeyResolver.java,Java,,63,23,51,137
RetrievalMethodResolver.java,Java,,187,48,72,307
RSAKeyValueResolver.java,Java,,65,26,28,119
X509CertificateResolver.java,Java,,83,34,60,177
X509IssuerSerialResolver.java,Java,,99,32,25,156
X509SKIResolver.java,Java,,93,39,58,190
X509SubjectNameResolver.java,Java,,99,42,57,198
InvalidKeyResolverException.java,Java,,22,12,52,86
KeyResolver.java,Java,,114,42,161,317
KeyResolverException.java,Java,,21,12,55,88
KeyResolverSpi.java,Java,,58,30,93,181
KeyUtils.java,Java,,38,17,29,84
CertsInFilesystemDirectoryResolver.java,Java,,122,40,64,226
KeyStoreResolver.java,Java,,62,27,57,146
SingleCertificateResolver.java,Java,,33,20,49,102
StorageResolver.java,Java,,70,34,92,196
StorageResolverException.java,Java,,21,12,51,84
StorageResolverSpi.java,Java,,5,7,25,37
InvalidDigestValueException.java,Java,,21,10,52,83
InvalidSignatureValueException.java,Java,,21,10,53,84
Manifest.java,Java,,267,90,202,559
MissingResourceFailureException.java,Java,,32,21,74,127
NodeFilter.java,Java,,5,3,26,34
ObjectContainer.java,Java,,56,24,74,154
Reference.java,Java,,382,116,252,750
ReferenceNotInitializedException.java,Java,,21,12,53,86
SignatureProperties.java,Java,,57,20,66,143
SignatureProperty.java,Java,,48,16,70,134
SignedInfo.java,Java,,202,55,127,384
XMLSignature.java,Java,,323,108,322,753
XMLSignatureException.java,Java,,21,12,53,86
XMLSignatureInput.java,Java,,280,73,259,612
XMLSignatureInputDebugger.java,Java,,435,149,130,714
FuncHere.java,Java,,67,30,60,157
FuncHereContext.java,Java,,42,16,81,139
TransformBase64Decode.java,Java,,98,20,60,178
TransformC14N.java,Java,,33,10,29,72
TransformC14NExclusive.java,Java,,55,14,35,104
TransformC14NExclusiveWithComments.java,Java,,52,14,31,97
TransformC14NWithComments.java,Java,,33,11,26,70
TransformEnvelopedSignature.java,Java,,57,23,57,137
TransformXPath.java,Java,,83,24,59,166
TransformXPath2Filter.java,Java,,133,34,53,220
TransformXPointer.java,Java,,18,14,31,63
TransformXSLT.java,Java,,85,26,54,165
InvalidTransformException.java,Java,,21,12,51,84
InclusiveNamespaces.java,Java,,70,29,79,178
XPath2FilterContainer.java,Java,,131,52,127,310
XPath2FilterContainer04.java,Java,,111,41,109,261
XPathContainer.java,Java,,28,12,39,79
XPathFilterCHGPContainer.java,Java,,134,48,135,317
Transform.java,Java,,177,64,135,376
TransformationException.java,Java,,21,12,51,84
TransformParam.java,Java,,3,4,20,27
Transforms.java,Java,,139,38,121,298
TransformSpi.java,Java,,31,12,53,96
Base64.java,Java,,469,142,200,811
CachedXPathAPIHolder.java,Java,,31,5,27,63
CachedXPathFuncHereAPI.java,Java,,200,48,209,457
Constants.java,Java,,81,19,133,233
DigesterOutputStream.java,Java,,25,8,30,63
ElementProxy.java,Java,,245,96,202,543
EncryptionConstants.java,Java,,61,20,95,176
EncryptionElementProxy.java,Java,,16,8,35,59
HelperNodeList.java,Java,,37,19,51,107
I18n.java,Java,,72,27,134,233
IdResolver.java,Java,,134,33,72,239
IgnoreAllErrorHandler.java,Java,,37,14,28,79
JavaUtils.java,Java,,53,22,48,123
ResolverAnonymous.java,Java,,32,12,34,78
ResolverDirectHTTP.java,Java,,161,56,77,294
ResolverFragment.java,Java,,57,21,56,134
ResolverLocalFilesystem.java,Java,,77,27,38,142
ResolverXPointer.java,Java,,90,34,64,188
ResourceResolver.java,Java,,112,40,145,297
ResourceResolverException.java,Java,,44,23,75,142
ResourceResolverSpi.java,Java,,78,38,78,194
RFC2253Parser.java,Java,,281,115,168,564
SignatureElementProxy.java,Java,,16,9,37,62
SignerOutputStream.java,Java,,35,9,27,71
UnsyncBufferedOutputStream.java,Java,,46,11,30,87
UnsyncByteArrayOutputStream.java,Java,,44,5,27,76
XMLUtils.java,Java,,387,100,206,693
XPathFuncHereAPI.java,Java,,85,36,182,303
BaseMarkupSerializer.java,Java,,1219,264,482,1965
DOMSerializer.java,Java,,14,18,47,79
DOMSerializerImpl.java,Java,,853,79,279,1211
ElementState.java,Java,,16,30,59,105
EncodingInfo.java,Java,,143,31,93,267
Encodings.java,Java,,66,14,41,121
HTMLdtd.java,Java,,269,88,198,555
HTMLSerializer.java,Java,,523,101,258,882
IndentPrinter.java,Java,,162,58,142,362
LineSeparator.java,Java,,8,16,32,56
Method.java,Java,,9,18,35,62
OutputFormat.java,Java,,332,160,467,959
Printer.java,Java,,198,64,99,361
Serializer.java,Java,,18,26,81,125
SerializerFactory.java,Java,,60,29,59,148
SerializerFactoryImpl.java,Java,,64,26,24,114
TextSerializer.java,Java,,189,76,124,389
XHTMLSerializer.java,Java,,29,18,54,101
XML11Serializer.java,Java,,311,68,159,538
XMLSerializer.java,Java,,890,177,403,1470
AttributesImplSerializer.java,Java,,103,22,110,235
CharInfo.java,Java,,320,95,328,743
DOMSerializer.java,Java,,7,3,54,64
ElemContext.java,Java,,57,18,142,217
ElemDesc.java,Java,,55,36,85,176
EmptySerializer.java,Java,,443,23,289,755
EncodingInfo.java,Java,,188,45,275,508
Encodings.java,Java,,248,43,172,463
ExtendedContentHandler.java,Java,,49,17,203,269
ExtendedLexicalHandler.java,Java,,6,2,29,37
Method.java,Java,,11,7,56,74
NamespaceMappings.java,Java,,158,34,133,325
OutputPropertiesFactory.java,Java,,260,49,206,515
OutputPropertyUtils.java,Java,,21,8,52,81
SerializationHandler.java,Java,,30,14,80,124
Serializer.java,Java,,17,12,191,220
SerializerBase.java,Java,,586,150,647,1383
SerializerConstants.java,Java,,19,7,31,57
SerializerFactory.java,Java,,75,23,84,182
SerializerTrace.java,Java,,22,24,105,151
SerializerTraceWriter.java,Java,,152,44,143,339
ToHTMLSAXHandler.java,Java,,284,65,394,743
ToHTMLStream.java,Java,,1384,240,692,2316
ToSAXHandler.java,Java,,204,48,184,436
ToStream.java,Java,,1760,335,1277,3372
ToTextSAXHandler.java,Java,,215,55,140,410
ToTextStream.java,Java,,247,54,331,632
ToUnknownStream.java,Java,,674,154,506,1334
ToXMLSAXHandler.java,Java,,407,102,265,774
ToXMLStream.java,Java,,354,70,202,626
TransformStateSetter.java,Java,,8,6,40,54
TreeWalker.java,Java,,328,71,127,526
AttList.java,Java,,86,23,153,262
BoolStack.java,Java,,67,27,108,202
DOM2Helper.java,Java,,30,14,88,132
Messages.java,Java,,104,22,157,283
MsgKey.java,Java,,58,6,34,98
SerializerMessages.java,Java,,82,41,81,204
SerializerMessages_ca.java,Java,,73,35,18,126
SerializerMessages_cs.java,Java,,65,31,22,118
SerializerMessages_de.java,Java,,65,31,22,118
SerializerMessages_en.java,Java,,4,2,22,28
SerializerMessages_es.java,Java,,65,31,22,118
SerializerMessages_fr.java,Java,,65,31,22,118
SerializerMessages_it.java,Java,,65,31,22,118
SerializerMessages_ja.java,Java,,65,31,22,118
SerializerMessages_ko.java,Java,,65,31,22,118
SerializerMessages_pt_BR.java,Java,,82,41,81,204
SerializerMessages_sv.java,Java,,43,20,33,96
SerializerMessages_zh_CN.java,Java,,65,31,22,118
SerializerMessages_zh_TW.java,Java,,65,31,22,118
StringToIntTable.java,Java,,82,35,84,201
SystemIDResolver.java,Java,,154,27,119,300
URI.java,Java,,899,219,534,1652
Utils.java,Java,,8,2,31,41
WrappedRuntimeException.java,Java,,20,9,50,79
Utils.java,Java,,27,4,45,76
Version.java,Java,,46,11,91,148
WriterChain.java,Java,,14,4,62,80
WriterToASCI.java,Java,,49,15,89,153
WriterToUTF8Buffered.java,Java,,225,53,223,501
XSLOutputAttributes.java,Java,,24,12,144,180
AttList.java,Java,,86,23,144,253
BoolStack.java,Java,,72,29,99,200
CharKey.java,Java,,24,9,49,82
Constants.java,Java,,32,9,69,110
DefaultErrorHandler.java,Java,,143,31,166,340
DOM2Helper.java,Java,,90,32,190,312
DOMBuilder.java,Java,,263,87,436,786
DOMHelper.java,Java,,620,172,540,1332
DOMOrder.java,Java,,5,2,32,39
ElemDesc.java,Java,,56,36,95,187
FastStringBuffer.java,Java,,539,192,563,1294
Hashtree2Node.java,Java,,69,12,58,139
IntStack.java,Java,,86,25,98,209
IntVector.java,Java,,177,70,170,417
ListingErrorHandler.java,Java,,236,65,263,564
LocaleUtility.java,Java,,45,17,24,86
MutableAttrListImpl.java,Java,,51,18,68,137
NameSpace.java,Java,,14,6,37,57
NamespaceSupport2.java,Java,,276,85,386,747
NodeConsumer.java,Java,,6,3,29,38
NodeVector.java,Java,,338,133,266,737
NSInfo.java,Java,,33,15,60,108
ObjectPool.java,Java,,71,26,80,177
ObjectStack.java,Java,,88,27,98,213
ObjectVector.java,Java,,183,74,172,429
PrefixResolver.java,Java,,8,5,57,70
PrefixResolverDefault.java,Java,,65,17,61,143
QName.java,Java,,343,94,270,707
RawCharacterHandler.java,Java,,6,2,32,40
CharArrayWrapper.java,Java,,13,4,23,40
IntArrayWrapper.java,Java,,13,4,23,40
LongArrayWrapper.java,Java,,13,4,23,40
StringArrayWrapper.java,Java,,13,5,23,41
XResourceBundle.java,Java,,37,7,30,74
XResourceBundleBase.java,Java,,7,4,37,48
XResources_de.java,Java,,21,6,44,71
XResources_en.java,Java,,21,6,44,71
XResources_es.java,Java,,21,6,44,71
XResources_fr.java,Java,,21,6,44,71
XResources_it.java,Java,,21,6,44,71
XResources_ja_JP_A.java,Java,,37,8,39,84
XResources_ja_JP_HA.java,Java,,37,8,39,84
XResources_ja_JP_HI.java,Java,,37,8,40,85
XResources_ja_JP_I.java,Java,,36,8,40,84
XResources_ko.java,Java,,33,8,37,78
XResources_pt_BR.java,Java,,21,5,44,70
XResources_sv.java,Java,,21,6,44,71
XResources_zh_CN.java,Java,,33,8,37,78
XResources_zh_TW.java,Java,,33,8,37,78
SAXSourceLocator.java,Java,,52,13,103,168
SerializableLocatorImpl.java,Java,,52,33,139,224
StopParseException.java,Java,,9,1,28,38
StringBufferPool.java,Java,,15,4,39,58
StringComparable.java,Java,,155,30,28,213
StringToIntTable.java,Java,,82,35,77,194
StringToStringTable.java,Java,,104,40,96,240
StringToStringTableVector.java,Java,,80,32,85,197
StringVector.java,Java,,92,41,88,221
StylesheetPIHandler.java,Java,,206,33,99,338
SuballocatedByteVector.java,Java,,267,37,192,496
SuballocatedIntVector.java,Java,,290,47,218,555
SystemIDResolver.java,Java,,154,27,112,293
ThreadControllerWrapper.java,Java,,50,15,57,122
TreeWalker.java,Java,,303,72,117,492
Trie.java,Java,,93,24,86,203
UnImplNode.java,Java,,634,274,1142,2050
URI.java,Java,,909,220,543,1672
WrappedRuntimeException.java,Java,,20,9,43,72
WrongParserException.java,Java,,9,2,27,38
XML11Char.java,Java,,222,42,166,430
XMLChar.java,Java,,322,80,264,666
XMLCharacterRecognizer.java,Java,,41,15,51,107
XMLReaderManager.java,Java,,89,19,72,180
XMLString.java,Java,,47,40,586,673
XMLStringDefault.java,Java,,171,42,587,800
XMLStringFactory.java,Java,,10,5,54,69
XMLStringFactoryDefault.java,Java,,21,5,56,82
Arg.java,Java,,97,27,132,256
AttributeIterator.java,Java,,23,8,42,73
AxesWalker.java,Java,,274,79,235,588
BasicTestIterator.java,Java,,110,28,85,223
ChildIterator.java,Java,,45,15,59,119
ChildTestIterator.java,Java,,54,22,100,176
ContextNodeList.java,Java,,18,14,102,134
DescendantIterator.java,Java,,224,48,105,377
FilterExprIterator.java,Java,,98,26,88,212
FilterExprIteratorSimple.java,Java,,159,39,115,313
FilterExprWalker.java,Java,,156,43,149,348
HasPositionalPredChecker.java,Java,,55,12,55,122
IteratorPool.java,Java,,53,15,53,121
LocPathIterator.java,Java,,363,123,545,1031
MatchPatternIterator.java,Java,,197,44,87,328
NodeSequence.java,Java,,390,70,189,649
OneStepIterator.java,Java,,162,52,128,342
OneStepIteratorForward.java,Java,,48,20,101,169
PathComponent.java,Java,,5,3,26,34
PredicatedNodeTest.java,Java,,333,76,236,645
ReverseAxesWalker.java,Java,,109,38,98,245
RTFIterator.java,Java,,9,5,27,41
SelfIteratorNoPredicate.java,Java,,47,15,64,126
SubContextList.java,Java,,7,4,39,50
UnionChildIterator.java,Java,,72,13,63,148
UnionPathIterator.java,Java,,322,77,182,581
WalkerFactory.java,Java,,1245,195,384,1824
WalkingIterator.java,Java,,166,52,142,360
WalkingIteratorSorted.java,Java,,73,18,121,212
CachedXPathAPI.java,Java,,85,32,216,333
Compiler.java,Java,,609,149,508,1266
FuncLoader.java,Java,,40,12,53,105
FunctionTable.java,Java,,232,58,116,406
Keywords.java,Java,,136,67,81,284
Lexer.java,Java,,422,88,150,660
OpCodes.java,Java,,68,66,496,630
OpMap.java,Java,,192,57,204,453
OpMapVector.java,Java,,36,22,56,114
PsuedoNames.java,Java,,10,7,40,57
XPathDumper.java,Java,,4,3,22,29
XPathParser.java,Java,,1264,395,740,2399
XPathEvaluatorImpl.java,Java,,68,26,175,269
XPathExpressionImpl.java,Java,,60,18,103,181
XPathNamespaceImpl.java,Java,,131,49,140,320
XPathNSResolverImpl.java,Java,,12,6,41,59
XPathResultImpl.java,Java,,232,60,216,508
XPathStylesheetDOM3Exception.java,Java,,9,3,22,34
Expression.java,Java,,194,56,337,587
ExpressionNode.java,Java,,10,6,34,50
ExpressionOwner.java,Java,,6,5,32,43
ExtensionsProvider.java,Java,,16,7,35,58
FoundIndex.java,Java,,6,2,27,35
FuncBoolean.java,Java,,12,4,30,46
FuncCeiling.java,Java,,12,3,30,45
FuncConcat.java,Java,,33,10,45,88
FuncContains.java,Java,,17,7,31,55
FuncCount.java,Java,,16,6,40,62
FuncCurrent.java,Java,,37,8,35,80
FuncDoclocation.java,Java,,27,8,34,69
FuncExtElementAvailable.java,Java,,41,8,46,95
FuncExtFunction.java,Java,,146,43,149,338
FuncExtFunctionAvailable.java,Java,,55,9,38,102
FuncFalse.java,Java,,15,5,34,54
FuncFloor.java,Java,,12,3,30,45
FuncGenerateId.java,Java,,19,5,36,60
FuncId.java,Java,,82,22,45,149
FuncLang.java,Java,,39,10,31,80
FuncLast.java,Java,,40,12,52,104
FuncLocalPart.java,Java,,20,5,30,55
FuncNamespace.java,Java,,35,9,32,76
FuncNormalizeSpace.java,Java,,36,6,42,84
FuncNot.java,Java,,12,3,30,45
FuncNumber.java,Java,,12,3,30,45
FuncPosition.java,Java,,60,14,58,132
FuncQname.java,Java,,25,6,30,61
FuncRound.java,Java,,17,3,30,50
FuncStartsWith.java,Java,,13,3,30,46
FuncString.java,Java,,12,3,30,45
FuncStringLength.java,Java,,12,3,30,45
FuncSubstring.java,Java,,61,14,47,122
FuncSubstringAfter.java,Java,,18,5,30,53
FuncSubstringBefore.java,Java,,16,5,30,51
FuncSum.java,Java,,26,7,30,63
FuncSystemProperty.java,Java,,111,23,50,184
Function.java,Java,,49,14,79,142
Function2Args.java,Java,,79,21,82,182
Function3Args.java,Java,,79,21,81,181
FunctionDef1Arg.java,Java,,68,13,84,165
FunctionMultiArgs.java,Java,,121,29,84,234
FunctionOneArg.java,Java,,71,20,81,172
FuncTranslate.java,Java,,34,11,41,86
FuncTrue.java,Java,,15,5,34,54
FuncUnparsedEntityURI.java,Java,,18,6,29,53
WrongNumberArgsException.java,Java,,9,3,29,41
JAXPExtensionsProvider.java,Java,,125,30,51,206
JAXPPrefixResolver.java,Java,,55,25,45,125
JAXPVariableStack.java,Java,,36,10,24,70
XPathExpressionImpl.java,Java,,179,32,161,372
XPathFactoryImpl.java,Java,,107,42,141,290
XPathImpl.java,Java,,254,49,227,530
NodeSet.java,Java,,598,234,536,1368
NodeSetDTM.java,Java,,399,167,679,1245
DTMXRTreeFrag.java,Java,,27,7,22,56
XBoolean.java,Java,,58,21,87,166
XBooleanStatic.java,Java,,22,6,39,67
XMLStringFactoryImpl.java,Java,,29,8,62,99
XNodeSet.java,Java,,407,101,454,962
XNodeSetForDOM.java,Java,,56,15,55,126
XNull.java,Java,,39,12,77,128
XNumber.java,Java,,136,43,256,435
XObject.java,Java,,284,105,364,753
XObjectFactory.java,Java,,107,11,41,159
XRTreeFrag.java,Java,,143,33,123,299
XRTreeFragSelectWrapper.java,Java,,59,14,79,152
XString.java,Java,,349,95,657,1101
XStringForChars.java,Java,,70,23,121,214
XStringForFSB.java,Java,,402,122,460,984
And.java,Java,,24,8,41,73
Bool.java,Java,,20,6,40,66
Div.java,Java,,18,6,41,65
Equals.java,Java,,23,6,43,72
Gt.java,Java,,12,3,32,47
Gte.java,Java,,13,3,32,48
Lt.java,Java,,12,3,32,47
Lte.java,Java,,12,3,32,47
Minus.java,Java,,18,6,42,66
Mod.java,Java,,18,6,41,65
Mult.java,Java,,18,5,41,64
Neg.java,Java,,17,6,40,63
NotEquals.java,Java,,12,3,32,47
Number.java,Java,,20,7,40,67
Operation.java,Java,,92,26,92,210
Or.java,Java,,24,8,41,73
Plus.java,Java,,18,6,41,65
Quo.java,Java,,12,4,34,50
String.java,Java,,11,3,31,45
UnaryOperation.java,Java,,59,21,81,161
Variable.java,Java,,130,46,219,395
VariableSafeAbsRef.java,Java,,24,6,42,72
ContextMatchStepPattern.java,Java,,95,24,58,177
FunctionPattern.java,Java,,112,40,94,246
NodeTest.java,Java,,297,102,291,690
NodeTestFilter.java,Java,,5,2,30,37
StepPattern.java,Java,,601,136,314,1051
UnionPattern.java,Java,,116,29,71,216
XPATHErrorResources.java,Java,,545,185,200,930
XPATHErrorResources_de.java,Java,,484,306,471,1261
XPATHErrorResources_en.java,Java,,4,2,23,29
XPATHErrorResources_es.java,Java,,484,307,471,1262
XPATHErrorResources_fr.java,Java,,484,306,471,1261
XPATHErrorResources_it.java,Java,,484,307,471,1262
XPATHErrorResources_ja.java,Java,,484,306,471,1261
XPATHErrorResources_ko.java,Java,,484,307,471,1262
XPATHErrorResources_pt_BR.java,Java,,545,185,200,930
XPATHErrorResources_sv.java,Java,,395,522,332,1249
XPATHErrorResources_zh_CN.java,Java,,484,307,471,1262
XPATHErrorResources_zh_TW.java,Java,,484,307,471,1262
XPATHMessages.java,Java,,65,17,63,145
SourceTree.java,Java,,11,5,34,50
SourceTreeManager.java,Java,,191,54,143,388
VariableStack.java,Java,,152,67,297,516
WhitespaceStrippingElementMatcher.java,Java,,9,4,39,52
XPath.java,Java,,292,80,269,641
XPathAPI.java,Java,,73,27,181,281
XPathContext.java,Java,,580,157,614,1351
XPathException.java,Java,,161,57,108,326
XPathFactory.java,Java,,8,4,36,48
XPathProcessorException.java,Java,,13,4,35,52
XPathVisitable.java,Java,,5,2,33,40
XPathVisitor.java,Java,,63,17,121,201
DialogCallbackHandler.java,Java,,196,43,59,298
TextCallbackHandler.java,Java,,175,29,35,239
LdapPrincipal.java,Java,,42,14,64,120
ConfigFile.java,Java,,428,72,121,621
Crypt.java,Java,,263,55,68,386
JndiLoginModule.java,Java,,380,75,296,751
KeyStoreLoginModule.java,Java,,607,86,203,896
Krb5LoginModule.java,Java,defUsername,608,75,459,1142
LdapLoginModule.java,Java,,473,107,423,1003
NTLoginModule.java,Java,,229,32,119,380
NTSystem.java,Java,,47,15,66,128
SolarisLoginModule.java,Java,,151,25,122,298
SolarisSystem.java,Java,,26,10,44,80
UnixLoginModule.java,Java,,149,25,117,291
UnixSystem.java,Java,,26,10,44,80
NTDomainPrincipal.java,Java,,43,13,75,131
NTNumericCredential.java,Java,,33,12,57,102
NTSid.java,Java,,50,13,78,141
NTSidDomainPrincipal.java,Java,,24,9,58,91
NTSidGroupPrincipal.java,Java,,24,10,53,87
NTSidPrimaryGroupPrincipal.java,Java,,24,10,56,90
NTSidUserPrincipal.java,Java,,24,9,52,85
NTUserPrincipal.java,Java,,43,13,69,125
PolicyFile.java,Java,,760,138,556,1454
PolicyParser.java,Java,,611,106,229,946
PrincipalComparator.java,Java,,4,2,41,47
SolarisNumericGroupPrincipal.java,Java,,60,19,120,199
SolarisNumericUserPrincipal.java,Java,,49,18,98,165
SolarisPrincipal.java,Java,,41,16,72,129
SubjectCodeSource.java,Java,,191,44,150,385
UnixNumericGroupPrincipal.java,Java,,67,19,116,202
UnixNumericUserPrincipal.java,Java,,51,15,95,161
UnixPrincipal.java,Java,,43,14,69,126
UserPrincipal.java,Java,,30,10,54,94
X500Principal.java,Java,,61,20,86,167
GSSUtil.java,Java,,11,5,38,54
AnnotationTree.java,Java,,6,3,24,33
ArrayAccessTree.java,Java,,5,2,23,30
ArrayTypeTree.java,Java,,4,2,23,29
AssertTree.java,Java,,5,2,25,32
AssignmentTree.java,Java,,5,2,23,30
BinaryTree.java,Java,,5,2,24,31
BlockTree.java,Java,,6,3,27,36
BreakTree.java,Java,,5,3,25,33
CaseTree.java,Java,,6,3,30,39
CatchTree.java,Java,,5,2,24,31
ClassTree.java,Java,,11,3,30,44
CompilationUnitTree.java,Java,,12,4,23,39
CompoundAssignmentTree.java,Java,,5,2,24,31
ConditionalExpressionTree.java,Java,,6,2,23,31
ContinueTree.java,Java,,5,3,24,32
DoWhileLoopTree.java,Java,,5,2,25,32
EmptyStatementTree.java,Java,,2,2,23,27
EnhancedForLoopTree.java,Java,,6,2,24,32
ErroneousTree.java,Java,,5,3,16,24
ExpressionStatementTree.java,Java,,4,2,23,29
ExpressionTree.java,Java,,2,2,19,23
ForLoopTree.java,Java,,8,3,24,35
IdentifierTree.java,Java,,5,3,23,31
IfTree.java,Java,,6,2,32,40
ImportTree.java,Java,,5,2,29,36
InstanceOfTree.java,Java,,5,2,23,30
LabeledStatementTree.java,Java,,6,3,23,32
LineMap.java,Java,,7,6,50,63
LiteralTree.java,Java,,4,2,24,30
MemberSelectTree.java,Java,,6,3,24,33
MethodInvocationTree.java,Java,,7,3,25,35
MethodTree.java,Java,,13,3,28,44
ModifiersTree.java,Java,,8,3,26,37
NewArrayTree.java,Java,,7,3,25,35
NewClassTree.java,Java,,9,3,30,42
package-info.java,Java,,1,1,17,19
ParameterizedTypeTree.java,Java,,6,3,23,32
ParenthesizedTree.java,Java,,4,2,24,30
PrimitiveTypeTree.java,Java,,5,3,23,31
ReturnTree.java,Java,,4,2,24,30
Scope.java,Java,,12,6,40,58
StatementTree.java,Java,,2,2,19,23
SwitchTree.java,Java,,6,3,25,34
SynchronizedTree.java,Java,,5,2,24,31
ThrowTree.java,Java,,4,2,23,29
Tree.java,Java,,106,100,364,570
TreeVisitor.java,Java,,51,2,40,93
TryTree.java,Java,,7,3,27,37
TypeCastTree.java,Java,,5,2,23,30
TypeParameterTree.java,Java,,7,3,25,35
UnaryTree.java,Java,,4,2,26,32
VariableTree.java,Java,,8,3,23,34
WhileLoopTree.java,Java,,5,2,25,32
WildcardTree.java,Java,,4,2,28,34
JavacTask.java,Java,,20,9,47,76
package-info.java,Java,,1,1,16,18
SimpleTreeVisitor.java,Java,,168,56,15,239
SourcePositions.java,Java,,6,6,59,71
TaskEvent.java,Java,,55,14,38,107
TaskListener.java,Java,,6,4,15,25
TreePath.java,Java,,73,15,39,127
TreePathScanner.java,Java,,28,8,31,67
Trees.java,Java,,54,21,90,165
TreeScanner.java,Java,,246,58,62,366
Applet.java,Java,,143,37,381,561
AppletContext.java,Java,,21,12,144,177
AppletStub.java,Java,,10,8,76,94
AudioClip.java,Java,,6,4,26,36
ActiveEvent.java,Java,,4,3,35,42
Adjustable.java,Java,,22,23,97,142
AlphaComposite.java,Java,,120,46,622,788
AttributeValue.java,Java,,21,5,8,34
AWTError.java,Java,,7,4,21,32
AWTEvent.java,Java,,309,71,218,598
AWTEventMulticaster.java,Java,,366,88,561,1015
AWTException.java,Java,,7,4,23,34
AWTKeyStroke.java,Java,,459,69,346,874
AWTPermission.java,Java,,13,9,190,212
BasicStroke.java,Java,,270,58,258,586
BorderLayout.java,Java,,335,57,478,870
BufferCapabilities.java,Java,,60,21,118,199
Button.java,Java,[PENDING:  WDW -- need to provide a localized string,205,54,399,658
Canvas.java,Java,,60,19,147,226
CardLayout.java,Java,,318,48,226,592
Checkbox.java,Java,,281,70,498,849
CheckboxGroup.java,Java,,34,9,90,133
CheckboxMenuItem.java,Java,,191,51,382,624
Choice.java,Java,,255,65,474,794
CMMException.java,Java,,6,7,29,42
ColorSpace.java,Java,,187,76,330,593
ICC_ColorSpace.java,Java,,200,36,353,589
ICC_Profile.java,Java,,878,348,834,2060
ICC_ProfileGray.java,Java,,25,18,88,131
ICC_ProfileRGB.java,Java,,73,34,156,263
ProfileDataException.java,Java,,6,4,14,24
Color.java,Java,,467,81,677,1225
ColorPaintContext.java,Java,,31,11,6,48
Component.java,Java,,4509,766,4748,10023
ComponentOrientation.java,Java,,54,16,114,184
Composite.java,Java,,7,5,57,69
CompositeContext.java,Java,,9,8,35,52
Conditional.java,Java,,4,2,14,20
Container.java,Java,,2388,353,1906,4647
ContainerOrderFocusTraversalPolicy.java,Java,,294,36,153,483
Cursor.java,Java,,240,70,142,452
Clipboard.java,Java,,116,33,192,341
ClipboardOwner.java,Java,,4,5,30,39
DataFlavor.java,Java,,501,124,755,1380
FlavorEvent.java,Java,,7,3,22,32
FlavorListener.java,Java,,5,3,30,38
FlavorMap.java,Java,,6,6,46,58
FlavorTable.java,Java,,6,6,53,65
MimeType.java,Java,,171,40,164,375
MimeTypeParameterList.java,Java,,244,56,89,389
MimeTypeParseException.java,Java,,10,6,21,37
StringSelection.java,Java,,38,11,73,122
SystemFlavorMap.java,Java,,707,113,462,1282
Transferable.java,Java,,7,8,41,56
UnsupportedFlavorException.java,Java,,7,4,22,33
DefaultFocusTraversalPolicy.java,Java,,33,7,71,111
DefaultKeyboardFocusManager.java,Java,,874,129,344,1347
Desktop.java,Java,,154,31,281,466
Dialog.java,Java,,680,120,918,1718
Dimension.java,Java,,58,20,142,220
DisplayMode.java,Java,,45,14,79,138
Autoscroll.java,Java,,7,9,47,63
DnDConstants.java,Java,,10,14,44,68
DnDEventMulticaster.java,Java,,82,19,116,217
DragGestureEvent.java,Java,,88,55,197,340
DragGestureListener.java,Java,,5,8,28,41
DragGestureRecognizer.java,Java,,94,57,295,446
DragSource.java,Java,,264,75,560,899
DragSourceAdapter.java,Java,,10,8,107,125
DragSourceContext.java,Java,,214,81,303,598
DragSourceDragEvent.java,Java,,97,26,188,311
DragSourceDropEvent.java,Java,,23,19,109,151
DragSourceEvent.java,Java,,37,18,113,168
DragSourceListener.java,Java,,9,15,91,115
DragSourceMotionListener.java,Java,,5,5,34,44
DropTarget.java,Java,,303,140,399,842
DropTargetAdapter.java,Java,,7,6,79,92
DropTargetContext.java,Java,,131,65,207,403
DropTargetDragEvent.java,Java,,47,31,148,226
DropTargetDropEvent.java,Java,,59,43,181,283
DropTargetEvent.java,Java,,18,14,36,68
DropTargetListener.java,Java,,12,22,109,143
InvalidDnDOperationException.java,Java,,6,12,23,41
MouseDragGestureRecognizer.java,Java,,35,35,123,193
DragSourceContextPeer.java,Java,,19,15,29,63
DropTargetContextPeer.java,Java,,23,30,49,102
DropTargetPeer.java,Java,,6,8,28,42
SerializationTester.java,Java,,33,6,17,56
ActionEvent.java,Java,,50,22,172,244
ActionListener.java,Java,,5,5,25,35
AdjustmentEvent.java,Java,,75,26,140,241
AdjustmentListener.java,Java,,5,5,16,26
AWTEventListener.java,Java,,6,5,34,45
AWTEventListenerProxy.java,Java,,19,7,36,62
ComponentAdapter.java,Java,,7,5,43,55
ComponentEvent.java,Java,,45,14,83,142
ComponentListener.java,Java,,8,6,43,57
ContainerAdapter.java,Java,,5,3,37,45
ContainerEvent.java,Java,,36,13,86,135
ContainerListener.java,Java,,6,5,38,49
FocusAdapter.java,Java,,5,3,37,45
FocusEvent.java,Java,,53,19,146,218
FocusListener.java,Java,,6,5,33,44
HierarchyBoundsAdapter.java,Java,,6,3,35,44
HierarchyBoundsListener.java,Java,,6,4,35,45
HierarchyEvent.java,Java,,86,19,186,291
HierarchyListener.java,Java,,5,3,32,40
InputEvent.java,Java,,128,44,215,387
InputMethodEvent.java,Java,,129,32,239,400
InputMethodListener.java,Java,,6,7,26,39
InvocationEvent.java,Java,,72,22,178,272
ItemEvent.java,Java,,51,18,101,170
ItemListener.java,Java,,5,5,29,39
KeyAdapter.java,Java,,6,4,42,52
KeyEvent.java,Java,,694,165,738,1597
KeyListener.java,Java,,7,6,43,56
MouseAdapter.java,Java,,11,9,76,96
MouseEvent.java,Java,,300,54,538,892
MouseListener.java,Java,,9,8,50,67
MouseMotionAdapter.java,Java,,5,3,46,54
MouseMotionListener.java,Java,,6,6,46,58
MouseWheelEvent.java,Java,,57,25,262,344
MouseWheelListener.java,Java,,5,4,32,41
NativeLibLoader.java,Java,,7,3,31,41
PaintEvent.java,Java,,36,13,66,115
TextEvent.java,Java,,23,13,57,93
TextListener.java,Java,,5,5,29,39
WindowAdapter.java,Java,,15,11,74,100
WindowEvent.java,Java,,99,32,256,387
WindowFocusListener.java,Java,,6,5,41,52
WindowListener.java,Java,,11,9,66,86
WindowStateListener.java,Java,,5,3,29,37
Event.java,Java,,230,106,526,862
EventDispatchThread.java,Java,,287,46,126,459
EventFilter.java,Java,,9,3,31,43
EventQueue.java,Java,,665,94,372,1131
FileDialog.java,Java,,123,33,293,449
FlowLayout.java,Java,,275,52,354,681
FocusTraversalPolicy.java,Java,,20,7,131,158
CharArrayIterator.java,Java,,84,26,58,168
FontRenderContext.java,Java,,143,20,177,340
GlyphJustificationInfo.java,Java,,60,23,111,194
GlyphMetrics.java,Java,,69,30,208,307
GlyphVector.java,Java,,82,41,471,594
GraphicAttribute.java,Java,,52,23,128,203
ImageGraphicAttribute.java,Java,,68,36,107,211
LayoutPath.java,Java,,7,4,56,67
LineBreakMeasurer.java,Java,,113,36,367,516
LineMetrics.java,Java,,14,16,98,128
MultipleMaster.java,Java,,15,10,64,89
NumericShaper.java,Java,,663,81,213,957
OpenType.java,Java,,61,64,291,416
ShapeGraphicAttribute.java,Java,,87,36,115,238
StyledParagraph.java,Java,,275,61,131,467
TextAttribute.java,Java,,145,73,881,1099
TextHitInfo.java,Java,,54,18,157,229
TextJustifier.java,Java,,146,26,50,222
TextLayout.java,Java,,1278,326,1131,2735
TextLine.java,Java,,988,275,145,1408
TextMeasurer.java,Java,,401,118,223,742
TransformAttribute.java,Java,,51,14,72,137
Font.java,Java,,952,186,1429,2567
FontFormatException.java,Java,,8,3,23,34
FontMetrics.java,Java,,150,39,436,625
Frame.java,Java,,426,95,666,1187
AffineTransform.java,Java,,2117,150,1637,3904
Arc2D.java,Java,,552,102,803,1457
ArcIterator.java,Java,,143,10,142,295
Area.java,Java,,314,38,374,726
CubicCurve2D.java,Java,,669,115,895,1679
CubicIterator.java,Java,,66,9,64,139
Dimension2D.java,Java,,18,8,71,97
Ellipse2D.java,Java,,159,39,249,447
EllipseIterator.java,Java,,91,11,70,172
FlatteningPathIterator.java,Java,,184,36,158,378
GeneralPath.java,Java,,29,9,72,110
IllegalPathStateException.java,Java,,8,4,27,39
Line2D.java,Java,,306,74,731,1111
LineIterator.java,Java,,58,9,64,131
NoninvertibleTransformException.java,Java,,6,3,20,29
Path2D.java,Java,,1303,137,1138,2578
PathIterator.java,Java,,15,13,170,198
Point2D.java,Java,,117,36,258,411
QuadCurve2D.java,Java,,505,104,775,1384
QuadIterator.java,Java,,62,9,64,135
Rectangle2D.java,Java,,317,68,528,913
RectangularShape.java,Java,,101,29,248,378
RectIterator.java,Java,,66,9,64,139
RoundRectangle2D.java,Java,,250,55,359,664
RoundRectIterator.java,Java,,92,11,69,172
GradientPaint.java,Java,,85,19,141,245
GradientPaintContext.java,Java,,209,23,44,276
Graphics.java,Java,,164,57,1018,1239
Graphics2D.java,Java,,99,47,1071,1217
GraphicsCallback.java,Java,,109,13,6,128
GraphicsConfigTemplate.java,Java,,15,11,70,96
GraphicsConfiguration.java,Java,,92,27,297,416
GraphicsDevice.java,Java,,88,24,312,424
GraphicsEnvironment.java,Java,,113,29,269,411
GridBagConstraints.java,Java,,100,53,493,646
GridBagLayout.java,Java,,1060,158,993,2211
GridBagLayoutInfo.java,Java,,23,5,34,62
GridLayout.java,Java,,155,24,276,455
HeadlessException.java,Java,,19,3,17,39
IllegalComponentStateException.java,Java,,10,4,26,40
InputContext.java,Java,,39,18,263,320
InputMethodHighlight.java,Java,,48,21,109,178
InputMethodRequests.java,Java,,15,11,165,191
InputSubset.java,Java,,24,15,58,97
InputMethod.java,Java,,23,22,320,365
InputMethodContext.java,Java,,15,8,100,123
InputMethodDescriptor.java,Java,,11,10,85,106
AffineTransformOp.java,Java,,273,39,231,543
AreaAveragingScaleFilter.java,Java,,164,11,89,264
BandCombineOp.java,Java,,132,15,125,272
BandedSampleModel.java,Java,,387,92,342,821
BufferedImage.java,Java,,712,127,753,1592
BufferedImageFilter.java,Java,,263,15,122,400
BufferedImageOp.java,Java,,12,7,100,119
BufferStrategy.java,Java,,13,10,162,185
ByteLookupTable.java,Java,,79,13,101,193
ColorConvertOp.java,Java,,730,82,273,1085
ColorModel.java,Java,,702,89,1145,1936
ComponentColorModel.java,Java,,1824,80,1028,2932
ComponentSampleModel.java,Java,,596,112,476,1184
ConvolveOp.java,Java,,134,31,149,314
CropImageFilter.java,Java,,86,11,79,176
DataBuffer.java,Java,,127,40,240,407
DataBufferByte.java,Java,,63,18,130,211
DataBufferDouble.java,Java,,86,26,210,322
DataBufferFloat.java,Java,,86,26,213,325
DataBufferInt.java,Java,,63,19,128,210
DataBufferShort.java,Java,,63,19,127,209
DataBufferUShort.java,Java,,94,21,129,244
DirectColorModel.java,Java,,715,56,629,1400
FilteredImageSource.java,Java,,60,10,122,192
ImageConsumer.java,Java,,22,18,169,209
ImageFilter.java,Java,,52,13,176,241
ImageObserver.java,Java,,14,11,128,153
ImageProducer.java,Java,,8,6,81,95
ImagingOpException.java,Java,,6,4,18,28
IndexColorModel.java,Java,,684,79,754,1517
Kernel.java,Java,,59,19,64,142
LookupOp.java,Java,,331,52,169,552
LookupTable.java,Java,,25,10,57,92
MemoryImageSource.java,Java,,220,24,310,554
MultiPixelPackedSampleModel.java,Java,,291,60,330,681
PackedColorModel.java,Java,,208,35,221,464
PixelGrabber.java,Java,,308,28,319,655
PixelInterleavedSampleModel.java,Java,,67,6,80,153
Raster.java,Java,,649,138,990,1777
RasterFormatException.java,Java,,6,4,17,27
RasterOp.java,Java,,11,7,72,90
ContextualRenderedImageFactory.java,Java,,15,9,101,125
ParameterBlock.java,Java,,191,50,466,707
RenderableImage.java,Java,,18,15,147,180
RenderableImageOp.java,Java,,121,29,182,332
RenderableImageProducer.java,Java,,93,19,89,201
RenderContext.java,Java,,63,22,169,254
RenderedImageFactory.java,Java,,7,4,49,60
RenderedImage.java,Java,,27,25,147,199
ReplicateScaleFilter.java,Java,,115,16,107,238
RescaleOp.java,Java,,348,63,238,649
RGBImageFilter.java,Java,,101,13,161,275
SampleModel.java,Java,,464,152,759,1375
ShortLookupTable.java,Java,,79,13,95,187
SinglePixelPackedSampleModel.java,Java,,380,75,332,787
TileObserver.java,Java,,6,4,27,37
VolatileImage.java,Java,,33,23,269,325
WritableRaster.java,Java,,223,37,466,726
WritableRenderedImage.java,Java,,13,13,107,133
Image.java,Java,,70,23,243,336
ImageCapabilities.java,Java,,20,8,35,63
Insets.java,Java,,53,15,103,171
ItemSelectable.java,Java,,7,7,34,48
JobAttributes.java,Java,,443,68,537,1048
KeyboardFocusManager.java,Java,,1487,252,1337,3076
KeyEventDispatcher.java,Java,,5,4,64,73
KeyEventPostProcessor.java,Java,,5,4,67,76
Label.java,Java,,123,33,187,343
LayoutManager.java,Java,,8,5,53,66
LayoutManager2.java,Java,,8,7,55,70
LinearGradientPaint.java,Java,,97,16,221,334
LinearGradientPaintContext.java,Java,,54,20,73,147
List.java,Java,[FIXME,623,154,1153,1930
MediaTracker.java,Java,,390,56,487,933
Menu.java,Java,,251,60,302,613
MenuBar.java,Java,,216,43,235,494
MenuComponent.java,Java,,350,102,604,1056
MenuContainer.java,Java,,7,3,16,26
MenuItem.java,Java,[PENDING:  WDW -- need to provide a localized string,323,76,524,923
MenuShortcut.java,Java,,52,13,112,177
ModalEventFilter.java,Java,,156,23,19,198
MouseInfo.java,Java,,53,12,53,118
MultipleGradientPaint.java,Java,,124,38,125,287
MultipleGradientPaintContext.java,Java,,357,94,253,704
PageAttributes.java,Java,,521,52,788,1361
Paint.java,Java,,12,6,59,77
PaintContext.java,Java,,12,7,46,65
Panel.java,Java,,38,14,65,117
ButtonPeer.java,Java,,5,3,13,21
CanvasPeer.java,Java,,4,2,13,19
CheckboxMenuItemPeer.java,Java,,4,1,13,18
CheckboxPeer.java,Java,,7,2,13,22
ChoicePeer.java,Java,,9,3,16,28
ComponentPeer.java,Java,,71,18,53,142
ContainerPeer.java,Java,,13,4,28,45
DesktopPeer.java,Java,,13,9,66,88
DialogPeer.java,Java,,7,5,13,25
FileDialogPeer.java,Java,,8,3,13,24
FontPeer.java,Java,,3,2,13,18
FramePeer.java,Java,,12,3,13,28
KeyboardFocusManagerPeer.java,Java,,10,5,6,21
LabelPeer.java,Java,,7,2,13,22
LightweightPeer.java,Java,,3,3,21,27
ListPeer.java,Java,,19,7,28,54
MenuBarPeer.java,Java,,7,2,13,22
MenuComponentPeer.java,Java,,6,2,13,21
MenuItemPeer.java,Java,,7,4,19,30
MenuPeer.java,Java,,7,2,13,22
MouseInfoPeer.java,Java,,7,6,35,48
PanelPeer.java,Java,,4,2,13,19
PopupMenuPeer.java,Java,,5,2,13,20
RobotPeer.java,Java,,14,7,17,38
ScrollbarPeer.java,Java,,6,1,13,20
ScrollPanePeer.java,Java,,11,2,13,26
SystemTrayPeer.java,Java,,6,3,4,13
TextAreaPeer.java,Java,,12,6,25,43
TextComponentPeer.java,Java,,18,2,13,33
TextFieldPeer.java,Java,,10,5,22,37
TrayIconPeer.java,Java,,11,3,4,18
WindowPeer.java,Java,,18,6,13,37
Point.java,Java,,54,18,143,215
PointerInfo.java,Java,,15,8,44,67
Polygon.java,Java,,268,52,340,660
PopupMenu.java,Java,,97,21,105,223
Book.java,Java,,66,27,110,203
Pageable.java,Java,,9,7,50,66
PageFormat.java,Java,,141,58,146,345
Paper.java,Java,,53,25,113,191
Printable.java,Java,,8,7,110,125
PrinterAbortException.java,Java,,9,6,22,37
PrinterException.java,Java,,8,6,21,35
PrinterGraphics.java,Java,,4,5,20,29
PrinterIOException.java,Java,,16,6,48,70
PrinterJob.java,Java,,165,47,386,598
PrintGraphics.java,Java,,4,4,16,24
PrintJob.java,Java,,11,9,43,63
RadialGradientPaint.java,Java,,156,25,398,579
RadialGradientPaintContext.java,Java,,176,65,190,431
Rectangle.java,Java,,434,62,701,1197
RenderingHints.java,Java,,222,76,984,1282
Robot.java,Java,,210,48,220,478
Scrollbar.java,Java,,355,91,870,1316
ScrollPane.java,Java,,356,79,393,828
ScrollPaneAdjustable.java,Java,,147,45,244,436
SentEvent.java,Java,,51,7,18,76
SequencedEvent.java,Java,,113,18,67,198
Shape.java,Java,,17,12,312,341
SplashScreen.java,Java,,147,21,163,331
Stroke.java,Java,,4,6,45,55
SystemColor.java,Java,,111,65,296,472
SystemTray.java,Java,,145,29,286,460
TextArea.java,Java,,245,60,392,697
TextComponent.java,Java,,484,93,627,1204
TextField.java,Java,,225,55,458,738
TexturePaint.java,Java,,47,13,63,123
TexturePaintContext.java,Java,,702,47,57,806
Toolkit.java,Java,,861,162,1488,2511
Transparency.java,Java,,7,6,29,42
TrayIcon.java,Java,,294,55,432,781
Window.java,Java,,1565,276,1710,3551
AppletInitializer.java,Java,,7,10,57,74
BeanContext.java,Java,,16,13,87,116
BeanContextChild.java,Java,,13,12,96,121
BeanContextChildComponentProxy.java,Java,,5,6,26,37
BeanContextChildSupport.java,Java,,100,57,199,356
BeanContextContainerProxy.java,Java,,5,5,25,35
BeanContextEvent.java,Java,,19,19,55,93
BeanContextMembershipEvent.java,Java,,28,24,66,118
BeanContextMembershipListener.java,Java,,7,7,30,44
BeanContextProxy.java,Java,,4,4,60,68
BeanContextServiceAvailableEvent.java,Java,,19,17,35,71
BeanContextServiceProvider.java,Java,,7,9,72,88
BeanContextServiceProviderBeanInfo.java,Java,,5,5,19,29
BeanContextServiceRevokedEvent.java,Java,,20,18,48,86
BeanContextServiceRevokedListener.java,Java,,6,7,18,31
BeanContextServices.java,Java,,17,17,107,141
BeanContextServicesListener.java,Java,,7,4,17,28
BeanContextServicesSupport.java,Java,,623,314,282,1219
BeanContextSupport.java,Java,,590,258,528,1376
BeanDescriptor.java,Java,,29,11,42,82
BeanInfo.java,Java,,15,15,123,153
Beans.java,Java,,310,92,248,650
ConstructorProperties.java,Java,,8,3,47,58
Customizer.java,Java,,6,8,34,48
DefaultPersistenceDelegate.java,Java,,184,26,188,398
DesignMode.java,Java,,6,9,57,72
Encoder.java,Java,,108,65,172,345
EventHandler.java,Java,,173,22,486,681
EventSetDescriptor.java,Java,,256,44,200,500
ExceptionListener.java,Java,,4,48,21,73
Expression.java,Java,,27,10,90,127
FeatureDescriptor.java,Java,,143,33,138,314
IndexedPropertyChangeEvent.java,Java,,13,6,39,58
IndexedPropertyDescriptor.java,Java,,267,51,161,479
IntrospectionException.java,Java,,7,4,20,31
Introspector.java,Java,,1012,163,403,1578
MetaData.java,Java,,1048,171,255,1474
MethodDescriptor.java,Java,,119,31,68,218
NameGenerator.java,Java,,52,11,36,99
ParameterDescriptor.java,Java,,8,6,21,35
PersistenceDelegate.java,Java,,26,6,160,192
PropertyChangeEvent.java,Java,,29,13,82,124
PropertyChangeListener.java,Java,,4,6,16,26
PropertyChangeListenerProxy.java,Java,,16,6,39,61
PropertyChangeSupport.java,Java,,223,42,243,508
PropertyDescriptor.java,Java,,368,69,232,669
PropertyEditor.java,Java,,15,25,166,206
PropertyEditorManager.java,Java,,92,19,81,192
PropertyEditorSupport.java,Java,,87,32,152,271
PropertyVetoException.java,Java,,12,8,26,46
ReflectionUtils.java,Java,,261,33,122,416
SimpleBeanInfo.java,Java,,54,14,60,128
Statement.java,Java,,166,20,113,299
VetoableChangeListener.java,Java,,5,2,19,26
VetoableChangeListenerProxy.java,Java,,18,7,39,64
VetoableChangeSupport.java,Java,,229,43,180,452
Visibility.java,Java,,7,8,34,49
XMLDecoder.java,Java,,110,21,138,269
XMLEncoder.java,Java,,342,53,298,693
Bits.java,Java,,93,18,18,129
BufferedInputStream.java,Java,,157,27,273,457
BufferedOutputStream.java,Java,,44,9,73,126
BufferedReader.java,Java,,263,36,203,502
BufferedWriter.java,Java,,109,23,122,254
ByteArrayInputStream.java,Java,,65,17,182,264
ByteArrayOutputStream.java,Java,,64,19,144,227
CharArrayReader.java,Java,,95,17,103,215
CharArrayWriter.java,Java,,90,20,153,263
CharConversionException.java,Java,,10,1,21,32
Closeable.java,Java,,5,6,21,32
Console.java,Java,,246,22,279,547
DataInput.java,Java,,19,16,583,618
DataInputStream.java,Java,,212,35,399,646
DataOutput.java,Java,,18,15,304,337
DataOutputStream.java,Java,,145,29,225,399
DeleteOnExitHook.java,Java,,33,12,13,58
EOFException.java,Java,,10,3,33,46
ExpiringCache.java,Java,,84,15,9,108
Externalizable.java,Java,,7,4,69,80
File.java,Java,,509,101,1349,1959
FileDescriptor.java,Java,,40,21,88,149
FileFilter.java,Java,,4,5,23,32
FileInputStream.java,Java,,101,33,254,388
FilenameFilter.java,Java,,5,2,29,36
FileNotFoundException.java,Java,,14,8,42,64
FileOutputStream.java,Java,,120,36,260,416
FilePermission.java,Java,,328,95,380,803
FileReader.java,Java,,12,8,49,69
FileSystem.java,Java,,59,47,132,238
FileWriter.java,Java,,18,10,74,102
FilterInputStream.java,Java,,35,12,172,219
FilterOutputStream.java,Java,,31,9,105,145
FilterReader.java,Java,,32,15,60,107
FilterWriter.java,Java,,23,12,55,90
Flushable.java,Java,,5,5,20,30
InputStream.java,Java,,62,21,266,349
InputStreamReader.java,Java,,50,15,119,184
InterruptedIOException.java,Java,,11,4,40,55
InvalidClassException.java,Java,,18,7,39,64
InvalidObjectException.java,Java,,7,4,23,34
IOError.java,Java,,7,3,23,33
IOException.java,Java,,17,6,61,84
LineNumberInputStream.java,Java,,97,19,159,275
LineNumberReader.java,Java,,100,23,141,264
NotActiveException.java,Java,,10,5,21,36
NotSerializableException.java,Java,,10,5,23,38
ObjectInput.java,Java,,11,8,71,90
ObjectInputStream.java,Java,,1930,295,1287,3512
ObjectInputValidation.java,Java,,4,2,22,28
ObjectOutput.java,Java,,10,7,56,73
ObjectOutputStream.java,Java,,1257,192,995,2444
ObjectStreamClass.java,Java,,1506,192,590,2288
ObjectStreamConstants.java,Java,,34,36,148,218
ObjectStreamException.java,Java,,10,5,21,36
ObjectStreamField.java,Java,,97,21,142,260
OptionalDataException.java,Java,,14,6,46,66
OutputStream.java,Java,,24,7,106,137
OutputStreamWriter.java,Java,,56,17,145,218
PipedInputStream.java,Java,,191,31,211,433
PipedOutputStream.java,Java,,53,11,98,162
PipedReader.java,Java,,158,27,161,346
PipedWriter.java,Java,,53,14,100,167
PrintStream.java,Java,,335,62,682,1079
PrintWriter.java,Java,,306,57,659,1022
PushbackInputStream.java,Java,,111,19,232,362
PushbackReader.java,Java,,120,20,124,264
RandomAccessFile.java,Java,,283,67,759,1109
Reader.java,Java,,64,20,161,245
SequenceInputStream.java,Java,,78,14,126,218
SerialCallbackContext.java,Java,,28,7,21,56
Serializable.java,Java,,3,2,148,153
SerializablePermission.java,Java,,17,10,88,115
StreamCorruptedException.java,Java,,10,5,22,37
StreamTokenizer.java,Java,,365,52,400,817
StringBufferInputStream.java,Java,,54,11,90,155
StringReader.java,Java,,78,15,91,184
StringWriter.java,Java,,59,19,141,219
SyncFailedException.java,Java,,6,2,21,29
UnsupportedEncodingException.java,Java,,11,2,20,33
UTFDataFormatException.java,Java,,10,3,37,50
Win32FileSystem.java,Java,,422,64,105,591
WinNTFileSystem.java,Java,,33,12,16,61
WriteAbortedException.java,Java,,19,6,51,76
Writer.java,Java,,64,20,224,308
AbstractMethodError.java,Java,,10,3,26,39
AbstractStringBuilder.java,Java,,463,65,893,1421
Annotation.java,Java,,7,5,98,110
AnnotationFormatError.java,Java,,12,5,38,55
AnnotationTypeMismatchException.java,Java,,18,6,43,67
Documented.java,Java,,6,2,18,26
ElementType.java,Java,,11,9,25,45
IncompleteAnnotationException.java,Java,,18,6,28,52
Inherited.java,Java,,6,2,26,34
Retention.java,Java,,7,2,19,28
RetentionPolicy.java,Java,,6,4,29,39
Target.java,Java,,7,2,41,50
Appendable.java,Java,,7,6,91,104
ApplicationShutdownHooks.java,Java,,45,15,24,84
ArithmeticException.java,Java,,10,3,25,38
ArrayIndexOutOfBoundsException.java,Java,,13,4,31,48
ArrayStoreException.java,Java,,10,4,28,42
AssertionError.java,Java,,31,10,92,133
AssertionStatusDirectives.java,Java,,8,6,62,76
Boolean.java,Java,,58,19,170,247
Byte.java,Java,,112,35,295,442
Character.java,Java,,2132,340,2997,5469
CharacterData00.java,Java,,1001,50,94,1145
CharacterData01.java,Java,,379,43,69,491
CharacterData02.java,Java,,285,42,68,395
CharacterData0E.java,Java,,290,41,68,399
CharacterDataLatin1.java,Java,,225,44,52,321
CharacterDataPrivateUse.java,Java,,87,33,13,133
CharacterDataUndefined.java,Java,,72,30,13,115
CharSequence.java,Java,,7,9,78,94
Class.java,Java,,1120,235,1752,3107
ClassCastException.java,Java,,10,3,28,41
ClassCircularityError.java,Java,,9,3,22,34
ClassFormatError.java,Java,,10,3,24,37
ClassLoader.java,Java,,871,142,1064,2077
ClassNotFoundException.java,Java,,21,8,79,108
Cloneable.java,Java,,3,2,32,37
CloneNotSupportedException.java,Java,,10,4,32,46
Comparable.java,Java,,5,3,112,120
Compiler.java,Java,,40,10,67,117
ConditionalSpecialCasing.java,Java,,273,61,115,449
Deprecated.java,Java,,6,3,16,25
Double.java,Java,,131,49,771,951
Enum.java,Java,,64,17,135,216
EnumConstantNotPresentException.java,Java,,13,6,36,55
Error.java,Java,,16,6,64,86
Exception.java,Java,,16,6,57,79
ExceptionInInitializerError.java,Java,,22,8,79,109
Float.java,Java,,115,42,694,851
IllegalAccessError.java,Java,,9,3,27,39
IllegalAccessException.java,Java,,9,3,47,59
IllegalArgumentException.java,Java,,17,6,55,78
IllegalMonitorStateException.java,Java,,10,3,30,43
IllegalStateException.java,Java,,17,6,57,80
IllegalThreadStateException.java,Java,,9,3,28,40
IncompatibleClassChangeError.java,Java,,10,3,25,38
IndexOutOfBoundsException.java,Java,,10,3,26,39
InheritableThreadLocal.java,Java,,13,5,49,67
InstantiationError.java,Java,,10,5,27,42
InstantiationException.java,Java,,10,3,33,46
ClassDefinition.java,Java,,22,7,40,69
ClassFileTransformer.java,Java,,11,6,153,170
IllegalClassFormatException.java,Java,,11,4,28,43
Instrumentation.java,Java,,37,20,576,633
UnmodifiableClassException.java,Java,,11,3,23,37
Integer.java,Java,,392,82,728,1202
InternalError.java,Java,,10,3,23,36
InterruptedException.java,Java,,10,3,37,50
Iterable.java,Java,,5,4,15,24
LinkageError.java,Java,,10,3,25,38
Long.java,Java,,362,67,723,1152
ClassLoadingMXBean.java,Java,,8,9,77,94
CompilationMXBean.java,Java,,6,5,70,81
GarbageCollectorMXBean.java,Java,,5,6,63,74
LockInfo.java,Java,,29,10,66,105
ManagementFactory.java,Java,,115,29,501,645
ManagementPermission.java,Java,,19,5,81,105
MemoryManagerMXBean.java,Java,,6,5,57,68
MemoryMXBean.java,Java,,10,9,264,283
MemoryNotificationInfo.java,Java,,50,13,176,239
MemoryPoolMXBean.java,Java,,21,19,582,622
MemoryType.java,Java,,13,8,35,56
MemoryUsage.java,Java,,80,15,191,286
MonitorInfo.java,Java,,47,10,85,142
OperatingSystemMXBean.java,Java,,8,7,107,122
RuntimeMXBean.java,Java,,19,19,281,319
ThreadInfo.java,Java,,281,36,507,824
ThreadMXBean.java,Java,,31,30,724,785
Math.java,Java,,197,66,1250,1513
NegativeArraySizeException.java,Java,,10,3,23,36
NoClassDefFoundError.java,Java,,10,3,29,42
NoSuchFieldError.java,Java,,10,3,27,40
NoSuchFieldException.java,Java,,9,3,21,33
NoSuchMethodError.java,Java,,10,3,28,41
NoSuchMethodException.java,Java,,10,3,21,34
NullPointerException.java,Java,,10,3,35,48
Number.java,Java,,14,8,73,95
NumberFormatException.java,Java,,14,5,31,50
Object.java,Java,,36,17,483,536
OutOfMemoryError.java,Java,,10,3,24,37
Override.java,Java,,6,3,15,24
Package.java,Java,,307,41,248,596
Process.java,Java,,11,8,112,131
ProcessBuilder.java,Java,,113,25,339,477
ProcessEnvironment.java,Java,,199,36,69,304
ProcessImpl.java,Java,,135,31,58,224
Readable.java,Java,,5,6,27,38
Finalizer.java,Java,,141,19,31,191
FinalReference.java,Java,,6,6,7,19
PhantomReference.java,Java,,9,7,50,66
Reference.java,Java,,71,33,117,221
ReferenceQueue.java,Java,,72,13,52,137
SoftReference.java,Java,,19,10,70,99
WeakReference.java,Java,,9,7,39,55
AccessibleObject.java,Java,,54,15,115,184
AnnotatedElement.java,Java,,8,6,75,89
Array.java,Java,,56,29,382,467
Constructor.java,Java,,305,44,319,668
Field.java,Java,,295,55,671,1021
GenericArrayType.java,Java,,4,3,28,35
GenericDeclaration.java,Java,,4,2,25,31
GenericSignatureFormatError.java,Java,,2,3,13,18
InvocationHandler.java,Java,,5,3,70,78
InvocationTargetException.java,Java,,22,8,63,93
MalformedParameterizedTypeException.java,Java,,2,3,14,19
Member.java,Java,,10,8,57,75
Method.java,Java,,330,45,386,761
Modifier.java,Java,,89,34,216,339
ParameterizedType.java,Java,,6,6,66,78
Proxy.java,Java,,271,46,461,778
ReflectAccess.java,Java,,98,17,13,128
ReflectPermission.java,Java,,11,6,66,83
Type.java,Java,,3,3,13,19
TypeVariable.java,Java,,6,5,61,72
UndeclaredThrowableException.java,Java,,21,7,74,102
WildcardType.java,Java,,5,4,57,66
Runnable.java,Java,,5,2,45,52
Runtime.java,Java,,126,35,719,880
RuntimeException.java,Java,,16,6,57,79
RuntimePermission.java,Java,,16,9,329,354
SecurityException.java,Java,,16,6,45,67
SecurityManager.java,Java,,374,66,1278,1718
Short.java,Java,,121,35,302,458
Shutdown.java,Java,,102,26,66,194
StackOverflowError.java,Java,,10,3,23,36
StackTraceElement.java,Java,,59,14,139,212
StrictMath.java,Java,,188,71,1193,1452
String.java,Java,,925,131,1946,3002
StringBuffer.java,Java,,239,63,327,629
StringBuilder.java,Java,,189,47,226,462
StringCoding.java,Java,,231,36,34,301
StringIndexOutOfBoundsException.java,Java,,13,4,35,52
StringValue.java,Java,,8,5,13,26
SuppressWarnings.java,Java,,9,3,35,47
System.java,Java,,254,66,843,1163
Terminator.java,Java,,22,10,23,55
Thread.java,Java,,508,138,1237,1883
ThreadDeath.java,Java,,2,3,30,35
ThreadGroup.java,Java,,455,48,515,1018
ThreadLocal.java,Java,,285,59,321,665
Throwable.java,Java,,138,36,480,654
TypeNotPresentException.java,Java,,9,4,33,46
UnknownError.java,Java,,10,3,23,36
UnsatisfiedLinkError.java,Java,,10,3,24,37
UnsupportedClassVersionError.java,Java,,10,3,23,36
UnsupportedOperationException.java,Java,,15,6,56,77
VerifyError.java,Java,,10,3,23,36
VirtualMachineError.java,Java,,10,3,24,37
Void.java,Java,,6,4,22,32
BigDecimal.java,Java,,1489,218,2140,3847
BigInteger.java,Java,,1605,383,1162,3150
BitSieve.java,Java,,84,21,92,197
MathContext.java,Java,,87,29,198,314
MutableBigInteger.java,Java,,900,175,381,1456
RoundingMode.java,Java,,37,22,280,339
SignedMutableBigInteger.java,Java,,42,19,59,120
Authenticator.java,Java,,152,34,228,414
BindException.java,Java,,7,5,23,35
CacheRequest.java,Java,,7,5,34,46
CacheResponse.java,Java,,9,5,33,47
ConnectException.java,Java,,7,3,24,34
ContentHandler.java,Java,,14,6,73,93
ContentHandlerFactory.java,Java,,4,2,31,37
CookieHandler.java,Java,,28,7,88,123
CookieManager.java,Java,,206,45,167,418
CookiePolicy.java,Java,,19,7,34,60
CookieStore.java,Java,,11,14,86,111
DatagramPacket.java,Java,,105,26,238,369
DatagramSocket.java,Java,,453,60,679,1192
DatagramSocketImpl.java,Java,,37,24,165,226
DatagramSocketImplFactory.java,Java,,5,2,22,29
FileNameMap.java,Java,,4,3,20,27
HttpCookie.java,Java,,450,190,549,1189
HttpRetryException.java,Java,,25,9,47,81
HttpURLConnection.java,Java,,187,82,435,704
IDN.java,Java,,197,59,195,451
Inet4Address.java,Java,,117,29,217,363
Inet4AddressImpl.java,Java,,38,5,14,57
Inet6Address.java,Java,,311,62,376,749
Inet6AddressImpl.java,Java,,60,7,24,91
InetAddress.java,Java,,689,150,713,1552
InetAddressImpl.java,Java,,12,4,15,31
InetSocketAddress.java,Java,,191,35,167,393
InterfaceAddress.java,Java,,36,10,70,116
JarURLConnection.java,Java,,57,25,219,301
MalformedURLException.java,Java,,9,4,24,37
MulticastSocket.java,Java,,219,46,395,660
NetPermission.java,Java,,16,8,151,175
NetworkInterface.java,Java,,247,53,217,517
NoRouteToHostException.java,Java,,7,3,24,34
PasswordAuthentication.java,Java,,15,9,41,65
PlainDatagramSocketImpl.java,Java,,208,45,119,372
PlainSocketImpl.java,Java,,466,61,190,717
PortUnreachableException.java,Java,,7,5,21,33
ProtocolException.java,Java,,10,4,23,37
Proxy.java,Java,,49,12,93,154
ProxySelector.java,Java,,33,9,104,146
ResponseCache.java,Java,,26,8,112,146
SdpSocketImpl.java,Java,,20,5,10,35
SecureCacheResponse.java,Java,,14,7,69,90
ServerSocket.java,Java,,276,40,510,826
Socket.java,Java,,550,82,944,1576
SocketAddress.java,Java,,3,2,19,24
SocketException.java,Java,,10,4,23,37
SocketImpl.java,Java,,72,33,235,340
SocketImplFactory.java,Java,,5,2,24,31
SocketInputStream.java,Java,,129,25,97,251
SocketOptions.java,Java,,20,34,264,318
SocketOutputStream.java,Java,,72,17,77,166
SocketPermission.java,Java,,718,177,503,1398
SocketTimeoutException.java,Java,,7,5,19,31
SocksConsts.java,Java,,25,6,9,40
SocksSocketImpl.java,Java,,817,33,194,1044
UnknownHostException.java,Java,,10,4,23,37
UnknownServiceException.java,Java,,9,4,26,39
URI.java,Java,,1524,282,1701,3507
URISyntaxException.java,Java,,39,11,66,116
URL.java,Java,,459,108,742,1309
URLClassLoader.java,Java,,372,39,218,629
URLConnection.java,Java,,550,144,1014,1708
URLDecoder.java,Java,,65,20,103,188
URLEncoder.java,Java,,110,19,147,276
URLStreamHandler.java,Java,,303,42,228,573
URLStreamHandlerFactory.java,Java,,4,2,28,34
Bits.java,Java,,552,140,64,756
Buffer.java,Java,,130,36,372,538
BufferOverflowException.java,Java,,6,7,19,32
BufferUnderflowException.java,Java,,6,7,19,32
ByteBuffer.java,Java,,196,491,1307,1994
ByteBufferAsCharBufferB.java,Java,,123,68,9,200
ByteBufferAsCharBufferL.java,Java,,123,68,9,200
ByteBufferAsCharBufferRB.java,Java,,83,109,8,200
ByteBufferAsCharBufferRL.java,Java,,83,109,8,200
ByteBufferAsDoubleBufferB.java,Java,,92,100,8,200
ByteBufferAsDoubleBufferL.java,Java,,92,100,8,200
ByteBufferAsDoubleBufferRB.java,Java,,52,141,7,200
ByteBufferAsDoubleBufferRL.java,Java,,52,141,7,200
ByteBufferAsFloatBufferB.java,Java,,92,100,8,200
ByteBufferAsFloatBufferL.java,Java,,92,100,8,200
ByteBufferAsFloatBufferRB.java,Java,,52,141,7,200
ByteBufferAsFloatBufferRL.java,Java,,52,141,7,200
ByteBufferAsIntBufferB.java,Java,,92,100,8,200
ByteBufferAsIntBufferL.java,Java,,92,100,8,200
ByteBufferAsIntBufferRB.java,Java,,52,141,7,200
ByteBufferAsIntBufferRL.java,Java,,52,141,7,200
ByteBufferAsLongBufferB.java,Java,,92,100,8,200
ByteBufferAsLongBufferL.java,Java,,92,100,8,200
ByteBufferAsLongBufferRB.java,Java,,52,141,7,200
ByteBufferAsLongBufferRL.java,Java,,52,141,7,200
ByteBufferAsShortBufferB.java,Java,,92,100,8,200
ByteBufferAsShortBufferL.java,Java,,92,100,8,200
ByteBufferAsShortBufferRB.java,Java,,52,141,7,200
ByteBufferAsShortBufferRL.java,Java,,52,141,7,200
ByteOrder.java,Java,,17,11,44,72
AlreadyConnectedException.java,Java,,6,7,19,32
AsynchronousCloseException.java,Java,,6,7,20,33
ByteChannel.java,Java,,6,6,16,28
CancelledKeyException.java,Java,,6,7,19,32
Channel.java,Java,,7,8,52,67
Channels.java,Java,,212,44,196,452
ClosedByInterruptException.java,Java,,6,7,21,34
ClosedChannelException.java,Java,,6,7,22,35
ClosedSelectorException.java,Java,,6,7,19,32
ConnectionPendingException.java,Java,,6,7,20,33
DatagramChannel.java,Java,,41,25,355,421
FileChannel.java,Java,,64,43,858,965
FileLock.java,Java,,51,16,177,244
FileLockInterruptionException.java,Java,,6,7,20,33
GatheringByteChannel.java,Java,,10,9,130,149
IllegalBlockingModeException.java,Java,,6,7,19,32
IllegalSelectorException.java,Java,,6,7,20,33
InterruptibleChannel.java,Java,,7,8,49,64
NoConnectionPendingException.java,Java,,6,7,20,33
NonReadableChannelException.java,Java,,6,7,19,32
NonWritableChannelException.java,Java,,6,7,19,32
NotYetBoundException.java,Java,,6,7,19,32
NotYetConnectedException.java,Java,,6,7,19,32
OverlappingFileLockException.java,Java,,6,7,21,34
Pipe.java,Java,,33,16,87,136
ReadableByteChannel.java,Java,,6,7,78,91
ScatteringByteChannel.java,Java,,10,8,127,145
SelectableChannel.java,Java,,25,17,277,319
SelectionKey.java,Java,,37,33,310,380
Selector.java,Java,,20,17,341,378
ServerSocketChannel.java,Java,,20,13,121,154
SocketChannel.java,Java,,46,25,292,363
AbstractInterruptibleChannel.java,Java,,63,18,113,194
AbstractSelectableChannel.java,Java,,139,34,105,278
AbstractSelectionKey.java,Java,,22,10,28,60
AbstractSelector.java,Java,,59,23,131,213
SelectorProvider.java,Java,,87,17,162,266
UnresolvedAddressException.java,Java,,6,7,19,32
UnsupportedAddressTypeException.java,Java,,6,7,19,32
WritableByteChannel.java,Java,,8,7,73,88
CharBuffer.java,Java,,198,179,1030,1407
CharacterCodingException.java,Java,,6,7,19,32
Charset.java,Java,,304,60,520,884
CharsetDecoder.java,Java,,218,187,550,955
CharsetEncoder.java,Java,,263,141,551,955
CoderMalfunctionError.java,Java,,8,6,21,35
CoderResult.java,Java,,97,29,141,267
CodingErrorAction.java,Java,,16,11,40,67
IllegalCharsetNameException.java,Java,,13,9,27,49
MalformedInputException.java,Java,,15,9,13,37
CharsetProvider.java,Java,,12,9,72,93
UnmappableCharacterException.java,Java,,15,9,13,37
UnsupportedCharsetException.java,Java,,13,9,27,49
DirectByteBuffer.java,Java,,614,351,27,992
DirectByteBufferR.java,Java,,339,642,11,992
DirectCharBufferRS.java,Java,,92,353,8,453
DirectCharBufferRU.java,Java,,92,353,8,453
DirectCharBufferS.java,Java,,196,240,17,453
DirectCharBufferU.java,Java,,196,240,17,453
DirectDoubleBufferRS.java,Java,,61,385,7,453
DirectDoubleBufferRU.java,Java,,61,385,7,453
DirectDoubleBufferS.java,Java,,165,272,16,453
DirectDoubleBufferU.java,Java,,165,272,16,453
DirectFloatBufferRS.java,Java,,61,385,7,453
DirectFloatBufferRU.java,Java,,61,385,7,453
DirectFloatBufferS.java,Java,,165,272,16,453
DirectFloatBufferU.java,Java,,165,272,16,453
DirectIntBufferRS.java,Java,,61,385,7,453
DirectIntBufferRU.java,Java,,61,385,7,453
DirectIntBufferS.java,Java,,165,272,16,453
DirectIntBufferU.java,Java,,165,272,16,453
DirectLongBufferRS.java,Java,,61,385,7,453
DirectLongBufferRU.java,Java,,61,385,7,453
DirectLongBufferS.java,Java,,165,272,16,453
DirectLongBufferU.java,Java,,165,272,16,453
DirectShortBufferRS.java,Java,,61,385,7,453
DirectShortBufferRU.java,Java,,61,385,7,453
DirectShortBufferS.java,Java,,165,272,16,453
DirectShortBufferU.java,Java,,165,272,16,453
DoubleBuffer.java,Java,,149,504,754,1407
FloatBuffer.java,Java,,149,504,754,1407
HeapByteBuffer.java,Java,,301,232,43,576
HeapByteBufferR.java,Java,,201,344,31,576
HeapCharBuffer.java,Java,,132,406,38,576
HeapCharBufferR.java,Java,,80,470,26,576
HeapDoubleBuffer.java,Java,,112,427,37,576
HeapDoubleBufferR.java,Java,,60,491,25,576
HeapFloatBuffer.java,Java,,112,427,37,576
HeapFloatBufferR.java,Java,,60,491,25,576
HeapIntBuffer.java,Java,,112,427,37,576
HeapIntBufferR.java,Java,,60,491,25,576
HeapLongBuffer.java,Java,,112,427,37,576
HeapLongBufferR.java,Java,,60,491,25,576
HeapShortBuffer.java,Java,,112,427,37,576
HeapShortBufferR.java,Java,,60,491,25,576
IntBuffer.java,Java,,149,504,754,1407
InvalidMarkException.java,Java,,6,7,19,32
LongBuffer.java,Java,,149,504,754,1407
MappedByteBuffer.java,Java,,52,15,95,162
ReadOnlyBufferException.java,Java,,6,7,19,32
ShortBuffer.java,Java,,149,504,754,1407
StringCharBuffer.java,Java,,77,21,8,106
AccessException.java,Java,,10,5,38,53
Activatable.java,Java,,134,22,382,538
ActivateFailedException.java,Java,,10,5,30,45
ActivationDesc.java,Java,,98,22,202,322
ActivationException.java,Java,,28,9,64,101
ActivationGroup.java,Java,,175,31,305,511
ActivationGroupDesc.java,Java,,122,31,200,353
ActivationGroupID.java,Java,,26,9,63,98
ActivationID.java,Java,,94,16,163,273
ActivationInstantiator.java,Java,,9,4,46,59
ActivationMonitor.java,Java,,16,9,68,93
ActivationSystem.java,Java,,32,14,166,212
Activator.java,Java,,10,4,83,97
UnknownGroupException.java,Java,,7,4,32,43
UnknownObjectException.java,Java,,7,4,34,45
AlreadyBoundException.java,Java,,10,4,31,45
ConnectException.java,Java,,10,5,30,45
ConnectIOException.java,Java,,10,6,31,47
DGC.java,Java,,9,4,84,97
Lease.java,Java,,19,6,34,59
VMID.java,Java,,84,18,58,160
MarshalException.java,Java,,10,5,39,54
MarshalledObject.java,Java,,111,28,160,299
Naming.java,Java,,171,22,146,339
NoSuchObjectException.java,Java,,7,4,34,45
NotBoundException.java,Java,,10,4,33,47
LocateRegistry.java,Java,,68,15,141,224
Registry.java,Java,,18,8,149,175
RegistryHandler.java,Java,,11,5,40,56
Remote.java,Java,,2,2,29,33
RemoteException.java,Java,,28,9,68,105
RMISecurityException.java,Java,,13,4,33,50
RMISecurityManager.java,Java,,6,4,37,47
ExportException.java,Java,,10,6,35,51
LoaderHandler.java,Java,,15,7,56,78
LogStream.java,Java,,123,27,103,253
ObjID.java,Java,,68,18,145,231
Operation.java,Java,,17,5,34,56
RemoteCall.java,Java,,24,10,81,115
RemoteObject.java,Java,,89,15,337,441
RemoteObjectInvocationHandler.java,Java,,129,16,122,267
RemoteRef.java,Java,,22,14,142,178
RemoteServer.java,Java,,27,8,63,98
RemoteStub.java,Java,,14,5,38,57
RMIClassLoader.java,Java,,129,27,546,702
RMIClassLoaderSpi.java,Java,,15,7,153,175
RMIClientSocketFactory.java,Java,,7,4,46,57
RMIFailureHandler.java,Java,,4,5,35,44
RMIServerSocketFactory.java,Java,,7,4,46,57
RMISocketFactory.java,Java,,52,12,107,171
ServerCloneException.java,Java,,25,8,62,95
ServerNotActiveException.java,Java,,9,5,30,44
ServerRef.java,Java,,8,6,35,49
Skeleton.java,Java,,10,3,40,53
SkeletonMismatchException.java,Java,,10,6,29,45
SkeletonNotFoundException.java,Java,,12,6,33,51
SocketSecurityException.java,Java,,10,6,29,45
UID.java,Java,,88,17,144,249
UnicastRemoteObject.java,Java,,83,18,194,295
Unreferenced.java,Java,,4,2,22,28
ServerError.java,Java,,7,4,28,39
ServerException.java,Java,,10,5,35,50
ServerRuntimeException.java,Java,,9,4,35,48
StubNotFoundException.java,Java,,10,5,35,50
UnexpectedException.java,Java,,10,5,32,47
UnknownHostException.java,Java,,10,5,30,45
UnmarshalException.java,Java,,10,5,44,59
AccessControlContext.java,Java,,313,78,215,606
AccessControlException.java,Java,,15,9,42,66
AccessController.java,Java,,89,34,428,551
Acl.java,Java,,16,28,196,240
AclEntry.java,Java,,15,15,108,138
AclNotFoundException.java,Java,,6,5,15,26
Group.java,Java,,9,9,51,69
LastOwnerException.java,Java,,6,4,17,27
NotOwnerException.java,Java,,6,4,16,26
Owner.java,Java,,9,7,61,77
Permission.java,Java,,5,6,25,36
AlgorithmParameterGenerator.java,Java,,78,18,216,312
AlgorithmParameterGeneratorSpi.java,Java,,9,7,53,69
AlgorithmParameters.java,Java,,108,21,236,365
AlgorithmParametersSpi.java,Java,,20,11,103,134
AllPermission.java,Java,,69,32,121,222
AuthProvider.java,Java,,13,7,89,109
BasicPermission.java,Java,,209,77,272,558
Certificate.java,Java,,90,24,143,257
CertificateEncodingException.java,Java,,16,7,48,71
CertificateException.java,Java,,17,8,46,71
CertificateExpiredException.java,Java,,10,5,27,42
CertificateFactory.java,Java,,102,22,378,502
CertificateFactorySpi.java,Java,,38,12,248,298
CertificateNotYetValidException.java,Java,,10,5,27,42
CertificateParsingException.java,Java,,16,7,49,72
CertPath.java,Java,,91,25,196,312
CertPathBuilder.java,Java,,69,13,192,274
CertPathBuilderException.java,Java,,17,9,61,87
CertPathBuilderResult.java,Java,,5,4,42,51
CertPathBuilderSpi.java,Java,,7,5,46,58
CertPathHelperImpl.java,Java,,42,18,20,80
CertPathParameters.java,Java,,4,3,25,32
CertPathValidator.java,Java,,71,13,202,286
CertPathValidatorException.java,Java,,38,14,108,160
CertPathValidatorResult.java,Java,,4,3,26,33
CertPathValidatorSpi.java,Java,,8,5,55,68
CertSelector.java,Java,,5,4,41,50
CertStore.java,Java,,100,15,282,397
CertStoreException.java,Java,,17,9,60,86
CertStoreParameters.java,Java,,4,3,56,63
CertStoreSpi.java,Java,,11,6,91,108
CollectionCertStoreParameters.java,Java,,33,9,82,124
CRL.java,Java,,12,8,51,71
CRLException.java,Java,,17,8,46,71
CRLSelector.java,Java,,5,4,40,49
LDAPCertStoreParameters.java,Java,,39,13,80,132
PKIXBuilderParameters.java,Java,,40,9,133,182
PKIXCertPathBuilderResult.java,Java,,28,7,67,102
PKIXCertPathChecker.java,Java,,20,9,135,164
PKIXCertPathValidatorResult.java,Java,,43,10,89,142
PKIXParameters.java,Java,,250,42,426,718
PolicyNode.java,Java,,12,10,94,116
PolicyQualifierInfo.java,Java,,46,12,98,156
TrustAnchor.java,Java,,101,17,201,319
X509Certificate.java,Java,,60,30,536,626
X509CertSelector.java,Java,,1264,106,1251,2621
X509CRL.java,Java,,82,27,309,418
X509CRLEntry.java,Java,,44,15,99,158
X509CRLSelector.java,Java,,271,38,386,695
X509Extension.java,Java,,8,8,153,169
Certificate.java,Java,,15,11,113,139
CodeSigner.java,Java,,63,15,71,149
CodeSource.java,Java,,266,61,294,621
DigestException.java,Java,,16,7,46,69
DigestInputStream.java,Java,,41,18,116,175
DigestOutputStream.java,Java,,39,16,103,158
DomainCombiner.java,Java,,5,3,87,95
GeneralSecurityException.java,Java,,16,8,47,71
Guard.java,Java,,4,4,31,39
GuardedObject.java,Java,,25,11,49,85
Identity.java,Java,,179,41,259,479
IdentityScope.java,Java,,67,26,146,239
DSAKey.java,Java,,4,3,26,33
DSAKeyPairGenerator.java,Java,,8,5,84,97
DSAParams.java,Java,,7,6,34,47
DSAPrivateKey.java,Java,,6,8,29,43
DSAPublicKey.java,Java,,6,8,29,43
ECKey.java,Java,,5,2,21,28
ECPrivateKey.java,Java,,7,3,26,36
ECPublicKey.java,Java,,7,4,27,38
RSAKey.java,Java,,5,5,22,32
RSAMultiPrimePrivateCrtKey.java,Java,,13,12,58,83
RSAPrivateCrtKey.java,Java,,11,11,46,68
RSAPrivateKey.java,Java,,7,6,20,33
RSAPublicKey.java,Java,,7,5,18,30
InvalidAlgorithmParameterException.java,Java,,17,8,55,80
InvalidKeyException.java,Java,,16,9,47,72
InvalidParameterException.java,Java,,10,6,26,42
Key.java,Java,,7,8,121,136
KeyException.java,Java,,16,8,49,73
KeyFactory.java,Java,,188,25,231,444
KeyFactorySpi.java,Java,,14,9,100,123
KeyManagementException.java,Java,,16,8,58,82
KeyPair.java,Java,,17,9,38,64
KeyPairGenerator.java,Java,,235,41,393,669
KeyPairGeneratorSpi.java,Java,,11,7,71,89
KeyRep.java,Java,,60,21,97,178
KeyStore.java,Java,,637,103,1001,1741
KeyStoreException.java,Java,,16,8,49,73
KeyStoreSpi.java,Java,,181,39,356,576
MessageDigest.java,Java,,217,42,299,558
MessageDigestSpi.java,Java,,56,15,118,189
NoSuchAlgorithmException.java,Java,,16,8,48,72
NoSuchProviderException.java,Java,,10,6,25,41
Permission.java,Java,,31,23,161,215
PermissionCollection.java,Java,,30,12,134,176
Permissions.java,Java,,238,80,262,580
Policy.java,Java,,344,68,432,844
PolicySpi.java,Java,,14,8,79,101
Principal.java,Java,,7,6,42,55
PrivateKey.java,Java,,4,3,32,39
PrivilegedAction.java,Java,,4,4,30,38
PrivilegedActionException.java,Java,,19,7,61,87
PrivilegedExceptionAction.java,Java,,4,5,35,44
ProtectionDomain.java,Java,,212,42,166,420
Provider.java,Java,,817,102,544,1463
ProviderException.java,Java,,16,7,49,72
PublicKey.java,Java,,4,3,29,36
SecureClassLoader.java,Java,,111,17,130,258
SecureRandom.java,Java,,140,36,386,562
SecureRandomSpi.java,Java,,7,7,43,57
Security.java,Java,,494,96,479,1069
SecurityPermission.java,Java,,16,9,274,299
Signature.java,Java,,626,96,540,1262
SignatureException.java,Java,,16,8,46,70
SignatureSpi.java,Java,,92,30,259,381
SignedObject.java,Java,,59,16,168,243
Signer.java,Java,,60,18,88,166
AlgorithmParameterSpec.java,Java,,2,3,22,27
DSAParameterSpec.java,Java,,22,9,41,72
DSAPrivateKeySpec.java,Java,,27,10,52,89
DSAPublicKeySpec.java,Java,,27,10,52,89
ECField.java,Java,,6,2,24,32
ECFieldF2m.java,Java,,91,12,121,224
ECFieldFp.java,Java,,28,8,45,81
ECGenParameterSpec.java,Java,,13,4,34,51
ECParameterSpec.java,Java,,42,8,46,96
ECPoint.java,Java,,37,10,50,97
ECPrivateKeySpec.java,Java,,22,6,36,64
ECPublicKeySpec.java,Java,,24,5,39,68
EllipticCurve.java,Java,,83,13,82,178
EncodedKeySpec.java,Java,,11,7,50,68
InvalidKeySpecException.java,Java,,17,9,51,77
InvalidParameterSpecException.java,Java,,11,7,31,49
KeySpec.java,Java,,2,3,40,45
MGF1ParameterSpec.java,Java,,22,7,61,90
PKCS8EncodedKeySpec.java,Java,,12,6,61,79
PSSParameterSpec.java,Java,,59,14,121,194
RSAKeyGenParameterSpec.java,Java,,19,10,40,69
RSAMultiPrimePrivateCrtKeySpec.java,Java,,90,13,92,195
RSAOtherPrimeInfo.java,Java,,35,10,58,103
RSAPrivateCrtKeySpec.java,Java,,44,14,68,126
RSAPrivateKeySpec.java,Java,,16,8,36,60
RSAPublicKeySpec.java,Java,,16,8,36,60
X509EncodedKeySpec.java,Java,,12,6,51,69
Timestamp.java,Java,,49,15,68,132
UnrecoverableEntryException.java,Java,,10,6,23,39
UnrecoverableKeyException.java,Java,,10,6,23,39
UnresolvedPermission.java,Java,,296,47,246,589
UnresolvedPermissionCollection.java,Java,,90,29,82,201
URIParameter.java,Java,,14,6,25,45
Array.java,Java,,17,16,317,350
BatchUpdateException.java,Java,,52,16,260,328
Blob.java,Java,,15,18,255,288
CallableStatement.java,Java,,162,122,2142,2426
ClientInfoStatus.java,Java,,8,8,28,44
Clob.java,Java,,17,20,294,331
Connection.java,Java,,75,61,1123,1259
DatabaseMetaData.java,Java,,272,248,3036,3556
DataTruncation.java,Java,,44,18,108,170
Date.java,Java,,97,21,128,246
Driver.java,Java,,11,12,113,136
DriverManager.java,Java,,285,99,299,683
DriverPropertyInfo.java,Java,,12,9,45,66
NClob.java,Java,,3,4,30,37
ParameterMetaData.java,Java,,19,20,139,178
PreparedStatement.java,Java,,89,56,1048,1193
Ref.java,Java,,7,10,94,111
ResultSet.java,Java,,250,220,3597,4067
ResultSetMetaData.java,Java,,27,28,204,259
RowId.java,Java,,7,9,88,104
RowIdLifetime.java,Java,,9,9,31,49
Savepoint.java,Java,,5,7,32,44
SQLClientInfoException.java,Java,,63,27,213,303
SQLData.java,Java,,6,6,108,120
SQLDataException.java,Java,,28,11,113,152
SQLException.java,Java,,152,35,170,357
SQLFeatureNotSupportedException.java,Java,,28,11,122,161
SQLInput.java,Java,,30,36,340,406
SQLIntegrityConstraintViolationException.java,Java,,28,11,113,152
SQLInvalidAuthorizationSpecException.java,Java,,28,11,113,152
SQLNonTransientConnectionException.java,Java,,28,12,116,156
SQLNonTransientException.java,Java,,28,12,117,157
SQLOutput.java,Java,,30,39,351,420
SQLPermission.java,Java,,11,11,89,111
SQLRecoverableException.java,Java,,28,11,118,157
SQLSyntaxErrorException.java,Java,,28,11,113,152
SQLTimeoutException.java,Java,,28,12,114,154
SQLTransactionRollbackException.java,Java,,28,10,114,152
SQLTransientConnectionException.java,Java,,28,11,116,155
SQLTransientException.java,Java,,28,11,115,154
SQLWarning.java,Java,,52,14,133,199
SQLXML.java,Java,,19,13,375,407
Statement.java,Java,,52,56,828,936
Struct.java,Java,,7,8,75,90
Time.java,Java,,86,23,124,233
Timestamp.java,Java,,253,42,225,520
Types.java,Java,,40,47,211,298
Wrapper.java,Java,,5,8,51,64
Annotation.java,Java,,13,8,45,66
AttributedCharacterIterator.java,Java,,54,29,139,222
AttributedString.java,Java,,716,132,255,1103
Bidi.java,Java,,370,69,200,639
BreakDictionary.java,Java,,142,37,146,325
BreakIterator.java,Java,,231,49,411,691
CharacterIterator.java,Java,,15,17,143,175
CharacterIteratorFieldDelegate.java,Java,,60,11,36,107
ChoiceFormat.java,Java,,263,40,300,603
CollationElementIterator.java,Java,,410,57,285,752
CollationKey.java,Java,,15,11,103,129
CollationRules.java,Java,,204,11,42,257
Collator.java,Java,,147,33,356,536
DateFormat.java,Java,,303,73,589,965
DateFormatSymbols.java,Java,,279,64,409,752
DecimalFormat.java,Java,,1527,237,1496,3260
DecimalFormatSymbols.java,Java,,305,81,427,813
DictionaryBasedBreakIterator.java,Java,,216,49,232,497
DigitList.java,Java,,385,63,250,698
DontCareFieldPosition.java,Java,,18,5,12,35
EntryPair.java,Java,,15,4,23,42
FieldPosition.java,Java,,96,27,163,286
Format.java,Java,,68,28,293,389
MergeCollation.java,Java,,187,32,107,326
MessageFormat.java,Java,,622,70,809,1501
Normalizer.java,Java,,18,12,135,165
NumberFormat.java,Java,,333,94,718,1145
ParseException.java,Java,,12,6,43,61
ParsePosition.java,Java,,38,12,72,122
PatternEntry.java,Java,,206,29,54,289
RBCollationTables.java,Java,,129,31,125,285
RBTableBuilder.java,Java,,338,55,207,600
RuleBasedBreakIterator.java,Java,,494,121,519,1134
RuleBasedCollationKey.java,Java,,38,13,57,108
RuleBasedCollator.java,Java,,273,44,417,734
SimpleDateFormat.java,Java,,1158,170,863,2191
BreakIteratorProvider.java,Java,,12,8,70,90
CollatorProvider.java,Java,,9,5,30,44
DateFormatProvider.java,Java,,12,7,78,97
DateFormatSymbolsProvider.java,Java,,9,5,31,45
DecimalFormatSymbolsProvider.java,Java,,9,5,31,45
NumberFormatProvider.java,Java,,12,8,76,96
StringCharacterIterator.java,Java,,129,26,106,261
AbstractCollection.java,Java,,149,27,253,429
AbstractList.java,Java,,335,74,355,764
AbstractMap.java,Java,,292,70,427,789
AbstractQueue.java,Java,,44,9,114,167
AbstractSequentialList.java,Java,,57,14,165,236
AbstractSet.java,Java,,46,10,110,166
ArrayDeque.java,Java,,361,72,406,839
ArrayList.java,Java,,218,51,326,595
Arrays.java,Java,...,1590,311,2271,4172
BitSet.java,Java,,388,125,433,946
Calendar.java,Java,,870,201,1616,2687
Collection.java,Java,,18,23,382,423
Collections.java,Java,,1825,370,1455,3650
Comparator.java,Java,,5,4,137,146
AbstractExecutorService.java,Java,,176,22,73,271
ArrayBlockingQueue.java,Java,,443,45,275,763
AtomicBoolean.java,Java,,49,14,73,136
AtomicInteger.java,Java,,104,26,107,237
AtomicIntegerArray.java,Java,,111,21,126,258
AtomicIntegerFieldUpdater.java,Java,,140,28,150,318
AtomicLong.java,Java,,106,28,117,251
AtomicLongArray.java,Java,,111,22,125,258
AtomicLongFieldUpdater.java,Java,,221,40,147,408
AtomicMarkableReference.java,Java,,62,12,90,164
AtomicReference.java,Java,,44,15,68,127
AtomicReferenceArray.java,Java,,95,24,91,210
AtomicReferenceFieldUpdater.java,Java,,123,24,130,277
AtomicStampedReference.java,Java,,65,13,90,168
BlockingDeque.java,Java,,39,33,542,614
BlockingQueue.java,Java,,18,13,314,345
BrokenBarrierException.java,Java,,8,4,27,39
Callable.java,Java,,4,2,31,37
CancellationException.java,Java,,8,4,23,35
CompletionService.java,Java,,8,7,83,98
ConcurrentHashMap.java,Java,,652,113,516,1281
ConcurrentLinkedQueue.java,Java,,318,58,328,704
ConcurrentMap.java,Java,,8,5,122,135
ConcurrentNavigableMap.java,Java,,17,12,120,149
ConcurrentSkipListMap.java,Java,,1735,249,1133,3117
ConcurrentSkipListSet.java,Java,,147,46,264,457
CopyOnWriteArrayList.java,Java,,704,98,492,1294
CopyOnWriteArraySet.java,Java,,81,22,262,365
CountDownLatch.java,Java,,48,13,230,291
CyclicBarrier.java,Java,,131,22,302,455
Delayed.java,Java,,5,4,25,34
DelayQueue.java,Java,,255,30,202,487
Exchanger.java,Java,,192,29,435,656
ExecutionException.java,Java,,14,6,46,66
Executor.java,Java,,4,3,106,113
ExecutorCompletionService.java,Java,,64,13,98,175
Executors.java,Java,,305,41,320,666
ExecutorService.java,Java,,26,16,292,334
Future.java,Java,,9,7,127,143
FutureTask.java,Java,,167,31,128,326
LinkedBlockingDeque.java,Java,,603,91,426,1120
LinkedBlockingQueue.java,Java,,447,62,321,830
AbstractOwnableSynchronizer.java,Java,,13,7,38,58
AbstractQueuedLongSynchronizer.java,Java,,850,126,1069,2045
AbstractQueuedSynchronizer.java,Java,,850,126,1294,2270
Condition.java,Java,,12,9,415,436
Lock.java,Java,,10,8,310,328
LockSupport.java,Java,,56,15,282,353
ReadWriteLock.java,Java,,5,3,97,105
ReentrantLock.java,Java,,177,42,522,741
ReentrantReadWriteLock.java,Java,,348,77,922,1347
PriorityBlockingQueue.java,Java,,258,36,270,564
RejectedExecutionException.java,Java,,14,6,43,63
RejectedExecutionHandler.java,Java,,4,3,27,34
RunnableFuture.java,Java,,4,2,20,26
RunnableScheduledFuture.java,Java,,4,3,23,30
ScheduledExecutorService.java,Java,,17,7,136,160
ScheduledFuture.java,Java,,3,2,15,20
ScheduledThreadPoolExecutor.java,Java,,302,54,295,651
Semaphore.java,Java,,144,36,502,682
SynchronousQueue.java,Java,,519,92,516,1127
ThreadFactory.java,Java,,4,3,35,42
ThreadPoolExecutor.java,Java,,609,107,1107,1823
TimeoutException.java,Java,,8,4,27,39
TimeUnit.java,Java,,141,19,172,332
ConcurrentModificationException.java,Java,,8,3,58,69
Currency.java,Java,,182,35,176,393
CurrencyData.java,Java,,37,12,0,49
Date.java,Java,,533,59,722,1314
Deque.java,Java,,30,35,483,548
Dictionary.java,Java,,13,9,116,138
DuplicateFormatFlagsException.java,Java,,16,7,28,51
EmptyStackException.java,Java,,6,2,19,27
Enumeration.java,Java,,5,3,54,62
EnumMap.java,Java,,386,75,259,720
EnumSet.java,Java,,139,31,249,419
EventListener.java,Java,,3,2,10,15
EventListenerProxy.java,Java,,10,4,39,53
EventObject.java,Java,,16,9,35,60
FormatFlagsConversionMismatchException.java,Java,,23,8,36,67
Formattable.java,Java,,5,4,138,147
FormattableFlags.java,Java,,7,6,45,58
Formatter.java,Java,,1730,248,2417,4395
FormatterClosedException.java,Java,,5,4,19,28
GregorianCalendar.java,Java,,1522,185,1192,2899
HashMap.java,Java,,512,100,426,1038
HashSet.java,Java,,78,26,191,295
Hashtable.java,Java,,547,114,450,1111
IdentityHashMap.java,Java,,588,100,527,1215
IllegalFormatCodePointException.java,Java,,14,7,31,52
IllegalFormatConversionException.java,Java,,21,8,38,67
IllegalFormatException.java,Java,,5,4,16,25
IllegalFormatFlagsException.java,Java,,16,7,27,50
IllegalFormatPrecisionException.java,Java,,14,7,25,46
IllegalFormatWidthException.java,Java,,14,7,24,45
InputMismatchException.java,Java,,10,3,27,40
InvalidPropertiesFormatException.java,Java,,22,8,43,73
Iterator.java,Java,,6,4,56,66
JapaneseImperialCalendar.java,Java,,1574,163,628,2365
Attributes.java,Java,,264,62,320,646
JarEntry.java,Java,,32,9,69,110
JarException.java,Java,,9,3,21,33
JarFile.java,Java,,464,54,195,713
JarInputStream.java,Java,,104,17,100,221
JarOutputStream.java,Java,,60,10,62,132
JarVerifier.java,Java,,594,111,149,854
JavaUtilJarAccessImpl.java,Java,,32,9,6,47
Manifest.java,Java,,263,34,131,428
Pack200.java,Java,,91,55,589,735
JumboEnumSet.java,Java,,182,47,123,352
LinkedHashMap.java,Java,,152,38,284,474
LinkedHashSet.java,Java,,19,8,127,154
LinkedList.java,Java,,417,87,462,966
List.java,Java,,28,41,500,569
ListIterator.java,Java,,12,13,156,181
ListResourceBundle.java,Java,,46,13,127,186
Locale.java,Java,,435,109,581,1125
LocaleISOData.java,Java,,447,4,10,461
ConsoleHandler.java,Java,,33,10,58,101
ErrorManager.java,Java,,24,7,50,81
FileHandler.java,Java,,323,37,247,607
Filter.java,Java,,4,6,23,33
Formatter.java,Java,,36,15,91,142
Handler.java,Java,,94,22,169,285
Level.java,Java,,215,54,273,542
Logger.java,Java,,575,109,866,1550
Logging.java,Java,,60,17,25,102
LoggingMXBean.java,Java,,7,6,101,114
LoggingPermission.java,Java,,14,7,40,61
LogManager.java,Java,,727,107,537,1371
LogRecord.java,Java,,190,47,273,510
MemoryHandler.java,Java,,102,16,133,251
SimpleFormatter.java,Java,,50,9,21,80
SocketHandler.java,Java,,74,15,85,174
StreamHandler.java,Java,,123,18,128,269
XMLFormatter.java,Java,,166,27,53,246
Map.java,Java,,24,27,401,452
MissingFormatArgumentException.java,Java,,16,7,30,53
MissingFormatWidthException.java,Java,,16,7,28,51
MissingResourceException.java,Java,,23,11,73,107
NavigableMap.java,Java,,25,22,349,396
NavigableSet.java,Java,,19,16,256,291
NoSuchElementException.java,Java,,10,3,28,41
Observable.java,Java,,47,15,134,196
Observer.java,Java,,4,1,25,30
AbstractPreferences.java,Java,,536,105,957,1598
BackingStoreException.java,Java,,11,5,25,41
Base64.java,Java,,145,20,79,244
InvalidPreferencesFormatException.java,Java,,14,6,40,60
NodeChangeEvent.java,Java,,24,11,53,88
NodeChangeListener.java,Java,,5,4,28,37
PreferenceChangeEvent.java,Java,,30,12,66,108
PreferenceChangeListener.java,Java,,4,2,23,29
Preferences.java,Java,,162,57,1019,1238
PreferencesFactory.java,Java,,6,3,31,40
WindowsPreferences.java,Java,,700,67,327,1094
WindowsPreferencesFactory.java,Java,,9,3,22,34
XmlSupport.java,Java,,245,33,126,404
PriorityQueue.java,Java,,304,54,362,720
Properties.java,Java,,474,42,579,1095
PropertyPermission.java,Java,,268,94,289,651
PropertyResourceBundle.java,Java,,32,10,129,171
Queue.java,Java,,9,7,174,190
Random.java,Java,,121,29,381,531
RandomAccess.java,Java,,3,2,45,50
ASCII.java,Java,,205,40,11,256
Matcher.java,Java,,317,70,776,1163
MatchResult.java,Java,,10,10,151,171
Pattern.java,Java,,3320,275,1651,5246
PatternSyntaxException.java,Java,,42,13,51,106
RegularEnumSet.java,Java,,133,38,113,284
ResourceBundle.java,Java,,838,135,1650,2623
Scanner.java,Java,,1079,164,1349,2592
ServiceConfigurationError.java,Java,,12,8,50,70
ServiceLoader.java,Java,,204,35,289,528
Set.java,Java,,18,25,314,357
SimpleTimeZone.java,Java,,629,109,940,1678
SortedMap.java,Java,,12,11,243,266
SortedSet.java,Java,,9,8,188,205
CurrencyNameProvider.java,Java,,8,5,43,56
LocaleNameProvider.java,Java,,9,7,78,94
LocaleServiceProvider.java,Java,,7,5,103,115
TimeZoneNameProvider.java,Java,,7,5,51,63
Stack.java,Java,,34,13,77,124
StringTokenizer.java,Java,,153,27,234,414
Timer.java,Java,,228,48,401,677
TimerTask.java,Java,,27,14,100,141
TimeZone.java,Java,,350,60,413,823
TooManyListenersException.java,Java,,9,8,37,54
TreeMap.java,Java,,1455,255,710,2420
TreeSet.java,Java,,147,47,328,522
UnknownFormatConversionException.java,Java,,16,7,28,51
UnknownFormatFlagsException.java,Java,,16,7,28,51
UUID.java,Java,,175,41,270,486
Vector.java,Java,,319,71,624,1014
WeakHashMap.java,Java,,470,99,381,950
XMLUtils.java,Java,,153,17,17,187
Adler32.java,Java,,31,10,35,76
CheckedInputStream.java,Java,,42,8,49,99
CheckedOutputStream.java,Java,,23,7,37,67
Checksum.java,Java,,8,5,30,43
CRC32.java,Java,,30,10,33,73
DataFormatException.java,Java,,10,3,20,33
Deflater.java,Java,,179,36,225,440
DeflaterInputStream.java,Java,,117,30,130,277
DeflaterOutputStream.java,Java,,73,16,69,158
GZIPInputStream.java,Java,,146,28,98,272
GZIPOutputStream.java,Java,,70,15,67,152
Inflater.java,Java,,151,26,201,378
InflaterInputStream.java,Java,,121,23,127,271
InflaterOutputStream.java,Java,,120,29,110,259
ZipConstants.java,Java,,43,7,31,81
ZipEntry.java,Java,,147,33,153,333
ZipError.java,Java,,7,3,17,27
ZipException.java,Java,,11,6,24,41
ZipFile.java,Java,,312,59,154,525
ZipInputStream.java,Java,,324,27,124,475
ZipOutputStream.java,Java,,362,28,125,515
ZStreamRef.java,Java,,13,6,9,28
Accessible.java,Java,,4,3,26,33
AccessibleAction.java,Java,,14,11,71,96
AccessibleAttributeSequence.java,Java,,12,9,41,62
AccessibleBundle.java,Java,,56,19,63,138
AccessibleComponent.java,Java,,32,30,236,298
AccessibleContext.java,Java,,130,55,547,732
AccessibleEditableText.java,Java,,15,14,87,116
AccessibleExtendedComponent.java,Java,,6,5,46,57
AccessibleExtendedTable.java,Java,,6,5,47,58
AccessibleExtendedText.java,Java,,13,13,101,127
AccessibleHyperlink.java,Java,,14,13,96,123
AccessibleHypertext.java,Java,,9,8,46,63
AccessibleIcon.java,Java,,7,7,51,65
AccessibleKeyBinding.java,Java,,5,4,56,65
AccessibleRelation.java,Java,,65,35,252,352
AccessibleRelationSet.java,Java,,115,16,95,226
AccessibleResourceBundle.java,Java,,89,4,41,134
AccessibleRole.java,Java,,135,85,425,645
AccessibleSelection.java,Java,,10,9,78,97
AccessibleState.java,Java,,68,35,255,358
AccessibleStateSet.java,Java,,86,14,82,182
AccessibleStreamable.java,Java,,7,4,37,48
AccessibleTable.java,Java,,25,26,152,203
AccessibleTableModelChange.java,Java,,11,10,63,84
AccessibleText.java,Java,,20,19,132,171
AccessibleTextSequence.java,Java,,11,8,41,60
AccessibleValue.java,Java,,7,7,61,75
Generated.java,Java,,13,6,29,48
PostConstruct.java,Java,,9,3,27,39
PreDestroy.java,Java,,9,4,26,39
AbstractProcessor.java,Java,,72,14,92,178
Completion.java,Java,,5,4,25,34
Completions.java,Java,,31,11,30,72
Filer.java,Java,,18,6,220,244
FilerException.java,Java,,9,3,24,36
Messager.java,Java,,14,6,64,84
package-info.java,Java,,1,1,24,26
ProcessingEnvironment.java,Java,,17,9,93,119
Processor.java,Java,,16,9,368,393
RoundEnvironment.java,Java,,12,7,77,96
SupportedAnnotationTypes.java,Java,,10,3,21,34
SupportedOptions.java,Java,,10,3,20,33
SupportedSourceVersion.java,Java,,11,4,19,34
Resource.java,Java,,18,9,73,100
Resources.java,Java,,10,3,10,23
IIOReadProgressListener.java,Java,,16,12,126,154
IIOReadUpdateListener.java,Java,,34,9,189,232
IIOReadWarningListener.java,Java,,6,4,31,41
IIOWriteProgressListener.java,Java,,14,10,99,123
IIOWriteWarningListener.java,Java,,8,4,33,45
IIOException.java,Java,,11,5,40,56
IIOImage.java,Java,,88,20,197,305
IIOParam.java,Java,,152,38,469,659
IIOParamController.java,Java,,4,3,94,101
ImageIO.java,Java,,804,134,633,1571
ImageReader.java,Java,,850,147,1884,2881
ImageReadParam.java,Java,,98,24,369,491
ImageTranscoder.java,Java,,9,5,121,135
ImageTypeSpecifier.java,Java,,722,100,402,1224
ImageWriteParam.java,Java,,398,59,1000,1457
ImageWriter.java,Java,,441,92,1487,2020
IIOInvalidTreeException.java,Java,,18,7,55,80
IIOMetadata.java,Java,,222,44,617,883
IIOMetadataController.java,Java,,4,3,62,69
IIOMetadataFormat.java,Java,,59,57,702,818
IIOMetadataFormatImpl.java,Java,,621,118,514,1253
IIOMetadataNode.java,Java,,545,158,307,1010
BMPImageWriteParam.java,Java,,23,11,64,98
JPEGHuffmanTable.java,Java,,156,27,102,285
JPEGImageReadParam.java,Java,,48,11,123,182
JPEGImageWriteParam.java,Java,,105,17,181,303
JPEGQTable.java,Java,,81,19,105,205
DigraphNode.java,Java,,62,20,62,144
IIORegistry.java,Java,,111,14,109,234
IIOServiceProvider.java,Java,,32,12,111,155
ImageInputStreamSpi.java,Java,,32,11,141,184
ImageOutputStreamSpi.java,Java,,33,11,139,183
ImageReaderSpi.java,Java,,78,18,297,393
ImageReaderWriterSpi.java,Java,,181,35,368,584
ImageTranscoderSpi.java,Java,,13,8,57,78
ImageWriterSpi.java,Java,,86,20,314,420
PartiallyOrderedSet.java,Java,,97,31,69,197
RegisterableService.java,Java,,5,4,38,47
ServiceRegistry.java,Java,,324,59,435,818
FileCacheImageInputStream.java,Java,,143,35,96,274
FileCacheImageOutputStream.java,Java,,127,29,86,242
FileImageInputStream.java,Java,,73,15,60,148
FileImageOutputStream.java,Java,,83,17,56,156
IIOByteBuffer.java,Java,,29,12,85,126
ImageInputStream.java,Java,,53,48,883,984
ImageInputStreamImpl.java,Java,,548,109,209,866
ImageOutputStream.java,Java,,29,26,592,647
ImageOutputStreamImpl.java,Java,,386,53,55,494
MemoryCache.java,Java,,185,37,124,346
MemoryCacheImageInputStream.java,Java,,93,26,68,187
MemoryCacheImageOutputStream.java,Java,,88,24,67,179
AnnotationMirror.java,Java,,7,5,45,57
AnnotationValue.java,Java,,8,7,45,60
AnnotationValueVisitor.java,Java,,21,21,143,185
Element.java,Java,,22,17,202,241
ElementKind.java,Java,,28,12,66,106
ElementVisitor.java,Java,,12,10,96,118
ExecutableElement.java,Java,,12,8,63,83
Modifier.java,Java,,21,9,29,59
Name.java,Java,,6,4,62,72
NestingKind.java,Java,,10,3,69,82
package-info.java,Java,,1,1,67,69
PackageElement.java,Java,,5,6,33,44
TypeElement.java,Java,,11,8,83,102
TypeParameterElement.java,Java,,8,5,35,48
UnknownAnnotationValueException.java,Java,,17,7,44,68
UnknownElementException.java,Java,,17,7,42,66
VariableElement.java,Java,,6,6,38,50
package-info.java,Java,,1,2,40,43
SourceVersion.java,Java,,70,19,128,217
ArrayType.java,Java,,4,4,22,30
DeclaredType.java,Java,,10,9,61,80
ErrorType.java,Java,,4,5,20,29
ExecutableType.java,Java,,9,10,53,72
MirroredTypeException.java,Java,,14,9,30,53
MirroredTypesException.java,Java,,17,10,31,58
NoType.java,Java,,4,5,24,33
NullType.java,Java,,3,4,16,23
package-info.java,Java,,1,1,22,24
PrimitiveType.java,Java,,3,3,17,23
ReferenceType.java,Java,,3,3,17,23
TypeKind.java,Java,,37,23,86,146
TypeMirror.java,Java,,10,8,73,91
TypeVariable.java,Java,,9,8,50,67
TypeVisitor.java,Java,,16,14,118,148
UnknownTypeException.java,Java,,17,7,42,66
WildcardType.java,Java,,5,5,38,48
AbstractAnnotationValueVisitor6.java,Java,,21,9,66,96
AbstractElementVisitor6.java,Java,,20,8,77,105
AbstractTypeVisitor6.java,Java,,14,6,74,94
ElementFilter.java,Java,,89,20,88,197
ElementKindVisitor6.java,Java,,115,38,214,367
Elements.java,Java,,23,21,175,219
ElementScanner6.java,Java,,43,14,130,187
package-info.java,Java,,1,1,24,26
SimpleAnnotationValueVisitor6.java,Java,,62,22,159,243
SimpleElementVisitor6.java,Java,,34,11,107,152
SimpleTypeVisitor6.java,Java,,45,16,131,192
TypeKindVisitor6.java,Java,,86,30,167,283
Types.java,Java,,27,22,235,284
AndQueryExp.java,Java,,25,16,49,90
Attribute.java,Java,,41,22,54,117
AttributeChangeNotification.java,Java,,29,22,79,130
AttributeChangeNotificationFilter.java,Java,,35,18,57,110
AttributeList.java,Java,,138,27,170,335
AttributeNotFoundException.java,Java,,10,7,20,37
AttributeValueExp.java,Java,,41,20,69,130
BadAttributeValueExpException.java,Java,,11,10,26,47
BadBinaryOpValueExpException.java,Java,,14,12,31,57
BadStringOperationException.java,Java,,11,9,25,45
BetweenQueryExp.java,Java,,60,20,54,134
BinaryOpValueExp.java,Java,,94,25,54,173
BinaryRelQueryExp.java,Java,,120,27,54,201
BooleanValueExp.java,Java,,21,13,35,69
ClassAttributeValueExp.java,Java,,48,14,62,124
DefaultLoaderRepository.java,Java,,14,6,53,73
Descriptor.java,Java,,27,20,429,476
DescriptorAccess.java,Java,,5,4,45,54
DescriptorKey.java,Java,,8,4,143,155
DescriptorRead.java,Java,,4,2,17,23
DynamicMBean.java,Java,,12,12,80,104
ImmutableDescriptor.java,Java,,315,35,199,549
InQueryExp.java,Java,,53,21,48,122
InstanceAlreadyExistsException.java,Java,,10,7,20,37
InstanceNotFoundException.java,Java,,10,6,20,36
InstanceOfQueryExp.java,Java,,37,13,53,103
IntrospectionException.java,Java,,10,6,20,36
InvalidApplicationException.java,Java,,8,8,24,40
InvalidAttributeValueException.java,Java,,10,6,20,36
JMException.java,Java,,10,7,21,38
JMRuntimeException.java,Java,,20,8,33,61
JMX.java,Java,,68,18,291,377
ListenerNotFoundException.java,Java,,10,7,20,37
ClassLoaderRepository.java,Java,,12,7,116,135
DefaultLoaderRepository.java,Java,,55,20,61,136
MLet.java,Java,,633,104,601,1338
MLetContent.java,Java,,75,28,118,221
MLetMBean.java,Java,,21,18,129,168
MLetObjectInputStream.java,Java,,60,21,22,103
MLetParser.java,Java,,208,34,70,312
PrivateClassLoader.java,Java,,4,3,16,23
PrivateMLet.java,Java,,18,6,58,82
MalformedObjectNameException.java,Java,,10,10,20,40
MatchQueryExp.java,Java,,94,19,55,168
MBeanAttributeInfo.java,Java,,163,32,139,334
MBeanConstructorInfo.java,Java,,87,19,94,200
MBeanException.java,Java,,19,12,40,71
MBeanFeatureInfo.java,Java,,84,31,135,250
MBeanInfo.java,Java,,289,71,339,699
MBeanNotificationInfo.java,Java,,72,20,96,188
MBeanOperationInfo.java,Java,,131,31,149,311
MBeanParameterInfo.java,Java,,51,16,63,130
MBeanPermission.java,Java,,666,95,381,1142
MBeanRegistration.java,Java,,8,9,57,74
MBeanRegistrationException.java,Java,,10,6,27,43
MBeanServer.java,Java,,115,46,525,686
MBeanServerBuilder.java,Java,,15,5,76,96
MBeanServerConnection.java,Java,,97,42,704,843
MBeanServerDelegate.java,Java,,114,25,86,225
MBeanServerDelegateMBean.java,Java,,10,11,49,70
MBeanServerFactory.java,Java,,172,37,327,536
MBeanServerInvocationHandler.java,Java,,239,46,192,477
MBeanServerNotification.java,Java,,14,13,48,75
MBeanServerPermission.java,Java,,165,43,146,354
MBeanTrustPermission.java,Java,,19,7,46,72
DescriptorSupport.java,Java,,764,143,417,1324
InvalidTargetObjectTypeException.java,Java,,88,21,89,198
ModelMBean.java,Java,,14,10,94,118
ModelMBeanAttributeInfo.java,Java,,276,46,228,550
ModelMBeanConstructorInfo.java,Java,,298,44,208,550
ModelMBeanInfo.java,Java,,34,33,272,339
ModelMBeanInfoSupport.java,Java,,703,110,267,1080
ModelMBeanNotificationBroadcaster.java,Java,,21,18,145,184
ModelMBeanNotificationInfo.java,Java,,192,42,206,440
ModelMBeanOperationInfo.java,Java,,311,48,219,578
RequiredModelMBean.java,Java,,1615,343,824,2782
XMLParseException.java,Java,,66,15,77,158
CounterMonitor.java,Java,,471,87,417,975
CounterMonitorMBean.java,Java,,25,21,159,205
GaugeMonitor.java,Java,,437,75,368,880
GaugeMonitorMBean.java,Java,,19,17,112,148
Monitor.java,Java,,948,169,593,1710
MonitorMBean.java,Java,,19,17,109,145
MonitorNotification.java,Java,,39,34,170,243
MonitorSettingException.java,Java,,10,6,26,42
StringMonitor.java,Java,,205,46,205,456
StringMonitorMBean.java,Java,,16,14,94,124
MXBean.java,Java,,31,5,1124,1160
NotCompliantMBeanException.java,Java,,10,8,20,38
Notification.java,Java,,138,32,209,379
NotificationBroadcaster.java,Java,,11,7,91,109
NotificationBroadcasterSupport.java,Java,,142,37,158,337
NotificationEmitter.java,Java,,8,3,70,81
NotificationFilter.java,Java,,4,4,18,26
NotificationFilterSupport.java,Java,,42,17,89,148
NotificationListener.java,Java,,5,7,23,35
NotQueryExp.java,Java,,20,14,41,75
NumericValueExp.java,Java,,128,19,81,228
ObjectInstance.java,Java,,45,17,74,136
ObjectName.java,Java,,920,178,1043,2141
ArrayType.java,Java,,347,72,592,1011
CompositeData.java,Java,,14,18,128,160
CompositeDataInvocationHandler.java,Java,,77,11,139,227
CompositeDataSupport.java,Java,,179,54,226,459
CompositeDataView.java,Java,,4,2,104,110
CompositeType.java,Java,,163,53,250,466
InvalidKeyException.java,Java,,10,6,24,40
InvalidOpenTypeException.java,Java,,10,6,22,38
KeyAlreadyExistsException.java,Java,,10,6,24,40
OpenDataException.java,Java,,11,7,26,44
OpenMBeanAttributeInfo.java,Java,,9,21,93,123
OpenMBeanAttributeInfoSupport.java,Java,,537,95,454,1086
OpenMBeanConstructorInfo.java,Java,,10,18,94,122
OpenMBeanConstructorInfoSupport.java,Java,,84,32,173,289
OpenMBeanInfo.java,Java,,16,22,135,173
OpenMBeanInfoSupport.java,Java,,127,42,229,398
OpenMBeanOperationInfo.java,Java,,14,23,130,167
OpenMBeanOperationInfoSupport.java,Java,,136,47,228,411
OpenMBeanParameterInfo.java,Java,,20,29,148,197
OpenMBeanParameterInfoSupport.java,Java,,146,68,391,605
OpenType.java,Java,,175,41,188,404
SimpleType.java,Java,,89,49,168,306
TabularData.java,Java,,21,52,217,290
TabularDataSupport.java,Java,,234,139,516,889
TabularType.java,Java,,130,51,189,370
OperationsException.java,Java,,10,8,21,39
OrQueryExp.java,Java,,26,15,47,88
PersistentMBean.java,Java,,10,9,70,89
QualifiedAttributeValueExp.java,Java,,35,16,47,98
Query.java,Java,,113,47,465,625
QueryEval.java,Java,,14,10,42,66
QueryExp.java,Java,,7,8,37,52
ReflectionException.java,Java,,19,11,39,69
InvalidRelationIdException.java,Java,,10,5,21,36
InvalidRelationServiceException.java,Java,,10,5,20,35
InvalidRelationTypeException.java,Java,,10,5,24,39
InvalidRoleInfoException.java,Java,,10,5,21,36
InvalidRoleValueException.java,Java,,10,5,26,41
MBeanServerNotificationFilter.java,Java,,233,67,192,492
Relation.java,Java,,45,16,187,248
RelationException.java,Java,,11,6,21,38
RelationNotFoundException.java,Java,,10,5,21,36
RelationNotification.java,Java,,297,49,261,607
RelationService.java,Java,,2056,507,1414,3977
RelationServiceMBean.java,Java,,143,41,596,780
RelationServiceNotRegisteredException.java,Java,,10,5,21,36
RelationSupport.java,Java,,816,218,776,1810
RelationSupportMBean.java,Java,,7,4,47,58
RelationType.java,Java,,11,8,38,57
RelationTypeNotFoundException.java,Java,,10,5,21,36
RelationTypeSupport.java,Java,,246,73,196,515
Role.java,Java,,151,35,133,319
RoleInfo.java,Java,,296,52,245,593
RoleInfoNotFoundException.java,Java,,10,5,21,36
RoleList.java,Java,,147,37,170,354
RoleNotFoundException.java,Java,,10,5,21,36
RoleResult.java,Java,,118,25,100,243
RoleStatus.java,Java,,22,5,48,75
RoleUnresolved.java,Java,,163,32,144,339
RoleUnresolvedList.java,Java,,148,37,166,351
JMXAddressable.java,Java,,4,3,27,34
JMXAuthenticator.java,Java,,6,4,43,53
JMXConnectionNotification.java,Java,,39,13,128,180
JMXConnector.java,Java,,33,12,237,282
JMXConnectorFactory.java,Java,,245,49,234,528
JMXConnectorProvider.java,Java,,8,4,44,56
JMXConnectorServer.java,Java,,143,38,218,399
JMXConnectorServerFactory.java,Java,,128,20,190,338
JMXConnectorServerMBean.java,Java,,15,12,151,178
JMXConnectorServerProvider.java,Java,,10,4,51,65
JMXPrincipal.java,Java,,31,15,70,116
JMXProviderException.java,Java,,19,10,38,67
JMXServerErrorException.java,Java,,14,9,31,54
JMXServiceURL.java,Java,...,322,65,293,680
MBeanServerForwarder.java,Java,,6,5,37,48
NotificationResult.java,Java,,37,13,80,130
NoCallStackClassLoader.java,Java,,65,13,133,211
RMIConnection.java,Java,,195,30,849,1074
RMIConnectionImpl.java,Java,,1452,246,102,1800
RMIConnectionImpl_Stub.java,Java,,540,33,31,604
RMIConnector.java,Java,,1705,287,544,2536
RMIConnectorServer.java,Java,,415,93,321,829
RMIIIOPServerImpl.java,Java,,66,16,64,146
RMIJRMPServerImpl.java,Java,,74,18,72,164
RMIServer.java,Java,,8,4,62,74
RMIServerImpl.java,Java,,230,56,226,512
RMIServerImpl_Stub.java,Java,,49,8,6,63
SubjectDelegationPermission.java,Java,,13,7,59,79
TargetedNotification.java,Java,,26,12,78,116
RuntimeErrorException.java,Java,,19,10,37,66
RuntimeMBeanException.java,Java,,19,10,40,69
RuntimeOperationsException.java,Java,,19,11,38,68
ServiceNotFoundException.java,Java,,11,8,21,40
StandardEmitterMBean.java,Java,,71,13,196,280
StandardMBean.java,Java,,532,80,639,1251
StringValueExp.java,Java,,21,13,54,88
Timer.java,Java,,504,173,619,1296
TimerAlarmClockNotification.java,Java,,8,5,21,34
TimerMBean.java,Java,,37,33,292,362
TimerNotification.java,Java,,18,16,66,100
ValueExp.java,Java,,8,5,72,85
AuthenticationException.java,Java,,10,5,43,58
AuthenticationNotSupportedException.java,Java,,10,5,48,63
BinaryRefAddr.java,Java,,50,13,103,166
Binding.java,Java,,40,15,128,183
CannotProceedException.java,Java,,42,21,206,269
CommunicationException.java,Java,,10,4,35,49
CompositeName.java,Java,,125,32,456,613
CompoundName.java,Java,,127,30,451,608
ConfigurationException.java,Java,,10,4,41,55
Context.java,Java,,56,49,977,1082
ContextNotEmptyException.java,Java,,10,4,41,55
Attribute.java,Java,,26,22,275,323
AttributeInUseException.java,Java,,11,5,34,50
AttributeModificationException.java,Java,,26,12,85,123
Attributes.java,Java,,16,15,135,166
BasicAttribute.java,Java,,269,51,219,539
BasicAttributes.java,Java,,169,45,145,359
DirContext.java,Java,,77,35,910,1022
InitialDirContext.java,Java,,181,38,62,281
InvalidAttributeIdentifierException.java,Java,,11,6,32,49
InvalidAttributesException.java,Java,,11,6,38,55
InvalidAttributeValueException.java,Java,,11,6,36,53
InvalidSearchControlsException.java,Java,,11,6,33,50
InvalidSearchFilterException.java,Java,,11,6,33,50
ModificationItem.java,Java,,37,14,66,117
NoSuchAttributeException.java,Java,,11,7,31,49
SchemaViolationException.java,Java,,11,6,43,60
SearchControls.java,Java,,70,26,223,319
SearchResult.java,Java,,34,14,124,172
EventContext.java,Java,,15,12,205,232
EventDirContext.java,Java,,15,6,121,142
NamespaceChangeListener.java,Java,,6,5,63,74
NamingEvent.java,Java,,52,20,211,283
NamingExceptionEvent.java,Java,,19,9,49,77
NamingListener.java,Java,,4,2,42,48
ObjectChangeListener.java,Java,,4,3,49,56
InitialContext.java,Java,,195,50,295,540
InsufficientResourcesException.java,Java,,10,5,40,55
InterruptedNamingException.java,Java,,10,5,44,59
InvalidNameException.java,Java,,10,5,40,55
BasicControl.java,Java,,24,11,65,100
Control.java,Java,,8,7,64,79
ControlFactory.java,Java,,27,13,100,140
ExtendedRequest.java,Java,,8,7,116,131
ExtendedResponse.java,Java,,5,6,71,82
HasControls.java,Java,,5,5,43,53
InitialLdapContext.java,Java,,62,20,110,192
LdapContext.java,Java,,17,11,306,334
LdapName.java,Java,,295,55,424,774
LdapReferralException.java,Java,,22,9,114,145
ManageReferralControl.java,Java,,11,6,32,49
PagedResultsControl.java,Java,,31,14,135,180
PagedResultsResponseControl.java,Java,,28,13,74,115
Rdn.java,Java,,369,71,311,751
Rfc2253Parser.java,Java,,153,33,42,228
SortControl.java,Java,,44,17,143,204
SortKey.java,Java,,24,11,65,100
SortResponseControl.java,Java,,35,16,100,151
StartTlsRequest.java,Java,,74,29,128,231
StartTlsResponse.java,Java,,23,19,146,188
UnsolicitedNotification.java,Java,,6,5,36,47
UnsolicitedNotificationEvent.java,Java,,16,8,43,67
UnsolicitedNotificationListener.java,Java,,5,4,42,51
LimitExceededException.java,Java,,11,7,39,57
LinkException.java,Java,,63,23,201,287
LinkLoopException.java,Java,,10,5,35,50
LinkRef.java,Java,,21,7,71,99
MalformedLinkException.java,Java,,10,6,34,50
Name.java,Java,,22,20,218,260
NameAlreadyBoundException.java,Java,,10,5,41,56
NameClassPair.java,Java,,48,21,212,281
NameImpl.java,Java,,530,81,103,714
NameNotFoundException.java,Java,,10,5,33,48
NameParser.java,Java,,4,3,33,40
NamingEnumeration.java,Java,,7,5,118,130
NamingException.java,Java,,104,24,290,418
NamingSecurityException.java,Java,,10,5,39,54
NoInitialContextException.java,Java,,10,4,44,58
NoPermissionException.java,Java,,10,4,33,47
NotContextException.java,Java,,10,5,41,56
OperationNotSupportedException.java,Java,,10,5,35,50
PartialResultException.java,Java,,10,5,34,49
RefAddr.java,Java,,36,12,86,134
Reference.java,Java,,109,29,240,378
Referenceable.java,Java,,4,2,35,41
ReferralException.java,Java,,18,11,158,187
ServiceUnavailableException.java,Java,,10,5,36,51
SizeLimitExceededException.java,Java,,11,6,35,52
ContinuationContext.java,Java,,181,34,14,229
ContinuationDirContext.java,Java,,244,52,20,316
DirectoryManager.java,Java,,121,30,169,320
DirObjectFactory.java,Java,,10,4,101,115
DirStateFactory.java,Java,,20,10,141,171
InitialContextFactory.java,Java,,7,4,44,55
InitialContextFactoryBuilder.java,Java,,8,3,43,54
NamingManager.java,Java,,302,83,472,857
ObjectFactory.java,Java,,8,5,144,157
ObjectFactoryBuilder.java,Java,,8,3,47,58
Resolver.java,Java,,12,7,60,79
ResolveResult.java,Java,,63,13,108,184
StateFactory.java,Java,,8,2,111,121
StringRefAddr.java,Java,,12,5,52,69
TimeLimitExceededException.java,Java,,11,6,35,52
Attribute.java,Java,,6,6,33,45
AttributeSet.java,Java,,16,19,257,292
AttributeSetUtilities.java,Java,,259,73,228,560
DateTimeSyntax.java,Java,,27,17,84,128
DocAttribute.java,Java,,3,4,23,30
DocAttributeSet.java,Java,,5,6,82,93
EnumSyntax.java,Java,,60,23,180,263
HashAttributeSet.java,Java,,163,37,310,510
HashDocAttributeSet.java,Java,,18,10,56,84
HashPrintJobAttributeSet.java,Java,,18,9,55,82
HashPrintRequestAttributeSet.java,Java,,19,12,55,86
HashPrintServiceAttributeSet.java,Java,,19,10,55,84
IntegerSyntax.java,Java,,30,12,74,116
PrintJobAttribute.java,Java,,3,2,22,27
PrintJobAttributeSet.java,Java,,5,5,81,91
PrintRequestAttribute.java,Java,,3,4,26,33
PrintRequestAttributeSet.java,Java,,5,6,82,93
PrintServiceAttribute.java,Java,,3,2,18,23
PrintServiceAttributeSet.java,Java,,5,7,84,96
ResolutionSyntax.java,Java,,82,29,229,340
SetOfIntegerSyntax.java,Java,,265,41,234,540
Size2DSyntax.java,Java,,85,23,220,328
Chromaticity.java,Java,,31,15,95,141
ColorSupported.java,Java,,29,13,70,112
Compression.java,Java,,34,16,66,116
Copies.java,Java,,21,8,89,118
CopiesSupported.java,Java,,31,10,82,123
DateTimeAtCompleted.java,Java,,22,9,76,107
DateTimeAtCreation.java,Java,,22,8,75,105
DateTimeAtProcessing.java,Java,,22,8,76,106
Destination.java,Java,,23,9,73,105
DocumentName.java,Java,,20,9,74,103
Fidelity.java,Java,,35,13,63,111
Finishings.java,Java,,122,30,307,459
JobHoldUntil.java,Java,,22,10,103,135
JobImpressions.java,Java,,21,9,96,126
JobImpressionsCompleted.java,Java,,21,8,81,110
JobImpressionsSupported.java,Java,,27,10,75,112
JobKOctets.java,Java,,21,8,147,176
JobKOctetsProcessed.java,Java,,21,8,93,122
JobKOctetsSupported.java,Java,,27,8,75,110
JobMediaSheets.java,Java,,21,9,90,120
JobMediaSheetsCompleted.java,Java,,21,8,81,110
JobMediaSheetsSupported.java,Java,,27,8,75,110
JobMessageFromOperator.java,Java,,22,9,80,111
JobName.java,Java,,22,9,76,107
JobOriginatingUserName.java,Java,,22,9,80,111
JobPriority.java,Java,,21,8,80,109
JobPrioritySupported.java,Java,,21,11,74,106
JobSheets.java,Java,,35,14,67,116
JobState.java,Java,,52,22,145,219
JobStateReason.java,Java,,138,41,264,443
JobStateReasons.java,Java,,33,12,118,163
Media.java,Java,,24,8,73,105
MediaName.java,Java,,33,15,47,95
MediaPrintableArea.java,Java,,85,24,208,317
MediaSize.java,Java,,319,35,483,837
MediaSizeName.java,Java,,260,35,252,547
MediaTray.java,Java,,45,20,57,122
MultipleDocumentHandling.java,Java,,44,17,189,250
NumberOfDocuments.java,Java,,21,9,66,96
NumberOfInterveningJobs.java,Java,,21,8,66,95
NumberUp.java,Java,,22,9,143,174
NumberUpSupported.java,Java,,51,11,99,161
OrientationRequested.java,Java,,48,16,106,170
OutputDeviceAssigned.java,Java,,22,11,77,110
PageRanges.java,Java,,60,13,174,247
PagesPerMinute.java,Java,,21,8,67,96
PagesPerMinuteColor.java,Java,,21,8,79,108
PDLOverrideSupported.java,Java,,35,14,61,110
PresentationDirection.java,Java,,60,19,89,168
PrinterInfo.java,Java,,21,9,73,103
PrinterIsAcceptingJobs.java,Java,,35,13,62,110
PrinterLocation.java,Java,,21,9,71,101
PrinterMakeAndModel.java,Java,,22,8,70,100
PrinterMessageFromOperator.java,Java,,22,9,85,116
PrinterMoreInfo.java,Java,,22,9,74,105
PrinterMoreInfoManufacturer.java,Java,,22,9,78,109
PrinterName.java,Java,,21,9,73,103
PrinterResolution.java,Java,,24,8,101,133
PrinterState.java,Java,,43,15,66,124
PrinterStateReason.java,Java,,156,45,225,426
PrinterStateReasons.java,Java,,108,23,160,291
PrinterURI.java,Java,,22,10,66,98
PrintQuality.java,Java,,41,14,62,117
QueuedJobCount.java,Java,,21,8,64,93
ReferenceUriSchemesSupported.java,Java,,51,19,95,165
RequestingUserName.java,Java,,22,9,81,112
Severity.java,Java,,34,15,91,140
SheetCollate.java,Java,,35,13,168,216
Sides.java,Java,,40,17,147,204
SupportedValuesAttribute.java,Java,,3,3,20,26
TextSyntax.java,Java,,42,16,76,134
UnmodifiableSetException.java,Java,,8,3,22,33
URISyntax.java,Java,,31,13,60,104
AttributeException.java,Java,,6,8,34,48
CancelablePrintJob.java,Java,,4,5,50,59
Doc.java,Java,,14,11,165,190
DocFlavor.java,Java,,226,123,1067,1416
DocPrintJob.java,Java,,20,12,127,159
PrintEvent.java,Java,,10,7,19,36
PrintJobAdapter.java,Java,,15,13,59,87
PrintJobAttributeEvent.java,Java,,19,16,29,64
PrintJobAttributeListener.java,Java,,4,4,20,28
PrintJobEvent.java,Java,,22,20,65,107
PrintJobListener.java,Java,,9,15,53,77
PrintServiceAttributeEvent.java,Java,,20,15,32,67
PrintServiceAttributeListener.java,Java,,4,5,21,30
FlavorException.java,Java,,5,5,19,29
MimeType.java,Java,,389,43,197,629
MultiDoc.java,Java,,6,8,104,118
MultiDocPrintJob.java,Java,,6,6,37,49
MultiDocPrintService.java,Java,,7,7,15,29
PrintException.java,Java,,15,8,32,55
PrintService.java,Java,,37,25,408,470
PrintServiceLookup.java,Java,,250,42,174,466
ServiceUI.java,Java,,132,27,159,318
ServiceUIFactory.java,Java,,13,15,96,124
SimpleDoc.java,Java,,76,22,135,233
StreamPrintService.java,Java,,21,12,63,96
StreamPrintServiceFactory.java,Java,,98,26,87,211
URIException.java,Java,,9,10,36,55
ClassDesc.java,Java,,5,4,23,32
GetORBPropertiesFileAction.java,Java,,54,18,18,90
PortableRemoteObjectDelegate.java,Java,,17,9,42,68
Stub.java,Java,,135,44,68,247
StubDelegate.java,Java,,17,10,50,77
Tie.java,Java,,18,9,42,69
Util.java,Java,,171,51,158,380
UtilDelegate.java,Java,,28,20,72,120
ValueHandler.java,Java,,14,9,57,80
ValueHandlerMultiFormat.java,Java,,7,4,41,52
PortableRemoteObject.java,Java,,152,45,85,282
SslRMIClientSocketFactory.java,Java,,67,10,120,197
SslRMIServerSocketFactory.java,Java,,128,23,243,394
AbstractScriptEngine.java,Java,,88,42,164,294
Bindings.java,Java,,9,6,93,108
Compilable.java,Java,,9,5,41,55
CompiledScript.java,Java,,23,13,64,100
Invocable.java,Java,,9,7,78,94
ScriptContext.java,Java,,22,24,143,189
ScriptEngine.java,Java,,27,33,246,306
ScriptEngineFactory.java,Java,,16,18,178,212
ScriptEngineManager.java,Java,,253,32,156,441
ScriptException.java,Java,,55,13,67,135
SimpleBindings.java,Java,,75,19,112,206
SimpleScriptContext.java,Java,,129,42,134,305
AuthPermission.java,Java,,13,5,137,155
Callback.java,Java,,2,3,30,35
CallbackHandler.java,Java,,5,3,128,136
ChoiceCallback.java,Java,,48,15,131,194
ConfirmationCallback.java,Java,,122,37,325,484
LanguageCallback.java,Java,,13,8,41,62
NameCallback.java,Java,,31,11,85,127
PasswordCallback.java,Java,,33,11,83,127
TextInputCallback.java,Java,,31,11,86,128
TextOutputCallback.java,Java,,23,9,58,90
UnsupportedCallbackException.java,Java,,16,7,41,64
Destroyable.java,Java,,5,4,36,45
DestroyFailedException.java,Java,,10,5,28,43
DelegationPermission.java,Java,,133,49,193,375
KerberosKey.java,Java,,112,30,143,285
KerberosPrincipal.java,Java,,103,43,139,285
KerberosTicket.java,Java,,336,85,310,731
KeyImpl.java,Java,,142,37,49,228
ServicePermission.java,Java,,218,92,270,580
AccountException.java,Java,,10,6,25,41
AccountExpiredException.java,Java,,10,5,31,46
AccountLockedException.java,Java,,10,5,29,44
AccountNotFoundException.java,Java,,10,5,28,43
AppConfigurationEntry.java,Java,,50,17,89,156
Configuration.java,Java,,198,37,369,604
ConfigurationSpi.java,Java,,6,5,47,58
CredentialException.java,Java,,10,5,25,40
CredentialExpiredException.java,Java,,10,5,33,48
CredentialNotFoundException.java,Java,,10,5,28,43
FailedLoginException.java,Java,,10,5,28,43
LoginContext.java,Java,,422,88,472,982
LoginException.java,Java,,10,6,25,41
Policy.java,Java,,70,14,214,298
PrivateCredentialPermission.java,Java,,230,80,236,546
Refreshable.java,Java,,5,4,36,45
RefreshFailedException.java,Java,,10,5,28,43
LoginModule.java,Java,,15,8,200,223
Subject.java,Java,,658,133,598,1389
SubjectDomainCombiner.java,Java,,357,69,150,576
X500Principal.java,Java,,140,23,317,480
X500PrivateCredential.java,Java,,41,14,62,117
AuthenticationException.java,Java,,13,5,47,65
AuthorizeCallback.java,Java,,34,14,79,127
RealmCallback.java,Java,,11,6,32,49
RealmChoiceCallback.java,Java,,9,5,30,44
Sasl.java,Java,,179,37,372,588
SaslClient.java,Java,,14,11,182,207
SaslClientFactory.java,Java,,13,4,77,94
SaslException.java,Java,,33,11,67,111
SaslServer.java,Java,,14,11,173,198
SaslServerFactory.java,Java,,12,4,75,91
ControllerEventListener.java,Java,,5,5,37,47
Instrument.java,Java,,12,15,46,73
InvalidMidiDataException.java,Java,,9,8,29,46
MetaEventListener.java,Java,,5,5,23,33
MetaMessage.java,Java,,74,36,106,216
MidiChannel.java,Java,,29,30,461,520
MidiDevice.java,Java,,48,52,262,362
MidiEvent.java,Java,,18,15,46,79
MidiFileFormat.java,Java,,59,35,193,287
MidiMessage.java,Java,,36,20,115,171
MidiSystem.java,Java,,590,158,698,1446
MidiUnavailableException.java,Java,,9,8,29,46
Patch.java,Java,,15,18,62,95
Receiver.java,Java,,5,6,46,57
Sequence.java,Java,,81,51,191,323
Sequencer.java,Java,,68,114,669,851
ShortMessage.java,Java,,129,57,215,401
Soundbank.java,Java,,11,17,88,116
SoundbankResource.java,Java,,21,27,113,161
MidiDeviceProvider.java,Java,,16,11,35,62
MidiFileReader.java,Java,,16,15,94,125
MidiFileWriter.java,Java,,30,18,70,118
SoundbankReader.java,Java,,12,15,40,67
Synthesizer.java,Java,,19,48,309,376
SysexMessage.java,Java,,47,26,113,186
Track.java,Java,,110,30,117,257
Transmitter.java,Java,,6,9,44,59
VoiceStatus.java,Java,,9,16,118,143
AudioFileFormat.java,Java,,106,61,233,400
AudioFormat.java,Java,,183,75,387,645
AudioInputStream.java,Java,,199,81,218,498
AudioPermission.java,Java,,10,11,201,222
AudioSystem.java,Java,,627,203,784,1614
BooleanControl.java,Java,,34,41,101,176
Clip.java,Java,,14,13,179,206
CompoundControl.java,Java,,33,38,53,124
Control.java,Java,,28,29,72,129
DataLine.java,Java,,107,56,317,480
EnumControl.java,Java,,43,51,104,198
FloatControl.java,Java,,87,91,300,478
Line.java,Java,,46,47,250,343
LineEvent.java,Java,,49,44,171,264
LineListener.java,Java,,4,6,42,52
LineUnavailableException.java,Java,,9,9,35,53
Mixer.java,Java,,49,38,249,336
Port.java,Java,,45,45,102,192
ReverbType.java,Java,,48,32,202,282
SourceDataLine.java,Java,,6,10,170,186
AudioFileReader.java,Java,,16,10,94,120
AudioFileWriter.java,Java,,31,22,77,130
FormatConversionProvider.java,Java,,48,34,96,178
MixerProvider.java,Java,,15,11,35,61
TargetDataLine.java,Java,,6,9,160,175
UnsupportedAudioFileException.java,Java,,9,9,33,51
CommonDataSource.java,Java,,9,8,78,95
ConnectionEvent.java,Java,,14,15,53,82
ConnectionEventListener.java,Java,,5,11,47,63
ConnectionPoolDataSource.java,Java,,7,12,41,60
DataSource.java,Java,,9,12,65,86
PooledConnection.java,Java,,11,11,138,160
BaseRowSet.java,Java,,756,285,3454,4495
CachedRowSet.java,Java,,52,52,1501,1605
FilteredRowSet.java,Java,,10,7,126,143
JdbcRowSet.java,Java,,17,17,236,270
Joinable.java,Java,,14,13,246,273
JoinRowSet.java,Java,,34,29,457,520
Predicate.java,Java,,8,8,130,146
RowSetMetaDataImpl.java,Java,,320,96,661,1077
RowSetWarning.java,Java,,24,11,93,128
SerialArray.java,Java,,145,42,330,517
SerialBlob.java,Java,,130,41,267,438
SerialClob.java,Java,,165,49,281,495
SerialDatalink.java,Java,,25,13,53,91
SerialException.java,Java,,10,6,23,39
SerialJavaObject.java,Java,,60,21,77,158
SerialRef.java,Java,,58,22,77,157
SerialStruct.java,Java,,70,28,138,236
SQLInputImpl.java,Java,,279,68,465,812
SQLOutputImpl.java,Java,,166,56,383,605
SyncFactory.java,Java,,343,118,455,916
SyncFactoryException.java,Java,,10,8,25,43
SyncProvider.java,Java,,28,26,358,412
SyncProviderException.java,Java,,40,13,95,148
SyncResolver.java,Java,,16,15,323,354
TransactionalWriter.java,Java,,11,7,47,65
XmlReader.java,Java,,9,6,41,56
XmlWriter.java,Java,,9,8,39,56
WebRowSet.java,Java,,18,12,451,481
RowSet.java,Java,,166,141,1870,2177
RowSetEvent.java,Java,,6,9,33,48
RowSetInternal.java,Java,,9,15,66,90
RowSetListener.java,Java,,6,6,47,59
RowSetMetaData.java,Java,,21,27,174,222
RowSetReader.java,Java,,5,6,44,55
RowSetWriter.java,Java,,5,6,35,46
StatementEvent.java,Java,,27,13,52,92
StatementEventListener.java,Java,,5,3,53,61
XAConnection.java,Java,,5,13,30,48
XADataSource.java,Java,,7,11,42,60
AbstractAction.java,Java,,150,36,159,345
AbstractButton.java,Java,,1429,232,1417,3078
AbstractCellEditor.java,Java,,51,15,85,151
AbstractListModel.java,Java,,60,19,125,204
AbstractSpinnerModel.java,Java,,33,18,73,124
Action.java,Java,,24,12,336,372
ActionMap.java,Java,,107,22,77,206
ActionPropertyChangeListener.java,Java,,81,16,43,140
AncestorNotifier.java,Java,,148,31,43,222
ArrayTable.java,Java,,219,21,78,318
Autoscroller.java,Java,,84,20,58,162
AbstractBorder.java,Java,,50,12,118,180
BevelBorder.java,Java,,123,38,130,291
Border.java,Java,,11,4,58,73
CompoundBorder.java,Java,,66,16,75,157
EmptyBorder.java,Java,,38,10,54,102
EtchedBorder.java,Java,,65,22,107,194
LineBorder.java,Java,,68,17,77,162
MatteBorder.java,Java,,126,26,96,248
SoftBevelBorder.java,Java,,68,20,67,155
TitledBorder.java,Java,,487,68,209,764
BorderFactory.java,Java,,127,30,348,505
BoundedRangeModel.java,Java,,18,30,203,251
Box.java,Java,,96,27,296,419
BoxLayout.java,Java,,192,43,285,520
BufferStrategyPaintManager.java,Java,,616,60,263,939
ButtonGroup.java,Java,,67,16,90,173
ButtonModel.java,Java,,27,25,173,225
CellEditor.java,Java,,12,10,95,117
CellRendererPane.java,Java,,83,32,97,212
AbstractColorChooserPanel.java,Java,,70,22,130,222
CenterLayout.java,Java,,41,9,12,62
ColorChooserComponentFactory.java,Java,,14,10,23,47
ColorSelectionModel.java,Java,,10,6,40,56
DefaultColorSelectionModel.java,Java,,47,16,75,138
DefaultHSBChooserPanel.java,Java,,555,125,101,781
DefaultPreviewPanel.java,Java,,161,45,22,228
DefaultRGBChooserPanel.java,Java,,157,41,79,277
DefaultSwatchChooserPanel.java,Java,,495,69,68,632
SmartGridLayout.java,Java,,108,49,16,173
SyntheticImage.java,Java,,106,10,33,149
ComboBoxEditor.java,Java,,11,8,20,39
ComboBoxModel.java,Java,,5,4,30,39
ComponentInputMap.java,Java,,43,7,51,101
DebugGraphics.java,Java,,1037,180,236,1453
DebugGraphicsFilter.java,Java,,13,5,11,29
DebugGraphicsInfo.java,Java,,35,9,12,56
DebugGraphicsObserver.java,Java,,19,6,11,36
DefaultBoundedRangeModel.java,Java,,142,50,216,408
DefaultButtonModel.java,Java,,209,62,247,518
DefaultCellEditor.java,Java,,163,42,175,380
DefaultComboBoxModel.java,Java,,98,25,51,174
DefaultDesktopManager.java,Java,,500,114,190,804
DefaultFocusManager.java,Java,,99,26,31,156
DefaultListCellRenderer.java,Java,,139,36,156,331
DefaultListModel.java,Java,,144,42,340,526
DefaultListSelectionModel.java,Java,,373,97,361,831
DefaultRowSorter.java,Java,,678,119,565,1362
DefaultSingleSelectionModel.java,Java,,52,15,94,161
DelegatingDefaultFocusManager.java,Java,,109,9,26,144
DesktopManager.java,Java,,19,11,72,102
DropMode.java,Java,,11,9,66,86
AncestorEvent.java,Java,,25,7,54,86
AncestorListener.java,Java,,10,8,36,54
CaretEvent.java,Java,,9,7,39,55
CaretListener.java,Java,,5,5,18,28
CellEditorListener.java,Java,,7,7,15,29
ChangeEvent.java,Java,,7,4,28,39
ChangeListener.java,Java,,5,5,17,27
DocumentEvent.java,Java,,28,20,118,166
DocumentListener.java,Java,,7,5,49,61
EventListenerList.java,Java,,115,18,140,273
HyperlinkEvent.java,Java,,48,20,103,171
HyperlinkListener.java,Java,,5,5,17,27
InternalFrameAdapter.java,Java,,10,8,45,63
InternalFrameEvent.java,Java,,49,18,108,175
InternalFrameListener.java,Java,,11,9,50,70
ListDataEvent.java,Java,,26,12,68,106
ListDataListener.java,Java,,7,9,37,53
ListSelectionEvent.java,Java,,29,10,68,107
ListSelectionListener.java,Java,,6,8,19,33
MenuDragMouseEvent.java,Java,,34,8,86,128
MenuDragMouseListener.java,Java,,8,5,36,49
MenuEvent.java,Java,,7,4,30,41
MenuKeyEvent.java,Java,,23,7,50,80
MenuKeyListener.java,Java,,7,7,22,36
MenuListener.java,Java,,7,5,27,39
MouseInputAdapter.java,Java,,5,3,17,25
MouseInputListener.java,Java,,5,5,14,24
PopupMenuEvent.java,Java,,7,2,28,37
PopupMenuListener.java,Java,,7,6,22,35
RowSorterEvent.java,Java,,38,10,79,127
RowSorterListener.java,Java,,4,1,20,25
SwingPropertyChangeSupport.java,Java,,34,11,62,107
TableColumnModelEvent.java,Java,,15,10,48,73
TableColumnModelListener.java,Java,,12,9,22,43
TableModelEvent.java,Java,,38,18,105,161
TableModelListener.java,Java,,6,5,18,29
TreeExpansionEvent.java,Java,,12,5,41,58
TreeExpansionListener.java,Java,,7,5,22,34
TreeModelEvent.java,Java,,75,16,206,297
TreeModelListener.java,Java,,8,8,65,81
TreeSelectionEvent.java,Java,,71,14,86,171
TreeSelectionListener.java,Java,,6,3,24,33
TreeWillExpandListener.java,Java,,7,5,22,34
UndoableEditEvent.java,Java,,12,5,33,50
UndoableEditListener.java,Java,,5,5,16,26
FileFilter.java,Java,,6,4,35,45
FileNameExtensionFilter.java,Java,,56,8,77,141
FileSystemView.java,Java,,424,110,259,793
FileView.java,Java,,20,8,66,94
FocusManager.java,Java,,38,10,87,135
GraphicsWrapper.java,Java,,10,8,12,30
GrayFilter.java,Java,,31,9,37,77
GroupLayout.java,Java,,2064,295,1291,3650
Icon.java,Java,,9,6,26,41
ImageIcon.java,Java,,280,66,332,678
InputMap.java,Java,,116,25,73,214
InputVerifier.java,Java,,8,11,98,117
InternalFrameFocusTraversalPolicy.java,Java,,10,4,37,51
JApplet.java,Java,,157,47,350,554
JButton.java,Java,,85,30,190,305
JCheckBox.java,Java,,93,36,205,334
JCheckBoxMenuItem.java,Java,,83,25,182,290
JColorChooser.java,Java,,305,93,345,743
JComboBox.java,Java,,861,195,1336,2392
JComponent.java,Java,,2352,431,2698,5481
JDesktopPane.java,Java,,300,56,264,620
JDialog.java,Java,,297,70,872,1239
JEditorPane.java,Java,,1262,181,1051,2494
JFileChooser.java,Java,,727,175,1040,1942
JFormattedTextField.java,Java,,414,88,668,1170
JFrame.java,Java,,261,62,595,918
JInternalFrame.java,Java,,891,186,1324,2401
JLabel.java,Java,,702,130,784,1616
JLayeredPane.java,Java,,311,68,389,768
JList.java,Java,,1581,338,1748,3667
JMenu.java,Java,,719,147,744,1610
JMenuBar.java,Java,,322,76,350,748
JMenuItem.java,Java,,420,84,429,933
JOptionPane.java,Java,,914,164,1500,2578
JPanel.java,Java,,63,23,146,232
JPasswordField.java,Java,,208,44,396,648
JPopupMenu.java,Java,,695,152,652,1499
JProgressBar.java,Java,,305,91,714,1110
JRadioButton.java,Java,,71,32,181,284
JRadioButtonMenuItem.java,Java,,72,22,170,264
JRootPane.java,Java,,353,85,647,1085
JScrollBar.java,Java,,306,111,486,903
JScrollPane.java,Java,,528,149,855,1532
JSeparator.java,Java,,86,25,166,277
JSlider.java,Java,,502,167,817,1486
JSpinner.java,Java,,787,207,1034,2028
JSplitPane.java,Java,,407,166,663,1236
JTabbedPane.java,Java,,999,248,1141,2388
JTable.java,Java,,4460,839,4292,9591
JTextArea.java,Java,,301,54,458,813
JTextField.java,Java,,329,69,547,945
JTextPane.java,Java,,177,35,294,506
JToggleButton.java,Java,,147,49,212,408
JToolBar.java,Java,[WDW - need to add orientation from BoxLayout,375,83,394,852
JToolTip.java,Java,,80,30,157,267
JTree.java,Java,,2561,481,2274,5316
JViewport.java,Java,,790,189,802,1781
JWindow.java,Java,,170,44,439,653
KeyboardManager.java,Java,,215,49,88,352
KeyStroke.java,Java,,61,11,219,291
LayoutComparator.java,Java,,92,24,27,143
LayoutFocusTraversalPolicy.java,Java,,107,11,138,256
LayoutStyle.java,Java,,40,11,149,200
LegacyGlueFocusTraversalPolicy.java,Java,,147,15,21,183
ListCellRenderer.java,Java,,11,4,80,95
ListModel.java,Java,,9,7,37,53
ListSelectionModel.java,Java,,28,36,232,296
LookAndFeel.java,Java,,153,46,512,711
MenuElement.java,Java,,10,10,47,67
MenuSelectionManager.java,Java,,321,54,110,485
MultiUIDefaults.java,Java,,176,28,11,215
MutableComboBoxModel.java,Java,,7,8,41,56
OverlayLayout.java,Java,,119,27,124,270
ActionMapUIResource.java,Java,,6,4,14,24
BasicArrowButton.java,Java,,155,32,106,293
BasicBorders.java,Java,,460,86,66,612
BasicButtonListener.java,Java,,224,37,40,301
BasicButtonUI.java,Java,,298,68,88,454
BasicCheckBoxMenuItemUI.java,Java,,32,15,14,61
BasicCheckBoxUI.java,Java,,24,11,24,59
BasicColorChooserUI.java,Java,,244,52,31,327
BasicComboBoxEditor.java,Java,,79,22,49,150
BasicComboBoxRenderer.java,Java,,61,20,48,129
BasicComboBoxUI.java,Java,,1173,228,554,1955
BasicComboPopup.java,Java,,647,141,490,1278
BasicDesktopIconUI.java,Java,,197,48,40,285
BasicDesktopPaneUI.java,Java,,529,60,107,696
BasicDirectoryModel.java,Java,,316,60,102,478
BasicEditorPaneUI.java,Java,,282,30,86,398
BasicFileChooserUI.java,Java,,971,188,160,1319
BasicFormattedTextFieldUI.java,Java,,11,3,26,40
BasicGraphicsUtils.java,Java,,190,54,53,297
BasicHTML.java,Java,,275,55,297,627
BasicIconFactory.java,Java,,151,33,22,206
BasicInternalFrameTitlePane.java,Java,,569,104,99,772
BasicInternalFrameUI.java,Java,,1084,201,172,1457
BasicLabelUI.java,Java,,334,49,82,465
BasicListUI.java,Java,,1864,318,686,2868
BasicLookAndFeel.java,Java,,1689,171,414,2274
BasicMenuBarUI.java,Java,,162,39,22,223
BasicMenuItemUI.java,Java,,678,93,171,942
BasicMenuUI.java,Java,,414,76,124,614
BasicOptionPaneUI.java,Java,,1015,172,254,1441
BasicPanelUI.java,Java,,54,13,29,96
BasicPasswordFieldUI.java,Java,,36,16,44,96
BasicPopupMenuSeparatorUI.java,Java,,27,9,13,49
BasicPopupMenuUI.java,Java,,907,132,115,1154
BasicProgressBarUI.java,Java,,686,135,438,1259
BasicRadioButtonMenuItemUI.java,Java,,33,13,13,59
BasicRadioButtonUI.java,Java,,160,40,44,244
BasicRootPaneUI.java,Java,,173,33,25,231
BasicScrollBarUI.java,Java,,1083,216,286,1585
BasicScrollPaneUI.java,Java,,820,132,206,1158
BasicSeparatorUI.java,Java,,69,22,14,105
BasicSliderUI.java,Java,,1465,271,231,1967
BasicSpinnerUI.java,Java,,635,117,300,1052
BasicSplitPaneDivider.java,Java,,636,146,291,1073
BasicSplitPaneUI.java,Java,,1298,281,652,2231
BasicTabbedPaneUI.java,Java,,2934,399,585,3918
BasicTableHeaderUI.java,Java,,674,122,150,946
BasicTableUI.java,Java,,1511,305,359,2175
BasicTextAreaUI.java,Java,,202,37,138,377
BasicTextFieldUI.java,Java,,198,29,176,403
BasicTextPaneUI.java,Java,,25,8,48,81
BasicTextUI.java,Java,,1355,246,1034,2635
BasicToggleButtonUI.java,Java,,99,31,28,158
BasicToolBarSeparatorUI.java,Java,,47,13,14,74
BasicToolBarUI.java,Java,,988,184,255,1427
BasicToolTipUI.java,Java,,167,32,37,236
BasicTransferable.java,Java,,154,31,80,265
BasicTreeUI.java,Java,,3035,607,852,4494
BasicViewportUI.java,Java,,32,11,13,56
CenterLayout.java,Java,,40,11,12,63
ComboPopup.java,Java,,15,11,58,84
DefaultMenuLayout.java,Java,,21,8,16,45
DragRecognitionSupport.java,Java,,95,25,47,167
LazyActionMap.java,Java,,87,17,44,148
BorderUIResource.java,Java,,152,43,33,228
ButtonUI.java,Java,,8,2,12,22
ColorChooserUI.java,Java,,6,6,13,25
ColorUIResource.java,Java,,18,7,24,49
ComboBoxUI.java,Java,,7,6,22,35
ComponentInputMapUIResource.java,Java,,8,4,14,26
ComponentUI.java,Java,,64,19,260,343
DesktopIconUI.java,Java,,3,4,12,19
DesktopPaneUI.java,Java,,3,4,12,19
DimensionUIResource.java,Java,,9,4,26,39
FileChooserUI.java,Java,,14,7,12,33
FontUIResource.java,Java,,12,5,25,42
IconUIResource.java,Java,,25,8,33,66
InputMapUIResource.java,Java,,6,4,14,24
InsetsUIResource.java,Java,,9,4,25,38
InternalFrameUI.java,Java,,3,3,12,18
LabelUI.java,Java,,3,2,12,17
ListUI.java,Java,,10,9,48,67
MenuBarUI.java,Java,,5,5,13,23
MenuItemUI.java,Java,,5,3,14,22
DefaultMetalTheme.java,Java,,178,40,198,416
MetalBorders.java,Java,,760,167,93,1020
MetalBumps.java,Java,,168,32,29,229
MetalButtonUI.java,Java,,112,23,55,190
MetalCheckBoxIcon.java,Java,,55,14,21,90
MetalCheckBoxUI.java,Java,,37,15,31,83
MetalComboBoxButton.java,Java,,147,31,29,207
MetalComboBoxEditor.java,Java,,67,14,46,127
MetalComboBoxIcon.java,Java,,24,11,22,57
MetalComboBoxUI.java,Java,,229,39,102,370
MetalDesktopIconUI.java,Java,,87,21,19,127
MetalFileChooserUI.java,Java,,935,200,145,1280
MetalFontDesktopProperty.java,Java,,33,8,39,80
MetalHighContrastTheme.java,Java,,121,33,18,172
MetalIconFactory.java,Java,,1974,372,304,2650
MetalInternalFrameTitlePane.java,Java,,404,69,61,534
MetalInternalFrameUI.java,Java,,176,37,26,239
MetalLabelUI.java,Java,,32,12,27,71
MetalLookAndFeel.java,Java,,1493,196,818,2507
MetalMenuBarUI.java,Java,,48,6,48,102
MetalPopupMenuSeparatorUI.java,Java,,29,13,13,55
MetalProgressBarUI.java,Java,,96,25,52,173
MetalRadioButtonUI.java,Java,,135,34,40,209
MetalRootPaneUI.java,Java,,594,93,285,972
MetalScrollBarUI.java,Java,,355,151,35,541
MetalScrollButton.java,Java,,228,57,45,330
MetalScrollPaneUI.java,Java,,87,19,31,137
MetalSeparatorUI.java,Java,,45,15,22,82
MetalSliderUI.java,Java,,390,66,60,516
MetalSplitPaneDivider.java,Java,,269,41,89,399
MetalSplitPaneUI.java,Java,,13,6,27,46
MetalTabbedPaneUI.java,Java,,862,167,185,1214
MetalTextFieldUI.java,Java,,15,7,29,51
MetalTheme.java,Java,,68,56,344,468
MetalTitlePane.java,Java,,674,135,214,1023
MetalToggleButtonUI.java,Java,,122,26,60,208
MetalToolBarUI.java,Java,,245,42,93,380
MetalToolTipUI.java,Java,,124,27,29,180
MetalTreeUI.java,Java,,127,40,54,221
MetalUtils.java,Java,,297,51,87,435
OceanTheme.java,Java,,248,54,141,443
MultiButtonUI.java,Java,,88,18,87,193
MultiColorChooserUI.java,Java,,88,18,87,193
MultiComboBoxUI.java,Java,,110,21,102,233
MultiDesktopIconUI.java,Java,,88,18,87,193
MultiDesktopPaneUI.java,Java,,88,18,87,193
MultiFileChooserUI.java,Java,,135,24,117,276
MultiInternalFrameUI.java,Java,,88,18,87,193
MultiLabelUI.java,Java,,88,18,87,193
MultiListUI.java,Java,,115,21,105,241
MultiLookAndFeel.java,Java,,123,16,147,286
MultiMenuBarUI.java,Java,,88,18,87,193
MultiMenuItemUI.java,Java,,89,19,90,198
MultiOptionPaneUI.java,Java,,102,20,96,218
MultiPanelUI.java,Java,,88,18,87,193
MultiPopupMenuUI.java,Java,,107,20,101,228
MultiProgressBarUI.java,Java,,88,18,87,193
MultiRootPaneUI.java,Java,,88,18,88,194
MultiScrollBarUI.java,Java,,88,18,87,193
MultiScrollPaneUI.java,Java,,88,18,87,193
MultiSeparatorUI.java,Java,,88,18,87,193
MultiSliderUI.java,Java,,88,18,87,193
MultiSpinnerUI.java,Java,,88,18,88,194
MultiSplitPaneUI.java,Java,,128,24,114,266
MultiTabbedPaneUI.java,Java,,114,21,105,240
MultiTableHeaderUI.java,Java,,88,18,87,193
MultiTableUI.java,Java,,88,18,87,193
MultiTextUI.java,Java,,173,28,142,343
MultiToolBarUI.java,Java,,88,18,87,193
MultiToolTipUI.java,Java,,88,18,87,193
MultiTreeUI.java,Java,,165,28,141,334
MultiViewportUI.java,Java,,88,18,87,193
OptionPaneUI.java,Java,,7,5,20,32
PanelUI.java,Java,,3,4,12,19
PopupMenuUI.java,Java,,14,7,26,47
ProgressBarUI.java,Java,,3,3,12,18
RootPaneUI.java,Java,,3,2,13,18
ScrollBarUI.java,Java,,3,2,12,17
ScrollPaneUI.java,Java,,3,4,12,19
SeparatorUI.java,Java,,3,4,13,20
SliderUI.java,Java,,3,3,12,18
SpinnerUI.java,Java,,3,4,13,20
SplitPaneUI.java,Java,,12,8,32,52
ColorType.java,Java,,34,12,78,124
DefaultMenuLayout.java,Java,,26,10,18,54
DefaultSynthStyleFactory.java,Java,,106,24,62,192
ImagePainter.java,Java,,778,149,75,1002
ParsedSynthStyle.java,Java,,1831,312,15,2158
Region.java,Java,,173,60,316,549
SynthArrowButton.java,Java,,89,17,21,127
SynthBorder.java,Java,,93,8,31,132
SynthButtonUI.java,Java,,338,55,52,445
SynthCheckBoxMenuItemUI.java,Java,,42,10,15,67
SynthCheckBoxUI.java,Java,,22,8,15,45
SynthColorChooserUI.java,Java,,93,25,13,131
SynthComboBoxUI.java,Java,,445,96,238,779
SynthComboPopup.java,Java,,44,6,25,75
SynthConstants.java,Java,,11,3,40,54
SynthContext.java,Java,,97,27,64,188
SynthDefaultLookup.java,Java,,17,2,12,31
SynthDesktopIconUI.java,Java,,139,25,13,177
SynthDesktopPaneUI.java,Java,,353,54,27,434
SynthEditorPaneUI.java,Java,,92,22,35,149
SynthFormattedTextFieldUI.java,Java,,21,5,25,51
SynthGraphicsUtils.java,Java,,377,68,201,646
SynthInternalFrameTitlePane.java,Java,,406,46,25,477
SynthInternalFrameUI.java,Java,,147,34,17,198
SynthLabelUI.java,Java,,182,32,21,235
SynthListUI.java,Java,,136,33,12,181
SynthLookAndFeel.java,Java,,595,93,297,985
SynthMenuBarUI.java,Java,,95,21,12,128
SynthMenuItemLayoutHelper.java,Java,,218,28,44,290
SynthMenuItemUI.java,Java,,173,41,17,231
SynthMenuUI.java,Java,,175,35,18,228
SynthOptionPaneUI.java,Java,,139,36,23,198
SynthPainter.java,Java,,573,139,1689,2401
SynthPanelUI.java,Java,,84,25,13,122
SynthParser.java,Java,,1084,104,136,1324
SynthPasswordFieldUI.java,Java,,34,9,35,78
SynthPopupMenuUI.java,Java,,101,26,14,141
SynthProgressBarUI.java,Java,,308,41,36,385
SynthRadioButtonMenuItemUI.java,Java,,41,7,13,61
SynthRadioButtonUI.java,Java,,26,8,18,52
SynthRootPaneUI.java,Java,,74,19,17,110
SynthScrollBarUI.java,Java,,288,54,49,391
SynthScrollPaneUI.java,Java,,194,45,15,254
SynthSeparatorUI.java,Java,,126,31,14,171
SynthSliderUI.java,Java,,745,129,77,951
SynthSpinnerUI.java,Java,,265,62,137,464
SynthSplitPaneDivider.java,Java,,96,17,21,134
SynthSplitPaneUI.java,Java,,195,50,52,297
SynthStyle.java,Java,,792,62,182,1036
SynthStyleFactory.java,Java,,10,3,48,61
SynthTabbedPaneUI.java,Java,,619,100,110,829
SynthTableHeaderUI.java,Java,,148,33,21,202
SynthTableUI.java,Java,,586,108,73,767
SynthTextAreaUI.java,Java,,86,24,41,151
SynthTextFieldUI.java,Java,,148,39,50,237
SynthTextPaneUI.java,Java,,70,17,58,145
SynthToggleButtonUI.java,Java,,27,6,15,48
SynthToolBarUI.java,Java,,354,64,46,464
SynthToolTipUI.java,Java,,123,27,15,165
SynthTreeUI.java,Java,,651,117,33,801
SynthViewportUI.java,Java,,92,25,17,134
TabbedPaneUI.java,Java,,8,3,13,24
TableHeaderUI.java,Java,,3,2,12,17
TableUI.java,Java,,3,2,12,17
TextUI.java,Java,,28,11,109,148
ToolBarUI.java,Java,,5,5,12,22
ToolTipUI.java,Java,,3,2,12,17
TreeUI.java,Java,,18,12,58,88
UIResource.java,Java,,3,4,43,50
ViewportUI.java,Java,,3,4,12,19
Popup.java,Java,,104,28,113,245
PopupFactory.java,Java,,571,121,252,944
ProgressMonitor.java,Java,,460,100,472,1032
ProgressMonitorInputStream.java,Java,,73,25,73,171
Renderer.java,Java,,6,3,25,34
RepaintManager.java,Java,,983,165,525,1673
RootPaneContainer.java,Java,,13,18,132,163
RowFilter.java,Java,,238,54,300,592
RowSorter.java,Java,,79,28,301,408
Scrollable.java,Java,,11,11,90,112
ScrollPaneConstants.java,Java,,25,8,68,101
ScrollPaneLayout.java,Java,,518,138,412,1068
SingleSelectionModel.java,Java,,10,8,42,60
SizeRequirements.java,Java,,175,27,269,471
SizeSequence.java,Java,,140,24,226,390
SortingFocusTraversalPolicy.java,Java,,315,67,211,593
SortOrder.java,Java,,6,3,28,37
SpinnerDateModel.java,Java,,110,33,304,447
SpinnerListModel.java,Java,,73,28,130,231
SpinnerModel.java,Java,,12,14,96,122
SpinnerNumberModel.java,Java,,118,39,277,434
Spring.java,Java,,293,93,288,674
SpringLayout.java,Java,,507,95,613,1215
SwingConstants.java,Java,,22,8,91,121
SwingHeavyWeight.java,Java,,3,1,13,17
SwingPaintEventDispatcher.java,Java,,56,6,15,77
SwingUtilities.java,Java,,1111,167,663,1941
SwingWorker.java,Java,,268,47,533,848
AbstractTableModel.java,Java,,74,24,226,324
DefaultTableCellRenderer.java,Java,,145,43,193,381
DefaultTableColumnModel.java,Java,,268,73,383,724
DefaultTableModel.java,Java,,214,55,422,691
JTableHeader.java,Java,,780,156,518,1454
TableCellEditor.java,Java,,9,7,40,56
TableCellRenderer.java,Java,,8,5,64,77
TableColumn.java,Java,,226,76,511,813
TableColumnModel.java,Java,,27,26,171,224
TableModel.java,Java,,15,13,99,127
TableRowSorter.java,Java,,99,21,171,291
TableStringConverter.java,Java,,4,1,26,31
TablePrintable.java,Java,,207,93,199,499
AbstractDocument.java,Java,,1288,300,1523,3111
AbstractWriter.java,Java,,329,54,313,696
AsyncBoxView.java,Java,,649,109,645,1403
AttributeSet.java,Java,,23,18,135,176
BadLocationException.java,Java,,12,3,33,48
BoxView.java,Java,,565,84,522,1171
Caret.java,Java,,24,21,143,188
ChangedCharSetException.java,Java,,16,7,13,36
ComponentView.java,Java,,234,37,205,476
CompositeView.java,Java,,321,47,409,777
DateFormatter.java,Java,,64,17,62,143
DefaultCaret.java,Java,,984,147,773,1904
DefaultEditorKit.java,Java,,1134,219,933,2286
DefaultFormatter.java,Java,,372,78,293,743
DefaultFormatterFactory.java,Java,,84,22,190,296
DefaultHighlighter.java,Java,,368,52,194,614
DefaultStyledDocument.java,Java,,1552,217,830,2599
DefaultTextUI.java,Java,,5,5,15,25
Document.java,Java,,23,23,413,459
DocumentFilter.java,Java,,26,8,124,158
EditorKit.java,Java,,34,16,141,191
Element.java,Java,,13,14,96,123
ElementIterator.java,Java,,167,42,155,364
FieldView.java,Java,,149,19,126,294
FlowView.java,Java,,409,67,378,854
GapContent.java,Java,,545,96,298,939
GapVector.java,Java,,120,33,131,284
GlyphPainter1.java,Java,,120,23,90,233
GlyphPainter2.java,Java,,211,26,127,364
GlyphView.java,Java,,658,97,547,1302
Highlighter.java,Java,,22,20,94,136
AccessibleHTML.java,Java,,1551,296,1194,3041
BlockView.java,Java,,206,32,188,426
BRView.java,Java,,14,4,22,40
CommentView.java,Java,,92,13,19,124
CSS.java,Java,,2133,327,787,3247
CSSParser.java,Java,,583,77,177,837
EditableView.java,Java,,70,11,30,111
FormSubmitEvent.java,Java,,21,9,45,75
FormView.java,Java,,544,74,297,915
FrameSetView.java,Java,,178,32,96,306
FrameView.java,Java,,288,52,122,462
HiddenTagView.java,Java,,254,39,51,344
HRuleView.java,Java,,177,27,96,300
HTML.java,Java,,411,47,222,680
HTMLDocument.java,Java,,2079,297,1413,3789
HTMLEditorKit.java,Java,,1296,166,772,2234
HTMLFrameHyperlinkEvent.java,Java,,30,11,55,96
HTMLWriter.java,Java,,819,105,335,1259
ImageView.java,Java,,612,95,273,980
InlineView.java,Java,,176,20,132,328
IsindexView.java,Java,,51,15,31,97
LineView.java,Java,,63,11,95,169
ListView.java,Java,,53,8,44,105
Map.java,Java,,348,48,92,488
MinimalHTMLWriter.java,Java,,348,82,279,709
MuxingAttributeSet.java,Java,,148,28,118,294
NoFramesView.java,Java,,57,15,84,156
ObjectView.java,Java,,75,11,80,166
Option.java,Java,,37,12,55,104
OptionComboBoxModel.java,Java,,13,7,26,46
OptionListModel.java,Java,,305,74,177,556
ParagraphView.java,Java,,151,22,113,286
AttributeList.java,Java,,83,19,53,155
ContentModel.java,Java,,144,26,68,238
ContentModelState.java,Java,,173,27,78,278
DocumentParser.java,Java,,152,19,93,264
DTD.java,Java,,263,42,148,453
DTDConstants.java,Java,,39,6,20,65
Element.java,Java,,79,22,57,158
Entity.java,Java,,53,15,55,123
Parser.java,Java,,1567,246,495,2308
ParserDelegator.java,Java,,65,21,28,114
ResourceLoader.java,Java,,16,7,20,43
TagElement.java,Java,,33,15,13,61
TagStack.java,Java,,123,29,53,205
ResourceLoader.java,Java,,16,7,20,43
StyleSheet.java,Java,,2103,224,1014,3341
TableView.java,Java,,1030,167,587,1784
TextAreaDocument.java,Java,,20,12,23,55
IconView.java,Java,,56,12,84,152
InternationalFormatter.java,Java,,569,96,421,1086
JTextComponent.java,Java,,2425,401,2199,5025
Keymap.java,Java,,18,16,94,128
LabelView.java,Java,,96,25,179,300
LayeredHighlighter.java,Java,,14,4,28,46
LayoutQueue.java,Java,,62,15,35,112
MaskFormatter.java,Java,,469,86,443,998
MutableAttributeSet.java,Java,,10,20,51,81
NavigationFilter.java,Java,,22,8,100,130
NumberFormatter.java,Java,,285,45,158,488
ParagraphView.java,Java,,612,73,439,1124
PasswordView.java,Java,,112,12,94,218
PlainDocument.java,Java,,172,16,119,307
PlainView.java,Java,,376,45,268,689
Position.java,Java,,15,8,53,76
AbstractFilter.java,Java,,108,27,78,213
Constants.java,Java,,28,10,22,60
MockAttributeSet.java,Java,,78,22,8,108
RTFAttribute.java,Java,,26,7,16,49
RTFAttributes.java,Java,,324,64,16,404
RTFEditorKit.java,Java,,43,13,82,138
RTFGenerator.java,Java,,764,130,97,991
RTFParser.java,Java,,228,35,53,316
RTFReader.java,Java,,1121,228,282,1631
Segment.java,Java,,122,31,148,301
SegmentCache.java,Java,,39,15,56,110
SimpleAttributeSet.java,Java,,200,35,153,388
StateInvariantError.java,Java,,7,2,19,28
StringContent.java,Java,,264,40,177,481
Style.java,Java,,11,10,37,58
StyleConstants.java,Java,,282,100,453,835
StyleContext.java,Java,,715,147,746,1608
StyledDocument.java,Java,,17,16,127,160
StyledEditorKit.java,Java,,397,76,405,878
TabableView.java,Java,,5,4,44,53
TabExpander.java,Java,,4,4,22,30
TableView.java,Java,,427,75,389,891
TabSet.java,Java,,103,17,75,195
TabStop.java,Java,,76,15,70,161
TextAction.java,Java,,45,6,69,120
TextLayoutStrategy.java,Java,,288,51,183,522
Utilities.java,Java,,682,52,317,1051
View.java,Java,,378,66,883,1327
ViewFactory.java,Java,,5,4,22,31
WrappedPlainView.java,Java,,454,65,321,840
ZoneView.java,Java,,247,49,338,634
Timer.java,Java,,170,70,356,596
TimerQueue.java,Java,,172,60,42,274
ToolTipManager.java,Java,,581,87,227,895
TransferHandler.java,Java,,800,205,724,1729
AbstractLayoutCache.java,Java,,140,56,318,514
DefaultMutableTreeNode.java,Java,,646,227,617,1490
DefaultTreeCellEditor.java,Java,,361,88,288,737
DefaultTreeCellRenderer.java,Java,,277,81,253,611
DefaultTreeModel.java,Java,,263,57,343,663
DefaultTreeSelectionModel.java,Java,,702,118,393,1213
ExpandVetoException.java,Java,,12,6,28,46
FixedHeightLayoutCache.java,Java,,964,185,435,1584
MutableTreeNode.java,Java,,10,8,38,56
RowMapper.java,Java,,6,3,20,29
TreeCellEditor.java,Java,,10,4,34,48
TreeCellRenderer.java,Java,,8,4,47,59
TreeModel.java,Java,,13,15,115,143
TreeNode.java,Java,,12,10,48,70
TreePath.java,Java,,138,33,149,320
TreeSelectionModel.java,Java,,36,33,225,294
VariableHeightLayoutCache.java,Java,,1046,191,513,1750
UIDefaults.java,Java,,471,103,630,1204
UIManager.java,Java,,579,136,738,1453
AbstractUndoableEdit.java,Java,,73,24,165,262
CannotRedoException.java,Java,,3,2,21,26
CannotUndoException.java,Java,,3,3,21,27
CompoundEdit.java,Java,,110,21,114,245
StateEdit.java,Java,,59,27,90,176
StateEditable.java,Java,,7,8,21,36
UndoableEdit.java,Java,,15,13,156,184
UndoableEditSupport.java,Java,,70,17,75,162
UndoManager.java,Java,,210,44,355,609
UnsupportedLookAndFeelException.java,Java,,7,1,26,34
ViewportLayout.java,Java,,82,20,84,186
WindowConstants.java,Java,,8,7,52,67
Diagnostic.java,Java,,21,14,117,152
DiagnosticCollector.java,Java,,14,5,20,39
DiagnosticListener.java,Java,,4,2,25,31
FileObject.java,Java,,20,13,110,143
ForwardingFileObject.java,Java,,41,14,47,102
ForwardingJavaFileManager.java,Java,,75,18,56,149
ForwardingJavaFileObject.java,Java,,25,9,19,53
JavaCompiler.java,Java,,26,9,276,311
JavaFileManager.java,Java,,43,17,324,384
JavaFileObject.java,Java,,26,12,80,118
OptionChecker.java,Java,,4,4,20,28
package-info.java,Java,,1,1,58,60
SimpleJavaFileObject.java,Java,,70,19,110,199
StandardJavaFileManager.java,Java,,17,11,194,222
StandardLocation.java,Java,,30,13,43,86
Tool.java,Java,,9,6,39,54
ToolProvider.java,Java,,63,9,36,108
CollapsedStringAdapter.java,Java,,44,17,38,99
HexBinaryAdapter.java,Java,,12,4,13,29
NormalizedStringAdapter.java,Java,,24,14,34,72
XmlAdapter.java,Java,,6,5,162,173
XmlJavaTypeAdapter.java,Java,,24,11,62,97
XmlJavaTypeAdapters.java,Java,,9,3,30,42
DomHandler.java,Java,,9,5,85,99
W3CDomHandler.java,Java,,47,13,29,89
XmlAccessOrder.java,Java,,5,4,21,30
XmlAccessorOrder.java,Java,,11,5,45,61
XmlAccessorType.java,Java,,11,6,64,81
XmlAccessType.java,Java,,7,6,39,52
XmlAnyAttribute.java,Java,,12,4,38,54
XmlAnyElement.java,Java,,18,7,245,270
XmlAttachmentRef.java,Java,,10,4,41,55
XmlAttribute.java,Java,,11,7,115,133
XmlElement.java,Java,,16,14,162,192
XmlElementDecl.java,Java,,16,10,170,196
XmlElementRef.java,Java,,15,6,227,248
XmlElementRefs.java,Java,,12,3,24,39
XmlElements.java,Java,,11,3,143,157
XmlElementWrapper.java,Java,,14,6,100,120
XmlEnum.java,Java,,9,4,42,55
XmlEnumValue.java,Java,,10,3,90,103
XmlID.java,Java,,7,7,64,78
XmlIDREF.java,Java,,7,4,220,231
XmlInlineBinaryData.java,Java,,15,4,21,40
XmlList.java,Java,,10,2,74,86
XmlMimeType.java,Java,,14,4,23,41
XmlMixed.java,Java,,12,5,95,112
XmlNs.java,Java,,9,7,26,42
XmlNsForm.java,Java,,2,5,43,50
XmlRegistry.java,Java,,9,3,11,23
XmlRootElement.java,Java,,11,6,145,162
XmlSchema.java,Java,,14,11,162,187
XmlSchemaType.java,Java,,14,11,65,90
XmlSchemaTypes.java,Java,,9,3,29,41
XmlSeeAlso.java,Java,,11,2,42,55
XmlTransient.java,Java,,7,5,65,77
XmlType.java,Java,,14,11,410,435
XmlValue.java,Java,,7,4,101,112
AttachmentMarshaller.java,Java,,9,7,160,176
AttachmentUnmarshaller.java,Java,,7,6,104,117
Binder.java,Java,,21,20,360,401
ContextFinder.java,Java,,293,65,134,492
DataBindingException.java,Java,,9,2,11,22
DatatypeConverter.java,Java,,131,44,449,624
DatatypeConverterImpl.java,Java,,582,169,140,891
DatatypeConverterInterface.java,Java,,43,41,420,504
Element.java,Java,,3,3,17,23
GetPropertyAction.java,Java,,11,4,4,19
AbstractMarshallerImpl.java,Java,,259,72,144,475
AbstractUnmarshallerImpl.java,Java,,219,63,133,415
DefaultValidationEventHandler.java,Java,,62,16,34,112
Messages.java,Java,,44,19,14,77
NotIdentifiableEventImpl.java,Java,,15,8,43,66
ParseConversionEventImpl.java,Java,,16,8,43,67
PrintConversionEventImpl.java,Java,,16,8,43,67
ValidationEventImpl.java,Java,,68,17,70,155
ValidationEventLocatorImpl.java,Java,,103,27,123,253
JAXB.java,Java,,231,33,340,604
JAXBContext.java,Java,,52,32,603,687
JAXBElement.java,Java,,55,23,120,198
JAXBException.java,Java,,52,19,94,165
JAXBIntrospector.java,Java,,13,5,54,72
MarshalException.java,Java,,18,10,54,82
Marshaller.java,Java,,58,39,711,808
Messages.java,Java,,40,17,14,71
NotIdentifiableEvent.java,Java,,3,3,14,20
ParseConversionEvent.java,Java,,3,3,15,21
PrintConversionEvent.java,Java,,3,3,15,21
PropertyException.java,Java,,26,12,56,94
SchemaOutputResolver.java,Java,,6,2,49,57
TypeConstraintException.java,Java,,47,19,98,164
UnmarshalException.java,Java,,18,10,56,84
Unmarshaller.java,Java,,51,35,1038,1124
UnmarshallerHandler.java,Java,,6,2,55,63
JAXBResult.java,Java,,25,9,95,129
JAXBSource.java,Java,,123,29,98,250
Messages.java,Java,,34,15,14,63
ValidationEventCollector.java,Java,,44,9,40,93
ValidationEvent.java,Java,,10,10,53,73
ValidationEventHandler.java,Java,,4,4,68,76
ValidationEventLocator.java,Java,,9,9,53,71
ValidationException.java,Java,,18,8,54,80
Validator.java,Java,,12,9,245,266
WhiteSpaceProcessor.java,Java,,82,29,62,173
AlgorithmMethod.java,Java,,6,4,27,37
Data.java,Java,,3,2,16,21
DOMCryptoContext.java,Java,,102,21,99,222
DOMStructure.java,Java,,23,6,38,67
DOMURIReference.java,Java,,6,3,21,30
CanonicalizationMethod.java,Java,,14,7,62,83
DigestMethod.java,Java,,12,7,58,77
DOMSignContext.java,Java,,74,11,103,188
DOMValidateContext.java,Java,,41,7,61,109
KeyInfo.java,Java,,11,5,86,102
KeyInfoFactory.java,Java,,106,27,368,501
KeyName.java,Java,,5,3,38,46
KeyValue.java,Java,,14,5,94,113
PGPData.java,Java,,10,6,79,95
RetrievalMethod.java,Java,,13,5,73,91
X509Data.java,Java,,10,5,77,92
X509IssuerSerial.java,Java,,8,4,56,68
Manifest.java,Java,,8,5,56,69
Reference.java,Java,,17,10,120,147
SignatureMethod.java,Java,,14,6,56,76
SignatureProperties.java,Java,,9,5,56,70
SignatureProperty.java,Java,,8,5,61,74
SignedInfo.java,Java,,11,7,63,81
C14NMethodParameterSpec.java,Java,,3,2,17,22
DigestMethodParameterSpec.java,Java,,4,2,17,23
ExcC14NParameterSpec.java,Java,,27,7,60,94
HMACParameterSpec.java,Java,,11,5,38,54
SignatureMethodParameterSpec.java,Java,,4,2,17,23
TransformParameterSpec.java,Java,,4,2,17,23
XPathFilter2ParameterSpec.java,Java,,28,5,38,71
XPathFilterParameterSpec.java,Java,,40,7,58,105
XPathType.java,Java,,58,14,106,178
XSLTTransformParameterSpec.java,Java,,15,4,38,57
Transform.java,Java,,23,10,94,127
TransformException.java,Java,,42,12,81,135
TransformService.java,Java,,151,16,205,372
XMLObject.java,Java,,10,7,89,106
XMLSignature.java,Java,,27,14,182,223
XMLSignatureException.java,Java,,42,12,78,132
XMLSignatureFactory.java,Java,,140,38,594,772
XMLSignContext.java,Java,,4,2,36,42
XMLValidateContext.java,Java,,3,2,37,42
KeySelector.java,Java,,40,14,77,131
KeySelectorException.java,Java,,33,12,82,127
KeySelectorResult.java,Java,,5,3,25,33
MarshalException.java,Java,,38,12,84,134
NodeSetData.java,Java,,5,3,27,35
NoSuchMechanismException.java,Java,,38,12,85,135
OctetStreamData.java,Java,,31,8,49,88
URIDereferencer.java,Java,,5,2,46,53
URIReference.java,Java,,5,3,31,39
URIReferenceException.java,Java,,46,15,106,167
XMLCryptoContext.java,Java,,17,15,173,205
XMLStructure.java,Java,,4,2,23,29
DatatypeConfigurationException.java,Java,,15,12,55,82
DatatypeConstants.java,Java,,55,47,175,277
DatatypeFactory.java,Java,,282,62,722,1066
Duration.java,Java,,186,55,751,992
FactoryFinder.java,Java,,185,33,111,329
SecuritySupport.java,Java,,65,11,32,108
XMLGregorianCalendar.java,Java,,102,58,902,1062
NamespaceContext.java,Java,,7,8,276,291
QName.java,Java,,125,31,358,514
DocumentBuilder.java,Java,,80,43,228,351
DocumentBuilderFactory.java,Java,,114,54,450,618
FactoryConfigurationError.java,Java,,30,21,77,128
FactoryFinder.java,Java,,185,34,111,330
ParserConfigurationException.java,Java,,9,10,41,60
SAXParser.java,Java,,150,43,342,535
SAXParserFactory.java,Java,,86,34,357,477
SecuritySupport.java,Java,,65,13,34,112
AttachmentPart.java,Java,,61,38,433,532
Detail.java,Java,,8,8,89,105
DetailEntry.java,Java,,3,4,35,42
FactoryFinder.java,Java,,112,21,103,236
MessageFactory.java,Java,,33,17,136,186
MimeHeader.java,Java,,15,8,53,76
MimeHeaders.java,Java,,123,32,120,275
Name.java,Java,,7,6,103,116
Node.java,Java,,9,9,100,118
SAAJMetaFactory.java,Java,,24,8,67,99
SAAJResult.java,Java,,19,11,108,138
SOAPBody.java,Java,,22,19,262,303
SOAPBodyElement.java,Java,,3,3,43,49
SOAPConnection.java,Java,,11,7,83,101
SOAPConnectionFactory.java,Java,,21,7,45,73
SOAPConstants.java,Java,,42,24,141,207
SOAPElement.java,Java,,44,34,452,530
SOAPElementFactory.java,Java,,25,10,109,144
SOAPEnvelope.java,Java,,12,8,186,206
SOAPException.java,Java,,41,12,116,169
SOAPFactory.java,Java,,49,22,214,285
SOAPFault.java,Java,,34,33,450,517
SOAPFaultElement.java,Java,,3,3,37,43
SOAPHeader.java,Java,,22,18,230,270
SOAPHeaderElement.java,Java,,11,11,150,172
SOAPMessage.java,Java,,52,29,381,462
SOAPPart.java,Java,,36,18,217,271
Text.java,Java,,4,4,40,48
EventFilter.java,Java,,5,0,15,20
Attribute.java,Java,,8,7,26,41
Characters.java,Java,,7,5,36,48
Comment.java,Java,,4,2,11,17
DTD.java,Java,,8,6,32,46
EndDocument.java,Java,,3,1,10,14
EndElement.java,Java,,7,4,20,31
EntityDeclaration.java,Java,,9,7,36,52
EntityReference.java,Java,,5,2,27,34
Namespace.java,Java,,7,5,19,31
NotationDeclaration.java,Java,,6,2,22,30
ProcessingInstruction.java,Java,,5,2,17,24
StartDocument.java,Java,,9,7,31,47
StartElement.java,Java,,13,9,67,89
XMLEvent.java,Java,,22,20,109,151
FactoryConfigurationError.java,Java,,33,10,44,87
FactoryFinder.java,Java,,194,34,112,340
Location.java,Java,,8,5,36,49
SecuritySupport.java,Java,,65,13,34,112
StreamFilter.java,Java,,4,1,17,22
EventReaderDelegate.java,Java,,60,16,30,106
StreamReaderDelegate.java,Java,,177,53,29,259
XMLEventAllocator.java,Java,,11,6,37,54
XMLEventConsumer.java,Java,,7,3,20,30
XMLEventFactory.java,Java,,94,25,265,384
XMLEventReader.java,Java,,12,6,57,75
XMLEventWriter.java,Java,,16,14,198,228
XMLInputFactory.java,Java,,99,42,273,414
XMLOutputFactory.java,Java,,55,21,207,283
XMLReporter.java,Java,,5,2,19,26
XMLResolver.java,Java,,8,2,22,32
XMLStreamConstants.java,Java,,18,18,71,107
XMLStreamException.java,Java,,39,12,50,101
XMLStreamReader.java,Java,,53,50,573,676
XMLStreamWriter.java,Java,,75,41,387,503
DOMLocator.java,Java,,6,8,38,52
DOMResult.java,Java,,84,31,250,365
DOMSource.java,Java,,29,15,96,140
ErrorListener.java,Java,,9,6,104,119
FactoryFinder.java,Java,,215,33,116,364
OutputKeys.java,Java,,15,14,173,202
Result.java,Java,,9,7,72,88
SAXResult.java,Java,,34,18,94,146
SAXSource.java,Java,,59,24,130,213
SAXTransformerFactory.java,Java,,22,14,116,152
TemplatesHandler.java,Java,,8,8,54,70
TransformerHandler.java,Java,,13,9,56,78
SecuritySupport.java,Java,,65,11,34,110
Source.java,Java,,5,5,45,55
SourceLocator.java,Java,,7,7,84,98
StAXResult.java,Java,,39,21,126,186
StAXSource.java,Java,,62,24,153,239
StreamResult.java,Java,,48,22,135,205
StreamSource.java,Java,,61,27,199,287
Templates.java,Java,,6,9,69,84
Transformer.java,Java,,28,20,294,342
TransformerConfigurationException.java,Java,,24,9,71,104
TransformerException.java,Java,,164,61,147,372
TransformerFactory.java,Java,,47,22,316,385
TransformerFactoryConfigurationError.java,Java,,30,21,73,124
URIResolver.java,Java,,5,4,43,52
Schema.java,Java,,7,6,94,107
SchemaFactory.java,Java,,93,33,630,756
SchemaFactoryFinder.java,Java,,347,65,176,588
SchemaFactoryLoader.java,Java,,6,5,60,71
SecuritySupport.java,Java,,117,14,34,165
TypeInfoProvider.java,Java,,10,9,181,200
Validator.java,Java,,52,29,427,508
ValidatorHandler.java,Java,,45,25,418,488
Action.java,Java,,15,7,35,57
AsyncHandler.java,Java,,4,3,15,22
Binding.java,Java,,6,6,35,47
BindingProvider.java,Java,,23,16,124,163
BindingType.java,Java,,12,3,27,42
Dispatch.java,Java,,8,7,81,96
Endpoint.java,Java,,34,27,279,340
EndpointReference.java,Java,,26,8,136,170
FaultAction.java,Java,,13,5,25,43
Handler.java,Java,,8,6,53,67
HandlerResolver.java,Java,,4,3,26,33
LogicalHandler.java,Java,,3,2,9,14
LogicalMessageContext.java,Java,,6,4,16,26
MessageContext.java,Java,,43,23,119,185
PortInfo.java,Java,,7,7,32,46
SOAPHandler.java,Java,,8,4,17,29
SOAPMessageContext.java,Java,,13,7,59,79
Holder.java,Java,,9,5,20,34
HTTPBinding.java,Java,,5,5,12,22
HTTPException.java,Java,,11,6,19,36
LogicalMessage.java,Java,,9,7,56,72
ProtocolException.java,Java,,15,5,48,68
Provider.java,Java,,4,3,36,43
RequestWrapper.java,Java,,14,8,25,47
RespectBinding.java,Java,,16,4,67,87
RespectBindingFeature.java,Java,,18,7,81,106
Response.java,Java,,6,3,23,32
ResponseWrapper.java,Java,,14,14,30,58
Service.java,Java,,92,38,566,696
ServiceMode.java,Java,,14,3,16,33
Addressing.java,Java,,18,7,63,88
AddressingFeature.java,Java,,27,9,106,142
MTOM.java,Java,,15,5,29,49
MTOMFeature.java,Java,,34,14,66,114
SOAPBinding.java,Java,,17,16,57,90
SOAPFaultException.java,Java,,12,6,37,55
FactoryFinder.java,Java,,100,20,39,159
Provider.java,Java,,55,17,213,285
ServiceDelegate.java,Java,,46,34,522,602
WebServiceFeatureAnnotation.java,Java,,14,4,35,53
WebEndpoint.java,Java,,12,3,21,36
WebFault.java,Java,,14,5,20,39
WebServiceClient.java,Java,,14,5,24,43
WebServiceContext.java,Java,,13,9,109,131
WebServiceException.java,Java,,15,8,36,59
WebServiceFeature.java,Java,,9,9,43,61
WebServicePermission.java,Java,,11,7,41,59
WebServiceProvider.java,Java,,15,6,22,43
WebServiceRef.java,Java,,16,8,55,79
WebServiceRefs.java,Java,,12,4,15,31
package-info.java,Java,,3,2,4,9
W3CEndpointReference.java,Java,,79,18,39,136
W3CEndpointReferenceBuilder.java,Java,,55,15,169,239
XMLConstants.java,Java,,21,17,158,196
SecuritySupport.java,Java,,116,14,32,162
XPath.java,Java,,26,16,280,322
XPathConstants.java,Java,,11,11,65,87
XPathException.java,Java,,40,15,79,134
XPathExpression.java,Java,,13,8,182,203
XPathExpressionException.java,Java,,10,6,61,77
XPathFactory.java,Java,,82,31,274,387
XPathFactoryConfigurationException.java,Java,,10,6,60,76
XPathFactoryFinder.java,Java,,350,64,151,565
XPathFunction.java,Java,,6,5,49,60
XPathFunctionException.java,Java,,10,6,59,75
XPathFunctionResolver.java,Java,,5,4,60,69
XPathVariableResolver.java,Java,,5,4,52,61
java.c,C/C++/ObjC,,1386,178,449,2013
java.h,h,,40,18,35,93
java_md.c,C/C++/ObjC,,844,136,380,1360
java_md.h,h,,28,8,17,53
jli_util.c,C/C++/ObjC,,38,5,22,65
jli_util.h,h,,8,4,6,18
manifest_info.h,h,,73,16,49,138
parse_manifest.c,C/C++/ObjC,,347,37,229,613
splashscreen.h,h,,5,4,6,15
splashscreen_stubs.c,C/C++/ObjC,,31,10,19,60
version_comp.c,C/C++/ObjC,,212,25,102,339
version_comp.h,h,,7,3,9,19
wildcard.c,C/C++/ObjC,,332,38,107,477
wildcard.h,h,,8,3,6,17
ChannelBinding.java,Java,,63,23,109,195
GSSContext.java,Java,,62,45,1223,1330
GSSCredential.java,Java,,21,24,309,354
GSSException.java,Java,,108,60,218,386
GSSManager.java,Java,,38,19,655,712
GSSName.java,Java,,27,19,231,277
MessageProp.java,Java,,67,21,130,218
Oid.java,Java,,83,23,93,199
ACTIVITY_COMPLETED.java,Java,,18,7,44,69
ACTIVITY_REQUIRED.java,Java,,18,7,42,67
Any.java,Java,,81,58,565,704
AnyHolder.java,Java,,21,9,60,90
AnySeqHelper.java,Java,,46,10,27,83
AnySeqHolder.java,Java,,24,9,15,48
ARG_IN.java,Java,,4,4,29,37
ARG_INOUT.java,Java,,4,7,30,41
ARG_OUT.java,Java,,4,6,29,39
BAD_CONTEXT.java,Java,,15,7,47,69
BAD_INV_ORDER.java,Java,,15,8,45,68
BAD_OPERATION.java,Java,,15,7,43,65
BAD_PARAM.java,Java,,15,7,52,74
BAD_POLICY.java,Java,,4,2,16,22
BAD_POLICY_TYPE.java,Java,,4,2,16,22
BAD_POLICY_VALUE.java,Java,,4,2,18,24
BAD_QOS.java,Java,,18,7,41,66
BAD_TYPECODE.java,Java,,15,7,44,66
BooleanHolder.java,Java,,21,9,62,92
BooleanSeqHelper.java,Java,,44,10,27,81
BooleanSeqHolder.java,Java,,24,9,15,48
Bounds.java,Java,,9,5,22,36
ByteHolder.java,Java,,21,10,62,93
CharHolder.java,Java,,21,10,63,94
CharSeqHelper.java,Java,,44,10,27,81
CharSeqHolder.java,Java,,24,9,15,48
CODESET_INCOMPATIBLE.java,Java,,18,7,40,65
COMM_FAILURE.java,Java,,15,7,51,73
CompletionStatus.java,Java,,27,13,85,125
CompletionStatusHelper.java,Java,,37,10,14,61
Context.java,Java,,11,19,198,228
ContextList.java,Java,,7,12,70,89
CTX_RESTRICT_SCOPE.java,Java,,4,4,28,36
Current.java,Java,,4,3,23,30
CurrentHelper.java,Java,,43,11,15,69
CurrentHolder.java,Java,,24,8,15,47
CurrentOperations.java,Java,,4,3,16,23
CustomMarshal.java,Java,,7,3,29,39
DataInputStream.java,Java,,36,34,258,328
DataOutputStream.java,Java,,36,34,196,266
DATA_CONVERSION.java,Java,,15,7,46,68
DefinitionKind.java,Java,,114,113,256,483
DefinitionKindHelper.java,Java,,37,10,15,62
DomainManager.java,Java,,5,4,17,26
DomainManagerOperations.java,Java,,5,4,23,32
DoubleHolder.java,Java,,21,12,59,92
DoubleSeqHelper.java,Java,,44,10,27,81
DoubleSeqHolder.java,Java,,24,9,15,48
DynamicImplementation.java,Java,,12,5,12,29
DynAny.java,Java,,90,66,557,713
Invalid.java,Java,,10,5,18,33
InvalidSeq.java,Java,,10,5,19,34
InvalidValue.java,Java,,10,4,22,36
TypeMismatch.java,Java,,10,5,19,34
DynArray.java,Java,,8,5,25,38
DynEnum.java,Java,,9,6,31,46
DynFixed.java,Java,,8,4,27,39
DynSequence.java,Java,,10,7,38,55
DynStruct.java,Java,,10,6,36,52
DynUnion.java,Java,,13,10,53,76
DynValue.java,Java,,9,6,40,55
Environment.java,Java,,6,10,28,44
ExceptionList.java,Java,,9,11,73,93
FieldNameHelper.java,Java,,40,10,14,64
FixedHolder.java,Java,,21,11,49,81
FloatHolder.java,Java,,21,9,58,88
FloatSeqHelper.java,Java,,44,10,27,81
FloatSeqHolder.java,Java,,24,9,15,48
FREE_MEM.java,Java,,15,6,43,64
IdentifierHelper.java,Java,,40,10,15,65
IDLType.java,Java,,4,6,24,34
IDLTypeHelper.java,Java,,51,11,15,77
IDLTypeOperations.java,Java,,5,4,31,40
IMP_LIMIT.java,Java,,15,7,46,68
INITIALIZE.java,Java,,15,6,49,70
INTERNAL.java,Java,,15,6,49,70
INTF_REPOS.java,Java,,15,6,42,63
IntHolder.java,Java,,21,9,65,95
INVALID_ACTIVITY.java,Java,,18,7,43,68
INVALID_TRANSACTION.java,Java,,15,6,44,65
INV_FLAG.java,Java,,15,6,44,65
INV_IDENT.java,Java,,15,6,45,66
INV_OBJREF.java,Java,,15,6,51,72
INV_POLICY.java,Java,,15,6,42,63
IRObject.java,Java,,5,2,17,24
IRObjectOperations.java,Java,,6,6,53,65
LocalObject.java,Java,,89,39,361,489
LongHolder.java,Java,,21,10,60,91
LongLongSeqHelper.java,Java,,44,10,27,81
LongLongSeqHolder.java,Java,,24,9,15,48
LongSeqHelper.java,Java,,44,10,27,81
LongSeqHolder.java,Java,,24,9,15,48
MARSHAL.java,Java,,15,6,49,70
NamedValue.java,Java,,6,10,92,108
NameValuePair.java,Java,,10,8,27,45
NameValuePairHelper.java,Java,,67,10,14,91
NO_IMPLEMENT.java,Java,,15,6,48,69
NO_MEMORY.java,Java,,15,7,41,63
NO_PERMISSION.java,Java,,15,6,41,62
NO_RESOURCES.java,Java,,15,6,42,63
NO_RESPONSE.java,Java,,15,6,42,63
NVList.java,Java,,9,16,136,161
Object.java,Java,,25,35,204,264
ObjectHelper.java,Java,,37,11,19,67
ObjectHolder.java,Java,,21,9,64,94
OBJECT_NOT_EXIST.java,Java,,15,6,51,72
OBJ_ADAPTER.java,Java,,15,6,46,67
OctetSeqHelper.java,Java,,44,10,27,81
OctetSeqHolder.java,Java,,24,9,15,48
OMGVMCID.java,Java,,4,5,16,25
ORB.java,Java,,302,103,902,1307
InconsistentTypeCode.java,Java,,10,4,20,34
InvalidName.java,Java,,9,4,23,36
ParameterMode.java,Java,,29,8,14,51
ParameterModeHelper.java,Java,,37,11,14,62
ParameterModeHolder.java,Java,,24,9,14,47
PERSIST_STORE.java,Java,,15,6,41,62
Policy.java,Java,,4,3,22,29
PolicyError.java,Java,,15,7,31,53
PolicyErrorCodeHelper.java,Java,,40,11,11,62
PolicyErrorHelper.java,Java,,62,11,12,85
PolicyErrorHolder.java,Java,,24,9,10,43
PolicyHelper.java,Java,,51,11,15,77
PolicyHolder.java,Java,,24,8,15,47
PolicyListHelper.java,Java,,46,10,15,71
PolicyListHolder.java,Java,,24,9,15,48
PolicyOperations.java,Java,,7,6,41,54
PolicyTypeHelper.java,Java,,40,11,16,67
ApplicationException.java,Java,,16,6,24,46
BoxedValueHelper.java,Java,,7,2,14,23
CustomValue.java,Java,,4,5,20,29
Delegate.java,Java,,84,30,277,391
IDLEntity.java,Java,,3,3,13,19
IndirectionException.java,Java,,9,4,39,52
InputStream.java,Java,,68,12,223,303
InvokeHandler.java,Java,,6,4,45,55
ObjectImpl.java,Java,,155,38,324,517
OutputStream.java,Java,,66,11,193,270
RemarshalException.java,Java,,6,2,20,28
ResponseHandler.java,Java,,5,3,28,36
ServantObject.java,Java,,5,4,22,31
Streamable.java,Java,,7,4,32,43
StreamableValue.java,Java,,3,5,17,25
UnknownException.java,Java,,8,1,33,42
ValueBase.java,Java,,4,2,29,35
ValueFactory.java,Java,,5,3,33,41
ValueInputStream.java,Java,,5,5,24,34
ValueOutputStream.java,Java,,5,3,23,31
Principal.java,Java,,12,4,24,40
PrincipalHolder.java,Java,,22,10,44,76
PRIVATE_MEMBER.java,Java,,4,2,23,29
PUBLIC_MEMBER.java,Java,,4,2,24,30
REBIND.java,Java,,18,7,44,69
RepositoryIdHelper.java,Java,,40,10,16,66
Request.java,Java,,25,50,209,284
ServerRequest.java,Java,,39,19,239,297
ServiceDetail.java,Java,,11,5,35,51
ServiceDetailHelper.java,Java,,50,6,11,67
ServiceInformation.java,Java,,13,7,24,44
ServiceInformationHelper.java,Java,,58,7,11,76
ServiceInformationHolder.java,Java,,20,10,63,93
SetOverrideType.java,Java,,25,11,69,105
SetOverrideTypeHelper.java,Java,,37,10,14,61
ShortHolder.java,Java,,21,9,63,93
ShortSeqHelper.java,Java,,44,10,27,81
ShortSeqHolder.java,Java,,24,9,15,48
StringHolder.java,Java,,21,9,62,92
StringSeqHelper.java,Java,,46,11,7,64
StringSeqHolder.java,Java,,24,10,7,41
StringValueHelper.java,Java,,73,14,35,122
StructMember.java,Java,,12,8,51,71
StructMemberHelper.java,Java,,74,10,15,99
SystemException.java,Java,,45,11,45,101
TCKind.java,Java,,149,79,310,538
TIMEOUT.java,Java,,18,7,41,66
TRANSACTION_MODE.java,Java,,15,6,44,65
TRANSACTION_REQUIRED.java,Java,,15,6,41,62
TRANSACTION_ROLLEDBACK.java,Java,,15,6,45,66
TRANSACTION_UNAVAILABLE.java,Java,,16,6,44,66
TRANSIENT.java,Java,,15,6,44,65
TypeCode.java,Java,,29,39,448,516
TypeCodeHolder.java,Java,,21,9,63,93
BadKind.java,Java,,9,4,25,38
Bounds.java,Java,,9,5,24,38
ULongLongSeqHelper.java,Java,,44,10,27,81
ULongLongSeqHolder.java,Java,,24,9,15,48
ULongSeqHelper.java,Java,,44,10,27,81
ULongSeqHolder.java,Java,,24,9,15,48
UnionMember.java,Java,,14,9,54,77
UnionMemberHelper.java,Java,,81,10,15,106
UNKNOWN.java,Java,,15,6,50,71
UnknownUserException.java,Java,,11,7,31,49
UnknownUserExceptionHelper.java,Java,,61,10,17,88
UnknownUserExceptionHolder.java,Java,,24,8,15,47
UNSUPPORTED_POLICY.java,Java,,4,2,17,23
UNSUPPORTED_POLICY_VALUE.java,Java,,4,2,18,24
UserException.java,Java,,9,5,27,41
UShortSeqHelper.java,Java,,44,10,27,81
UShortSeqHolder.java,Java,,24,9,15,48
ValueBaseHelper.java,Java,,37,12,22,71
ValueBaseHolder.java,Java,,21,10,58,89
ValueMember.java,Java,,20,12,71,103
ValueMemberHelper.java,Java,,106,10,15,131
VersionSpecHelper.java,Java,,40,10,15,65
VisibilityHelper.java,Java,,40,11,16,67
VM_ABSTRACT.java,Java,,4,2,16,22
VM_CUSTOM.java,Java,,4,2,16,22
VM_NONE.java,Java,,4,4,19,27
VM_TRUNCATABLE.java,Java,,4,2,18,24
WCharSeqHelper.java,Java,,44,10,27,81
WCharSeqHolder.java,Java,,24,9,15,48
WrongTransaction.java,Java,,9,4,25,38
WrongTransactionHelper.java,Java,,54,9,17,80
WrongTransactionHolder.java,Java,,24,8,15,47
WStringSeqHelper.java,Java,,46,11,7,64
WStringSeqHolder.java,Java,,24,10,7,41
WStringValueHelper.java,Java,,73,16,38,127
_IDLTypeStub.java,Java,,90,13,32,135
_PolicyStub.java,Java,,89,14,43,146
ORB.java,Java,,23,13,37,73
Delegate.java,Java,,6,4,29,39
InputStream.java,Java,,24,11,61,96
ObjectImpl.java,Java,,10,6,28,44
OutputStream.java,Java,,18,9,49,76
Binding.java,Java,,14,7,7,28
BindingHelper.java,Java,,68,10,6,84
BindingHolder.java,Java,,24,8,6,38
BindingIterator.java,Java,,4,4,14,22
BindingIteratorHelper.java,Java,,67,13,14,94
BindingIteratorHolder.java,Java,,24,9,14,47
BindingIteratorOperations.java,Java,,7,7,30,44
BindingIteratorPOA.java,Java,,70,21,32,123
BindingListHelper.java,Java,,46,11,9,66
BindingListHolder.java,Java,,24,10,9,43
BindingType.java,Java,,27,8,10,45
BindingTypeHelper.java,Java,,37,11,10,58
BindingTypeHolder.java,Java,,24,9,10,43
IstringHelper.java,Java,,40,10,6,56
NameComponent.java,Java,,14,6,6,26
NameComponentHelper.java,Java,,68,10,6,84
NameComponentHolder.java,Java,,24,8,6,38
NameHelper.java,Java,,46,11,9,66
NameHolder.java,Java,,24,10,9,43
NamingContext.java,Java,,4,4,15,23
NamingContextExt.java,Java,,4,4,19,27
NamingContextExtHelper.java,Java,,67,13,19,99
NamingContextExtHolder.java,Java,,24,9,19,52
NamingContextExtOperations.java,Java,,8,8,67,83
AddressHelper.java,Java,,40,11,9,60
InvalidAddress.java,Java,,12,7,6,25
InvalidAddressHelper.java,Java,,54,10,8,72
InvalidAddressHolder.java,Java,,24,8,6,38
StringNameHelper.java,Java,,40,11,10,61
URLStringHelper.java,Java,,40,11,10,61
NamingContextExtPOA.java,Java,,294,43,230,567
NamingContextHelper.java,Java,,67,13,15,95
NamingContextHolder.java,Java,,24,9,15,48
NamingContextOperations.java,Java,,14,14,176,204
AlreadyBound.java,Java,,12,7,6,25
AlreadyBoundHelper.java,Java,,54,10,8,72
AlreadyBoundHolder.java,Java,,24,8,6,38
CannotProceed.java,Java,,22,8,6,36
CannotProceedHelper.java,Java,,70,10,8,88
CannotProceedHolder.java,Java,,24,8,6,38
InvalidName.java,Java,,12,7,6,25
InvalidNameHelper.java,Java,,54,10,8,72
InvalidNameHolder.java,Java,,24,8,6,38
NotEmpty.java,Java,,12,7,6,25
NotEmptyHelper.java,Java,,54,10,8,72
NotEmptyHolder.java,Java,,24,8,6,38
NotFound.java,Java,,22,8,6,36
NotFoundHelper.java,Java,,70,10,8,88
NotFoundHolder.java,Java,,24,8,6,38
NotFoundReason.java,Java,,29,8,9,46
NotFoundReasonHelper.java,Java,,37,11,9,57
NotFoundReasonHolder.java,Java,,24,9,9,42
NamingContextPOA.java,Java,,223,35,178,436
_BindingIteratorImplBase.java,Java,,71,3,16,90
_BindingIteratorStub.java,Java,,92,14,31,137
_NamingContextExtStub.java,Java,,377,36,229,642
_NamingContextImplBase.java,Java,,370,3,16,389
_NamingContextStub.java,Java,,281,28,177,486
Parameter.java,Java,,14,6,6,26
AnySeqHelper.java,Java,,46,10,6,62
DynAny.java,Java,,4,4,73,81
DynAnyFactory.java,Java,,4,4,27,35
DynAnyFactoryHelper.java,Java,,67,13,27,107
DynAnyFactoryOperations.java,Java,,6,6,68,80
InconsistentTypeCode.java,Java,,12,7,6,25
InconsistentTypeCodeHelper.java,Java,,54,10,8,72
DynAnyHelper.java,Java,,67,13,73,153
DynAnyOperations.java,Java,,54,54,461,569
InvalidValue.java,Java,,12,7,6,25
InvalidValueHelper.java,Java,,54,10,8,72
TypeMismatch.java,Java,,12,7,6,25
TypeMismatchHelper.java,Java,,54,10,8,72
DynAnySeqHelper.java,Java,,46,10,6,62
DynArray.java,Java,,4,4,11,19
DynArrayHelper.java,Java,,67,13,11,91
DynArrayOperations.java,Java,,8,8,29,45
DynEnum.java,Java,,4,4,10,18
DynEnumHelper.java,Java,,67,13,10,90
DynEnumOperations.java,Java,,8,8,30,46
DynFixed.java,Java,,4,4,11,19
DynFixedHelper.java,Java,,67,13,11,91
DynFixedOperations.java,Java,,6,6,26,38
DynSequence.java,Java,,4,4,9,17
DynSequenceHelper.java,Java,,67,13,9,89
DynSequenceOperations.java,Java,,10,10,57,77
DynStruct.java,Java,,4,4,10,18
DynStructHelper.java,Java,,67,13,10,90
DynStructOperations.java,Java,,10,10,66,86
DynUnion.java,Java,,4,4,16,24
DynUnionHelper.java,Java,,67,13,16,96
DynUnionOperations.java,Java,,13,13,75,101
DynValue.java,Java,,4,4,18,26
DynValueBox.java,Java,,4,4,13,21
DynValueBoxOperations.java,Java,,8,8,37,53
DynValueCommon.java,Java,,4,4,9,17
DynValueCommonOperations.java,Java,,7,7,20,34
DynValueHelper.java,Java,,67,13,18,98
DynValueOperations.java,Java,,10,10,80,100
FieldNameHelper.java,Java,,40,10,6,56
NameDynAnyPair.java,Java,,14,8,12,34
NameDynAnyPairHelper.java,Java,,67,10,6,83
NameDynAnyPairSeqHelper.java,Java,,46,10,6,62
NameValuePair.java,Java,,14,8,12,34
NameValuePairHelper.java,Java,,67,10,6,83
NameValuePairSeqHelper.java,Java,,46,10,6,62
_DynAnyFactoryStub.java,Java,,57,15,69,141
_DynAnyStub.java,Java,,537,159,462,1158
_DynArrayStub.java,Java,,578,171,418,1167
_DynEnumStub.java,Java,,578,171,419,1168
_DynFixedStub.java,Java,,558,165,415,1138
_DynSequenceStub.java,Java,,598,177,446,1221
_DynStructStub.java,Java,,598,177,455,1230
_DynUnionStub.java,Java,,628,186,464,1278
_DynValueStub.java,Java,,629,186,480,1295
Codec.java,Java,,4,4,17,25
CodecFactory.java,Java,,4,4,11,19
CodecFactoryHelper.java,Java,,55,13,11,79
CodecFactoryOperations.java,Java,,5,5,19,29
UnknownEncoding.java,Java,,12,7,6,25
UnknownEncodingHelper.java,Java,,54,10,8,72
CodecOperations.java,Java,,8,8,61,77
FormatMismatch.java,Java,,12,7,6,25
FormatMismatchHelper.java,Java,,54,10,8,72
InvalidTypeForEncoding.java,Java,,12,7,6,25
InvalidTypeForEncodingHelper.java,Java,,54,10,8,72
TypeMismatch.java,Java,,12,7,6,25
TypeMismatchHelper.java,Java,,54,10,8,72
CodeSets.java,Java,,5,4,11,20
ComponentIdHelper.java,Java,,40,11,10,61
Encoding.java,Java,,16,9,15,40
ENCODING_CDR_ENCAPS.java,Java,,5,4,10,19
ExceptionDetailMessage.java,Java,,5,4,26,35
IOR.java,Java,,14,8,11,33
IORHelper.java,Java,,72,10,6,88
IORHolder.java,Java,,24,8,6,38
MultipleComponentProfileHelper.java,Java,,46,11,7,64
MultipleComponentProfileHolder.java,Java,,24,10,7,41
ProfileIdHelper.java,Java,,40,11,7,58
RMICustomMaxStreamFormat.java,Java,,5,4,13,22
ServiceContext.java,Java,,14,8,8,30
ServiceContextHelper.java,Java,,71,10,6,87
ServiceContextHolder.java,Java,,24,8,6,38
ServiceContextListHelper.java,Java,,46,11,7,64
ServiceContextListHolder.java,Java,,24,10,7,41
ServiceIdHelper.java,Java,,40,11,7,58
TaggedComponent.java,Java,,14,8,8,30
TaggedComponentHelper.java,Java,,71,10,6,87
TaggedComponentHolder.java,Java,,24,8,6,38
TaggedProfile.java,Java,,14,8,8,30
TaggedProfileHelper.java,Java,,71,10,6,87
TaggedProfileHolder.java,Java,,24,8,6,38
TAG_ALTERNATE_IIOP_ADDRESS.java,Java,,5,4,32,41
TAG_CODE_SETS.java,Java,,5,4,16,25
TAG_INTERNET_IOP.java,Java,,5,4,31,40
TAG_JAVA_CODEBASE.java,Java,,5,4,19,28
TAG_MULTIPLE_COMPONENTS.java,Java,,5,4,17,26
TAG_ORB_TYPE.java,Java,,5,4,24,33
TAG_POLICIES.java,Java,,5,4,10,19
TAG_RMI_CUSTOM_MAX_STREAM_FORMAT.java,Java,,5,4,15,24
TransactionService.java,Java,,5,4,11,20
SyncScopeHelper.java,Java,,40,11,7,58
SYNC_WITH_TRANSPORT.java,Java,,5,4,10,19
ACTIVE.java,Java,,5,4,8,17
AdapterManagerIdHelper.java,Java,,40,11,12,63
AdapterNameHelper.java,Java,,42,11,9,62
AdapterStateHelper.java,Java,,40,11,9,60
ClientRequestInfo.java,Java,,4,4,220,228
ClientRequestInfoOperations.java,Java,,13,13,319,345
ClientRequestInterceptor.java,Java,,4,4,22,30
ClientRequestInterceptorOperations.java,Java,,9,9,175,193
Current.java,Java,,4,4,23,31
CurrentHelper.java,Java,,55,13,23,91
CurrentOperations.java,Java,,6,6,52,64
DISCARDING.java,Java,,5,4,8,17
ForwardRequest.java,Java,,19,9,9,37
ForwardRequestHelper.java,Java,,61,10,8,79
HOLDING.java,Java,,5,4,9,18
INACTIVE.java,Java,,5,4,9,18
Interceptor.java,Java,,4,4,9,17
InterceptorOperations.java,Java,,6,6,38,50
InvalidSlot.java,Java,,12,7,6,25
InvalidSlotHelper.java,Java,,54,10,8,72
IORInfo.java,Java,,4,4,14,22
IORInfoOperations.java,Java,,12,12,82,106
IORInterceptor.java,Java,,4,4,20,28
IORInterceptorOperations.java,Java,,5,5,40,50
IORInterceptor_3_0.java,Java,,4,3,6,13
IORInterceptor_3_0Helper.java,Java,,55,12,6,73
IORInterceptor_3_0Holder.java,Java,,24,8,6,38
IORInterceptor_3_0Operations.java,Java,,7,6,34,47
LOCATION_FORWARD.java,Java,,5,4,15,24
NON_EXISTENT.java,Java,,5,4,8,17
ObjectIdHelper.java,Java,,42,11,9,62
ObjectReferenceFactory.java,Java,,5,6,13,24
ObjectReferenceFactoryHelper.java,Java,,52,13,9,74
ObjectReferenceFactoryHolder.java,Java,,24,9,9,42
ObjectReferenceTemplate.java,Java,,7,7,13,27
ObjectReferenceTemplateHelper.java,Java,,52,13,13,78
ObjectReferenceTemplateHolder.java,Java,,24,9,13,46
ObjectReferenceTemplateSeqHelper.java,Java,,46,11,9,66
ObjectReferenceTemplateSeqHolder.java,Java,,24,10,9,43
ORBIdHelper.java,Java,,40,11,7,58
ORBInitializer.java,Java,,4,4,116,124
ORBInitializerOperations.java,Java,,6,6,144,156
ORBInitInfo.java,Java,,4,4,19,27
ORBInitInfoOperations.java,Java,,14,14,106,134
DuplicateName.java,Java,,19,9,9,37
DuplicateNameHelper.java,Java,,61,10,8,79
InvalidName.java,Java,,12,7,6,25
InvalidNameHelper.java,Java,,54,10,8,72
ObjectIdHelper.java,Java,,40,11,7,58
PolicyFactory.java,Java,,4,4,19,27
PolicyFactoryOperations.java,Java,,5,5,40,50
RequestInfo.java,Java,,4,4,21,29
RequestInfoOperations.java,Java,,18,18,256,292
ServerIdHelper.java,Java,,40,11,7,58
ServerRequestInfo.java,Java,,4,4,218,226
ServerRequestInfoOperations.java,Java,,15,15,306,336
ServerRequestInterceptor.java,Java,,4,4,22,30
ServerRequestInterceptorOperations.java,Java,,9,9,180,198
SUCCESSFUL.java,Java,,5,4,15,24
SYSTEM_EXCEPTION.java,Java,,5,4,15,24
TRANSPORT_RETRY.java,Java,,5,4,15,24
UNKNOWN.java,Java,,5,4,9,18
USER_EXCEPTION.java,Java,,5,4,15,24
AdapterActivator.java,Java,,4,4,13,21
AdapterActivatorOperations.java,Java,,5,5,26,36
Current.java,Java,,4,4,24,32
CurrentHelper.java,Java,,52,13,30,95
CurrentOperations.java,Java,,6,6,44,56
NoContext.java,Java,,12,7,6,25
NoContextHelper.java,Java,,54,10,8,72
DynamicImplementation.java,Java,,4,2,19,25
ForwardRequest.java,Java,,19,8,6,33
ForwardRequestHelper.java,Java,,61,10,8,79
IdAssignmentPolicy.java,Java,,4,4,11,19
IdAssignmentPolicyOperations.java,Java,,5,5,14,24
IdAssignmentPolicyValue.java,Java,,27,8,15,50
IdUniquenessPolicy.java,Java,,4,4,11,19
IdUniquenessPolicyOperations.java,Java,,5,5,14,24
IdUniquenessPolicyValue.java,Java,,27,8,13,48
ID_ASSIGNMENT_POLICY_ID.java,Java,,5,4,9,18
ID_UNIQUENESS_POLICY_ID.java,Java,,5,4,9,18
ImplicitActivationPolicy.java,Java,,4,4,10,18
ImplicitActivationPolicyOperations.java,Java,,5,5,13,23
ImplicitActivationPolicyValue.java,Java,,27,8,15,50
IMPLICIT_ACTIVATION_POLICY_ID.java,Java,,5,4,9,18
LifespanPolicy.java,Java,,4,4,11,19
LifespanPolicyOperations.java,Java,,5,5,14,24
LifespanPolicyValue.java,Java,,27,8,14,49
LIFESPAN_POLICY_ID.java,Java,,5,4,9,18
POA.java,Java,,4,4,16,24
POAHelper.java,Java,,50,12,22,84
POAManager.java,Java,,4,4,12,20
POAManagerOperations.java,Java,,9,9,60,78
AdapterInactive.java,Java,,12,7,6,25
AdapterInactiveHelper.java,Java,,54,10,8,72
State.java,Java,,31,8,9,48
POAOperations.java,Java,,36,36,395,467
AdapterAlreadyExists.java,Java,,12,7,6,25
AdapterAlreadyExistsHelper.java,Java,,54,10,8,72
AdapterNonExistent.java,Java,,12,7,6,25
AdapterNonExistentHelper.java,Java,,54,10,8,72
InvalidPolicy.java,Java,,19,8,6,33
InvalidPolicyHelper.java,Java,,61,10,8,79
NoServant.java,Java,,12,7,6,25
NoServantHelper.java,Java,,54,10,8,72
ObjectAlreadyActive.java,Java,,12,7,6,25
ObjectAlreadyActiveHelper.java,Java,,54,10,8,72
ObjectNotActive.java,Java,,12,7,6,25
ObjectNotActiveHelper.java,Java,,54,10,8,72
ServantAlreadyActive.java,Java,,12,7,6,25
ServantAlreadyActiveHelper.java,Java,,54,10,8,72
ServantNotActive.java,Java,,12,7,6,25
ServantNotActiveHelper.java,Java,,54,10,8,72
WrongAdapter.java,Java,,12,7,6,25
WrongAdapterHelper.java,Java,,54,10,8,72
WrongPolicy.java,Java,,12,7,6,25
WrongPolicyHelper.java,Java,,54,10,8,72
Delegate.java,Java,,13,11,74,98
RequestProcessingPolicy.java,Java,,4,4,11,19
RequestProcessingPolicyOperations.java,Java,,5,5,14,24
RequestProcessingPolicyValue.java,Java,,29,8,24,61
REQUEST_PROCESSING_POLICY_ID.java,Java,,5,4,9,18
Servant.java,Java,,80,18,150,248
ServantActivator.java,Java,,4,4,10,18
ServantActivatorHelper.java,Java,,67,13,10,90
ServantActivatorOperations.java,Java,,6,6,48,60
ServantActivatorPOA.java,Java,,34,13,12,59
ServantLocator.java,Java,,4,4,24,32
ServantLocatorHelper.java,Java,,67,13,24,104
ServantLocatorOperations.java,Java,,6,6,55,67
CookieHolder.java,Java,,18,8,13,39
ServantLocatorPOA.java,Java,,34,13,26,73
ServantManager.java,Java,,4,4,17,25
ServantManagerOperations.java,Java,,4,4,17,25
ServantRetentionPolicy.java,Java,,4,4,10,18
ServantRetentionPolicyOperations.java,Java,,5,5,13,23
ServantRetentionPolicyValue.java,Java,,27,8,14,49
SERVANT_RETENTION_POLICY_ID.java,Java,,5,4,9,18
ThreadPolicy.java,Java,,4,4,11,19
ThreadPolicyOperations.java,Java,,5,5,14,24
ThreadPolicyValue.java,Java,,27,8,13,48
THREAD_POLICY_ID.java,Java,,5,4,9,18
_ServantActivatorStub.java,Java,,58,15,49,122
_ServantLocatorStub.java,Java,,58,15,56,129
RunTime.java,Java,,4,2,22,28
RunTimeOperations.java,Java,,4,2,22,28
_Remote_Stub.java,Java,,11,6,28,45
Attr.java,Java,,11,8,256,275
DOMImplementationRegistry.java,Java,,209,22,169,400
CDATASection.java,Java,,3,2,49,54
CharacterData.java,Java,,23,9,121,153
Comment.java,Java,,3,2,25,30
Counter.java,Java,,6,5,27,38
CSS2Properties.java,Java,,370,125,1282,1777
CSSCharsetRule.java,Java,,7,4,40,51
CSSFontFaceRule.java,Java,,4,3,21,28
CSSImportRule.java,Java,,7,6,31,44
CSSMediaRule.java,Java,,12,7,57,76
CSSPageRule.java,Java,,8,5,31,44
CSSPrimitiveValue.java,Java,,47,12,237,296
CSSRule.java,Java,,17,8,72,97
CSSRuleList.java,Java,,5,4,34,43
CSSStyleDeclaration.java,Java,,19,12,131,162
CSSStyleRule.java,Java,,8,5,34,47
CSSStyleSheet.java,Java,,12,7,66,85
CSSUnknownRule.java,Java,,3,2,17,22
CSSValue.java,Java,,12,6,53,71
CSSValueList.java,Java,,5,4,37,46
DocumentCSS.java,Java,,7,4,39,50
DOMImplementationCSS.java,Java,,8,4,28,40
ElementCSSInlineStyle.java,Java,,4,3,25,32
Rect.java,Java,,7,6,31,44
RGBColor.java,Java,,6,5,36,47
ViewCSS.java,Java,,7,4,32,43
Document.java,Java,,53,29,733,815
DocumentFragment.java,Java,,3,2,48,53
DocumentType.java,Java,,9,8,66,83
DOMConfiguration.java,Java,,11,6,396,413
DOMError.java,Java,,12,9,66,87
DOMErrorHandler.java,Java,,4,3,38,45
DOMException.java,Java,,26,3,104,133
DOMImplementation.java,Java,,15,6,115,136
DOMImplementationList.java,Java,,5,4,34,43
DOMImplementationSource.java,Java,,5,4,49,58
DOMLocator.java,Java,,9,8,41,58
DOMStringList.java,Java,,6,5,39,50
Element.java,Java,,49,22,368,439
Entity.java,Java,,9,8,73,90
EntityReference.java,Java,,3,2,38,43
DocumentEvent.java,Java,,6,4,46,56
Event.java,Java,,18,13,110,141
EventException.java,Java,,9,3,24,36
EventListener.java,Java,,4,3,34,41
EventTarget.java,Java,,11,5,86,102
MouseEvent.java,Java,,29,14,113,156
MutationEvent.java,Java,,20,10,78,108
UIEvent.java,Java,,11,6,41,58
HTMLAnchorElement.java,Java,,29,17,66,112
HTMLAppletElement.java,Java,,25,14,64,103
HTMLAreaElement.java,Java,,19,11,49,79
HTMLBaseElement.java,Java,,7,5,22,34
HTMLBaseFontElement.java,Java,,9,6,28,43
HTMLBodyElement.java,Java,,15,9,45,69
HTMLBRElement.java,Java,,5,4,19,28
HTMLButtonElement.java,Java,,15,10,42,67
HTMLCollection.java,Java,,7,7,43,57
HTMLDirectoryElement.java,Java,,5,4,20,29
HTMLDivElement.java,Java,,5,4,19,28
HTMLDListElement.java,Java,,5,4,19,28
HTMLDocument.java,Java,,24,20,111,155
HTMLDOMImplementation.java,Java,,5,5,25,35
HTMLElement.java,Java,,14,9,43,66
HTMLFieldSetElement.java,Java,,4,4,20,28
HTMLFontElement.java,Java,,9,6,28,43
HTMLFormElement.java,Java,,19,13,55,87
HTMLFrameElement.java,Java,,21,13,52,86
HTMLFrameSetElement.java,Java,,7,5,23,35
HTMLHeadElement.java,Java,,5,4,19,28
HTMLHeadingElement.java,Java,,5,4,20,29
HTMLHRElement.java,Java,,11,7,32,50
HTMLHtmlElement.java,Java,,5,4,20,29
HTMLIFrameElement.java,Java,,25,15,59,99
HTMLImageElement.java,Java,,29,16,65,110
HTMLInputElement.java,Java,,41,25,131,197
HTMLIsIndexElement.java,Java,,6,5,24,35
HTMLLabelElement.java,Java,,8,6,28,42
HTMLLegendElement.java,Java,,8,6,29,43
HTMLLIElement.java,Java,,7,5,24,36
HTMLLinkElement.java,Java,,21,12,51,84
HTMLMapElement.java,Java,,6,5,22,33
HTMLMenuElement.java,Java,,5,4,20,29
HTMLMetaElement.java,Java,,11,7,31,49
HTMLModElement.java,Java,,7,5,24,36
HTMLObjectElement.java,Java,,40,23,97,160
HTMLOListElement.java,Java,,9,6,27,42
HTMLOptGroupElement.java,Java,,7,5,24,36
HTMLOptionElement.java,Java,,16,11,51,78
HTMLParagraphElement.java,Java,,5,4,19,28
HTMLParamElement.java,Java,,11,7,33,51
HTMLPreElement.java,Java,,5,4,19,28
HTMLQuoteElement.java,Java,,5,4,20,29
HTMLScriptElement.java,Java,,17,10,40,67
HTMLSelectElement.java,Java,,28,19,87,134
HTMLStyleElement.java,Java,,9,6,27,42
HTMLTableCaptionElement.java,Java,,5,4,19,28
HTMLTableCellElement.java,Java,,32,18,76,126
HTMLTableColElement.java,Java,,15,9,39,63
HTMLTableElement.java,Java,,40,26,123,189
HTMLTableRowElement.java,Java,,21,14,68,103
HTMLTableSectionElement.java,Java,,17,11,57,85
HTMLTextAreaElement.java,Java,,26,17,71,114
HTMLTitleElement.java,Java,,5,4,18,27
HTMLUListElement.java,Java,,7,5,23,35
DOMImplementationLS.java,Java,,12,8,102,122
LSException.java,Java,,10,3,34,47
LSInput.java,Java,,19,10,189,218
LSLoadEvent.java,Java,,7,5,23,35
LSOutput.java,Java,,11,6,89,106
LSParser.java,Java,,26,12,428,466
LSParserFilter.java,Java,,12,7,153,172
LSProgressEvent.java,Java,,7,6,35,48
LSResourceResolver.java,Java,,8,3,70,81
LSSerializer.java,Java,,19,9,408,436
LSSerializerFilter.java,Java,,5,4,54,63
NamedNodeMap.java,Java,,18,10,155,183
NameList.java,Java,,9,7,52,68
Node.java,Java,,74,38,812,924
NodeList.java,Java,,5,4,32,41
Notation.java,Java,,5,4,31,40
ProcessingInstruction.java,Java,,7,4,40,51
DocumentRange.java,Java,,4,3,26,33
Range.java,Java,,61,28,327,416
RangeException.java,Java,,10,3,26,39
DocumentStyle.java,Java,,4,3,27,34
LinkStyle.java,Java,,4,3,24,31
MediaList.java,Java,,13,8,64,85
StyleSheet.java,Java,,12,10,81,103
StyleSheetList.java,Java,,5,4,33,42
Text.java,Java,,9,6,143,158
DocumentTraversal.java,Java,,15,5,73,93
NodeFilter.java,Java,,21,6,117,144
NodeIterator.java,Java,,14,10,85,109
TreeWalker.java,Java,,19,15,145,179
TypeInfo.java,Java,,12,6,167,185
UserDataHandler.java,Java,,13,4,55,72
AbstractView.java,Java,,4,3,20,27
DocumentView.java,Java,,4,3,23,30
XPathEvaluator.java,Java,,15,7,111,133
XPathException.java,Java,,10,3,26,39
XPathExpression.java,Java,,9,5,52,66
XPathNamespace.java,Java,,7,6,52,65
XPathNSResolver.java,Java,,4,4,27,35
XPathResult.java,Java,,31,14,167,212
AttributeList.java,Java,,9,21,163,193
Attributes.java,Java,,16,34,207,257
ContentHandler.java,Java,,27,25,367,419
DocumentHandler.java,Java,,18,20,194,232
DTDHandler.java,Java,,12,8,97,117
EntityResolver.java,Java,,7,8,104,119
ErrorHandler.java,Java,,9,11,119,139
Attributes2.java,Java,,11,9,112,132
Attributes2Impl.java,Java,,129,46,133,308
DeclHandler.java,Java,,18,13,115,146
DefaultHandler2.java,Java,,55,24,51,130
EntityResolver2.java,Java,,17,6,174,197
LexicalHandler.java,Java,,20,18,174,212
Locator2.java,Java,,7,5,63,75
Locator2Impl.java,Java,,26,15,60,101
HandlerBase.java,Java,,61,42,266,369
AttributeListImpl.java,Java,,90,43,179,312
AttributesImpl.java,Java,,255,75,288,618
DefaultHandler.java,Java,,86,51,330,467
LocatorImpl.java,Java,,51,36,127,214
NamespaceSupport.java,Java,,277,93,454,824
NewInstance.java,Java,,24,6,33,63
ParserAdapter.java,Java,,452,142,452,1046
ParserFactory.java,Java,,31,11,81,123
SecuritySupport.java,Java,,63,12,15,90
XMLFilterImpl.java,Java,,255,106,352,713
XMLReaderAdapter.java,Java,,178,85,275,538
XMLReaderFactory.java,Java,,87,19,113,219
InputSource.java,Java,,65,36,235,336
Locator.java,Java,,7,13,116,136
Parser.java,Java,,16,19,174,209
SAXException.java,Java,,48,24,91,163
SAXNotRecognizedException.java,Java,,13,8,34,55
SAXNotSupportedException.java,Java,,13,7,35,55
SAXParseException.java,Java,,63,34,174,271
XMLFilter.java,Java,,6,8,51,65
XMLReader.java,Java,,25,40,339,404
Serializable.java,Java,,3,3,30,36
EventListener.java,Java,,3,3,30,36
EventObject.java,Java,,7,6,30,43
