Activator.java,Java,,4,3,6,13
ActivatorHelper.java,Java,,53,11,6,70
ActivatorHolder.java,Java,,24,8,6,38
ActivatorOperations.java,Java,,12,11,14,37
BadServerDefinition.java,Java,,19,8,6,33
BadServerDefinitionHelper.java,Java,,61,10,8,79
BadServerDefinitionHolder.java,Java,,24,8,6,38
EndPointInfo.java,Java,,14,7,7,28
EndPointInfoHelper.java,Java,,67,11,7,85
EndPointInfoHolder.java,Java,,24,9,7,40
EndpointInfoListHelper.java,Java,,46,10,6,62
EndpointInfoListHolder.java,Java,,24,9,6,39
IIOP_CLEAR_TEXT.java,Java,,5,4,7,16
InitialNameService.java,Java,,4,3,6,13
InitialNameServiceHelper.java,Java,,53,11,6,70
InitialNameServiceHolder.java,Java,,24,8,6,38
InitialNameServiceOperations.java,Java,,5,4,7,16
NameAlreadyBound.java,Java,,12,7,6,25
NameAlreadyBoundHelper.java,Java,,54,10,8,72
NameAlreadyBoundHolder.java,Java,,24,8,6,38
InvalidORBid.java,Java,,12,7,6,25
InvalidORBidHelper.java,Java,,54,10,8,72
InvalidORBidHolder.java,Java,,24,8,6,38
Locator.java,Java,,4,3,6,13
LocatorHelper.java,Java,,53,11,6,70
LocatorHolder.java,Java,,24,8,6,38
LocatorOperations.java,Java,,8,7,10,25
ServerLocation.java,Java,,14,7,7,28
ServerLocationHelper.java,Java,,68,11,7,86
ServerLocationHolder.java,Java,,24,9,7,40
ServerLocationPerORB.java,Java,,14,7,7,28
ServerLocationPerORBHelper.java,Java,,68,11,7,86
ServerLocationPerORBHolder.java,Java,,24,9,7,40
NoSuchEndPoint.java,Java,,12,7,6,25
NoSuchEndPointHelper.java,Java,,54,10,8,72
NoSuchEndPointHolder.java,Java,,24,8,6,38
ORBAlreadyRegistered.java,Java,,19,8,6,33
ORBAlreadyRegisteredHelper.java,Java,,62,10,8,80
ORBAlreadyRegisteredHolder.java,Java,,24,8,6,38
ORBidHelper.java,Java,,40,11,7,58
ORBidListHelper.java,Java,,47,10,6,63
ORBidListHolder.java,Java,,24,9,6,39
ORBPortInfo.java,Java,,14,7,7,28
ORBPortInfoHelper.java,Java,,68,11,7,86
ORBPortInfoHolder.java,Java,,24,9,7,40
ORBPortInfoListHelper.java,Java,,46,10,6,62
ORBPortInfoListHolder.java,Java,,24,9,6,39
POANameHelper.java,Java,,46,10,6,62
POANameHolder.java,Java,,24,9,6,39
Repository.java,Java,,4,3,6,13
RepositoryHelper.java,Java,,53,11,6,70
RepositoryHolder.java,Java,,24,8,6,38
RepositoryOperations.java,Java,,13,12,15,40
ServerDef.java,Java,,20,10,10,40
ServerDefHelper.java,Java,,87,11,7,105
ServerDefHolder.java,Java,,24,9,7,40
StringSeqHelper.java,Java,,46,10,6,62
StringSeqHolder.java,Java,,24,9,6,39
Server.java,Java,,4,4,8,16
ServerAlreadyActive.java,Java,,19,8,6,33
ServerAlreadyActiveHelper.java,Java,,62,10,8,80
ServerAlreadyActiveHolder.java,Java,,24,8,6,38
ServerAlreadyInstalled.java,Java,,19,8,6,33
ServerAlreadyInstalledHelper.java,Java,,62,10,8,80
ServerAlreadyInstalledHolder.java,Java,,24,8,6,38
ServerAlreadyRegistered.java,Java,,19,8,6,33
ServerAlreadyRegisteredHelper.java,Java,,62,10,8,80
ServerAlreadyRegisteredHolder.java,Java,,24,8,6,38
ServerAlreadyUninstalled.java,Java,,19,8,6,33
ServerAlreadyUninstalledHelper.java,Java,,62,10,8,80
ServerAlreadyUninstalledHolder.java,Java,,24,8,6,38
ServerHeldDown.java,Java,,19,8,6,33
ServerHeldDownHelper.java,Java,,62,10,8,80
ServerHeldDownHolder.java,Java,,24,8,6,38
ServerHelper.java,Java,,53,12,8,73
ServerHolder.java,Java,,24,9,8,41
ServerIdHelper.java,Java,,40,10,6,56
ServerIdsHelper.java,Java,,47,10,6,63
ServerIdsHolder.java,Java,,24,9,6,39
ServerManager.java,Java,,4,3,6,13
ServerManagerHelper.java,Java,,53,11,6,70
ServerManagerHolder.java,Java,,24,8,6,38
ServerManagerOperations.java,Java,,4,3,6,13
ServerNotActive.java,Java,,19,8,6,33
ServerNotActiveHelper.java,Java,,62,10,8,80
ServerNotActiveHolder.java,Java,,24,8,6,38
ServerNotRegistered.java,Java,,19,8,6,33
ServerNotRegisteredHelper.java,Java,,62,10,8,80
ServerNotRegisteredHolder.java,Java,,24,8,6,38
ServerOperations.java,Java,,7,7,16,30
TCPPortHelper.java,Java,,40,10,6,56
_ActivatorImplBase.java,Java,,165,28,16,209
_ActivatorStub.java,Java,,213,23,15,251
_InitialNameServiceImplBase.java,Java,,48,14,9,71
_InitialNameServiceStub.java,Java,,49,9,8,66
_LocatorImplBase.java,Java,,108,20,12,140
_LocatorStub.java,Java,,125,15,11,151
_RepositoryImplBase.java,Java,,159,30,17,206
_RepositoryStub.java,Java,,219,25,16,260
_ServerImplBase.java,Java,,54,19,18,91
_ServerManagerImplBase.java,Java,,242,36,20,298
_ServerManagerStub.java,Java,,314,31,19,364
_ServerStub.java,Java,,77,14,17,108
Connection.java,Java,,5,3,9,17
EndPointInfo.java,Java,,7,5,12,24
GetEndPointInfoAgainException.java,Java,,14,5,13,32
ORBSocketFactory.java,Java,,19,15,325,359
ServantCachingPolicy.java,Java,,28,9,8,45
IORInfoExt.java,Java,,7,2,6,15
RequestInfoExt.java,Java,,6,4,17,27
UnknownType.java,Java,,14,3,6,23
BootStrapActivation.java,Java,,95,24,14,133
CommandHandler.java,Java,,13,8,11,32
InitialNamingImpl.java,Java,,35,8,13,56
MinorCodes.java,Java,,11,5,19,35
NameServiceStartThread.java,Java,,36,7,9,52
ORBD.java,Java,,241,50,54,345
ProcessMonitorThread.java,Java,,49,12,21,82
RepositoryImpl.java,Java,,344,79,46,469
ServerMain.java,Java,,245,71,64,380
ServerManagerImpl.java,Java,,453,110,52,615
ServerTableEntry.java,Java,,363,88,70,521
ServerTool.java,Java,,729,164,61,954
AnyImpl.java,Java,,789,185,520,1494
AnyImplHelper.java,Java,,37,9,17,63
AsynchInvoke.java,Java,,26,16,36,78
ClientDelegate.java,Java,,639,170,293,1102
ContextImpl.java,Java,,47,16,14,77
ContextListImpl.java,Java,,43,10,15,68
CorbaLoc.java,Java,,48,9,19,76
CorbaName.java,Java,,32,9,16,57
CORBAObjectImpl.java,Java,,8,2,17,27
EncapsInputStream.java,Java,,60,17,45,122
EncapsOutputStream.java,Java,,47,14,38,99
EnvironmentImpl.java,Java,,22,9,14,45
ExceptionListImpl.java,Java,,40,14,14,68
HostInfo.java,Java,,40,14,17,71
InitialNamingClient.java,Java,,839,100,309,1248
INSSubcontract.java,Java,,66,25,32,123
NamedValueImpl.java,Java,,38,8,16,62
NVListImpl.java,Java,,65,16,16,97
ORB.java,Java,,1606,338,763,2707
ORBSingleton.java,Java,,391,107,89,587
PrincipalImpl.java,Java,,13,5,14,32
RequestImpl.java,Java,,382,101,165,648
ServerDelegate.java,Java,,374,113,142,629
ServerRequestImpl.java,Java,,134,43,62,239
SpecialMethod.java,Java,,92,17,6,115
TCUtility.java,Java,,226,56,25,307
TypeCodeFactory.java,Java,,5,2,6,13
TypeCodeImpl.java,Java,,2048,339,537,2924
TypeCodeImplHelper.java,Java,,37,9,14,60
ClientGIOP.java,Java,,9,8,24,41
ClientRequest.java,Java,,4,10,45,59
ClientResponse.java,Java,,6,4,10,20
ClientSubcontract.java,Java,,15,12,46,73
Closure.java,Java,,4,2,6,12
CodeSetCache.java,Java,,34,15,44,93
CodeSetComponentInfo.java,Java,,162,51,67,280
CodeSetConversion.java,Java,,306,109,259,674
CodeSetServiceContext.java,Java,,33,9,7,49
Constant.java,Java,,13,6,6,25
DuplicateServiceContext.java,Java,,12,4,9,25
EndPoint.java,Java,,10,8,30,48
Future.java,Java,,21,6,6,33
GIOPVersion.java,Java,,108,39,29,176
INSObjectKeyEntry.java,Java,,16,5,15,36
INSObjectKeyMap.java,Java,,23,11,18,52
InternalRuntimeForwardRequest.java,Java,,9,2,21,32
IOR.java,Java,,330,86,66,482
MarshalInputStream.java,Java,,44,10,30,84
MarshalOutputStream.java,Java,,46,13,12,71
NoSuchServiceContext.java,Java,,12,4,9,25
ORB.java,Java,,22,19,63,104
ORBVersion.java,Java,,11,10,21,42
ORBVersionFactory.java,Java,,28,7,14,49
ORBVersionImpl.java,Java,,44,16,10,70
ORBVersionServiceContext.java,Java,,38,12,12,62
OSFCodeSetRegistry.java,Java,,104,21,87,212
Request.java,Java,,11,12,37,60
RequestHandler.java,Java,,7,5,17,29
Response.java,Java,,13,15,43,71
SendingContextServiceContext.java,Java,,33,9,7,49
ServerGIOP.java,Java,,15,14,55,84
ServerRequest.java,Java,,23,18,34,75
ServerResponse.java,Java,,3,2,10,15
ServerSubcontract.java,Java,,15,13,52,80
ServiceContext.java,Java,,39,13,52,104
ServiceContextData.java,Java,,112,21,13,146
ServiceContextRegistry.java,Java,,50,13,17,80
ServiceContexts.java,Java,,218,80,106,404
StandardIIOPProfileTemplate.java,Java,,31,9,8,48
SubcontractRegistry.java,Java,,142,30,49,221
UEInfoServiceContext.java,Java,,37,12,7,56
UnknownServiceContext.java,Java,,36,11,6,53
BindingIteratorImpl.java,Java,,55,17,92,164
BootstrapServer.java,Java,,262,61,193,516
InternalBindingKey.java,Java,,52,8,24,84
InternalBindingValue.java,Java,,15,5,13,33
InterOperableNamingImpl.java,Java,,297,22,77,396
MinorCodes.java,Java,,23,24,71,118
NamingContextDataStore.java,Java,,25,11,61,97
NamingContextImpl.java,Java,,449,61,421,931
NamingUtils.java,Java,,44,13,42,99
NSORB.java,Java,,43,15,9,67
TransientBindingIterator.java,Java,,59,10,49,118
TransientNameServer.java,Java,,113,32,56,201
TransientNameService.java,Java,,71,17,53,141
TransientNamingContext.java,Java,,151,31,131,313
DynAnyBasicImpl.java,Java,,535,56,25,616
DynAnyCollectionImpl.java,Java,,116,24,45,185
DynAnyComplexImpl.java,Java,,278,39,85,402
DynAnyConstructedImpl.java,Java,,790,71,57,918
DynAnyFactoryImpl.java,Java,,34,14,18,66
DynAnyImpl.java,Java,,109,24,37,170
DynAnyUtil.java,Java,,211,15,89,315
DynArrayImpl.java,Java,,65,17,37,119
DynEnumImpl.java,Java,,109,20,40,169
DynFixedImpl.java,Java,,121,10,59,190
DynSequenceImpl.java,Java,,129,24,85,238
DynStructImpl.java,Java,,40,9,19,68
DynUnionImpl.java,Java,,249,31,86,366
DynValueBoxImpl.java,Java,,88,14,12,114
DynValueCommonImpl.java,Java,,79,17,32,128
DynValueImpl.java,Java,,25,6,9,40
AddressingDispositionException.java,Java,,11,6,21,38
BufferManagerFactory.java,Java,,120,24,84,228
BufferManagerRead.java,Java,,14,14,46,74
BufferManagerReadGrow.java,Java,,38,14,8,60
BufferManagerReadStream.java,Java,,100,32,20,152
BufferManagerWrite.java,Java,,17,19,83,119
BufferManagerWriteCollect.java,Java,,69,30,26,125
BufferManagerWriteGrow.java,Java,,44,17,41,102
BufferManagerWriteStream.java,Java,,57,29,55,141
BufferQueue.java,Java,,24,6,11,41
ByteBufferWithInfo.java,Java,,48,10,8,66
CachedCodeBase.java,Java,,94,38,42,174
CDRInputStream.java,Java,,354,110,66,530
CDRInputStreamBase.java,Java,,145,38,41,224
CDRInputStream_1_0.java,Java,,1517,453,371,2341
CDRInputStream_1_1.java,Java,,77,44,45,166
CDRInputStream_1_2.java,Java,,35,13,24,72
CDROutputStream.java,Java,,313,70,34,417
CDROutputStreamBase.java,Java,,103,31,23,157
CDROutputStream_1_0.java,Java,,1268,411,321,2000
CDROutputStream_1_1.java,Java,,59,30,48,137
CDROutputStream_1_2.java,Java,,132,62,123,317
ClientRequestImpl.java,Java,,64,15,9,88
ClientResponseImpl.java,Java,,95,21,10,126
Connection.java,Java,,132,48,54,234
ConnectionTable.java,Java,,235,55,67,357
DefaultSocketFactory.java,Java,,54,9,6,69
EndPointImpl.java,Java,,69,13,6,88
ForwardException.java,Java,,13,6,9,28
GIOPImpl.java,Java,,210,47,53,310
IIOPConnection.java,Java,,557,157,307,1021
IIOPInputStream.java,Java,,139,48,72,259
IIOPOutputStream.java,Java,,178,58,76,312
ListenerThread.java,Java,,70,18,20,108
LocalClientRequestImpl.java,Java,,78,22,15,115
LocalClientResponseImpl.java,Java,,96,24,23,143
LocalServerRequestImpl.java,Java,,132,37,18,187
LocalServerResponseImpl.java,Java,,109,29,33,171
MarkAndResetHandler.java,Java,,7,4,10,21
MessageMediator.java,Java,,322,130,163,615
AddressingDispositionHelper.java,Java,,40,11,12,63
CancelRequestMessage.java,Java,,5,3,12,20
CancelRequestMessage_1_0.java,Java,,28,15,16,59
CancelRequestMessage_1_1.java,Java,,28,15,16,59
CancelRequestMessage_1_2.java,Java,,28,15,16,59
FragmentMessage.java,Java,,5,3,12,20
FragmentMessage_1_1.java,Java,,29,13,20,62
FragmentMessage_1_2.java,Java,,55,16,20,91
IORAddressingInfo.java,Java,,14,7,12,33
IORAddressingInfoHelper.java,Java,,66,11,12,89
KeyAddr.java,Java,,5,4,12,21
LocateReplyMessage.java,Java,,16,6,12,34
LocateReplyMessage_1_0.java,Java,,73,23,20,116
LocateReplyMessage_1_1.java,Java,,74,23,20,117
LocateReplyMessage_1_2.java,Java,,115,33,30,178
LocateRequestMessage.java,Java,,6,4,12,22
LocateRequestMessage_1_0.java,Java,,48,17,17,82
LocateRequestMessage_1_1.java,Java,,49,17,17,83
LocateRequestMessage_1_2.java,Java,,46,17,17,80
Message.java,Java,,30,15,17,62
MessageBase.java,Java,,516,82,111,709
Message_1_0.java,Java,,66,23,31,120
Message_1_1.java,Java,,85,27,44,156
Message_1_2.java,Java,,30,9,11,50
ProfileAddr.java,Java,,5,4,12,21
ReferenceAddr.java,Java,,5,4,12,21
ReplyMessage.java,Java,,20,6,14,40
ReplyMessage_1_0.java,Java,,130,33,22,185
ReplyMessage_1_1.java,Java,,131,33,22,186
ReplyMessage_1_2.java,Java,,140,35,31,206
RequestMessage.java,Java,,14,7,12,33
RequestMessage_1_0.java,Java,,95,22,18,135
RequestMessage_1_1.java,Java,,111,22,17,150
RequestMessage_1_2.java,Java,,107,26,33,166
TargetAddress.java,Java,,77,17,12,106
TargetAddressHelper.java,Java,,108,14,15,137
ORB.java,Java,,329,94,150,573
ORBThread.java,Java,,3,1,6,10
ReaderThread.java,Java,,78,17,66,161
RequestCanceledException.java,Java,,10,5,9,24
RequestProcessor.java,Java,,150,59,75,284
RestorableInputStream.java,Java,,6,2,11,19
ServerRequestImpl.java,Java,,200,52,39,291
ServerResponseImpl.java,Java,,124,25,34,183
ShutdownUtilDelegate.java,Java,,154,43,63,260
CDREncapsCodec.java,Java,,91,30,79,200
ClientRequestInfoImpl.java,Java,,528,125,323,976
CodecFactoryImpl.java,Java,,50,16,37,103
InterceptorInvoker.java,Java,,314,69,226,609
InterceptorList.java,Java,,127,30,83,240
IORInfoImpl.java,Java,,83,19,79,181
MinorCodes.java,Java,,74,14,41,129
ORBInitInfoImpl.java,Java,,157,46,121,324
PICurrent.java,Java,,69,23,61,153
PIORB.java,Java,,651,167,465,1283
RequestInfoImpl.java,Java,,459,118,404,981
ServerRequestInfoImpl.java,Java,,456,119,298,873
SlotTable.java,Java,,45,14,33,92
SlotTableStack.java,Java,,76,21,67,164
ThreadCurrentStack.java,Java,,67,20,58,145
FVDCodeBaseImpl.java,Java,,109,41,38,188
IIOPInputStream.java,Java,,1343,280,558,2181
IIOPOutputStream.java,Java,,534,95,147,776
InputStreamHook.java,Java,,100,31,50,181
LibraryManager.java,Java,,62,16,21,99
ObjectStreamClass.java,Java,,841,194,501,1536
ObjectStreamClassCorbaExt.java,Java,,51,14,29,94
ObjectStreamField.java,Java,,149,34,65,248
OptionalDataException.java,Java,,13,6,41,60
OutputStreamHook.java,Java,,68,32,52,152
TypeMismatchException.java,Java,,12,3,14,29
ValueHandlerImpl.java,Java,,542,120,148,810
ValueUtility.java,Java,,321,65,65,451
AlternateIIOPAddressComponent.java,Java,,37,12,29,78
ByteBuffer.java,Java,,80,18,92,190
CodeSetsComponent.java,Java,,37,11,31,79
FreezableList.java,Java,,220,59,14,293
GenericIdEncapsulation.java,Java,,47,15,59,121
GenericTaggedComponent.java,Java,,22,6,16,44
GenericTaggedProfile.java,Java,,28,7,22,57
IdEncapsulation.java,Java,,4,4,10,18
IdEncapsulationBase.java,Java,,41,10,32,83
IdEncapsulationContainerBase.java,Java,,35,5,27,67
IdEncapsulationFactory.java,Java,,6,4,9,19
IdEncapsulationFactoryFinder.java,Java,,7,5,18,30
Identifiable.java,Java,,5,5,16,26
IdentifiableContainerBase.java,Java,,44,10,23,77
IIOPAddress.java,Java,,8,6,10,24
IIOPAddressBase.java,Java,,37,11,16,64
IIOPAddressFutureImpl.java,Java,,24,9,10,43
IIOPAddressImpl.java,Java,,30,10,10,50
IIOPProfile.java,Java,,138,32,33,203
IIOPProfileTemplate.java,Java,,85,24,30,139
IOR.java,Java,,138,40,55,233
IORTemplate.java,Java,,19,6,16,41
JavaCodebaseComponent.java,Java,,37,13,29,79
JIDLObjectKeyTemplate.java,Java,,31,7,18,56
MinorCodes.java,Java,,5,4,9,18
NewObjectKeyTemplateBase.java,Java,,31,7,27,65
ObjectId.java,Java,,21,9,10,40
ObjectIds.java,Java,,3,4,10,17
ObjectKey.java,Java,,45,13,10,68
ObjectKeyFactory.java,Java,,57,17,29,103
ObjectKeyTemplate.java,Java,,20,15,34,69
ObjectKeyTemplateBase.java,Java,,71,16,44,131
OldJIDLObjectKeyTemplate.java,Java,,53,13,38,104
OldObjectKeyTemplateBase.java,Java,,21,5,19,45
OldPOAObjectKeyTemplate.java,Java,,64,15,28,107
ORBTypeComponent.java,Java,,37,13,36,86
POAId.java,Java,,8,6,7,21
POAIdArray.java,Java,,30,10,7,47
POAIdBase.java,Java,,46,15,7,68
POAIdPOAView.java,Java,,42,13,7,62
POAObjectKeyTemplate.java,Java,,81,22,30,133
POAView.java,Java,,6,4,6,16
PoliciesComponent.java,Java,,17,7,29,53
TaggedComponent.java,Java,,6,5,16,27
TaggedComponentBase.java,Java,,16,4,10,30
TaggedComponentFactories.java,Java,,69,17,27,113
TaggedComponentFactoryFinder.java,Java,,55,14,41,110
TaggedProfile.java,Java,,8,6,22,36
TaggedProfileFactoryFinder.java,Java,,27,8,19,54
TaggedProfileTemplate.java,Java,,7,4,10,21
WireObjectKeyTemplate.java,Java,,57,12,20,89
Writeable.java,Java,,6,5,17,28
StubDelegateImpl.java,Java,,166,68,95,329
Util.java,Java,,314,113,173,600
PortableRemoteObject.java,Java,,186,131,135,452
CacheTable.java,Java,,117,1,9,127
Condition.java,Java,,33,9,11,53
CorbaResourceUtil.java,Java,,57,14,6,77
HexOutputStream.java,Java,,30,10,23,63
IIOPInputStream_1_3.java,Java,,19,4,16,39
IIOPInputStream_1_3_1.java,Java,,15,5,15,35
IIOPOutputStream_1_3.java,Java,,24,6,20,50
IIOPOutputStream_1_3_1.java,Java,,20,9,19,48
LegacyHookGetFields.java,Java,,73,24,41,138
LegacyHookPutFields.java,Java,,37,13,42,92
Lock.java,Java,,22,7,10,39
MinorCodes.java,Java,,130,90,371,591
ObjectStreamClassUtil_1_3.java,Java,,370,71,112,553
ObjectStreamClass_1_3_1.java,Java,,713,162,394,1269
ObjectStreamField.java,Java,,149,34,70,253
ORBClassLoader.java,Java,,15,2,12,29
ORBConstants.java,Java,,124,68,103,295
ORBUtility.java,Java,,466,76,120,662
RepIdDelegator.java,Java,,102,31,18,151
RepIdDelegator_1_3.java,Java,,102,31,18,151
RepIdDelegator_1_3_1.java,Java,,102,31,18,151
RepositoryIdCache_1_3.java,Java,,41,18,35,94
RepositoryIdCache_1_3_1.java,Java,,41,18,27,86
RepositoryIdFactory.java,Java,,56,9,20,85
RepositoryIdInterface.java,Java,,14,6,10,30
RepositoryIdStrings.java,Java,,16,9,10,35
RepositoryIdUtility.java,Java,,18,6,15,39
RepositoryId_1_3.java,Java,,671,168,136,975
RepositoryId_1_3_1.java,Java,,717,182,148,1047
sunorb.java,Java,,77,2,0,79
sunorb_de.java,Java,,77,2,0,79
sunorb_es.java,Java,,77,2,0,79
sunorb_fr.java,Java,,78,2,0,80
sunorb_it.java,Java,,77,2,0,79
sunorb_ja.java,Java,,77,2,0,79
sunorb_ko.java,Java,,77,2,0,79
sunorb_sv.java,Java,,77,2,0,79
sunorb_zh_CN.java,Java,,77,2,0,79
sunorb_zh_TW.java,Java,,77,2,0,79
SubcontractList.java,Java,,20,9,18,47
ThreadPool.java,Java,,90,37,60,187
TransientObjectManager.java,Java,,135,37,21,193
ValueHandlerImpl_1_3.java,Java,,124,33,79,236
ValueHandlerImpl_1_3_1.java,Java,,24,7,28,59
Work.java,Java,,6,3,23,32
InternalBindingKey.java,Java,,79,13,41,133
InternalBindingValue.java,Java,,25,8,33,66
NameServer.java,Java,,47,17,21,85
NameService.java,Java,,128,23,75,226
NamingContextImpl.java,Java,,699,103,562,1364
PersistentBindingIterator.java,Java,,66,12,61,139
ServantManagerImpl.java,Java,,180,50,30,260
ActiveObjectMap.java,Java,,137,25,12,174
BadServerIdHandler.java,Java,,7,3,28,38
ClientSC.java,Java,,7,4,12,23
DelegateImpl.java,Java,,92,20,23,135
ForwardException.java,Java,,13,6,24,43
GenericPOAClientSC.java,Java,,270,70,140,480
GenericPOAServerSC.java,Java,,485,122,152,759
IdAssignmentPolicyImpl.java,Java,,30,10,6,46
IdUniquenessPolicyImpl.java,Java,,29,10,6,45
ImplicitActivationPolicyImpl.java,Java,,31,10,6,47
InvocationInfo.java,Java,,35,11,10,56
LifespanPolicyImpl.java,Java,,29,10,6,45
MinorCodes.java,Java,,51,11,38,100
POACurrent.java,Java,,154,30,28,212
POADestroyed.java,Java,,3,1,6,10
POAImpl.java,Java,,864,192,272,1328
POAManagerImpl.java,Java,,159,39,86,284
POAORB.java,Java,,533,125,329,987
POAPolicyCombinationValidator.java,Java,,190,18,50,258
Policies.java,Java,,167,29,17,213
RequestProcessingPolicyImpl.java,Java,,40,11,6,57
ServantCachePOAClientSC.java,Java,,90,22,35,147
ServantRetentionPolicyImpl.java,Java,,29,10,6,45
ShutdownUtilDelegate.java,Java,,23,7,8,38
SpecialMethod.java,Java,,84,16,6,106
SubcontractResponseHandler.java,Java,,87,27,31,145
ThreadPolicyImpl.java,Java,,29,10,6,45
IdentityHashtable.java,Java,,195,37,176,408
JDKBridge.java,Java,,97,22,74,193
JDKClassLoader.java,Java,,116,31,79,226
MinorCodes.java,Java,,14,12,48,74
ORBProperties.java,Java,,29,11,16,56
PackagePrefixChecker.java,Java,,37,14,10,61
RepositoryId.java,Java,,672,177,125,974
RepositoryIdCache.java,Java,,41,18,35,94
SUNVMCID.java,Java,,4,4,15,23
Utility.java,Java,,661,184,268,1113
Version.java,Java,,16,5,14,35
ORB.java,Java,,11,3,25,39
ImageFormatException.java,Java,,10,4,40,54
JPEGCodec.java,Java,,49,13,90,152
JPEGDecodeParam.java,Java,,62,45,264,371
JPEGEncodeParam.java,Java,,27,20,211,258
JPEGHuffmanTable.java,Java,,139,31,73,243
JPEGImageDecoder.java,Java,,23,14,105,142
JPEGImageEncoder.java,Java,,29,23,180,232
JPEGQTable.java,Java,,62,20,70,152
TruncatedFileException.java,Java,,19,8,57,84
InputStreamAdapter.java,Java,,17,8,9,34
StandardMetadataFormat.java,Java,,363,61,57,481
StandardMetadataFormatResources.java,Java,,129,55,8,192
SubImageInputStream.java,Java,,40,10,9,59
GIFImageMetadata.java,Java,,293,70,46,409
GIFImageMetadataFormat.java,Java,,122,16,15,153
GIFImageMetadataFormatResources.java,Java,,70,8,8,86
GIFImageReader.java,Java,,801,161,183,1145
GIFImageReaderSpi.java,Java,,56,17,9,82
GIFStreamMetadata.java,Java,,181,54,35,270
GIFStreamMetadataFormat.java,Java,,67,11,10,88
GIFStreamMetadataFormatResources.java,Java,,37,8,8,53
AdobeMarkerSegment.java,Java,,90,15,14,119
COMMarkerSegment.java,Java,,57,13,46,116
DHTMarkerSegment.java,Java,,177,30,35,242
DQTMarkerSegment.java,Java,,218,26,48,292
DRIMarkerSegment.java,Java,,37,12,17,66
JFIFMarkerSegment.java,Java,,1201,131,215,1547
JPEG.java,Java,,196,48,96,340
JPEGBuffer.java,Java,,134,20,83,237
JPEGImageMetadataFormat.java,Java,,302,37,9,348
JPEGImageMetadataFormatResources.java,Java,,106,7,12,125
JPEGImageReader.java,Java,,897,162,295,1354
JPEGImageReaderResources.java,Java,,13,7,6,26
JPEGImageReaderSpi.java,Java,,68,12,12,92
JPEGImageWriter.java,Java,,1233,164,211,1608
JPEGImageWriterResources.java,Java,,51,7,6,64
JPEGImageWriterSpi.java,Java,,73,16,9,98
JPEGMetadata.java,Java,,1788,186,424,2398
JPEGMetadataFormat.java,Java,,105,17,17,139
JPEGMetadataFormatResources.java,Java,,30,5,8,43
JPEGStreamMetadataFormat.java,Java,,17,6,6,29
JPEGStreamMetadataFormatResources.java,Java,,14,5,9,28
MarkerSegment.java,Java,,139,21,47,207
SOFMarkerSegment.java,Java,,219,25,22,266
SOSMarkerSegment.java,Java,,179,24,20,223
PNGImageReader.java,Java,,1208,224,162,1594
PNGImageReaderSpi.java,Java,,63,16,9,88
PNGImageWriter.java,Java,,860,171,76,1107
PNGImageWriterSpi.java,Java,,75,19,16,110
PNGMetadata.java,Java,,1598,243,151,1992
PNGMetadataFormat.java,Java,,323,118,41,482
PNGMetadataFormatResources.java,Java,,169,24,8,201
RowFilter.java,Java,,132,33,12,177
FileImageInputStreamSpi.java,Java,,30,9,6,45
FileImageOutputStreamSpi.java,Java,,31,9,6,46
InputStreamImageInputStreamSpi.java,Java,,41,12,6,59
OutputStreamImageOutputStreamSpi.java,Java,,41,11,6,58
RAFImageInputStreamSpi.java,Java,,32,9,6,47
RAFImageOutputStreamSpi.java,Java,,33,9,6,48
StreamCloser.java,Java,,61,9,21,91
BluecurveColorType.java,Java,,23,8,17,48
BluecurveEngine.java,Java,,399,28,23,450
BluecurveEngineParser.java,Java,,79,19,16,114
BluecurveStyle.java,Java,,106,17,33,156
BlueprintEngine.java,Java,,871,102,163,1136
BlueprintEngineParser.java,Java,,896,175,39,1110
BlueprintGraphics.java,Java,,26,6,11,43
BlueprintStyle.java,Java,,481,118,91,690
CircularIdentityList.java,Java,,93,16,28,137
ColorType.java,Java,,30,12,37,79
DefaultMenuLayout.java,Java,,18,7,17,42
DefaultSynthStyle.java,Java,,285,39,59,383
GTKColorChooserPanel.java,Java,,852,147,279,1278
GTKColorType.java,Java,,107,14,28,149
GTKConstants.java,Java,,23,16,15,54
GTKEngine.java,Java,,1032,119,95,1246
GTKEngineParser.java,Java,,8,6,64,78
GTKFileChooserUI.java,Java,,848,184,86,1118
GTKGraphics.java,Java,,42,6,21,69
GTKIconFactory.java,Java,,339,51,36,426
GTKLookAndFeel.java,Java,,275,51,112,438
GTKPainter.java,Java,,1082,121,144,1347
GTKParser.java,Java,,1433,356,54,1843
GTKRegion.java,Java,,7,2,13,22
GTKScanner.java,Java,,639,123,15,777
GTKStyle.java,Java,,1701,283,212,2196
GTKStyleFactory.java,Java,,613,95,183,891
GTKTransferable.java,Java,,154,31,80,265
ImagePainter.java,Java,,157,24,25,206
LazyActionMap.java,Java,,96,19,65,180
Metacity.java,Java,,366,71,15,452
MetacityBluecurve.java,Java,,608,112,413,1133
MetacityCrux.java,Java,,464,79,308,851
PangoFonts.java,Java,,72,19,31,122
PixmapEngine.java,Java,,407,34,104,545
PixmapEngineParser.java,Java,,626,117,18,761
PixmapStyle.java,Java,,373,90,76,539
PropertyParser.java,Java,,103,34,10,147
Region.java,Java,,135,59,23,217
gtk.java,Java,,43,2,0,45
gtk_de.java,Java,,43,2,0,45
gtk_es.java,Java,,43,2,0,45
gtk_fr.java,Java,,43,2,0,45
gtk_it.java,Java,,43,2,0,45
gtk_ja.java,Java,,43,2,0,45
gtk_ko.java,Java,,43,2,0,45
gtk_sv.java,Java,,43,2,0,45
gtk_zh_CN.java,Java,,43,2,0,45
gtk_zh_TW.java,Java,,43,2,0,45
SynthArrowButton.java,Java,,46,14,21,81
SynthBorder.java,Java,,55,9,31,95
SynthButtonListener.java,Java,,233,42,44,319
SynthButtonUI.java,Java,,269,59,61,389
SynthCheckBoxMenuItemUI.java,Java,,34,16,15,65
SynthCheckBoxUI.java,Java,,14,6,15,35
SynthColorChooserUI.java,Java,,287,77,18,382
SynthComboBoxUI.java,Java,,1016,227,492,1735
SynthComboPopup.java,Java,,545,122,462,1129
SynthConstants.java,Java,,11,3,33,47
SynthContext.java,Java,,88,25,46,159
SynthDesktopIconUI.java,Java,,219,56,29,304
SynthDesktopPaneUI.java,Java,,505,68,99,672
SynthDragGestureRecognizer.java,Java,,83,25,31,139
SynthDropTargetListener.java,Java,,145,34,104,283
SynthEditorPaneUI.java,Java,,73,11,56,140
SynthEventListener.java,Java,,3,1,9,13
SynthFileChooserUI.java,Java,,762,149,94,1005
SynthFormattedTextFieldUI.java,Java,,11,3,25,39
SynthGraphics.java,Java,,209,38,146,393
SynthIcon.java,Java,,47,10,49,106
SynthInternalFrameTitlePane.java,Java,,494,92,85,671
SynthInternalFrameUI.java,Java,,1137,169,179,1485
SynthLabelUI.java,Java,,239,45,36,320
SynthListUI.java,Java,,1350,279,712,2341
SynthLookAndFeel.java,Java,,364,47,116,527
SynthMenuBarUI.java,Java,,211,48,27,286
SynthMenuItemUI.java,Java,,769,134,162,1065
SynthMenuUI.java,Java,,428,78,79,585
SynthOptionPaneUI.java,Java,,945,171,260,1376
SynthPainter.java,Java,,8,2,24,34
SynthPanelUI.java,Java,,78,24,13,115
SynthPasswordFieldUI.java,Java,,15,7,35,57
SynthPopupMenuUI.java,Java,,897,164,144,1205
SynthProgressBarUI.java,Java,,706,147,376,1229
SynthRadioButtonMenuItemUI.java,Java,,32,13,13,58
SynthRadioButtonUI.java,Java,,45,12,24,81
SynthRootPaneUI.java,Java,,157,34,24,215
SynthScrollBarUI.java,Java,,935,191,248,1374
SynthScrollPaneUI.java,Java,,697,131,165,993
SynthSeparatorUI.java,Java,,109,30,13,152
SynthSliderUI.java,Java,,1208,223,144,1575
SynthSpinnerUI.java,Java,,438,117,262,817
SynthSplitPaneUI.java,Java,,1506,333,563,2402
SynthStyle.java,Java,,136,32,105,273
SynthStyleFactory.java,Java,,12,3,19,34
SynthTabbedPaneUI.java,Java,,2237,346,374,2957
SynthTableHeaderUI.java,Java,,392,90,104,586
SynthTableUI.java,Java,,959,201,250,1410
SynthTextAreaUI.java,Java,,159,30,99,288
SynthTextFieldUI.java,Java,,155,27,158,340
SynthTextPaneUI.java,Java,,62,16,58,136
SynthTextUI.java,Java,,1217,224,950,2391
SynthToggleButtonUI.java,Java,,15,4,15,34
SynthToolBarUI.java,Java,,872,159,54,1085
SynthToolTipUI.java,Java,,163,35,28,226
SynthTransferable.java,Java,,154,32,80,266
SynthTreeUI.java,Java,,2376,449,705,3530
SynthUI.java,Java,,5,2,18,25
SynthViewportUI.java,Java,,86,24,15,125
TabContext.java,Java,,30,4,10,44
XColors.java,Java,,788,16,10,814
MotifBorders.java,Java,,521,130,95,746
MotifButtonListener.java,Java,,14,7,13,34
MotifButtonUI.java,Java,,67,23,36,126
MotifCheckBoxMenuItemUI.java,Java,,72,25,14,111
MotifCheckBoxUI.java,Java,,26,13,25,64
MotifComboBoxRenderer.java,Java,,44,17,35,96
MotifComboBoxUI.java,Java,,245,41,30,316
MotifDesktopIconUI.java,Java,,254,52,30,336
MotifDesktopPaneUI.java,Java,,176,31,42,249
MotifEditorPaneUI.java,Java,,13,7,33,53
MotifFileChooserUI.java,Java,,565,122,60,747
MotifGraphicsUtils.java,Java,,310,61,75,446
MotifIconFactory.java,Java,,355,58,38,451
MotifInternalFrameTitlePane.java,Java,,341,51,20,412
MotifInternalFrameUI.java,Java,,136,29,42,207
MotifLabelUI.java,Java,,11,4,20,35
MotifLookAndFeel.java,Java,,977,128,58,1163
MotifMenuBarUI.java,Java,,23,8,22,53
MotifMenuItemUI.java,Java,,71,23,13,107
MotifMenuMouseListener.java,Java,,17,2,12,31
MotifMenuMouseMotionListener.java,Java,,11,3,12,26
MotifMenuUI.java,Java,,95,24,27,146
MotifOptionPaneUI.java,Java,,49,13,35,97
MotifPasswordFieldUI.java,Java,,13,10,33,56
MotifPopupMenuSeparatorUI.java,Java,,27,9,13,49
MotifPopupMenuUI.java,Java,,62,15,23,100
MotifProgressBarUI.java,Java,,13,6,22,41
MotifRadioButtonMenuItemUI.java,Java,,75,23,20,118
MotifRadioButtonUI.java,Java,,33,15,31,79
MotifScrollBarButton.java,Java,,154,25,16,195
MotifScrollBarUI.java,Java,,54,18,20,92
MotifScrollPaneUI.java,Java,,85,20,19,124
MotifSeparatorUI.java,Java,,16,9,21,46
MotifSliderUI.java,Java,,82,29,32,143
MotifSplitPaneDivider.java,Java,,181,36,61,278
MotifSplitPaneUI.java,Java,,18,6,25,49
MotifTabbedPaneUI.java,Java,,218,33,38,289
MotifTextAreaUI.java,Java,,13,5,35,53
MotifTextFieldUI.java,Java,,13,5,33,51
MotifTextPaneUI.java,Java,,13,7,33,53
MotifTextUI.java,Java,,69,13,76,158
MotifToggleButtonUI.java,Java,,52,18,31,101
MotifTreeCellRenderer.java,Java,,51,16,29,96
MotifTreeUI.java,Java,,74,24,47,145
motif.java,Java,,26,2,0,28
motif_de.java,Java,,26,2,0,28
motif_es.java,Java,,26,2,0,28
motif_fr.java,Java,,26,2,0,28
motif_it.java,Java,,26,2,0,28
motif_ja.java,Java,,26,2,0,28
motif_ko.java,Java,,26,2,0,28
motif_sv.java,Java,,26,2,0,28
motif_zh_CN.java,Java,,26,2,0,28
motif_zh_TW.java,Java,,26,2,0,28
DesktopProperty.java,Java,,137,31,106,274
windows.java,Java,,27,2,0,29
windows_de.java,Java,,27,2,0,29
windows_es.java,Java,,27,2,0,29
windows_fr.java,Java,,27,2,0,29
windows_it.java,Java,,27,2,0,29
windows_ja.java,Java,,27,2,0,29
windows_ko.java,Java,,27,2,0,29
windows_sv.java,Java,,27,2,0,29
windows_zh_CN.java,Java,,27,2,0,29
windows_zh_TW.java,Java,,27,2,0,29
WindowsBorders.java,Java,,207,40,43,290
WindowsButtonListener.java,Java,,12,8,32,52
WindowsButtonUI.java,Java,,158,33,66,257
WindowsCheckBoxMenuItemUI.java,Java,,6,6,16,28
WindowsCheckBoxUI.java,Java,,28,14,28,70
WindowsComboBoxUI.java,Java,,128,28,60,216
WindowsDesktopIconUI.java,Java,,52,18,25,95
WindowsDesktopManager.java,Java,,34,9,27,70
WindowsDesktopPaneUI.java,Java,,26,7,20,53
WindowsEditorPaneUI.java,Java,,14,7,30,51
WindowsFileChooserUI.java,Java,,1724,290,173,2187
WindowsGraphicsUtils.java,Java,,50,10,28,88
WindowsIconFactory.java,Java,,404,63,47,514
WindowsInternalFrameTitlePane.java,Java,,267,40,16,323
WindowsInternalFrameUI.java,Java,,113,30,23,166
WindowsLabelUI.java,Java,,51,14,21,86
WindowsListUI.java,Java,,5,6,6,17
WindowsLookAndFeel.java,Java,,1320,154,237,1711
WindowsMenuBarUI.java,Java,,56,11,25,92
WindowsMenuItemUI.java,Java,,32,12,28,72
WindowsMenuUI.java,Java,,111,25,48,184
WindowsOptionPaneUI.java,Java,,8,6,16,30
WindowsPasswordFieldUI.java,Java,,13,9,30,52
WindowsPopupMenuUI.java,Java,,43,11,27,81
WindowsPopupWindow.java,Java,,34,10,34,78
WindowsProgressBarUI.java,Java,,129,23,26,178
WindowsRadioButtonMenuItemUI.java,Java,,6,5,16,27
WindowsRadioButtonUI.java,Java,,51,19,34,104
WindowsRootPaneUI.java,Java,,151,22,15,188
WindowsScrollBarUI.java,Java,,287,46,48,381
WindowsScrollPaneUI.java,Java,,5,6,16,27
WindowsSeparatorUI.java,Java,,3,3,12,18
WindowsSliderUI.java,Java,,81,18,17,116
WindowsSpinnerUI.java,Java,,43,12,6,61
WindowsSplitPaneDivider.java,Java,,23,7,25,55
WindowsSplitPaneUI.java,Java,,18,10,22,50
WindowsTabbedPaneUI.java,Java,,46,13,16,75
WindowsTableHeaderUI.java,Java,,69,16,6,91
WindowsTableUI.java,Java,,5,6,6,17
WindowsTextAreaUI.java,Java,,13,8,30,51
WindowsTextFieldUI.java,Java,,82,17,72,171
WindowsTextPaneUI.java,Java,,14,6,30,50
WindowsTextUI.java,Java,,139,15,65,219
WindowsToggleButtonUI.java,Java,,93,27,37,157
WindowsToolBarSeparatorUI.java,Java,,73,19,13,105
WindowsToolBarUI.java,Java,,50,14,6,70
WindowsTreeUI.java,Java,,137,28,56,221
WindowsUtils.java,Java,,9,4,16,29
XPStyle.java,Java,,564,74,159,797
SwingUtilities2.java,Java,,189,25,108,322
FactoryEnumeration.java,Java,,50,10,33,93
NamedWeakReference.java,Java,,11,8,12,31
ResourceManager.java,Java,,263,53,228,544
VersionHelper.java,Java,,65,21,52,138
VersionHelper12.java,Java,,174,29,32,235
DialogCallbackHandler.java,Java,,195,43,59,297
TextCallbackHandler.java,Java,,220,38,36,294
ConfigFile.java,Java,,407,69,106,582
Crypt.java,Java,,259,55,67,381
JndiLoginModule.java,Java,,375,75,295,745
KeyStoreLoginModule.java,Java,,467,61,167,695
Krb5LoginModule.java,Java,defUsername,544,62,428,1034
NTLoginModule.java,Java,,227,32,119,378
NTSystem.java,Java,,43,15,69,127
SolarisLoginModule.java,Java,,148,25,122,295
SolarisSystem.java,Java,,26,10,44,80
UnixLoginModule.java,Java,,147,25,117,289
UnixSystem.java,Java,,26,10,44,80
NTDomainPrincipal.java,Java,,43,13,75,131
NTNumericCredential.java,Java,,33,12,57,102
NTSid.java,Java,,49,12,78,139
NTSidDomainPrincipal.java,Java,,23,8,58,89
NTSidGroupPrincipal.java,Java,,23,9,53,85
NTSidPrimaryGroupPrincipal.java,Java,,23,9,56,88
NTSidUserPrincipal.java,Java,,23,8,52,83
NTUserPrincipal.java,Java,,43,13,69,125
PolicyFile.java,Java,,758,137,555,1450
PolicyParser.java,Java,,609,106,229,944
PrincipalComparator.java,Java,,4,2,41,47
SolarisNumericGroupPrincipal.java,Java,,58,18,120,196
SolarisNumericUserPrincipal.java,Java,,47,17,98,162
SolarisPrincipal.java,Java,,39,15,72,126
SubjectCodeSource.java,Java,,190,43,150,383
UnixNumericGroupPrincipal.java,Java,,66,17,116,199
UnixNumericUserPrincipal.java,Java,,50,14,95,159
UnixPrincipal.java,Java,,42,13,69,124
X500Principal.java,Java,,59,20,86,165
GSSUtil.java,Java,,11,5,38,54
Applet.java,Java,,142,37,363,542
AppletContext.java,Java,,21,12,142,175
AppletStub.java,Java,,10,8,76,94
AudioClip.java,Java,,6,4,26,36
ActiveEvent.java,Java,,4,3,35,42
Adjustable.java,Java,,22,23,91,136
AlphaComposite.java,Java,,109,45,324,478
AttributeValue.java,Java,,21,5,8,34
AWTError.java,Java,,7,4,21,32
AWTEvent.java,Java,,267,59,202,528
AWTEventMulticaster.java,Java,,362,87,504,953
AWTException.java,Java,,7,4,23,34
AWTKeyStroke.java,Java,,332,55,340,727
AWTPermission.java,Java,,13,9,137,159
BasicStroke.java,Java,,257,56,256,569
BorderLayout.java,Java,,262,50,428,740
BufferCapabilities.java,Java,,60,21,117,198
Button.java,Java,[PENDING:  WDW -- need to provide a localized string,203,53,385,641
Canvas.java,Java,,58,19,141,218
CardLayout.java,Java,,317,48,232,597
Checkbox.java,Java,,279,70,485,834
CheckboxGroup.java,Java,,32,9,90,131
CheckboxMenuItem.java,Java,,182,50,373,605
Choice.java,Java,,270,68,468,806
CMMException.java,Java,,6,7,29,42
ColorSpace.java,Java,,136,77,324,537
ICC_ColorSpace.java,Java,,200,36,355,591
ICC_Profile.java,Java,,809,343,777,1929
ICC_ProfileGray.java,Java,,25,18,88,131
ICC_ProfileRGB.java,Java,,73,34,156,263
ProfileDataException.java,Java,,6,4,14,24
Color.java,Java,,467,81,647,1195
ColorPaintContext.java,Java,,31,11,6,48
Component.java,Java,,3337,560,3962,7859
ComponentOrientation.java,Java,,52,15,111,178
Composite.java,Java,,7,5,57,69
CompositeContext.java,Java,,9,8,35,52
Conditional.java,Java,,4,2,14,20
Container.java,Java,,1828,268,1452,3548
ContainerOrderFocusTraversalPolicy.java,Java,,218,31,141,390
Cursor.java,Java,,226,68,138,432
Clipboard.java,Java,,24,15,55,94
ClipboardOwner.java,Java,,4,5,30,39
DataFlavor.java,Java,,494,138,699,1331
FlavorMap.java,Java,,6,6,46,58
FlavorTable.java,Java,,6,6,53,65
MimeType.java,Java,,171,40,164,375
MimeTypeParameterList.java,Java,,244,56,89,389
MimeTypeParseException.java,Java,,10,6,20,36
StringSelection.java,Java,,38,11,72,121
SystemFlavorMap.java,Java,,657,108,426,1191
Transferable.java,Java,,7,8,36,51
UnsupportedFlavorException.java,Java,,7,4,22,33
DefaultFocusTraversalPolicy.java,Java,,32,7,61,100
DefaultKeyboardFocusManager.java,Java,,739,108,294,1141
Dialog.java,Java,,309,65,435,809
Dimension.java,Java,,58,20,139,217
DisplayMode.java,Java,,35,11,59,105
Autoscroll.java,Java,,7,9,47,63
DnDConstants.java,Java,,10,14,44,68
DnDEventMulticaster.java,Java,,82,19,116,217
DragGestureEvent.java,Java,,86,55,197,338
DragGestureListener.java,Java,,5,8,28,41
DragGestureRecognizer.java,Java,,94,57,295,446
DragSource.java,Java,,245,74,544,863
DragSourceAdapter.java,Java,,10,8,101,119
DragSourceContext.java,Java,,214,81,301,596
DragSourceDragEvent.java,Java,,81,25,153,259
DragSourceDropEvent.java,Java,,23,19,92,134
DragSourceEvent.java,Java,,37,18,107,162
DragSourceListener.java,Java,,9,15,82,106
DragSourceMotionListener.java,Java,,5,5,34,44
DropTarget.java,Java,,299,146,361,806
DropTargetAdapter.java,Java,,7,6,69,82
DropTargetContext.java,Java,,131,65,207,403
DropTargetDragEvent.java,Java,,43,30,138,211
DropTargetDropEvent.java,Java,,59,43,181,283
DropTargetEvent.java,Java,,18,14,36,68
DropTargetListener.java,Java,,12,22,99,133
InvalidDnDOperationException.java,Java,,6,12,23,41
MouseDragGestureRecognizer.java,Java,,35,35,110,180
DragSourceContextPeer.java,Java,,19,15,29,63
DropTargetContextPeer.java,Java,,23,30,49,102
DropTargetPeer.java,Java,,6,8,28,42
SerializationTester.java,Java,,33,6,17,56
ActionEvent.java,Java,,50,22,148,220
ActionListener.java,Java,,5,5,26,36
AdjustmentEvent.java,Java,,75,26,131,232
AdjustmentListener.java,Java,,5,5,16,26
AWTEventListener.java,Java,,6,5,34,45
AWTEventListenerProxy.java,Java,,19,7,36,62
ComponentAdapter.java,Java,,7,5,44,56
ComponentEvent.java,Java,,45,14,81,140
ComponentListener.java,Java,,8,6,44,58
ContainerAdapter.java,Java,,5,3,38,46
ContainerEvent.java,Java,,36,13,82,131
ContainerListener.java,Java,,6,5,39,50
FocusAdapter.java,Java,,5,3,38,46
FocusEvent.java,Java,,53,19,137,209
FocusListener.java,Java,,6,5,34,45
HierarchyBoundsAdapter.java,Java,,6,3,35,44
HierarchyBoundsListener.java,Java,,6,4,35,45
HierarchyEvent.java,Java,,85,19,177,281
HierarchyListener.java,Java,,5,3,32,40
InputEvent.java,Java,,126,43,203,372
InputMethodEvent.java,Java,,129,32,224,385
InputMethodListener.java,Java,,6,7,26,39
InvocationEvent.java,Java,,73,22,156,251
ItemEvent.java,Java,,51,18,99,168
ItemListener.java,Java,,5,5,30,40
KeyAdapter.java,Java,,6,4,43,53
KeyEvent.java,Java,,661,153,665,1479
KeyListener.java,Java,,7,6,44,57
MouseAdapter.java,Java,,8,6,53,67
MouseEvent.java,Java,,271,47,384,702
MouseListener.java,Java,,9,8,51,68
MouseMotionAdapter.java,Java,,5,3,47,55
MouseMotionListener.java,Java,,6,6,47,59
MouseWheelEvent.java,Java,,49,23,215,287
MouseWheelListener.java,Java,,5,4,29,38
NativeLibLoader.java,Java,,7,3,31,41
PaintEvent.java,Java,,36,13,63,112
TextEvent.java,Java,,23,13,55,91
TextListener.java,Java,,5,5,30,40
WindowAdapter.java,Java,,15,11,75,101
WindowEvent.java,Java,,98,31,240,369
WindowFocusListener.java,Java,,6,5,42,53
WindowListener.java,Java,,11,9,69,89
WindowStateListener.java,Java,,5,3,29,37
Event.java,Java,,230,106,526,862
EventDispatchThread.java,Java,,178,38,112,328
EventQueue.java,Java,,481,73,357,911
FileDialog.java,Java,,112,30,227,369
FlowLayout.java,Java,,189,40,282,511
FocusTraversalPolicy.java,Java,,17,7,113,137
CharArrayIterator.java,Java,,84,26,58,168
FontRenderContext.java,Java,,56,15,98,169
GlyphJustificationInfo.java,Java,,60,23,111,194
GlyphMetrics.java,Java,,69,30,205,304
GlyphVector.java,Java,,82,41,469,592
GraphicAttribute.java,Java,,43,21,111,175
ImageGraphicAttribute.java,Java,,68,36,108,212
LineBreakMeasurer.java,Java,,113,36,367,516
LineMetrics.java,Java,,14,16,98,128
MultipleMaster.java,Java,,15,10,64,89
NumericShaper.java,Java,,643,79,202,924
OpenType.java,Java,,61,64,291,416
ShapeGraphicAttribute.java,Java,,82,35,108,225
StyledParagraph.java,Java,,280,64,131,475
TextAttribute.java,Java,,79,65,760,904
TextHitInfo.java,Java,,54,18,157,229
TextJustifier.java,Java,,146,26,50,222
TextLayout.java,Java,,1300,365,1057,2722
TextLine.java,Java,,791,246,113,1150
TextMeasurer.java,Java,,405,118,223,746
TransformAttribute.java,Java,,31,12,48,91
Font.java,Java,,896,168,1009,2073
FontFormatException.java,Java,,7,2,20,29
FontMetrics.java,Java,,135,36,398,569
Frame.java,Java,,415,99,658,1172
AffineTransform.java,Java,,1769,136,1211,3116
Arc2D.java,Java,,582,111,692,1385
ArcIterator.java,Java,,151,10,64,225
Area.java,Java,,307,37,250,594
CubicCurve2D.java,Java,,674,112,855,1641
CubicIterator.java,Java,,66,9,64,139
Dimension2D.java,Java,,18,7,65,90
Ellipse2D.java,Java,,136,33,238,407
EllipseIterator.java,Java,,100,12,64,176
FlatteningPathIterator.java,Java,,184,36,158,378
GeneralPath.java,Java,,285,40,312,637
GeneralPathIterator.java,Java,,51,10,80,141
IllegalPathStateException.java,Java,,8,4,27,39
Line2D.java,Java,,297,72,635,1004
LineIterator.java,Java,,58,9,64,131
NoninvertibleTransformException.java,Java,,6,3,20,29
PathIterator.java,Java,,15,13,170,198
Point2D.java,Java,,112,32,226,370
QuadCurve2D.java,Java,,499,98,685,1282
QuadIterator.java,Java,,62,9,64,135
Rectangle2D.java,Java,,314,65,624,1003
RectangularShape.java,Java,,101,28,230,359
RectIterator.java,Java,,66,9,64,139
RoundRectangle2D.java,Java,,213,49,353,615
RoundRectIterator.java,Java,,92,11,69,172
GradientPaint.java,Java,,85,19,141,245
GradientPaintContext.java,Java,,209,23,44,276
Graphics.java,Java,,163,57,985,1205
Graphics2D.java,Java,,99,47,1070,1216
GraphicsCallback.java,Java,,109,13,6,128
GraphicsConfigTemplate.java,Java,,14,11,67,92
GraphicsConfiguration.java,Java,,44,22,240,306
GraphicsDevice.java,Java,,62,22,223,307
GraphicsEnvironment.java,Java,,78,23,194,295
GridBagConstraints.java,Java,,83,42,375,500
GridBagLayout.java,Java,,640,135,757,1532
GridLayout.java,Java,,154,23,273,450
HeadlessException.java,Java,,7,2,14,23
IllegalComponentStateException.java,Java,,10,4,26,40
InputContext.java,Java,,39,18,256,313
InputMethodHighlight.java,Java,,45,21,109,175
InputMethodRequests.java,Java,,15,11,165,191
InputSubset.java,Java,,24,15,58,97
InputMethod.java,Java,,23,22,313,358
InputMethodContext.java,Java,,15,8,94,117
InputMethodDescriptor.java,Java,,11,10,85,106
AffineTransformOp.java,Java,,275,37,229,541
AreaAveragingScaleFilter.java,Java,,164,11,89,264
BandCombineOp.java,Java,,124,15,120,259
BandedSampleModel.java,Java,,387,92,328,807
BufferedImage.java,Java,,704,131,651,1486
BufferedImageFilter.java,Java,,263,15,122,400
BufferedImageOp.java,Java,,12,7,100,119
BufferStrategy.java,Java,,11,9,136,156
ByteLookupTable.java,Java,,79,13,101,193
ColorConvertOp.java,Java,,712,80,270,1062
ColorModel.java,Java,,702,89,1144,1935
ComponentColorModel.java,Java,,1822,79,1028,2929
ComponentSampleModel.java,Java,,596,112,460,1168
ConvolveOp.java,Java,,134,31,149,314
CropImageFilter.java,Java,,77,8,76,161
DataBuffer.java,Java,,127,40,240,407
DataBufferByte.java,Java,,63,18,130,211
DataBufferDouble.java,Java,,86,26,210,322
DataBufferFloat.java,Java,,86,26,213,325
DataBufferInt.java,Java,,63,19,128,210
DataBufferShort.java,Java,,63,19,127,209
DataBufferUShort.java,Java,,94,21,129,244
DirectColorModel.java,Java,,715,56,629,1400
FilteredImageSource.java,Java,,60,10,64,134
ImageConsumer.java,Java,,22,18,165,205
ImageFilter.java,Java,,52,13,148,213
ImageObserver.java,Java,,14,11,128,153
ImageProducer.java,Java,,8,6,81,95
ImagingOpException.java,Java,,6,4,18,28
IndexColorModel.java,Java,,650,72,660,1382
Kernel.java,Java,,59,19,64,142
LookupOp.java,Java,,331,52,169,552
LookupTable.java,Java,,25,10,57,92
MemoryImageSource.java,Java,,215,24,308,547
MultiPixelPackedSampleModel.java,Java,,291,60,323,674
PackedColorModel.java,Java,,208,35,221,464
PixelGrabber.java,Java,,308,28,315,651
PixelInterleavedSampleModel.java,Java,,67,6,80,153
Raster.java,Java,,636,137,965,1738
RasterFormatException.java,Java,,6,4,17,27
RasterOp.java,Java,,11,7,72,90
ContextualRenderedImageFactory.java,Java,,15,9,101,125
ParameterBlock.java,Java,,189,50,466,705
RenderableImage.java,Java,,18,15,147,180
RenderableImageOp.java,Java,,121,29,182,332
RenderableImageProducer.java,Java,,93,19,89,201
RenderContext.java,Java,,61,22,167,250
RenderedImageFactory.java,Java,,7,4,49,60
RenderedImage.java,Java,,27,25,147,199
ReplicateScaleFilter.java,Java,,115,16,105,236
RescaleOp.java,Java,,348,63,238,649
RGBImageFilter.java,Java,,101,13,156,270
SampleModel.java,Java,,464,152,750,1366
ShortLookupTable.java,Java,,79,13,95,187
SinglePixelPackedSampleModel.java,Java,,380,75,331,786
TileObserver.java,Java,,6,4,27,37
VolatileImage.java,Java,,30,23,257,310
WritableRaster.java,Java,,223,37,463,723
WritableRenderedImage.java,Java,,13,13,107,133
Image.java,Java,,32,14,144,190
ImageCapabilities.java,Java,,20,8,35,63
Insets.java,Java,,47,14,94,155
ItemSelectable.java,Java,,7,7,34,48
JobAttributes.java,Java,,443,68,531,1042
KeyboardFocusManager.java,Java,,1315,228,1268,2811
KeyEventDispatcher.java,Java,,5,4,64,73
KeyEventPostProcessor.java,Java,,5,4,67,76
Label.java,Java,,121,33,182,336
LayoutManager.java,Java,,8,5,46,59
LayoutManager2.java,Java,,8,7,55,70
List.java,Java,[FIXME,606,155,1107,1868
MediaTracker.java,Java,,390,56,467,913
Menu.java,Java,,238,58,294,590
MenuBar.java,Java,,200,41,223,464
MenuComponent.java,Java,,302,92,575,969
MenuContainer.java,Java,,6,3,16,25
MenuItem.java,Java,[PENDING:  WDW -- need to provide a localized string,279,70,506,855
MenuShortcut.java,Java,,52,13,110,175
PageAttributes.java,Java,,521,52,782,1355
Paint.java,Java,,12,6,59,77
PaintContext.java,Java,,12,7,46,65
Panel.java,Java,,37,13,63,113
ButtonPeer.java,Java,,5,3,13,21
CanvasPeer.java,Java,,4,2,13,19
CheckboxMenuItemPeer.java,Java,,4,1,13,18
CheckboxPeer.java,Java,,7,2,13,22
ChoicePeer.java,Java,,9,3,16,28
ComponentPeer.java,Java,,57,13,34,104
ContainerPeer.java,Java,,11,3,16,30
DialogPeer.java,Java,,6,5,13,24
FileDialogPeer.java,Java,,8,3,13,24
FontPeer.java,Java,,3,2,13,18
FramePeer.java,Java,,11,3,13,27
LabelPeer.java,Java,,7,2,13,22
LightweightPeer.java,Java,,3,3,21,27
ListPeer.java,Java,,19,7,28,54
MenuBarPeer.java,Java,,7,2,13,22
MenuComponentPeer.java,Java,,4,1,13,18
MenuItemPeer.java,Java,,7,4,19,30
MenuPeer.java,Java,,7,2,13,22
PanelPeer.java,Java,,4,2,13,19
PopupMenuPeer.java,Java,,5,2,13,20
RobotPeer.java,Java,,13,6,17,36
ScrollbarPeer.java,Java,,6,1,13,20
ScrollPanePeer.java,Java,,11,2,13,26
TextAreaPeer.java,Java,,12,6,25,43
TextComponentPeer.java,Java,,16,2,13,31
TextFieldPeer.java,Java,,10,5,22,37
WindowPeer.java,Java,,7,4,13,24
Point.java,Java,,54,18,140,212
Polygon.java,Java,,261,52,361,674
PopupMenu.java,Java,,76,18,94,188
Book.java,Java,,66,27,110,203
Pageable.java,Java,,9,7,50,66
PageFormat.java,Java,,141,58,146,345
Paper.java,Java,,53,25,111,189
Printable.java,Java,,8,7,53,68
PrinterAbortException.java,Java,,9,6,22,37
PrinterException.java,Java,,8,6,21,35
PrinterGraphics.java,Java,,4,5,20,29
PrinterIOException.java,Java,,16,6,48,70
PrinterJob.java,Java,,91,37,357,485
PrintGraphics.java,Java,,4,4,16,24
PrintJob.java,Java,,11,9,43,63
Rectangle.java,Java,,287,54,557,898
RenderingHints.java,Java,,210,71,425,706
Robot.java,Java,,188,42,207,437
Scrollbar.java,Java,,334,82,786,1202
ScrollPane.java,Java,,344,79,383,806
ScrollPaneAdjustable.java,Java,,137,43,230,410
SentEvent.java,Java,,50,6,15,71
SequencedEvent.java,Java,,111,17,62,190
Shape.java,Java,,17,12,288,317
Stroke.java,Java,,4,6,45,55
SystemColor.java,Java,,111,65,296,472
TextArea.java,Java,,236,60,387,683
TextComponent.java,Java,,450,89,596,1135
TextField.java,Java,,220,55,435,710
TexturePaint.java,Java,,47,13,63,123
TexturePaintContext.java,Java,,702,47,57,806
Toolkit.java,Java,,720,142,1295,2157
Transparency.java,Java,,7,6,29,42
Window.java,Java,,858,147,1105,2110
AppletInitializer.java,Java,,7,10,57,74
BeanContext.java,Java,,16,13,87,116
BeanContextChild.java,Java,,13,12,96,121
BeanContextChildComponentProxy.java,Java,,5,6,26,37
BeanContextChildSupport.java,Java,,100,57,171,328
BeanContextContainerProxy.java,Java,,5,5,25,35
BeanContextEvent.java,Java,,19,19,55,93
BeanContextMembershipEvent.java,Java,,28,24,66,118
BeanContextMembershipListener.java,Java,,7,7,30,44
BeanContextProxy.java,Java,,4,4,60,68
BeanContextServiceAvailableEvent.java,Java,,19,17,35,71
BeanContextServiceProvider.java,Java,,7,9,72,88
BeanContextServiceProviderBeanInfo.java,Java,,5,5,19,29
BeanContextServiceRevokedEvent.java,Java,,20,18,48,86
BeanContextServiceRevokedListener.java,Java,,6,7,18,31
BeanContextServices.java,Java,,17,17,107,141
BeanContextServicesListener.java,Java,,7,4,17,28
BeanContextServicesSupport.java,Java,,615,313,282,1210
BeanContextSupport.java,Java,,589,256,528,1373
BeanDescriptor.java,Java,,28,10,42,80
BeanInfo.java,Java,,15,15,123,153
Beans.java,Java,,310,92,248,650
Customizer.java,Java,,6,8,34,48
DefaultPersistenceDelegate.java,Java,,176,26,196,398
DesignMode.java,Java,,6,9,57,72
Encoder.java,Java,,106,66,150,322
EventHandler.java,Java,,145,24,369,538
EventSetDescriptor.java,Java,,200,34,204,438
ExceptionListener.java,Java,,4,48,21,73
Expression.java,Java,,28,58,90,176
FeatureDescriptor.java,Java,,146,32,138,316
IdentityHashtable.java,Java,,25,58,11,94
IndexedPropertyDescriptor.java,Java,,269,47,138,454
IntrospectionException.java,Java,,7,4,20,31
Introspector.java,Java,,1020,161,403,1584
MetaData.java,Java,,684,119,192,995
MethodDescriptor.java,Java,,41,14,48,103
NameGenerator.java,Java,,49,12,36,97
ParameterDescriptor.java,Java,,8,6,21,35
PersistenceDelegate.java,Java,,24,54,162,240
PropertyChangeEvent.java,Java,,29,13,82,124
PropertyChangeListener.java,Java,,4,6,16,26
PropertyChangeListenerProxy.java,Java,,16,6,39,61
PropertyChangeSupport.java,Java,,217,44,167,428
PropertyDescriptor.java,Java,,337,60,191,588
PropertyEditor.java,Java,,15,25,146,186
PropertyEditorManager.java,Java,,90,19,80,189
PropertyEditorSupport.java,Java,,81,33,129,243
PropertyVetoException.java,Java,,12,8,26,46
ReflectionUtils.java,Java,,212,25,5,242
SimpleBeanInfo.java,Java,,54,14,60,128
Statement.java,Java,,137,19,117,273
VetoableChangeListener.java,Java,,5,2,19,26
VetoableChangeListenerProxy.java,Java,,18,7,39,64
VetoableChangeSupport.java,Java,,217,43,155,415
Visibility.java,Java,,7,8,34,49
XMLDecoder.java,Java,,341,53,109,503
XMLEncoder.java,Java,,300,46,259,605
Bits.java,Java,,93,18,18,129
BufferedInputStream.java,Java,,133,25,244,402
BufferedOutputStream.java,Java,,44,9,74,127
BufferedReader.java,Java,,263,37,208,508
BufferedWriter.java,Java,,105,24,121,250
ByteArrayInputStream.java,Java,,66,17,175,258
ByteArrayOutputStream.java,Java,,66,19,128,213
CharArrayReader.java,Java,,96,17,84,197
CharArrayWriter.java,Java,,83,16,76,175
CharConversionException.java,Java,,10,1,21,32
DataInput.java,Java,,19,16,454,489
DataInputStream.java,Java,,184,32,464,680
DataOutput.java,Java,,18,15,301,334
DataOutputStream.java,Java,,131,25,219,375
EOFException.java,Java,,10,3,33,46
ExpiringCache.java,Java,,79,15,9,103
Externalizable.java,Java,,7,4,69,80
File.java,Java,,422,86,1061,1569
FileDescriptor.java,Java,,21,12,82,115
FileFilter.java,Java,,4,5,23,32
FileInputStream.java,Java,,73,23,202,298
FilenameFilter.java,Java,,5,2,29,36
FileNotFoundException.java,Java,,14,8,42,64
FileOutputStream.java,Java,,90,25,233,348
FilePermission.java,Java,,332,98,375,805
FileReader.java,Java,,12,8,49,69
FileSystem.java,Java,,51,46,130,227
FileWriter.java,Java,,18,10,74,102
FilterInputStream.java,Java,,35,12,176,223
FilterOutputStream.java,Java,,31,9,105,145
FilterReader.java,Java,,32,15,65,112
FilterWriter.java,Java,,23,12,60,95
InputStream.java,Java,,68,20,262,350
InputStreamReader.java,Java,,50,16,124,190
InterruptedIOException.java,Java,,11,4,40,55
InvalidClassException.java,Java,,17,5,39,61
InvalidObjectException.java,Java,,6,2,23,31
IOException.java,Java,,10,3,29,42
LineNumberInputStream.java,Java,,96,19,159,274
LineNumberReader.java,Java,,100,23,115,238
NotActiveException.java,Java,,9,3,21,33
NotSerializableException.java,Java,,9,3,23,35
ObjectInput.java,Java,,11,8,71,90
ObjectInputStream.java,Java,,1825,294,1255,3374
ObjectInputValidation.java,Java,,4,2,22,28
ObjectOutput.java,Java,,10,7,56,73
ObjectOutputStream.java,Java,,1109,173,915,2197
ObjectStreamClass.java,Java,,1340,181,536,2057
ObjectStreamConstants.java,Java,,32,34,140,206
ObjectStreamException.java,Java,,9,3,21,33
ObjectStreamField.java,Java,,95,21,134,250
OptionalDataException.java,Java,,13,4,46,63
OutputStream.java,Java,,24,7,100,131
OutputStreamWriter.java,Java,,56,20,149,225
PipedInputStream.java,Java,,134,20,171,325
PipedOutputStream.java,Java,,53,11,95,159
PipedReader.java,Java,,144,23,138,305
PipedWriter.java,Java,,53,14,92,159
PrintStream.java,Java,,248,50,306,604
PrintWriter.java,Java,,211,48,275,534
PushbackInputStream.java,Java,,106,19,183,308
PushbackReader.java,Java,,120,21,119,260
RandomAccessFile.java,Java,,269,64,719,1052
Reader.java,Java,,56,19,146,221
SequenceInputStream.java,Java,,79,14,108,201
Serializable.java,Java,,3,2,100,105
SerializablePermission.java,Java,,16,11,82,109
StreamCorruptedException.java,Java,,9,3,22,34
StreamTokenizer.java,Java,,367,52,395,814
StringBufferInputStream.java,Java,,53,11,90,154
StringReader.java,Java,,77,16,76,169
StringWriter.java,Java,,43,16,64,123
SyncFailedException.java,Java,,6,2,21,29
UnsupportedEncodingException.java,Java,,11,2,20,33
UTFDataFormatException.java,Java,,10,3,32,45
Win32FileSystem.java,Java,,378,56,103,537
WinNTFileSystem.java,Java,,26,9,16,51
WriteAbortedException.java,Java,,19,6,51,76
Writer.java,Java,,48,17,109,174
AbstractMethodError.java,Java,,10,3,26,39
ArithmeticException.java,Java,,10,3,25,38
ArrayIndexOutOfBoundsException.java,Java,,13,4,31,48
ArrayStoreException.java,Java,,10,4,28,42
AssertionError.java,Java,,31,10,92,133
AssertionStatusDirectives.java,Java,,8,6,62,76
Boolean.java,Java,,51,17,147,215
Byte.java,Java,,102,31,296,429
Character.java,Java,,758,118,1145,2021
CharacterData.java,Java,,839,42,84,965
CharacterDataLatin1.java,Java,,201,41,52,294
CharSequence.java,Java,,7,9,70,86
Class.java,Java,,755,160,1209,2124
ClassCastException.java,Java,,10,3,28,41
ClassCircularityError.java,Java,,9,3,22,34
ClassFormatError.java,Java,,10,3,24,37
ClassLoader.java,Java,,769,129,959,1857
ClassNotFoundException.java,Java,,21,8,79,108
Cloneable.java,Java,,3,2,32,37
CloneNotSupportedException.java,Java,,10,4,32,46
Comparable.java,Java,,4,3,115,122
Compiler.java,Java,,40,10,67,117
Double.java,Java,,88,35,556,679
Error.java,Java,,16,6,64,86
Exception.java,Java,,16,6,57,79
ExceptionInInitializerError.java,Java,,22,8,79,109
Float.java,Java,,89,36,544,669
FloatingDecimal.java,Java,,1463,110,719,2292
IllegalAccessError.java,Java,,9,3,27,39
IllegalAccessException.java,Java,,9,3,47,59
IllegalArgumentException.java,Java,,10,3,25,38
IllegalMonitorStateException.java,Java,,10,3,30,43
IllegalStateException.java,Java,,10,3,27,40
IllegalThreadStateException.java,Java,,9,3,28,40
IncompatibleClassChangeError.java,Java,,10,3,25,38
IndexOutOfBoundsException.java,Java,,10,3,26,39
InheritableThreadLocal.java,Java,,13,5,49,67
InstantiationError.java,Java,,10,5,27,42
InstantiationException.java,Java,,10,3,26,39
Integer.java,Java,,333,60,567,960
InternalError.java,Java,,10,3,23,36
InterruptedException.java,Java,,10,3,30,43
LinkageError.java,Java,,10,3,25,38
Long.java,Java,,281,51,574,906
Math.java,Java,,131,43,694,868
NegativeArraySizeException.java,Java,,10,3,23,36
NoClassDefFoundError.java,Java,,10,3,29,42
NoSuchFieldError.java,Java,,10,3,27,40
NoSuchFieldException.java,Java,,9,3,21,33
NoSuchMethodError.java,Java,,10,3,28,41
NoSuchMethodException.java,Java,,10,3,21,34
NullPointerException.java,Java,,10,3,35,48
Number.java,Java,,14,8,73,95
NumberFormatException.java,Java,,14,5,31,50
Object.java,Java,,36,17,427,480
OutOfMemoryError.java,Java,,10,3,24,37
Package.java,Java,,264,35,231,530
Process.java,Java,,11,8,107,126
Finalizer.java,Java,,129,19,31,179
FinalReference.java,Java,,6,6,7,19
PhantomReference.java,Java,,9,7,46,62
Reference.java,Java,,77,31,113,221
ReferenceQueue.java,Java,,64,14,52,130
SoftReference.java,Java,,18,10,71,99
WeakReference.java,Java,,9,7,41,57
AccessibleObject.java,Java,,42,13,112,167
Array.java,Java,,56,29,384,469
Constructor.java,Java,,135,19,161,315
Field.java,Java,,216,39,587,842
InvocationHandler.java,Java,,5,3,70,78
InvocationTargetException.java,Java,,22,8,63,93
Member.java,Java,,9,8,49,66
Method.java,Java,,158,21,194,373
Modifier.java,Java,,81,34,212,327
Proxy.java,Java,,168,38,426,632
ReflectAccess.java,Java,,71,14,13,98
ReflectPermission.java,Java,,10,5,59,74
UndeclaredThrowableException.java,Java,,21,7,74,102
Runnable.java,Java,,5,2,44,51
Runtime.java,Java,,151,39,653,843
RuntimeException.java,Java,,16,6,57,79
RuntimePermission.java,Java,,15,8,262,285
SecurityException.java,Java,,9,2,23,34
SecurityManager.java,Java,,359,65,1269,1693
Short.java,Java,,104,30,296,430
Shutdown.java,Java,,136,34,66,236
StackOverflowError.java,Java,,10,3,23,36
StackTraceElement.java,Java,,49,13,123,185
StrictMath.java,Java,,101,44,634,779
String.java,Java,,711,109,1487,2307
StringBuffer.java,Java,,360,63,853,1276
StringCoding.java,Java,,306,50,49,405
StringIndexOutOfBoundsException.java,Java,,13,4,35,52
System.java,Java,,180,45,684,909
Terminator.java,Java,,22,10,23,55
Thread.java,Java,,298,82,861,1241
ThreadDeath.java,Java,,2,3,30,35
ThreadGroup.java,Java,,439,43,461,943
ThreadLocal.java,Java,,242,62,316,620
Throwable.java,Java,,138,36,476,650
UnknownError.java,Java,,10,3,23,36
UnsatisfiedLinkError.java,Java,,10,3,24,37
UnsupportedClassVersionError.java,Java,,10,3,23,36
UnsupportedOperationException.java,Java,,8,3,26,37
VerifyError.java,Java,,10,3,23,36
VirtualMachineError.java,Java,,10,3,24,37
Void.java,Java,,6,4,21,31
Win32Process.java,Java,,86,14,8,108
BigDecimal.java,Java,,317,87,687,1091
BigInteger.java,Java,,1563,374,1169,3106
BitSieve.java,Java,,86,21,92,199
MutableBigInteger.java,Java,,838,183,336,1357
SignedMutableBigInteger.java,Java,,44,19,59,122
Authenticator.java,Java,,105,29,161,295
BindException.java,Java,,7,5,23,35
ConnectException.java,Java,,7,3,24,34
ContentHandler.java,Java,,14,6,72,92
ContentHandlerFactory.java,Java,,4,2,31,37
DatagramPacket.java,Java,,103,26,238,367
DatagramSocket.java,Java,,441,59,669,1169
DatagramSocketImpl.java,Java,,35,24,163,222
DatagramSocketImplFactory.java,Java,,5,2,22,29
FileNameMap.java,Java,,4,3,20,27
HttpURLConnection.java,Java,,157,77,363,597
Inet4Address.java,Java,,149,34,225,408
Inet4AddressImpl.java,Java,,23,5,11,39
Inet6Address.java,Java,,258,44,264,566
Inet6AddressImpl.java,Java,,33,6,16,55
InetAddress.java,Java,,539,122,652,1313
InetAddressImpl.java,Java,,9,5,15,29
InetSocketAddress.java,Java,,93,16,130,239
JarURLConnection.java,Java,,55,25,224,304
MalformedURLException.java,Java,,9,4,24,37
MulticastSocket.java,Java,,210,47,395,652
NetPermission.java,Java,,16,8,91,115
NetworkInterface.java,Java,,174,34,124,332
NoRouteToHostException.java,Java,,7,3,24,34
PasswordAuthentication.java,Java,,15,9,41,65
PlainDatagramSocketImpl.java,Java,,174,39,106,319
PlainSocketImpl.java,Java,,423,58,167,648
PortUnreachableException.java,Java,,7,5,21,33
ProtocolException.java,Java,,10,4,23,37
ServerSocket.java,Java,,263,37,463,763
Socket.java,Java,,529,81,856,1466
SocketAddress.java,Java,,3,2,19,24
SocketException.java,Java,,10,4,23,37
SocketImpl.java,Java,,68,32,194,294
SocketImplFactory.java,Java,,5,2,24,31
SocketInputStream.java,Java,,129,25,97,251
SocketOptions.java,Java,,20,34,264,318
SocketOutputStream.java,Java,,72,17,77,166
SocketPermission.java,Java,,691,176,505,1372
SocketTimeoutException.java,Java,,7,5,19,31
SocksConsts.java,Java,,25,6,9,40
SocksSocketImpl.java,Java,,636,28,147,811
SocksSocketImplFactory.java,Java,,102,8,46,156
UnknownHostException.java,Java,,10,4,23,37
UnknownServiceException.java,Java,,9,4,26,39
URI.java,Java,,1462,279,1689,3430
URISyntaxException.java,Java,,39,11,65,115
URL.java,Java,,421,102,666,1189
URLClassLoader.java,Java,,330,36,210,576
URLConnection.java,Java,,515,130,933,1578
URLDecoder.java,Java,,61,20,102,183
URLEncoder.java,Java,,109,19,147,275
URLStreamHandler.java,Java,,293,41,193,527
URLStreamHandlerFactory.java,Java,,4,2,28,34
Bits.java,Java,,520,137,33,690
Buffer.java,Java,,120,31,306,457
BufferOverflowException.java,Java,,6,7,19,32
BufferUnderflowException.java,Java,,6,7,19,32
ByteBuffer.java,Java,,197,349,1312,1858
ByteBufferAsCharBufferB.java,Java,,118,68,9,195
ByteBufferAsCharBufferL.java,Java,,118,68,9,195
ByteBufferAsCharBufferRB.java,Java,,78,109,8,195
ByteBufferAsCharBufferRL.java,Java,,78,109,8,195
ByteBufferAsDoubleBufferB.java,Java,,91,96,8,195
ByteBufferAsDoubleBufferL.java,Java,,91,96,8,195
ByteBufferAsDoubleBufferRB.java,Java,,51,137,7,195
ByteBufferAsDoubleBufferRL.java,Java,,51,137,7,195
ByteBufferAsFloatBufferB.java,Java,,91,96,8,195
ByteBufferAsFloatBufferL.java,Java,,91,96,8,195
ByteBufferAsFloatBufferRB.java,Java,,51,137,7,195
ByteBufferAsFloatBufferRL.java,Java,,51,137,7,195
ByteBufferAsIntBufferB.java,Java,,91,96,8,195
ByteBufferAsIntBufferL.java,Java,,91,96,8,195
ByteBufferAsIntBufferRB.java,Java,,51,137,7,195
ByteBufferAsIntBufferRL.java,Java,,51,137,7,195
ByteBufferAsLongBufferB.java,Java,,91,96,8,195
ByteBufferAsLongBufferL.java,Java,,91,96,8,195
ByteBufferAsLongBufferRB.java,Java,,51,137,7,195
ByteBufferAsLongBufferRL.java,Java,,51,137,7,195
ByteBufferAsShortBufferB.java,Java,,91,96,8,195
ByteBufferAsShortBufferL.java,Java,,91,96,8,195
ByteBufferAsShortBufferRB.java,Java,,51,137,7,195
ByteBufferAsShortBufferRL.java,Java,,51,137,7,195
ByteOrder.java,Java,,17,11,44,72
AlreadyConnectedException.java,Java,,6,7,19,32
AsynchronousCloseException.java,Java,,6,7,20,33
ByteChannel.java,Java,,6,6,16,28
CancelledKeyException.java,Java,,6,7,19,32
Channel.java,Java,,6,8,52,66
Channels.java,Java,,206,40,196,442
ClosedByInterruptException.java,Java,,6,7,21,34
ClosedChannelException.java,Java,,6,7,22,35
ClosedSelectorException.java,Java,,6,7,19,32
ConnectionPendingException.java,Java,,6,7,20,33
DatagramChannel.java,Java,,41,25,355,421
FileChannel.java,Java,,64,43,863,970
FileLock.java,Java,,51,16,177,244
FileLockInterruptionException.java,Java,,6,7,20,33
GatheringByteChannel.java,Java,,10,9,130,149
IllegalBlockingModeException.java,Java,,6,7,19,32
IllegalSelectorException.java,Java,,6,7,20,33
InterruptibleChannel.java,Java,,7,8,49,64
NoConnectionPendingException.java,Java,,6,7,20,33
NonReadableChannelException.java,Java,,6,7,19,32
NonWritableChannelException.java,Java,,6,7,19,32
NotYetBoundException.java,Java,,6,7,19,32
NotYetConnectedException.java,Java,,6,7,19,32
OverlappingFileLockException.java,Java,,6,7,21,34
Pipe.java,Java,,33,16,87,136
ReadableByteChannel.java,Java,,6,7,78,91
ScatteringByteChannel.java,Java,,10,8,127,145
SelectableChannel.java,Java,,25,17,277,319
SelectionKey.java,Java,,37,33,310,380
Selector.java,Java,,20,17,341,378
ServerSocketChannel.java,Java,,20,13,121,154
SocketChannel.java,Java,,46,25,292,363
AbstractInterruptibleChannel.java,Java,,105,25,115,245
AbstractSelectableChannel.java,Java,,138,34,105,277
AbstractSelectionKey.java,Java,,17,9,25,51
AbstractSelector.java,Java,,60,23,131,214
SelectorProvider.java,Java,,84,16,103,203
UnresolvedAddressException.java,Java,,6,7,19,32
UnsupportedAddressTypeException.java,Java,,6,7,19,32
WritableByteChannel.java,Java,,8,7,73,88
CharBuffer.java,Java,,168,171,932,1271
CharacterCodingException.java,Java,,6,7,19,32
Charset.java,Java,,270,57,510,837
CharsetDecoder.java,Java,,208,186,545,939
CharsetEncoder.java,Java,,253,138,548,939
CoderMalfunctionError.java,Java,,8,6,21,35
CoderResult.java,Java,,97,29,141,267
CodingErrorAction.java,Java,,16,11,40,67
IllegalCharsetNameException.java,Java,,13,9,27,49
MalformedInputException.java,Java,,15,9,13,37
CharsetProvider.java,Java,,12,9,72,93
UnmappableCharacterException.java,Java,,15,9,13,37
UnsupportedCharsetException.java,Java,,13,9,27,49
DirectByteBuffer.java,Java,,613,332,24,969
DirectByteBufferR.java,Java,,338,618,13,969
DirectCharBufferRS.java,Java,,87,333,10,430
DirectCharBufferRU.java,Java,,87,333,10,430
DirectCharBufferS.java,Java,,190,223,17,430
DirectCharBufferU.java,Java,,190,223,17,430
DirectDoubleBufferRS.java,Java,,60,361,9,430
DirectDoubleBufferRU.java,Java,,60,361,9,430
DirectDoubleBufferS.java,Java,,163,251,16,430
DirectDoubleBufferU.java,Java,,163,251,16,430
DirectFloatBufferRS.java,Java,,60,361,9,430
DirectFloatBufferRU.java,Java,,60,361,9,430
DirectFloatBufferS.java,Java,,163,251,16,430
DirectFloatBufferU.java,Java,,163,251,16,430
DirectIntBufferRS.java,Java,,60,361,9,430
DirectIntBufferRU.java,Java,,60,361,9,430
DirectIntBufferS.java,Java,,163,251,16,430
DirectIntBufferU.java,Java,,163,251,16,430
DirectLongBufferRS.java,Java,,60,361,9,430
DirectLongBufferRU.java,Java,,60,361,9,430
DirectLongBufferS.java,Java,,163,251,16,430
DirectLongBufferU.java,Java,,163,251,16,430
DirectShortBufferRS.java,Java,,60,361,9,430
DirectShortBufferRU.java,Java,,60,361,9,430
DirectShortBufferS.java,Java,,163,251,16,430
DirectShortBufferU.java,Java,,163,251,16,430
DoubleBuffer.java,Java,,150,362,759,1271
FloatBuffer.java,Java,,150,362,759,1271
HeapByteBuffer.java,Java,,301,229,43,573
HeapByteBufferR.java,Java,,201,341,31,573
HeapCharBuffer.java,Java,,129,406,38,573
HeapCharBufferR.java,Java,,77,470,26,573
HeapDoubleBuffer.java,Java,,112,424,37,573
HeapDoubleBufferR.java,Java,,60,488,25,573
HeapFloatBuffer.java,Java,,112,424,37,573
HeapFloatBufferR.java,Java,,60,488,25,573
HeapIntBuffer.java,Java,,112,424,37,573
HeapIntBufferR.java,Java,,60,488,25,573
HeapLongBuffer.java,Java,,112,424,37,573
HeapLongBufferR.java,Java,,60,488,25,573
HeapShortBuffer.java,Java,,112,424,37,573
HeapShortBufferR.java,Java,,60,488,25,573
IntBuffer.java,Java,,150,362,759,1271
InvalidMarkException.java,Java,,6,7,19,32
LongBuffer.java,Java,,150,362,759,1271
MappedByteBuffer.java,Java,,37,14,95,146
ReadOnlyBufferException.java,Java,,6,7,19,32
ShortBuffer.java,Java,,150,362,759,1271
StringCharBuffer.java,Java,,66,22,8,96
AccessException.java,Java,,10,5,38,53
Activatable.java,Java,,162,27,320,509
ActivateFailedException.java,Java,,10,5,30,45
ActivationDesc.java,Java,,99,22,202,323
ActivationException.java,Java,,28,9,62,99
ActivationGroup.java,Java,,181,37,316,534
ActivationGroupDesc.java,Java,,121,31,189,341
ActivationGroupID.java,Java,,26,9,63,98
ActivationID.java,Java,,74,18,163,255
ActivationInstantiator.java,Java,,8,5,46,59
ActivationMonitor.java,Java,,15,9,68,92
ActivationSystem.java,Java,,32,14,163,209
Activator.java,Java,,9,4,83,96
UnknownGroupException.java,Java,,7,4,32,43
UnknownObjectException.java,Java,,7,4,34,45
AlreadyBoundException.java,Java,,10,4,31,45
ConnectException.java,Java,,10,5,30,45
ConnectIOException.java,Java,,10,6,31,47
DGC.java,Java,,9,4,84,97
Lease.java,Java,,19,6,34,59
VMID.java,Java,,83,18,58,159
MarshalException.java,Java,,10,5,39,54
MarshalledObject.java,Java,,107,28,157,292
Naming.java,Java,,129,22,137,288
NoSuchObjectException.java,Java,,7,4,34,45
NotBoundException.java,Java,,10,4,33,47
LocateRegistry.java,Java,,64,15,114,193
Registry.java,Java,,18,8,149,175
RegistryHandler.java,Java,,8,5,40,53
Remote.java,Java,,2,2,29,33
RemoteException.java,Java,,28,9,63,100
RMISecurityException.java,Java,,10,4,33,47
RMISecurityManager.java,Java,,6,4,31,41
ExportException.java,Java,,10,6,35,51
LoaderHandler.java,Java,,11,7,56,74
LogStream.java,Java,,107,25,105,237
ObjID.java,Java,,77,23,152,252
Operation.java,Java,,13,5,34,52
RemoteCall.java,Java,,16,10,81,107
RemoteObject.java,Java,,81,14,334,429
RemoteRef.java,Java,,19,14,154,187
RemoteServer.java,Java,,27,8,63,98
RemoteStub.java,Java,,13,5,38,56
RMIClassLoader.java,Java,,127,27,559,713
RMIClassLoaderSpi.java,Java,,14,7,156,177
RMIClientSocketFactory.java,Java,,7,4,46,57
RMIFailureHandler.java,Java,,4,5,35,44
RMIServerSocketFactory.java,Java,,7,4,46,57
RMISocketFactory.java,Java,,52,12,107,171
ServerCloneException.java,Java,,25,8,60,93
ServerNotActiveException.java,Java,,9,5,30,44
ServerRef.java,Java,,8,6,35,49
Skeleton.java,Java,,7,3,40,50
SkeletonMismatchException.java,Java,,8,6,29,43
SkeletonNotFoundException.java,Java,,11,6,35,52
SocketSecurityException.java,Java,,10,6,37,53
UID.java,Java,,84,18,149,251
UnicastRemoteObject.java,Java,,113,26,139,278
Unreferenced.java,Java,,4,2,22,28
ServerError.java,Java,,7,4,28,39
ServerException.java,Java,,10,5,35,50
ServerRuntimeException.java,Java,,7,4,35,46
StubNotFoundException.java,Java,,10,5,35,50
UnexpectedException.java,Java,,10,5,32,47
UnknownHostException.java,Java,,10,5,30,45
UnmarshalException.java,Java,,10,5,44,59
AccessControlContext.java,Java,,240,65,183,488
AccessControlException.java,Java,,14,8,42,64
AccessController.java,Java,,43,23,338,404
Acl.java,Java,,16,28,196,240
AclEntry.java,Java,,15,15,108,138
AclNotFoundException.java,Java,,5,4,15,24
Group.java,Java,,9,9,51,69
LastOwnerException.java,Java,,5,3,17,25
NotOwnerException.java,Java,,5,3,16,24
Owner.java,Java,,9,7,61,77
Permission.java,Java,,5,6,25,36
AlgorithmParameterGenerator.java,Java,,78,18,184,280
AlgorithmParameterGeneratorSpi.java,Java,,9,7,53,69
AlgorithmParameters.java,Java,,107,21,229,357
AlgorithmParametersSpi.java,Java,,19,11,103,133
AllPermission.java,Java,,68,31,121,220
BasicPermission.java,Java,,186,71,264,521
Certificate.java,Java,,88,21,141,250
CertificateEncodingException.java,Java,,9,4,25,38
CertificateException.java,Java,,10,5,24,39
CertificateExpiredException.java,Java,,9,4,27,40
CertificateFactory.java,Java,,205,27,355,587
CertificateFactorySpi.java,Java,,36,12,242,290
CertificateNotYetValidException.java,Java,,9,4,27,40
CertificateParsingException.java,Java,,9,4,26,39
CertPath.java,Java,,89,22,195,306
CertPathBuilder.java,Java,,200,19,158,377
CertPathBuilderException.java,Java,,43,13,98,154
CertPathBuilderResult.java,Java,,5,4,42,51
CertPathBuilderSpi.java,Java,,7,5,46,58
CertPathHelperImpl.java,Java,,37,17,20,74
CertPathParameters.java,Java,,4,3,25,32
CertPathValidator.java,Java,,202,19,168,389
CertPathValidatorException.java,Java,,63,18,145,226
CertPathValidatorResult.java,Java,,4,3,26,33
CertPathValidatorSpi.java,Java,,8,5,55,68
CertSelector.java,Java,,5,4,41,50
CertStore.java,Java,,220,20,242,482
CertStoreException.java,Java,,43,13,96,152
CertStoreParameters.java,Java,,4,3,56,63
CertStoreSpi.java,Java,,11,6,91,108
CollectionCertStoreParameters.java,Java,,33,9,82,124
CRL.java,Java,,12,8,51,71
CRLException.java,Java,,10,5,24,39
CRLSelector.java,Java,,5,4,40,49
LDAPCertStoreParameters.java,Java,,39,13,80,132
PKIXBuilderParameters.java,Java,,40,9,133,182
PKIXCertPathBuilderResult.java,Java,,28,7,67,102
PKIXCertPathChecker.java,Java,,19,9,135,163
PKIXCertPathValidatorResult.java,Java,,43,10,89,142
PKIXParameters.java,Java,,240,39,424,703
PolicyNode.java,Java,,12,10,94,116
PolicyQualifierInfo.java,Java,,46,12,98,156
TrustAnchor.java,Java,,96,16,166,278
X509Certificate.java,Java,,59,29,526,614
X509CertSelector.java,Java,,1260,106,1171,2537
X509CRL.java,Java,,74,26,287,387
X509CRLEntry.java,Java,,40,13,85,138
X509CRLSelector.java,Java,,243,34,318,595
X509Extension.java,Java,,8,8,153,169
Certificate.java,Java,,14,11,113,138
CodeSource.java,Java,,216,42,220,478
DigestException.java,Java,,9,4,24,37
DigestInputStream.java,Java,,41,18,116,175
DigestOutputStream.java,Java,,39,16,103,158
DomainCombiner.java,Java,,5,3,86,94
GeneralSecurityException.java,Java,,9,5,25,39
Guard.java,Java,,4,4,31,39
GuardedObject.java,Java,,24,10,49,83
Identity.java,Java,,178,42,259,479
IdentityScope.java,Java,,67,26,144,237
DSAKey.java,Java,,4,3,26,33
DSAKeyPairGenerator.java,Java,,8,5,79,92
DSAParams.java,Java,,7,6,34,47
DSAPrivateKey.java,Java,,6,8,29,43
DSAPublicKey.java,Java,,6,8,29,43
RSAKey.java,Java,,5,5,22,32
RSAMultiPrimePrivateCrtKey.java,Java,,12,11,58,81
RSAPrivateCrtKey.java,Java,,10,10,46,66
RSAPrivateKey.java,Java,,6,4,20,30
RSAPublicKey.java,Java,,6,4,18,28
InvalidAlgorithmParameterException.java,Java,,10,5,32,47
InvalidKeyException.java,Java,,9,6,25,40
InvalidParameterException.java,Java,,9,5,26,40
Key.java,Java,,7,8,113,128
KeyException.java,Java,,9,5,27,41
KeyFactory.java,Java,,65,17,197,279
KeyFactorySpi.java,Java,,13,9,100,122
KeyManagementException.java,Java,,9,5,36,50
KeyPair.java,Java,,16,8,38,62
KeyPairGenerator.java,Java,,110,26,342,478
KeyPairGeneratorSpi.java,Java,,11,7,71,89
KeyStore.java,Java,,209,32,448,689
KeyStoreException.java,Java,,9,5,27,41
KeyStoreSpi.java,Java,,34,20,215,269
MessageDigest.java,Java,,206,39,274,519
MessageDigestSpi.java,Java,,35,12,107,154
NoSuchAlgorithmException.java,Java,,9,5,26,40
NoSuchProviderException.java,Java,,9,5,25,39
Permission.java,Java,,30,22,161,213
PermissionCollection.java,Java,,30,12,134,176
Permissions.java,Java,,232,79,267,578
Policy.java,Java,,174,42,201,417
Principal.java,Java,,7,6,42,55
PrivateKey.java,Java,,4,3,32,39
PrivilegedAction.java,Java,,4,4,30,38
PrivilegedActionException.java,Java,,19,7,61,87
PrivilegedExceptionAction.java,Java,,4,5,35,44
ProtectionDomain.java,Java,,157,36,139,332
Provider.java,Java,,130,33,229,392
ProviderException.java,Java,,9,5,25,39
PublicKey.java,Java,,4,3,29,36
SecureClassLoader.java,Java,,64,14,100,178
SecureRandom.java,Java,,136,30,349,515
SecureRandomSpi.java,Java,,6,6,38,50
Security.java,Java,,940,165,617,1722
SecurityPermission.java,Java,,15,8,260,283
Signature.java,Java,,283,68,484,835
SignatureException.java,Java,,9,6,24,39
SignatureSpi.java,Java,,62,27,240,329
SignedObject.java,Java,,57,15,168,240
Signer.java,Java,,58,17,88,163
AlgorithmParameterSpec.java,Java,,2,3,22,27
DSAParameterSpec.java,Java,,22,9,41,72
DSAPrivateKeySpec.java,Java,,27,10,52,89
DSAPublicKeySpec.java,Java,,27,10,52,89
EncodedKeySpec.java,Java,,11,7,46,64
InvalidKeySpecException.java,Java,,10,6,29,45
InvalidParameterSpecException.java,Java,,10,6,31,47
KeySpec.java,Java,,2,3,40,45
PKCS8EncodedKeySpec.java,Java,,12,6,57,75
PSSParameterSpec.java,Java,,14,7,33,54
RSAKeyGenParameterSpec.java,Java,,19,10,40,69
RSAMultiPrimePrivateCrtKeySpec.java,Java,,92,13,90,195
RSAOtherPrimeInfo.java,Java,,35,10,58,103
RSAPrivateCrtKeySpec.java,Java,,46,14,68,128
RSAPrivateKeySpec.java,Java,,16,8,36,60
RSAPublicKeySpec.java,Java,,16,8,36,60
X509EncodedKeySpec.java,Java,,12,6,47,65
UnrecoverableKeyException.java,Java,,9,5,23,37
UnresolvedPermission.java,Java,,282,41,196,519
UnresolvedPermissionCollection.java,Java,,74,31,90,195
Array.java,Java,,15,16,257,288
BatchUpdateException.java,Java,,29,10,114,153
Blob.java,Java,,12,16,160,188
CallableStatement.java,Java,,111,97,1208,1416
Clob.java,Java,,14,17,184,215
Connection.java,Java,,57,51,768,876
DatabaseMetaData.java,Java,,247,227,2571,3045
DataTruncation.java,Java,,38,15,75,128
Date.java,Java,,64,22,137,223
Driver.java,Java,,11,12,113,136
DriverManager.java,Java,,251,71,250,572
DriverPropertyInfo.java,Java,,12,9,43,64
ParameterMetaData.java,Java,,19,20,123,162
PreparedStatement.java,Java,,56,45,545,646
Ref.java,Java,,7,10,83,100
ResultSet.java,Java,,174,177,2022,2373
ResultSetMetaData.java,Java,,27,28,195,250
Savepoint.java,Java,,5,7,32,44
SQLData.java,Java,,6,6,101,113
SQLException.java,Java,,65,14,89,168
SQLInput.java,Java,,26,31,219,276
SQLOutput.java,Java,,26,31,229,286
SQLPermission.java,Java,,11,11,83,105
SQLWarning.java,Java,,32,11,67,110
Statement.java,Java,,47,53,703,803
Struct.java,Java,,6,8,62,76
Time.java,Java,,78,23,124,225
Timestamp.java,Java,,253,40,210,503
Types.java,Java,,34,40,174,248
Annotation.java,Java,,13,8,45,66
AttributedCharacterIterator.java,Java,,54,29,139,222
AttributedString.java,Java,,712,132,237,1081
Bidi.java,Java,,369,72,200,641
BreakDictionary.java,Java,,121,35,150,306
BreakIterator.java,Java,,176,43,354,573
CharacterBreakData.java,Java,,163,23,138,324
CharacterIterator.java,Java,,15,17,143,175
CharacterIteratorFieldDelegate.java,Java,,60,11,36,107
CharSet.java,Java,,697,91,287,1075
ChoiceFormat.java,Java,,262,39,299,600
CollationElementIterator.java,Java,,390,57,285,732
CollationKey.java,Java,,45,17,129,191
CollationRules.java,Java,,204,11,42,257
Collator.java,Java,,115,30,338,483
DateFormat.java,Java,,261,66,572,899
DateFormatSymbols.java,Java,,225,49,288,562
DecimalFormat.java,Java,,1312,195,1259,2766
DecimalFormatSymbols.java,Java,,251,72,340,663
DictionaryBasedBreakIterator.java,Java,,236,57,265,558
DigitList.java,Java,,262,48,222,532
DontCareFieldPosition.java,Java,,18,5,12,35
EntryPair.java,Java,,15,4,23,42
FieldPosition.java,Java,,96,27,163,286
Format.java,Java,,65,25,288,378
LineBreakData.java,Java,,296,15,197,508
MergeCollation.java,Java,,187,32,107,326
MessageFormat.java,Java,,620,68,797,1485
NumberFormat.java,Java,,273,84,670,1027
ParseException.java,Java,,12,6,43,61
ParsePosition.java,Java,,38,12,72,122
PatternEntry.java,Java,,206,29,54,289
RBCollationTables.java,Java,,129,31,121,281
RBTableBuilder.java,Java,,279,55,165,499
RuleBasedBreakIterator.java,Java,,1200,276,1167,2643
RuleBasedCollator.java,Java,,260,43,469,772
SentenceBreakData.java,Java,,219,33,189,441
SimpleDateFormat.java,Java,,983,120,800,1903
SimpleTextBoundary.java,Java,,199,33,110,342
SpecialMapping.java,Java,,17,6,45,68
StringCharacterIterator.java,Java,,129,26,106,261
TextBoundaryData.java,Java,,259,10,28,297
UnicodeClassMapping.java,Java,,43,8,42,93
WordBreakData.java,Java,,293,40,180,513
WordBreakTable.java,Java,,31,9,53,93
AbstractCollection.java,Java,,124,29,311,464
AbstractList.java,Java,,335,75,456,866
AbstractMap.java,Java,,256,56,355,667
AbstractSequentialList.java,Java,,52,14,196,262
AbstractSet.java,Java,,46,11,98,155
ArrayList.java,Java,,201,53,302,556
Arrays.java,Java,,1017,214,1150,2381
BitSet.java,Java,,486,121,439,1046
Calendar.java,Java,,562,119,1108,1789
Collection.java,Java,,18,24,370,412
Collections.java,Java,,1236,256,1020,2512
Comparator.java,Java,,5,4,129,138
ConcurrentModificationException.java,Java,,8,3,58,69
Currency.java,Java,,166,30,168,364
CurrencyData.java,Java,,36,11,0,47
Date.java,Java,,408,48,733,1189
Dictionary.java,Java,,13,9,116,138
EmptyStackException.java,Java,,6,2,19,27
Enumeration.java,Java,,5,3,56,64
EventListener.java,Java,,3,2,10,15
EventListenerProxy.java,Java,,10,4,39,53
EventObject.java,Java,,15,7,34,56
GregorianCalendar.java,Java,,991,202,1038,2231
HashMap.java,Java,,508,104,411,1023
HashSet.java,Java,,77,26,177,280
Hashtable.java,Java,,526,111,423,1060
IdentityHashMap.java,Java,,555,94,518,1167
Iterator.java,Java,,6,4,56,66
Attributes.java,Java,,251,62,319,632
JarEntry.java,Java,,26,8,54,88
JarException.java,Java,,9,3,21,33
JarFile.java,Java,,289,37,160,486
JarInputStream.java,Java,,88,16,79,183
JarOutputStream.java,Java,,58,10,62,130
JarVerifier.java,Java,,252,61,87,400
JavaUtilJarAccessImpl.java,Java,,8,3,6,17
Manifest.java,Java,,261,34,118,413
LinkedHashMap.java,Java,,146,36,276,458
LinkedHashSet.java,Java,,17,6,124,147
LinkedList.java,Java,,317,69,322,708
List.java,Java,,28,41,494,563
ListIterator.java,Java,,12,13,159,184
ListResourceBundle.java,Java,,39,11,106,156
Locale.java,Java,,468,116,576,1160
ConsoleHandler.java,Java,,33,10,57,100
ErrorManager.java,Java,,24,7,50,81
FileHandler.java,Java,,316,37,243,596
Filter.java,Java,,4,6,23,33
Formatter.java,Java,,35,15,87,137
Handler.java,Java,,87,22,170,279
Level.java,Java,,102,30,210,342
Logger.java,Java,,525,104,808,1437
LoggingPermission.java,Java,,13,6,37,56
LogManager.java,Java,,509,76,337,922
LogRecord.java,Java,,186,45,275,506
MemoryHandler.java,Java,,103,16,133,252
SimpleFormatter.java,Java,,50,9,21,80
SocketHandler.java,Java,,74,15,83,172
StreamHandler.java,Java,,123,18,129,270
XMLFormatter.java,Java,,158,24,51,233
Map.java,Java,,24,27,370,421
MissingResourceException.java,Java,,17,9,54,80
NoSuchElementException.java,Java,,10,3,28,41
Observable.java,Java,,47,15,134,196
Observer.java,Java,,4,1,25,30
AbstractPreferences.java,Java,,528,106,957,1591
BackingStoreException.java,Java,,18,7,38,63
Base64.java,Java,,145,20,79,244
InvalidPreferencesFormatException.java,Java,,21,9,53,83
NodeChangeEvent.java,Java,,23,10,51,84
NodeChangeListener.java,Java,,5,4,28,37
PreferenceChangeEvent.java,Java,,29,11,64,104
PreferenceChangeListener.java,Java,,4,2,23,29
Preferences.java,Java,,128,55,990,1173
PreferencesFactory.java,Java,,6,3,31,40
WindowsPreferences.java,Java,,700,67,327,1094
WindowsPreferencesFactory.java,Java,,9,3,22,34
XmlSupport.java,Java,,219,30,115,364
Properties.java,Java,,259,40,378,677
PropertyPermission.java,Java,,255,95,286,636
PropertyResourceBundle.java,Java,,22,8,90,120
Random.java,Java,,112,33,359,504
RandomAccess.java,Java,,3,2,44,49
ASCII.java,Java,,205,40,11,256
Matcher.java,Java,,220,51,510,781
Pattern.java,Java,,3293,259,1458,5010
PatternSyntaxException.java,Java,,45,14,51,110
ResourceBundle.java,Java,,437,68,622,1127
ResourceBundleEnumeration.java,Java,,36,7,16,59
Set.java,Java,,18,26,287,331
SimpleTimeZone.java,Java,,644,111,973,1728
SortedMap.java,Java,,9,8,207,224
SortedSet.java,Java,,9,8,206,223
Stack.java,Java,,34,13,71,118
StringTokenizer.java,Java,,108,23,209,340
Timer.java,Java,,190,36,337,563
TimerTask.java,Java,,27,14,100,141
TimeZone.java,Java,,260,47,406,713
TooManyListenersException.java,Java,,9,8,37,54
TreeMap.java,Java,,851,166,619,1636
TreeSet.java,Java,,108,36,344,488
Vector.java,Java,,325,71,623,1019
WeakHashMap.java,Java,,493,103,355,951
Adler32.java,Java,,35,11,38,84
CheckedInputStream.java,Java,,42,8,44,94
CheckedOutputStream.java,Java,,23,7,37,67
Checksum.java,Java,,8,5,30,43
CRC32.java,Java,,34,11,36,81
DataFormatException.java,Java,,10,3,20,33
Deflater.java,Java,,149,32,200,381
DeflaterOutputStream.java,Java,,76,15,73,164
GZIPInputStream.java,Java,,116,20,86,222
GZIPOutputStream.java,Java,,70,15,67,152
Inflater.java,Java,,119,22,176,317
InflaterInputStream.java,Java,,111,20,88,219
ZipConstants.java,Java,,43,7,31,81
ZipEntry.java,Java,,147,33,151,331
ZipException.java,Java,,11,6,24,41
ZipFile.java,Java,,299,47,150,496
ZipInputStream.java,Java,,284,22,111,417
ZipOutputStream.java,Java,,349,25,125,499
Accessible.java,Java,,4,3,26,33
AccessibleAction.java,Java,,6,5,48,59
AccessibleBundle.java,Java,,56,19,63,138
AccessibleComponent.java,Java,,32,30,236,298
AccessibleContext.java,Java,,123,52,489,664
AccessibleEditableText.java,Java,,15,14,86,115
AccessibleExtendedComponent.java,Java,,6,5,45,56
AccessibleExtendedTable.java,Java,,6,5,46,57
AccessibleHyperlink.java,Java,,14,13,96,123
AccessibleHypertext.java,Java,,9,8,46,63
AccessibleIcon.java,Java,,7,7,50,64
AccessibleKeyBinding.java,Java,,5,4,55,64
AccessibleRelation.java,Java,,51,21,152,224
AccessibleRelationSet.java,Java,,115,16,94,225
AccessibleResourceBundle.java,Java,,89,5,43,137
AccessibleRole.java,Java,,121,77,379,577
AccessibleSelection.java,Java,,10,9,78,97
AccessibleState.java,Java,,62,32,228,322
AccessibleStateSet.java,Java,,86,14,82,182
AccessibleTable.java,Java,,25,26,151,202
AccessibleTableModelChange.java,Java,,11,10,62,83
AccessibleText.java,Java,,20,19,125,164
AccessibleValue.java,Java,,7,7,61,75
IIOReadProgressListener.java,Java,,16,12,126,154
IIOReadUpdateListener.java,Java,,34,9,189,232
IIOReadWarningListener.java,Java,,6,4,31,41
IIOWriteProgressListener.java,Java,,14,10,99,123
IIOWriteWarningListener.java,Java,,8,4,33,45
IIOException.java,Java,,11,5,40,56
IIOImage.java,Java,,88,20,197,305
IIOParam.java,Java,,152,38,469,659
IIOParamController.java,Java,,4,3,94,101
ImageIO.java,Java,,772,137,603,1512
ImageReader.java,Java,,824,146,1871,2841
ImageReadParam.java,Java,,98,24,364,486
ImageTranscoder.java,Java,,9,5,121,135
ImageTypeSpecifier.java,Java,,677,95,378,1150
ImageWriteParam.java,Java,,398,59,991,1448
ImageWriter.java,Java,,405,90,1451,1946
IIOInvalidTreeException.java,Java,,18,7,55,80
IIOMetadata.java,Java,,196,41,609,846
IIOMetadataController.java,Java,,4,3,62,69
IIOMetadataFormat.java,Java,,59,57,702,818
IIOMetadataFormatImpl.java,Java,,601,115,506,1222
IIOMetadataNode.java,Java,,420,127,303,850
JPEGHuffmanTable.java,Java,,156,27,102,285
JPEGImageReadParam.java,Java,,48,11,123,182
JPEGImageWriteParam.java,Java,,104,17,181,302
JPEGQTable.java,Java,,81,19,105,205
DigraphNode.java,Java,,62,20,62,144
IIORegistry.java,Java,,70,11,98,179
IIOServiceProvider.java,Java,,32,12,111,155
ImageInputStreamSpi.java,Java,,32,11,141,184
ImageOutputStreamSpi.java,Java,,33,11,139,183
ImageReaderSpi.java,Java,,76,16,297,389
ImageReaderWriterSpi.java,Java,,181,35,368,584
ImageTranscoderSpi.java,Java,,13,8,57,78
ImageWriterSpi.java,Java,,84,18,314,416
PartiallyOrderedSet.java,Java,,97,31,69,197
RegisterableService.java,Java,,5,4,38,47
ServiceRegistry.java,Java,,320,59,435,814
FileCacheImageInputStream.java,Java,,103,25,83,211
FileCacheImageOutputStream.java,Java,,110,23,84,217
FileImageInputStream.java,Java,,61,11,52,124
FileImageOutputStream.java,Java,,70,13,48,131
IIOByteBuffer.java,Java,,29,12,85,126
ImageInputStream.java,Java,,51,48,869,968
ImageInputStreamImpl.java,Java,,547,109,200,856
ImageOutputStream.java,Java,,28,26,585,639
ImageOutputStreamImpl.java,Java,,382,53,51,486
MemoryCache.java,Java,,182,36,122,340
MemoryCacheImageInputStream.java,Java,,64,20,61,145
MemoryCacheImageOutputStream.java,Java,,81,24,70,175
AuthenticationException.java,Java,,10,5,43,58
AuthenticationNotSupportedException.java,Java,,10,5,48,63
BinaryRefAddr.java,Java,,50,13,103,166
Binding.java,Java,,40,15,128,183
CannotProceedException.java,Java,,42,21,206,269
CommunicationException.java,Java,,10,4,35,49
CompositeName.java,Java,,119,32,456,607
CompoundName.java,Java,,127,30,451,608
ConfigurationException.java,Java,,10,4,41,55
Context.java,Java,,51,49,982,1082
ContextNotEmptyException.java,Java,,10,4,41,55
Attribute.java,Java,,26,22,275,323
AttributeInUseException.java,Java,,11,5,34,50
AttributeModificationException.java,Java,,26,12,85,123
Attributes.java,Java,,16,15,135,166
BasicAttribute.java,Java,,269,51,219,539
BasicAttributes.java,Java,,169,45,145,359
DirContext.java,Java,,71,35,910,1016
InitialDirContext.java,Java,,165,38,62,265
InvalidAttributeIdentifierException.java,Java,,11,6,32,49
InvalidAttributesException.java,Java,,11,6,38,55
InvalidAttributeValueException.java,Java,,11,6,36,53
InvalidSearchControlsException.java,Java,,11,6,33,50
InvalidSearchFilterException.java,Java,,11,6,33,50
ModificationItem.java,Java,,37,14,66,117
NoSuchAttributeException.java,Java,,11,7,31,49
SchemaViolationException.java,Java,,11,6,43,60
SearchControls.java,Java,,70,26,223,319
SearchResult.java,Java,,34,14,124,172
EventContext.java,Java,,15,12,205,232
EventDirContext.java,Java,,15,6,121,142
NamespaceChangeListener.java,Java,,6,5,63,74
NamingEvent.java,Java,,52,20,211,283
NamingExceptionEvent.java,Java,,19,9,49,77
NamingListener.java,Java,,4,2,42,48
ObjectChangeListener.java,Java,,4,3,49,56
InitialContext.java,Java,,175,48,264,487
InsufficientResourcesException.java,Java,,10,5,40,55
InterruptedNamingException.java,Java,,10,5,44,59
InvalidNameException.java,Java,,10,5,40,55
Control.java,Java,,8,7,64,79
ControlFactory.java,Java,,27,13,100,140
ExtendedRequest.java,Java,,8,7,116,131
ExtendedResponse.java,Java,,5,6,71,82
HasControls.java,Java,,5,5,43,53
InitialLdapContext.java,Java,,61,20,110,191
LdapContext.java,Java,,17,11,306,334
LdapReferralException.java,Java,,18,9,114,141
StartTlsRequest.java,Java,,74,29,128,231
StartTlsResponse.java,Java,,23,19,146,188
UnsolicitedNotification.java,Java,,6,5,36,47
UnsolicitedNotificationEvent.java,Java,,16,8,43,67
UnsolicitedNotificationListener.java,Java,,5,4,42,51
LimitExceededException.java,Java,,11,7,39,57
LinkException.java,Java,,63,23,201,287
LinkLoopException.java,Java,,10,5,35,50
LinkRef.java,Java,,21,7,71,99
MalformedLinkException.java,Java,,10,6,34,50
Name.java,Java,,19,19,213,251
NameAlreadyBoundException.java,Java,,10,5,41,56
NameClassPair.java,Java,,38,16,163,217
NameImpl.java,Java,,530,81,103,714
NameNotFoundException.java,Java,,10,5,33,48
NameParser.java,Java,,4,3,33,40
NamingEnumeration.java,Java,,7,5,118,130
NamingException.java,Java,,104,24,242,370
NamingSecurityException.java,Java,,10,5,39,54
NoInitialContextException.java,Java,,10,4,44,58
NoPermissionException.java,Java,,10,4,33,47
NotContextException.java,Java,,10,5,41,56
OperationNotSupportedException.java,Java,,10,5,35,50
PartialResultException.java,Java,,10,5,34,49
RefAddr.java,Java,,36,12,86,134
Reference.java,Java,,109,29,240,378
Referenceable.java,Java,,4,2,35,41
ReferralException.java,Java,,16,11,158,185
ServiceUnavailableException.java,Java,,10,5,36,51
SizeLimitExceededException.java,Java,,11,6,35,52
ContinuationContext.java,Java,,173,34,14,221
ContinuationDirContext.java,Java,,244,52,20,316
DirectoryManager.java,Java,,120,30,169,319
DirObjectFactory.java,Java,,9,4,101,114
DirStateFactory.java,Java,,19,10,141,170
InitialContextFactory.java,Java,,7,4,44,55
InitialContextFactoryBuilder.java,Java,,7,3,43,53
NamingManager.java,Java,,294,83,472,849
ObjectFactory.java,Java,,7,5,144,156
ObjectFactoryBuilder.java,Java,,7,3,47,57
Resolver.java,Java,,9,7,60,76
ResolveResult.java,Java,,63,13,108,184
StateFactory.java,Java,,8,2,111,121
StringRefAddr.java,Java,,12,5,52,69
TimeLimitExceededException.java,Java,,11,6,35,52
Attribute.java,Java,,6,6,33,45
AttributeSet.java,Java,,16,19,257,292
AttributeSetUtilities.java,Java,,259,73,228,560
DateTimeSyntax.java,Java,,26,16,84,126
DocAttribute.java,Java,,3,4,23,30
DocAttributeSet.java,Java,,5,6,82,93
EnumSyntax.java,Java,,59,22,180,261
HashAttributeSet.java,Java,,162,36,310,508
HashDocAttributeSet.java,Java,,17,9,56,82
HashPrintJobAttributeSet.java,Java,,17,8,55,80
HashPrintRequestAttributeSet.java,Java,,18,12,55,85
HashPrintServiceAttributeSet.java,Java,,18,9,55,82
IntegerSyntax.java,Java,,29,11,74,114
PrintJobAttribute.java,Java,,3,2,22,27
PrintJobAttributeSet.java,Java,,5,5,81,91
PrintRequestAttribute.java,Java,,3,4,26,33
PrintRequestAttributeSet.java,Java,,5,6,82,93
PrintServiceAttribute.java,Java,,3,2,18,23
PrintServiceAttributeSet.java,Java,,5,7,84,96
ResolutionSyntax.java,Java,,81,28,229,338
SetOfIntegerSyntax.java,Java,,264,40,234,538
Size2DSyntax.java,Java,,84,22,220,326
Chromaticity.java,Java,,29,14,95,138
ColorSupported.java,Java,,27,12,70,109
Compression.java,Java,,32,15,66,113
Copies.java,Java,,19,7,89,115
CopiesSupported.java,Java,,29,9,82,120
DateTimeAtCompleted.java,Java,,20,8,76,104
DateTimeAtCreation.java,Java,,20,7,75,102
DateTimeAtProcessing.java,Java,,20,7,76,103
Destination.java,Java,,21,8,73,102
DocumentName.java,Java,,18,8,74,100
Fidelity.java,Java,,33,12,63,108
Finishings.java,Java,,120,29,307,456
JobHoldUntil.java,Java,,20,8,103,131
JobImpressions.java,Java,,19,7,96,122
JobImpressionsCompleted.java,Java,,19,7,81,107
JobImpressionsSupported.java,Java,,25,8,75,108
JobKOctets.java,Java,,19,7,147,173
JobKOctetsProcessed.java,Java,,19,7,93,119
JobKOctetsSupported.java,Java,,25,7,75,107
JobMediaSheets.java,Java,,19,7,90,116
JobMediaSheetsCompleted.java,Java,,19,6,81,106
JobMediaSheetsSupported.java,Java,,25,7,75,107
JobMessageFromOperator.java,Java,,20,8,80,108
JobName.java,Java,,20,8,76,104
JobOriginatingUserName.java,Java,,20,8,80,108
JobPriority.java,Java,,19,7,80,106
JobPrioritySupported.java,Java,,19,9,74,102
JobSheets.java,Java,,33,13,67,113
JobState.java,Java,,50,21,145,216
JobStateReason.java,Java,,137,40,264,441
JobStateReasons.java,Java,,30,11,117,158
Media.java,Java,,23,7,73,103
MediaName.java,Java,,32,14,47,93
MediaPrintableArea.java,Java,,83,23,208,314
MediaSize.java,Java,,311,33,479,823
MediaSizeName.java,Java,,259,33,252,544
MediaTray.java,Java,,44,19,57,120
MultipleDocumentHandling.java,Java,,42,16,189,247
NumberOfDocuments.java,Java,,19,7,66,92
NumberOfInterveningJobs.java,Java,,19,7,66,92
NumberUp.java,Java,,20,7,143,170
NumberUpSupported.java,Java,,49,9,99,157
OrientationRequested.java,Java,,46,15,106,167
OutputDeviceAssigned.java,Java,,20,10,77,107
PageRanges.java,Java,,58,12,174,244
PagesPerMinute.java,Java,,19,7,67,93
PagesPerMinuteColor.java,Java,,19,7,79,105
PDLOverrideSupported.java,Java,,33,13,61,107
PresentationDirection.java,Java,,58,18,89,165
PrinterInfo.java,Java,,19,8,73,100
PrinterIsAcceptingJobs.java,Java,,33,12,62,107
PrinterLocation.java,Java,,19,8,71,98
PrinterMakeAndModel.java,Java,,20,7,70,97
PrinterMessageFromOperator.java,Java,,20,8,85,113
PrinterMoreInfo.java,Java,,20,8,74,102
PrinterMoreInfoManufacturer.java,Java,,20,8,78,106
PrinterName.java,Java,,19,8,73,100
PrinterResolution.java,Java,,22,7,101,130
PrinterState.java,Java,,41,14,66,121
PrinterStateReason.java,Java,,155,44,225,424
PrinterStateReasons.java,Java,,105,22,159,286
PrinterURI.java,Java,,20,9,66,95
PrintQuality.java,Java,,39,14,62,115
QueuedJobCount.java,Java,,19,7,64,90
ReferenceUriSchemesSupported.java,Java,,50,18,95,163
RequestingUserName.java,Java,,20,8,81,109
Severity.java,Java,,33,14,91,138
SheetCollate.java,Java,,33,12,168,213
Sides.java,Java,,38,16,147,201
SupportedValuesAttribute.java,Java,,3,3,20,26
TextSyntax.java,Java,,41,16,76,133
UnmodifiableSetException.java,Java,,8,3,22,33
URISyntax.java,Java,,30,12,60,102
AttributeException.java,Java,,6,8,34,48
CancelablePrintJob.java,Java,,4,5,50,59
Doc.java,Java,,14,11,165,190
DocFlavor.java,Java,,219,116,1067,1402
DocPrintJob.java,Java,,20,12,127,159
PrintEvent.java,Java,,9,6,17,32
PrintJobAdapter.java,Java,,15,13,59,87
PrintJobAttributeEvent.java,Java,,18,15,27,60
PrintJobAttributeListener.java,Java,,4,4,20,28
PrintJobEvent.java,Java,,21,19,63,103
PrintJobListener.java,Java,,9,15,53,77
PrintServiceAttributeEvent.java,Java,,19,14,30,63
PrintServiceAttributeListener.java,Java,,4,5,21,30
FlavorException.java,Java,,5,5,19,29
MimeType.java,Java,,388,42,197,627
MultiDoc.java,Java,,6,8,104,118
MultiDocPrintJob.java,Java,,6,6,37,49
MultiDocPrintService.java,Java,,7,7,15,29
PrintException.java,Java,,15,8,32,55
PrintService.java,Java,,33,25,407,465
PrintServiceLookup.java,Java,,250,42,174,466
ServiceUI.java,Java,,122,28,149,299
ServiceUIFactory.java,Java,,13,15,96,124
SimpleDoc.java,Java,,76,22,135,233
StreamPrintService.java,Java,,21,12,63,96
StreamPrintServiceFactory.java,Java,,98,26,87,211
URIException.java,Java,,9,10,36,55
ClassDesc.java,Java,,5,4,23,32
GetORBPropertiesFileAction.java,Java,,54,18,18,90
PortableRemoteObjectDelegate.java,Java,,17,9,42,68
Stub.java,Java,,115,45,67,227
StubDelegate.java,Java,,17,10,50,77
Tie.java,Java,,18,9,42,69
Util.java,Java,,150,52,157,359
UtilDelegate.java,Java,,28,20,72,120
ValueHandler.java,Java,,14,9,57,80
PortableRemoteObject.java,Java,,132,43,84,259
AuthPermission.java,Java,,12,4,125,141
Callback.java,Java,,2,3,30,35
CallbackHandler.java,Java,,5,3,127,135
ChoiceCallback.java,Java,,47,14,131,192
ConfirmationCallback.java,Java,,121,36,325,482
LanguageCallback.java,Java,,12,7,41,60
NameCallback.java,Java,,30,10,85,125
PasswordCallback.java,Java,,32,10,83,125
TextInputCallback.java,Java,,30,10,86,126
TextOutputCallback.java,Java,,22,8,58,88
UnsupportedCallbackException.java,Java,,15,6,41,62
Destroyable.java,Java,,5,4,36,45
DestroyFailedException.java,Java,,9,4,28,41
DelegationPermission.java,Java,,124,47,187,358
KerberosKey.java,Java,,69,24,123,216
KerberosPrincipal.java,Java,,102,42,143,287
KerberosTicket.java,Java,,271,72,280,623
KeyImpl.java,Java,,104,23,49,176
ServicePermission.java,Java,,212,91,268,571
AccountExpiredException.java,Java,,9,4,31,44
AppConfigurationEntry.java,Java,,49,17,85,151
Configuration.java,Java,,79,14,203,296
CredentialExpiredException.java,Java,,9,4,33,46
FailedLoginException.java,Java,,9,4,28,41
LoginContext.java,Java,,348,71,420,839
LoginException.java,Java,,9,5,25,39
Policy.java,Java,,69,14,213,296
PrivateCredentialPermission.java,Java,,242,79,247,568
Refreshable.java,Java,,5,4,36,45
RefreshFailedException.java,Java,,9,4,28,41
LoginModule.java,Java,,14,8,200,222
Subject.java,Java,,666,144,585,1395
SubjectDomainCombiner.java,Java,,356,62,150,568
X500Principal.java,Java,,115,22,252,389
X500PrivateCredential.java,Java,,41,14,62,117
ControllerEventListener.java,Java,,5,5,37,47
Instrument.java,Java,,12,15,46,73
InvalidMidiDataException.java,Java,,9,8,29,46
MetaEventListener.java,Java,,5,5,23,33
MetaMessage.java,Java,,74,39,193,306
MidiChannel.java,Java,,29,30,362,421
MidiDevice.java,Java,,45,66,243,354
MidiEvent.java,Java,,18,15,46,79
MidiFileFormat.java,Java,,33,25,95,153
MidiMessage.java,Java,,36,20,115,171
MidiSystem.java,Java,,442,198,477,1117
MidiUnavailableException.java,Java,,9,8,29,46
Patch.java,Java,,15,18,62,95
Receiver.java,Java,,5,6,34,45
Sequence.java,Java,,133,68,202,403
Sequencer.java,Java,,61,125,567,753
ShortMessage.java,Java,,129,57,210,396
Soundbank.java,Java,,11,38,227,276
SoundbankResource.java,Java,,21,27,114,162
MidiDeviceProvider.java,Java,,16,11,35,62
MidiFileReader.java,Java,,16,15,94,125
MidiFileWriter.java,Java,,30,18,70,118
SoundbankReader.java,Java,,12,17,54,83
Synthesizer.java,Java,,19,48,298,365
SysexMessage.java,Java,,47,26,113,186
Track.java,Java,,67,34,99,200
Transmitter.java,Java,,6,9,32,47
VoiceStatus.java,Java,,9,16,118,143
AudioFileFormat.java,Java,,72,52,134,258
AudioFormat.java,Java,,91,66,308,465
AudioInputStream.java,Java,,177,91,222,490
AudioPermission.java,Java,,10,11,208,229
AudioSystem.java,Java,,569,220,409,1198
BooleanControl.java,Java,,34,41,101,176
Clip.java,Java,,14,13,176,203
CompoundControl.java,Java,,33,38,53,124
Control.java,Java,,28,29,72,129
DataLine.java,Java,,106,53,286,445
EnumControl.java,Java,,43,51,104,198
FloatControl.java,Java,,87,91,300,478
Line.java,Java,,46,47,246,339
LineEvent.java,Java,,41,45,164,250
LineListener.java,Java,,4,6,42,52
LineUnavailableException.java,Java,,9,9,35,53
Mixer.java,Java,,49,41,257,347
Port.java,Java,,45,45,102,192
ReverbType.java,Java,,45,30,197,272
SourceDataLine.java,Java,,6,10,161,177
AudioFileReader.java,Java,,16,10,94,120
AudioFileWriter.java,Java,,31,24,115,170
FormatConversionProvider.java,Java,,48,43,166,257
MixerProvider.java,Java,,15,11,35,61
TargetDataLine.java,Java,,6,9,153,168
UnsupportedAudioFileException.java,Java,,9,9,33,51
ConnectionEvent.java,Java,,14,15,51,80
ConnectionEventListener.java,Java,,5,11,47,63
ConnectionPoolDataSource.java,Java,,11,17,97,125
DataSource.java,Java,,12,15,127,154
PooledConnection.java,Java,,9,9,96,114
RowSet.java,Java,,76,79,786,941
RowSetEvent.java,Java,,6,9,32,47
RowSetInternal.java,Java,,9,15,66,90
RowSetListener.java,Java,,6,6,47,59
RowSetMetaData.java,Java,,21,27,174,222
RowSetReader.java,Java,,5,6,44,55
RowSetWriter.java,Java,,5,6,35,46
XAConnection.java,Java,,5,13,27,45
XADataSource.java,Java,,11,16,88,115
AbstractAction.java,Java,,323,48,199,570
AbstractActionPropertyChangeListener.java,Java,,46,10,27,83
AbstractButton.java,Java,,1283,205,1295,2783
AbstractCellEditor.java,Java,,51,15,84,150
AbstractListModel.java,Java,,60,19,124,203
AbstractSpinnerModel.java,Java,,33,18,73,124
Action.java,Java,,20,9,162,191
ActionMap.java,Java,,107,22,76,205
AncestorNotifier.java,Java,,145,31,43,219
Autoscroller.java,Java,,73,17,10,100
AbstractBorder.java,Java,,36,10,75,121
BevelBorder.java,Java,,123,38,118,279
Border.java,Java,,11,4,58,73
CompoundBorder.java,Java,,66,16,75,157
EmptyBorder.java,Java,,38,10,52,100
EtchedBorder.java,Java,,65,22,103,190
LineBorder.java,Java,,68,17,76,161
MatteBorder.java,Java,,126,26,89,241
SoftBevelBorder.java,Java,,68,20,67,155
TitledBorder.java,Java,,383,65,193,641
BorderFactory.java,Java,,127,30,344,501
BoundedRangeModel.java,Java,,18,30,201,249
Box.java,Java,,94,32,287,413
BoxLayout.java,Java,,183,41,261,485
ButtonGroup.java,Java,,60,15,90,165
ButtonModel.java,Java,,27,25,156,208
CellEditor.java,Java,,12,10,95,117
CellRendererPane.java,Java,,83,32,97,212
AbstractColorChooserPanel.java,Java,,70,22,130,222
CenterLayout.java,Java,,41,9,12,62
ColorChooserComponentFactory.java,Java,,14,10,23,47
ColorSelectionModel.java,Java,,10,6,40,56
DefaultColorSelectionModel.java,Java,,47,16,75,138
DefaultHSBChooserPanel.java,Java,,537,125,99,761
DefaultPreviewPanel.java,Java,,147,46,22,215
DefaultRGBChooserPanel.java,Java,,145,41,79,265
DefaultSwatchChooserPanel.java,Java,,481,67,68,616
SmartGridLayout.java,Java,,108,49,16,173
SyntheticImage.java,Java,,104,10,33,147
ComboBoxEditor.java,Java,,11,8,20,39
ComboBoxModel.java,Java,,5,4,30,39
ComponentInputMap.java,Java,,43,7,50,100
DebugGraphics.java,Java,,1036,177,236,1449
DebugGraphicsFilter.java,Java,,13,5,11,29
DebugGraphicsInfo.java,Java,,32,9,12,53
DebugGraphicsObserver.java,Java,,19,6,11,36
DefaultBoundedRangeModel.java,Java,,141,49,216,406
DefaultButtonModel.java,Java,,195,58,299,552
DefaultCellEditor.java,Java,,148,42,169,359
DefaultComboBoxModel.java,Java,,98,25,51,174
DefaultDesktopManager.java,Java,,437,113,163,713
DefaultFocusManager.java,Java,,99,26,27,152
DefaultListCellRenderer.java,Java,,76,27,123,226
DefaultListModel.java,Java,,141,42,340,523
DefaultListSelectionModel.java,Java,,320,81,269,670
DefaultSingleSelectionModel.java,Java,,52,15,94,161
DelegatingDefaultFocusManager.java,Java,,106,9,26,141
DesktopManager.java,Java,,19,11,72,102
AncestorEvent.java,Java,,25,7,54,86
AncestorListener.java,Java,,10,8,36,54
CaretEvent.java,Java,,9,7,39,55
CaretListener.java,Java,,5,5,18,28
CellEditorListener.java,Java,,7,7,15,29
ChangeEvent.java,Java,,7,4,28,39
ChangeListener.java,Java,,5,5,17,27
DocumentEvent.java,Java,,28,20,118,166
DocumentListener.java,Java,,7,5,49,61
EventListenerList.java,Java,,115,18,140,273
HyperlinkEvent.java,Java,,48,20,103,171
HyperlinkListener.java,Java,,5,5,17,27
InternalFrameAdapter.java,Java,,10,8,45,63
InternalFrameEvent.java,Java,,49,18,108,175
InternalFrameListener.java,Java,,11,9,50,70
ListDataEvent.java,Java,,26,12,66,104
ListDataListener.java,Java,,7,9,37,53
ListSelectionEvent.java,Java,,29,10,59,98
ListSelectionListener.java,Java,,6,8,19,33
MenuDragMouseEvent.java,Java,,24,7,54,85
MenuDragMouseListener.java,Java,,8,5,36,49
MenuEvent.java,Java,,7,4,30,41
MenuKeyEvent.java,Java,,23,7,50,80
MenuKeyListener.java,Java,,7,7,22,36
MenuListener.java,Java,,7,5,27,39
MouseInputAdapter.java,Java,,11,7,24,42
MouseInputListener.java,Java,,5,5,13,23
PopupMenuEvent.java,Java,,7,2,28,37
PopupMenuListener.java,Java,,7,6,22,35
SwingPropertyChangeSupport.java,Java,,176,35,119,330
TableColumnModelEvent.java,Java,,15,10,45,70
TableColumnModelListener.java,Java,,12,9,22,43
TableModelEvent.java,Java,,38,18,105,161
TableModelListener.java,Java,,6,5,18,29
TreeExpansionEvent.java,Java,,12,5,41,58
TreeExpansionListener.java,Java,,7,5,22,34
TreeModelEvent.java,Java,,75,16,206,297
TreeModelListener.java,Java,,8,8,65,81
TreeSelectionEvent.java,Java,,71,14,86,171
TreeSelectionListener.java,Java,,6,3,24,33
TreeWillExpandListener.java,Java,,7,5,22,34
UndoableEditEvent.java,Java,,12,5,33,50
UndoableEditListener.java,Java,,5,5,16,26
FileFilter.java,Java,,6,4,30,40
FileSystemView.java,Java,,408,93,241,742
FileView.java,Java,,20,8,64,92
FocusManager.java,Java,,36,10,81,127
GraphicsWrapper.java,Java,,10,8,12,30
GrayFilter.java,Java,,31,9,37,77
Icon.java,Java,,9,6,26,41
ImageIcon.java,Java,,230,61,318,609
InputMap.java,Java,,116,25,73,214
InputVerifier.java,Java,,8,11,98,117
InternalFrameFocusTraversalPolicy.java,Java,,10,4,37,51
JApplet.java,Java,,138,45,261,444
JButton.java,Java,,96,33,196,325
JCheckBox.java,Java,,124,38,218,380
JCheckBoxMenuItem.java,Java,,80,24,167,271
JColorChooser.java,Java,,283,89,340,712
JComboBox.java,Java,,747,170,1245,2162
JComponent.java,Java,,2296,432,2441,5169
JDesktopPane.java,Java,,140,44,220,404
JDialog.java,Java,,251,64,588,903
JEditorPane.java,Java,,1106,159,991,2256
JFileChooser.java,Java,,675,171,1025,1871
JFormattedTextField.java,Java,,398,88,661,1147
JFrame.java,Java,,244,60,525,829
JInternalFrame.java,Java,,864,183,1321,2368
JLabel.java,Java,,709,130,760,1599
JLayeredPane.java,Java,,295,66,372,733
JList.java,Java,,1321,293,1475,3089
JMenu.java,Java,,789,149,755,1693
JMenuBar.java,Java,,315,74,347,736
JMenuItem.java,Java,,418,75,432,925
JOptionPane.java,Java,,806,152,1443,2401
JPanel.java,Java,,63,23,141,227
JPasswordField.java,Java,,91,30,228,349
JPopupMenu.java,Java,,633,135,580,1348
JProgressBar.java,Java,,306,91,669,1066
JRadioButton.java,Java,,102,33,196,331
JRadioButtonMenuItem.java,Java,,69,21,155,245
JRootPane.java,Java,,309,78,604,991
JScrollBar.java,Java,,297,110,467,874
JScrollPane.java,Java,,468,140,809,1417
JSeparator.java,Java,,86,25,161,272
JSlider.java,Java,,466,164,581,1211
JSpinner.java,Java,,460,147,667,1274
JSplitPane.java,Java,,385,165,661,1211
JTabbedPane.java,Java,,830,196,994,2020
JTable.java,Java,,2700,539,2863,6102
JTextArea.java,Java,,295,53,456,804
JTextField.java,Java,,319,65,527,911
JTextPane.java,Java,,166,34,310,510
JToggleButton.java,Java,,144,48,198,390
JToolBar.java,Java,[WDW - need to add orientation from BoxLayout,390,83,421,894
JToolTip.java,Java,,77,29,155,261
JTree.java,Java,,2314,436,2090,4840
JViewport.java,Java,,833,187,776,1796
JWindow.java,Java,,133,42,376,551
KeyboardManager.java,Java,,201,47,84,332
KeyStroke.java,Java,,60,11,185,256
LayoutComparator.java,Java,,91,24,27,142
LayoutFocusTraversalPolicy.java,Java,,106,12,134,252
LegacyGlueFocusTraversalPolicy.java,Java,,147,15,21,183
ListCellRenderer.java,Java,,11,4,55,70
ListModel.java,Java,,9,7,37,53
ListSelectionModel.java,Java,,28,36,191,255
LookAndFeel.java,Java,,166,44,230,440
MenuElement.java,Java,,10,10,43,63
MenuSelectionManager.java,Java,,302,50,103,455
MultiUIDefaults.java,Java,,130,34,11,175
MutableComboBoxModel.java,Java,,7,8,41,56
OverlayLayout.java,Java,,116,26,116,258
ActionMapUIResource.java,Java,,6,4,13,23
BasicArrowButton.java,Java,,155,32,26,213
BasicBorders.java,Java,,457,86,65,608
BasicButtonListener.java,Java,,229,45,41,315
BasicButtonUI.java,Java,,242,67,96,405
BasicCheckBoxMenuItemUI.java,Java,,32,15,14,61
BasicCheckBoxUI.java,Java,,16,10,24,50
BasicColorChooserUI.java,Java,,206,59,18,283
BasicComboBoxEditor.java,Java,,71,21,42,134
BasicComboBoxRenderer.java,Java,,62,20,43,125
BasicComboBoxUI.java,Java,,918,201,470,1589
BasicComboPopup.java,Java,,548,122,462,1132
BasicDesktopIconUI.java,Java,,175,44,27,246
BasicDesktopPaneUI.java,Java,,466,51,97,614
BasicDirectoryModel.java,Java,,272,46,42,360
BasicDragGestureRecognizer.java,Java,,83,24,31,138
BasicDropTargetListener.java,Java,,147,35,110,292
BasicEditorPaneUI.java,Java,,81,14,58,153
BasicFileChooserUI.java,Java,,879,173,145,1197
BasicFormattedTextFieldUI.java,Java,,11,3,26,40
BasicGraphicsUtils.java,Java,,189,57,59,305
BasicHTML.java,Java,,228,49,269,546
BasicIconFactory.java,Java,,151,33,22,206
BasicInternalFrameTitlePane.java,Java,,494,98,95,687
BasicInternalFrameUI.java,Java,,1077,186,199,1462
BasicLabelUI.java,Java,,290,54,108,452
BasicListUI.java,Java,,1336,268,707,2311
BasicLookAndFeel.java,Java,,1368,151,236,1755
BasicMenuBarUI.java,Java,,186,40,23,249
BasicMenuItemUI.java,Java,,814,137,187,1138
BasicMenuUI.java,Java,,450,80,91,621
BasicOptionPaneUI.java,Java,,913,166,271,1350
BasicPanelUI.java,Java,,34,11,13,58
BasicPasswordFieldUI.java,Java,,17,12,35,64
BasicPopupMenuSeparatorUI.java,Java,,27,9,13,49
BasicPopupMenuUI.java,Java,,820,141,112,1073
BasicProgressBarUI.java,Java,,766,151,422,1339
BasicRadioButtonMenuItemUI.java,Java,,33,13,13,59
BasicRadioButtonUI.java,Java,,151,41,46,238
BasicRootPaneUI.java,Java,,121,25,24,170
BasicScrollBarUI.java,Java,,884,186,226,1296
BasicScrollPaneUI.java,Java,,641,111,157,909
BasicSeparatorUI.java,Java,,68,22,14,104
BasicSliderUI.java,Java,,1294,248,135,1677
BasicSpinnerUI.java,Java,,507,112,276,895
BasicSplitPaneDivider.java,Java,,578,141,269,988
BasicSplitPaneUI.java,Java,,1245,278,649,2172
BasicTabbedPaneUI.java,Java,,2398,360,428,3186
BasicTableHeaderUI.java,Java,,331,75,98,504
BasicTableUI.java,Java,,936,192,241,1369
BasicTextAreaUI.java,Java,,164,30,102,296
BasicTextFieldUI.java,Java,,182,29,168,379
BasicTextPaneUI.java,Java,,67,17,60,144
BasicTextUI.java,Java,,1217,211,1023,2451
BasicToggleButtonUI.java,Java,,98,31,28,157
BasicToolBarSeparatorUI.java,Java,,55,16,14,85
BasicToolBarUI.java,Java,,928,178,204,1310
BasicToolTipUI.java,Java,,169,31,37,237
BasicTransferable.java,Java,,154,31,80,265
BasicTreeUI.java,Java,,2608,505,743,3856
BasicViewportUI.java,Java,,31,11,13,55
CenterLayout.java,Java,,41,9,12,62
ComboPopup.java,Java,,15,11,58,84
DefaultMenuLayout.java,Java,,19,6,15,40
BorderUIResource.java,Java,,152,43,33,228
ButtonUI.java,Java,,5,3,12,20
ColorChooserUI.java,Java,,6,6,13,25
ColorUIResource.java,Java,,18,7,24,49
ComboBoxUI.java,Java,,7,6,22,35
ComponentInputMapUIResource.java,Java,,8,4,13,25
ComponentUI.java,Java,,46,17,223,286
DesktopIconUI.java,Java,,3,4,12,19
DesktopPaneUI.java,Java,,3,4,12,19
DimensionUIResource.java,Java,,9,4,26,39
FileChooserUI.java,Java,,14,7,12,33
FontUIResource.java,Java,,12,5,25,42
IconUIResource.java,Java,,25,8,33,66
InputMapUIResource.java,Java,,6,4,13,23
InsetsUIResource.java,Java,,9,4,25,38
InternalFrameUI.java,Java,,3,3,12,18
LabelUI.java,Java,,3,2,12,17
ListUI.java,Java,,10,9,38,57
MenuBarUI.java,Java,,5,5,13,23
MenuItemUI.java,Java,,5,3,14,22
DefaultMetalTheme.java,Java,,149,33,71,253
MetalBorders.java,Java,,636,167,87,890
MetalBumps.java,Java,,164,35,24,223
MetalButtonUI.java,Java,,97,30,43,170
MetalCheckBoxIcon.java,Java,,55,14,21,90
MetalCheckBoxUI.java,Java,,29,14,31,74
MetalComboBoxButton.java,Java,,136,29,28,193
MetalComboBoxEditor.java,Java,,49,14,39,102
MetalComboBoxIcon.java,Java,,24,11,22,57
MetalComboBoxUI.java,Java,,132,34,68,234
MetalDesktopIconUI.java,Java,,88,21,19,128
MetalFileChooserUI.java,Java,,1561,279,176,2016
MetalFontDesktopProperty.java,Java,,35,8,39,82
MetalHighContrastTheme.java,Java,,121,33,18,172
MetalIconFactory.java,Java,,1537,327,290,2154
MetalInternalFrameTitlePane.java,Java,,382,68,61,511
MetalInternalFrameUI.java,Java,,143,32,17,192
MetalLabelUI.java,Java,,24,10,21,55
MetalLookAndFeel.java,Java,,1100,136,184,1420
MetalPopupMenuSeparatorUI.java,Java,,29,13,13,55
MetalProgressBarUI.java,Java,,96,25,50,171
MetalRadioButtonUI.java,Java,,128,33,40,201
MetalRootPaneUI.java,Java,,591,95,285,971
MetalScrollBarUI.java,Java,,281,134,35,450
MetalScrollButton.java,Java,,236,57,45,338
MetalScrollPaneUI.java,Java,,73,21,27,121
MetalSeparatorUI.java,Java,,45,15,22,82
MetalSliderUI.java,Java,,256,58,40,354
MetalSplitPaneDivider.java,Java,,257,38,83,378
MetalSplitPaneUI.java,Java,,13,6,27,46
MetalTabbedPaneUI.java,Java,,651,157,169,977
MetalTextFieldUI.java,Java,,15,7,29,51
MetalTheme.java,Java,,68,21,27,116
MetalTitlePane.java,Java,,644,135,217,996
MetalToggleButtonUI.java,Java,,89,24,38,151
MetalToolBarUI.java,Java,,139,31,46,216
MetalToolTipUI.java,Java,,105,25,30,160
MetalTreeUI.java,Java,,127,40,54,221
MetalUtils.java,Java,,103,23,37,163
MultiButtonUI.java,Java,,88,18,87,193
MultiColorChooserUI.java,Java,,88,18,87,193
MultiComboBoxUI.java,Java,,110,21,102,233
MultiDesktopIconUI.java,Java,,88,18,87,193
MultiDesktopPaneUI.java,Java,,88,18,87,193
MultiFileChooserUI.java,Java,,135,24,117,276
MultiInternalFrameUI.java,Java,,88,18,87,193
MultiLabelUI.java,Java,,88,18,87,193
MultiListUI.java,Java,,115,21,105,241
MultiLookAndFeel.java,Java,,120,16,147,283
MultiMenuBarUI.java,Java,,88,18,87,193
MultiMenuItemUI.java,Java,,89,19,90,198
MultiOptionPaneUI.java,Java,,102,20,96,218
MultiPanelUI.java,Java,,88,18,87,193
MultiPopupMenuUI.java,Java,,107,20,99,226
MultiProgressBarUI.java,Java,,88,18,87,193
MultiRootPaneUI.java,Java,,88,18,87,193
MultiScrollBarUI.java,Java,,88,18,87,193
MultiScrollPaneUI.java,Java,,88,18,87,193
MultiSeparatorUI.java,Java,,88,18,87,193
MultiSliderUI.java,Java,,88,18,87,193
MultiSpinnerUI.java,Java,,88,18,87,193
MultiSplitPaneUI.java,Java,,128,24,114,266
MultiTabbedPaneUI.java,Java,,114,21,105,240
MultiTableHeaderUI.java,Java,,88,18,87,193
MultiTableUI.java,Java,,88,18,87,193
MultiTextUI.java,Java,,173,28,141,342
MultiToolBarUI.java,Java,,88,18,87,193
MultiToolTipUI.java,Java,,88,18,87,193
MultiTreeUI.java,Java,,165,28,141,334
MultiViewportUI.java,Java,,88,18,87,193
OptionPaneUI.java,Java,,7,5,20,32
PanelUI.java,Java,,3,4,12,19
PopupMenuUI.java,Java,,14,7,26,47
ProgressBarUI.java,Java,,3,3,12,18
RootPaneUI.java,Java,,3,2,12,17
ScrollBarUI.java,Java,,3,2,12,17
ScrollPaneUI.java,Java,,3,4,12,19
SeparatorUI.java,Java,,3,4,13,20
SliderUI.java,Java,,3,3,12,18
SpinnerUI.java,Java,,3,4,13,20
SplitPaneUI.java,Java,,12,8,32,52
TabbedPaneUI.java,Java,,8,3,13,24
TableHeaderUI.java,Java,,3,2,12,17
TableUI.java,Java,,3,2,12,17
TextUI.java,Java,,28,11,107,146
ToolBarUI.java,Java,,5,5,12,22
ToolTipUI.java,Java,,3,2,12,17
TreeUI.java,Java,,18,12,58,88
UIResource.java,Java,,3,4,43,50
ViewportUI.java,Java,,3,4,12,19
Popup.java,Java,,92,28,105,225
PopupFactory.java,Java,,538,113,233,884
ProgressMonitor.java,Java,,199,51,144,394
ProgressMonitorInputStream.java,Java,,73,25,73,171
Renderer.java,Java,,6,3,25,34
RepaintManager.java,Java,,382,97,223,702
RootPaneContainer.java,Java,,13,18,108,139
Scrollable.java,Java,,11,11,89,111
ScrollPaneConstants.java,Java,,25,8,68,101
ScrollPaneLayout.java,Java,,517,138,412,1067
SingleSelectionModel.java,Java,,10,8,42,60
SizeRequirements.java,Java,,175,27,267,469
SizeSequence.java,Java,,126,22,221,369
SortingFocusTraversalPolicy.java,Java,,218,59,196,473
SpinnerDateModel.java,Java,,110,33,297,440
SpinnerListModel.java,Java,,73,28,130,231
SpinnerModel.java,Java,,12,14,96,122
SpinnerNumberModel.java,Java,,118,39,277,434
Spring.java,Java,,202,62,218,482
SpringLayout.java,Java,,399,83,530,1012
SwingConstants.java,Java,,22,8,91,121
SwingGraphics.java,Java,,449,87,48,584
SwingUtilities.java,Java,,1011,165,604,1780
SystemEventQueueUtilities.java,Java,,450,88,275,813
AbstractTableModel.java,Java,,74,24,226,324
DefaultTableCellRenderer.java,Java,,94,33,159,286
DefaultTableColumnModel.java,Java,,270,74,383,727
DefaultTableModel.java,Java,,214,55,407,676
JTableHeader.java,Java,,790,155,510,1455
TableCellEditor.java,Java,,9,7,40,56
TableCellRenderer.java,Java,,8,5,38,51
TableColumn.java,Java,,224,76,479,779
TableColumnModel.java,Java,,27,26,171,224
TableModel.java,Java,,15,13,99,127
AbstractDocument.java,Java,,1257,294,1511,3062
AbstractWriter.java,Java,,331,53,316,700
AsyncBoxView.java,Java,,649,109,642,1400
AttributeSet.java,Java,,23,18,121,162
BadLocationException.java,Java,,12,3,33,48
BoxView.java,Java,,565,82,519,1166
Caret.java,Java,,24,21,140,185
ChangedCharSetException.java,Java,,16,7,13,36
ComponentView.java,Java,,224,36,200,460
CompositeView.java,Java,,321,47,408,776
DateFormatter.java,Java,,64,17,62,143
DefaultCaret.java,Java,,841,131,636,1608
DefaultEditorKit.java,Java,,1053,211,898,2162
DefaultFormatter.java,Java,,371,77,294,742
DefaultFormatterFactory.java,Java,,87,22,190,299
DefaultHighlighter.java,Java,,317,44,162,523
DefaultStyledDocument.java,Java,,1476,202,809,2487
DefaultTextUI.java,Java,,4,5,15,24
Document.java,Java,,23,23,413,459
DocumentFilter.java,Java,,26,8,123,157
EditorKit.java,Java,,34,16,141,191
Element.java,Java,,13,14,96,123
ElementIterator.java,Java,,167,42,155,364
FieldView.java,Java,,147,19,126,292
FlowView.java,Java,,370,62,381,813
GapContent.java,Java,,537,94,294,925
GapVector.java,Java,,117,32,125,274
GlyphPainter1.java,Java,,105,20,86,211
GlyphPainter2.java,Java,,211,28,125,364
GlyphView.java,Java,,529,82,529,1140
Highlighter.java,Java,,22,20,94,136
AccessibleHTML.java,Java,,1527,290,1190,3007
BlockView.java,Java,,204,32,189,425
BRView.java,Java,,17,5,22,44
CommentView.java,Java,,87,13,19,119
CSS.java,Java,,2045,310,779,3134
CSSParser.java,Java,,583,77,177,837
EditableView.java,Java,,63,11,30,104
FormView.java,Java,,578,86,327,991
FrameSetView.java,Java,,170,33,94,297
FrameView.java,Java,,230,43,116,389
HiddenTagView.java,Java,,252,39,51,342
HRuleView.java,Java,,179,25,94,298
HTML.java,Java,,397,46,214,657
HTMLDocument.java,Java,,2015,286,1383,3684
HTMLEditorKit.java,Java,,1251,156,752,2159
HTMLFrameHyperlinkEvent.java,Java,,30,11,55,96
HTMLWriter.java,Java,,793,102,326,1221
ImageView.java,Java,,668,102,291,1061
InlineView.java,Java,,157,18,82,257
IsindexView.java,Java,,51,15,31,97
LineView.java,Java,,62,11,95,168
ListView.java,Java,,53,8,44,105
Map.java,Java,,348,48,92,488
MinimalHTMLWriter.java,Java,,348,82,279,709
MuxingAttributeSet.java,Java,,148,28,118,294
NoFramesView.java,Java,,57,15,84,156
ObjectView.java,Java,,75,11,82,168
Option.java,Java,,38,12,46,96
OptionComboBoxModel.java,Java,,13,7,26,46
OptionListModel.java,Java,,305,74,177,556
ParagraphView.java,Java,,148,21,113,282
AttributeList.java,Java,,83,19,53,155
ContentModel.java,Java,,144,26,68,238
ContentModelState.java,Java,,173,27,78,278
DocumentParser.java,Java,,141,20,93,254
DTD.java,Java,,251,33,151,435
DTDConstants.java,Java,,39,6,20,65
Element.java,Java,,79,22,57,158
Entity.java,Java,,53,15,55,123
Parser.java,Java,,1430,232,470,2132
ParserDelegator.java,Java,,67,15,28,110
ResourceLoader.java,Java,,16,7,20,43
TagElement.java,Java,,33,15,13,61
TagStack.java,Java,,123,29,53,205
ResourceLoader.java,Java,,16,7,20,43
StyleSheet.java,Java,,1960,211,981,3152
TableView.java,Java,,995,163,592,1750
TextAreaDocument.java,Java,,20,12,23,55
IconView.java,Java,,56,12,84,152
InternationalFormatter.java,Java,,567,95,421,1083
JTextComponent.java,Java,,1833,320,1609,3762
Keymap.java,Java,,18,16,94,128
LabelView.java,Java,,90,24,161,275
LayeredHighlighter.java,Java,,14,4,28,46
LayoutQueue.java,Java,,54,15,35,104
MaskFormatter.java,Java,,465,86,438,989
MutableAttributeSet.java,Java,,10,20,51,81
NavigationFilter.java,Java,,22,8,99,129
NumberFormatter.java,Java,,282,45,158,485
ParagraphView.java,Java,,433,52,407,892
PasswordView.java,Java,,110,12,94,216
PlainDocument.java,Java,,168,16,119,303
PlainView.java,Java,,369,45,268,682
Position.java,Java,,15,8,39,62
AbstractFilter.java,Java,,108,27,78,213
Constants.java,Java,,28,10,22,60
MockAttributeSet.java,Java,,78,22,8,108
RTFAttribute.java,Java,,26,7,16,49
RTFAttributes.java,Java,,324,64,16,404
RTFEditorKit.java,Java,,43,13,82,138
RTFGenerator.java,Java,,764,130,97,991
RTFParser.java,Java,,228,35,53,316
RTFReader.java,Java,,1124,227,282,1633
Segment.java,Java,,96,27,126,249
SegmentCache.java,Java,,39,15,56,110
SimpleAttributeSet.java,Java,,200,35,153,388
StateInvariantError.java,Java,,7,2,19,28
StringContent.java,Java,,264,40,177,481
Style.java,Java,,11,10,37,58
StyleConstants.java,Java,,308,131,552,991
StyleContext.java,Java,,698,146,744,1588
StyledDocument.java,Java,,17,16,127,160
StyledEditorKit.java,Java,,393,76,405,874
TabableView.java,Java,,5,4,44,53
TabExpander.java,Java,,4,4,22,30
TableView.java,Java,,425,75,394,894
TabSet.java,Java,,66,15,54,135
TabStop.java,Java,,76,15,70,161
TextAction.java,Java,,45,6,68,119
TextLayoutStrategy.java,Java,,301,52,192,545
Utilities.java,Java,,496,48,268,812
View.java,Java,,376,66,914,1356
ViewFactory.java,Java,,5,4,22,31
WrappedPlainView.java,Java,,384,57,311,752
ZoneView.java,Java,,247,49,338,634
Timer.java,Java,,139,65,337,541
TimerQueue.java,Java,,172,60,40,272
ToolTipManager.java,Java,,520,78,224,822
TransferHandler.java,Java,,442,94,315,851
AbstractLayoutCache.java,Java,,140,56,318,514
DefaultMutableTreeNode.java,Java,,646,227,617,1490
DefaultTreeCellEditor.java,Java,,344,88,287,719
DefaultTreeCellRenderer.java,Java,,223,66,227,516
DefaultTreeModel.java,Java,,263,57,341,661
DefaultTreeSelectionModel.java,Java,,702,118,391,1211
ExpandVetoException.java,Java,,12,6,28,46
FixedHeightLayoutCache.java,Java,,962,185,435,1582
MutableTreeNode.java,Java,,10,8,38,56
RowMapper.java,Java,,6,3,20,29
TreeCellEditor.java,Java,,10,4,34,48
TreeCellRenderer.java,Java,,8,4,31,43
TreeModel.java,Java,,13,15,106,134
TreeNode.java,Java,,12,10,46,68
TreePath.java,Java,,138,33,147,318
TreeSelectionModel.java,Java,,36,33,225,294
VariableHeightLayoutCache.java,Java,,1046,191,513,1750
UIDefaults.java,Java,,443,102,619,1164
UIManager.java,Java,,528,138,555,1221
AbstractUndoableEdit.java,Java,,73,24,165,262
CannotRedoException.java,Java,,3,2,21,26
CannotUndoException.java,Java,,3,3,21,27
CompoundEdit.java,Java,,110,21,114,245
StateEdit.java,Java,,59,27,90,176
StateEditable.java,Java,,7,8,21,36
UndoableEdit.java,Java,,15,14,90,119
UndoableEditSupport.java,Java,,70,17,75,162
UndoManager.java,Java,,210,44,209,463
UnsupportedLookAndFeelException.java,Java,,7,1,26,34
ViewportLayout.java,Java,,81,19,83,183
WindowConstants.java,Java,,8,7,52,67
DocumentBuilder.java,Java,,63,34,139,236
DocumentBuilderFactory.java,Java,,72,39,185,296
FactoryConfigurationError.java,Java,,30,27,56,113
FactoryFinder.java,Java,,139,22,60,221
ParserConfigurationException.java,Java,,9,9,22,40
SAXParser.java,Java,,136,49,242,427
SAXParserFactory.java,Java,,45,21,140,206
DOMLocator.java,Java,,6,7,20,33
DOMResult.java,Java,,32,18,82,132
DOMSource.java,Java,,32,18,71,121
ErrorListener.java,Java,,9,5,77,91
FactoryFinder.java,Java,,139,22,60,221
OutputKeys.java,Java,,15,13,141,169
Result.java,Java,,12,9,52,73
SAXResult.java,Java,,37,20,74,131
SAXSource.java,Java,,62,26,94,182
SAXTransformerFactory.java,Java,,27,14,98,139
TemplatesHandler.java,Java,,9,8,36,53
TransformerHandler.java,Java,,16,10,34,60
Source.java,Java,,8,7,27,42
SourceLocator.java,Java,,7,6,66,79
StreamResult.java,Java,,54,23,109,186
StreamSource.java,Java,,68,27,164,259
Templates.java,Java,,7,7,52,66
Transformer.java,Java,,22,17,197,236
TransformerConfigurationException.java,Java,,24,7,53,84
TransformerException.java,Java,,166,60,128,354
TransformerFactory.java,Java,,45,18,186,249
TransformerFactoryConfigurationError.java,Java,,30,19,51,100
URIResolver.java,Java,,5,3,25,33
java.c,C/C++/ObjC,,1125,150,359,1634
java.h,h,,35,17,32,84
java_md.c,C/C++/ObjC,,405,67,150,622
java_md.h,h,,28,9,18,55
DefaultValidationErrorHandler.java,Java,,28,5,58,91
DocumentBuilderFactoryImpl.java,Java,,24,9,72,105
DocumentBuilderImpl.java,Java,,97,33,76,206
SAXParserFactoryImpl.java,Java,,63,11,89,163
SAXParserImpl.java,Java,,76,22,104,202
AttributeDecl.java,Java,,26,13,64,103
AttributesEx.java,Java,,8,6,90,104
AttributesExImpl.java,Java,,48,14,84,146
ContentModel.java,Java,,104,27,158,289
ContentModelState.java,Java,,104,17,96,217
ElementDecl.java,Java,,13,13,90,116
ElementValidator.java,Java,,12,7,71,90
EndOfInputException.java,Java,,3,6,60,69
EntityDecl.java,Java,,6,5,63,74
ExternalEntity.java,Java,,25,9,61,95
InputEntity.java,Java,,666,133,310,1109
InternalEntity.java,Java,,10,5,60,75
Parser2.java,Java,,2203,470,855,3528
Resolver.java,Java,,207,46,253,506
SimpleHashtable.java,Java,,132,35,155,322
ValidatingParser.java,Java,,201,49,122,372
XmlReader.java,Java,,464,97,303,864
XMLReaderImpl.java,Java,,216,39,225,480
AttributeNode.java,Java,,143,37,144,324
AttributeNode1.java,Java,,22,5,76,103
AttributeSet.java,Java,,344,67,141,552
CDataNode.java,Java,,42,15,87,144
CommentNode.java,Java,,46,14,74,134
DataNode.java,Java,,121,38,121,280
Doctype.java,Java,,295,70,129,494
DocumentEx.java,Java,,15,19,147,181
DomEx.java,Java,,51,7,74,132
DOMImplementationImpl.java,Java,,52,12,83,147
ElementEx.java,Java,,9,7,96,112
ElementFactory.java,Java,,7,5,85,97
ElementNode.java,Java,,30,7,97,134
ElementNode2.java,Java,,348,66,209,623
NamespacedNode.java,Java,,58,15,101,174
NodeBase.java,Java,,147,54,230,431
NodeEx.java,Java,,10,8,106,124
ParentNode.java,Java,,464,110,227,801
ParseContext.java,Java,,9,6,84,99
PINode.java,Java,,50,21,87,158
SimpleElementFactory.java,Java,,145,34,201,380
TextNode.java,Java,,84,27,120,231
TreeWalker.java,Java,,115,23,144,282
XmlDocument.java,Java,,684,164,607,1455
XmlDocumentBuilder.java,Java,,329,99,368,796
XmlDocumentBuilderNS.java,Java,,85,17,100,202
XmlWritable.java,Java,,9,5,73,87
XmlWriteContext.java,Java,,51,16,114,181
MessageCatalog.java,Java,,218,54,301,573
XmlChars.java,Java,,177,38,212,427
XmlNames.java,Java,,72,23,135,230
ExpressionContext.java,Java,,17,10,101,128
ExpressionVisitor.java,Java,,23,4,79,106
ExtensionHandler.java,Java,,77,25,132,234
ExtensionHandlerExsltFunction.java,Java,,116,17,104,237
ExtensionHandlerGeneral.java,Java,,223,64,155,442
ExtensionHandlerJava.java,Java,,23,11,102,136
ExtensionHandlerJavaClass.java,Java,,249,45,164,458
ExtensionHandlerJavaPackage.java,Java,,298,41,168,507
ExtensionNamespacesManager.java,Java,,146,32,139,317
ExtensionNamespaceSupport.java,Java,,66,6,13,85
ExtensionsTable.java,Java,,104,17,126,247
MethodResolver.java,Java,,669,72,293,1034
XSLProcessorContext.java,Java,,181,40,135,356
ExsltBase.java,Java,,43,3,73,119
ExsltCommon.java,Java,,53,10,107,170
ExsltDatetime.java,Java,,439,70,449,958
ExsltDynamic.java,Java,,288,72,284,644
ExsltMath.java,Java,,157,35,232,424
ExsltSets.java,Java,,104,27,144,275
ExsltStrings.java,Java,,143,27,192,362
Extensions.java,Java,,178,41,222,441
NodeInfo.java,Java,,105,24,155,284
PipeDocument.java,Java,,132,19,128,279
Redirect.java,Java,,254,31,188,473
ConnectionPool.java,Java,,23,22,150,195
ConnectionPoolManager.java,Java,,41,19,108,168
DefaultConnectionPool.java,Java,,285,99,236,620
DTMDocument.java,Java,,870,173,586,1629
ObjectArray.java,Java,,104,30,73,207
PooledConnection.java,Java,,32,8,88,128
QueryParameter.java,Java,,23,8,86,117
SQLDocument.java,Java,,474,97,299,870
SQLErrorDocument.java,Java,,57,23,123,203
XConnection.java,Java,,760,182,455,1397
ProcessorAttributeSet.java,Java,,35,10,94,139
ProcessorCharacters.java,Java,,74,25,120,219
ProcessorDecimalFormat.java,Java,,16,7,86,109
ProcessorExsltFuncResult.java,Java,,44,7,65,116
ProcessorExsltFunction.java,Java,,137,14,85,236
ProcessorGlobalParamDecl.java,Java,,23,8,84,115
ProcessorGlobalVariableDecl.java,Java,,23,8,84,115
ProcessorImport.java,Java,,27,10,71,108
ProcessorInclude.java,Java,,177,42,122,341
ProcessorKey.java,Java,,76,20,97,193
ProcessorLRE.java,Java,,230,52,107,389
ProcessorNamespaceAlias.java,Java,,32,6,86,124
ProcessorOutputElem.java,Java,,94,27,143,264
ProcessorPreserveSpace.java,Java,,27,7,79,113
ProcessorStripSpace.java,Java,,26,8,79,113
ProcessorStylesheetDoc.java,Java,,4,1,61,66
ProcessorStylesheetElement.java,Java,,66,14,88,168
ProcessorTemplate.java,Java,,16,5,70,91
ProcessorTemplateElem.java,Java,,65,13,95,173
ProcessorText.java,Java,,26,12,84,122
ProcessorUnknown.java,Java,,20,5,86,111
StopParseException.java,Java,,8,2,66,76
StylesheetHandler.java,Java,,695,222,804,1721
StylesheetPIHandler.java,Java,,200,30,132,362
TransformerFactoryImpl.java,Java,,553,114,405,1072
WhitespaceInfoPaths.java,Java,,25,10,25,60
XSLProcessorVersion.java,Java,,18,10,124,152
XSLTAttributeDef.java,Java,,840,183,630,1653
XSLTElementDef.java,Java,,368,88,414,870
XSLTElementProcessor.java,Java,,162,43,216,421
XSLTSchema.java,Java,,721,65,147,933
XSLMessages.java,Java,,178,62,176,416
XSLTErrorResources.java,Java,,1131,660,816,2607
XSLTErrorResources_de.java,Java,,957,610,738,2305
XSLTErrorResources_en.java,Java,,4,2,61,67
XSLTErrorResources_es.java,Java,,964,620,739,2323
XSLTErrorResources_fr.java,Java,,964,609,739,2312
XSLTErrorResources_it.java,Java,,964,1178,745,2887
XSLTErrorResources_ja.java,Java,,965,1172,1023,3160
XSLTErrorResources_ko.java,Java,,1396,1187,748,3331
XSLTErrorResources_sv.java,Java,,955,1175,738,2868
XSLTErrorResources_zh_CN.java,Java,,966,1174,737,2877
XSLTErrorResources_zh_TW.java,Java,,966,1172,736,2874
CharInfo.java,Java,,121,42,148,311
DOMSerializer.java,Java,,7,3,84,94
ElemDesc.java,Java,,49,35,120,204
EncodingInfo.java,Java,,13,6,76,95
Encodings.java,Java,,215,42,162,419
Method.java,Java,,8,5,78,91
Serializer.java,Java,,18,12,134,164
SerializerFactory.java,Java,,46,20,81,147
SerializerToHTML.java,Java,,762,203,411,1376
SerializerToText.java,Java,,158,47,349,554
SerializerToXML.java,Java,,1355,337,906,2598
WriterToASCI.java,Java,,43,13,120,176
WriterToUTF8.java,Java,,83,17,126,226
WriterToUTF8Buffered.java,Java,,184,49,180,413
AbsPathChecker.java,Java,,30,6,81,117
AVT.java,Java,,344,101,197,642
AVTPart.java,Java,,19,11,103,133
AVTPartSimple.java,Java,,27,10,101,138
AVTPartXPath.java,Java,,51,13,126,190
Constants.java,Java,,307,44,168,519
DecimalFormatProperties.java,Java,,122,39,269,430
ElemApplyImport.java,Java,,48,14,97,159
ElemApplyTemplates.java,Java,,251,55,178,484
ElemAttribute.java,Java,,115,26,171,312
ElemAttributeSet.java,Java,,68,25,124,217
ElemCallTemplate.java,Java,,171,39,189,399
ElemChoose.java,Java,,93,38,111,242
ElemComment.java,Java,,67,16,111,194
ElemCopy.java,Java,,73,18,102,193
ElemCopyOf.java,Java,,127,33,133,293
ElemElement.java,Java,,197,61,201,459
ElemEmpty.java,Java,,9,5,65,79
ElemExsltFuncResult.java,Java,,51,10,32,93
ElemExsltFunction.java,Java,,86,26,130,242
ElemExtensionCall.java,Java,,178,50,155,383
ElemExtensionDecl.java,Java,,141,30,245,416
ElemExtensionScript.java,Java,,29,10,99,138
ElemFallback.java,Java,,42,14,104,160
ElemForEach.java,Java,,239,73,243,555
ElemIf.java,Java,,67,26,133,226
ElemLiteralResult.java,Java,,315,100,357,772
ElemMessage.java,Java,,41,16,116,173
ElemNumber.java,Java,,1141,317,765,2223
ElemOtherwise.java,Java,,17,6,76,99
ElemParam.java,Java,,47,17,107,171
ElemPI.java,Java,,98,30,144,272
ElemSort.java,Java,,89,26,271,386
ElemTemplate.java,Java,,127,46,289,462
ElemTemplateElement.java,Java,,732,226,746,1704
ElemText.java,Java,,41,16,136,193
ElemTextLiteral.java,Java,,82,24,166,272
ElemUnknown.java,Java,,23,9,69,101
ElemUse.java,Java,,73,24,152,249
ElemValueOf.java,Java,,148,41,191,380
ElemVariable.java,Java,,214,69,277,560
ElemVariablePsuedo.java,Java,,17,8,23,48
ElemWhen.java,Java,,41,13,113,167
ElemWithParam.java,Java,,100,31,151,282
FuncDocument.java,Java,,257,63,186,506
FuncFormatNumb.java,Java,,97,31,102,230
FuncKey.java,Java,,89,24,81,194
KeyDeclaration.java,Java,,52,15,144,211
NamespaceAlias.java,Java,,49,16,129,194
OutputProperties.java,Java,,510,128,484,1122
RedundentExprEliminator.java,Java,,910,129,435,1474
Stylesheet.java,Java,,581,213,753,1547
StylesheetComposed.java,Java,,149,57,192,398
StylesheetRoot.java,Java,,547,186,602,1335
TemplateList.java,Java,,560,108,289,957
TemplateSubPatternAssociation.java,Java,,87,32,167,286
VarNameCollector.java,Java,,27,9,24,60
WhiteSpaceInfo.java,Java,,24,12,91,127
XMLNSDecl.java,Java,,26,9,87,122
XSLTVisitable.java,Java,,5,2,13,20
XSLTVisitor.java,Java,,38,14,113,165
XUnresolvedVariable.java,Java,,74,23,133,230
XUnresolvedVariableSimple.java,Java,,27,10,27,64
EndSelectionEvent.java,Java,,15,5,17,37
GenerateEvent.java,Java,,62,32,163,257
PrintTraceListener.java,Java,,202,44,138,384
SelectionEvent.java,Java,,26,11,90,127
TraceListener.java,Java,,8,5,82,95
TraceListenerEx.java,Java,,5,3,68,76
TraceListenerEx2.java,Java,,5,1,66,72
TraceManager.java,Java,,153,47,151,351
TracerEvent.java,Java,,74,25,103,202
ClonerToResultTree.java,Java,,83,12,176,271
Counter.java,Java,,46,26,127,199
CountersTable.java,Java,,85,38,123,246
DecimalToRoman.java,Java,,16,7,75,98
KeyIterator.java,Java,,64,21,107,192
KeyManager.java,Java,,61,17,78,156
KeyRefIterator.java,Java,,90,23,92,205
KeyTable.java,Java,,139,28,130,297
MsgMgr.java,Java,,92,30,236,358
NodeSorter.java,Java,,250,86,282,618
NodeSortKey.java,Java,,49,22,96,167
NumeratorFormatter.java,Java,,147,51,178,376
QueuedEvents.java,Java,,56,30,125,211
ResultNameSpace.java,Java,,12,5,72,89
ResultTreeHandler.java,Java,,891,279,758,1928
SerializerSwitcher.java,Java,,97,33,113,243
StackGuard.java,Java,,75,20,131,226
TransformerClient.java,Java,,5,2,72,79
TransformerHandlerImpl.java,Java,,476,138,491,1105
TransformerIdentityImpl.java,Java,,586,148,690,1424
TransformerImpl.java,Java,,1626,456,1416,3498
TransformSnapshot.java,Java,,4,2,4,10
TransformSnapshotImpl.java,Java,,119,50,134,303
TransformState.java,Java,,16,11,128,155
TrAXFilter.java,Java,,121,25,72,218
TreeWalker2Result.java,Java,,84,22,96,202
XalanProperties.java,Java,,6,2,62,70
XSLInfiniteLoopException.java,Java,,12,3,70,85
Version.java,Java,,39,10,139,188
EnvironmentCheck.java,Java,,759,160,456,1375
Process.java,Java,,891,123,170,1184
Axis.java,Java,,49,25,149,223
DTM.java,Java,,93,93,818,1004
DTMAxisIterator.java,Java,,15,12,105,132
DTMAxisTraverser.java,Java,,14,5,133,152
DTMConfigurationException.java,Java,,25,8,47,80
DTMDOMException.java,Java,,12,2,75,89
DTMException.java,Java,,167,64,120,351
DTMFilter.java,Java,,21,20,183,224
DTMIterator.java,Java,,32,33,315,380
DTMManager.java,Java,,198,69,317,584
DTMWSFilter.java,Java,,8,5,23,36
ChunkedIntArray.java,Java,,148,23,174,345
CoroutineManager.java,Java,,92,23,266,381
CoroutineParser.java,Java,,17,14,149,180
CustomStringPool.java,Java,,33,6,86,125
DOM2DTM.java,Java,,879,193,697,1769
DOM2DTMdefaultNamespaceDeclarationNode.java,Java,,54,7,78,139
DTMAxisIteratorBase.java,Java,,83,38,170,291
DTMDefaultBase.java,Java,,893,268,990,2151
DTMDefaultBaseIterators.java,Java,,884,311,735,1930
DTMDefaultBaseTraversers.java,Java,,725,212,802,1739
DTMDocumentImpl.java,Java,,724,240,1485,2449
DTMManagerDefault.java,Java,,419,115,408,942
DTMNamedNodeMap.java,Java,,84,27,213,324
DTMNodeIterator.java,Java,,62,18,136,216
DTMNodeList.java,Java,,64,9,122,195
DTMNodeProxy.java,Java,,469,130,781,1380
DTMSafeStringPool.java,Java,,61,13,72,146
DTMStringPool.java,Java,,96,23,99,218
DTMTreeWalker.java,Java,,238,57,149,444
ExpandedNameTable.java,Java,,144,34,184,362
IncrementalSAXSource.java,Java,,14,11,102,127
IncrementalSAXSource_Filter.java,Java,,427,62,351,840
NodeLocator.java,Java,,39,9,97,145
SAX2DTM.java,Java,,998,326,1028,2352
SAX2RTFDTM.java,Java,,126,35,201,362
AttList.java,Java,,86,24,182,292
BoolStack.java,Java,,69,28,133,230
CharKey.java,Java,,24,9,33,66
DefaultErrorHandler.java,Java,,123,30,196,349
DOMBuilder.java,Java,,224,78,450,752
ElemDesc.java,Java,,56,36,133,225
FastStringBuffer.java,Java,,570,196,610,1376
Hashtree2Node.java,Java,,70,12,96,178
IntStack.java,Java,,86,25,136,247
IntVector.java,Java,,177,70,208,455
ListingErrorHandler.java,Java,,237,63,302,602
MutableAttrListImpl.java,Java,,51,20,106,177
NameSpace.java,Java,,13,6,75,94
NamespaceSupport2.java,Java,,276,85,424,785
NodeConsumer.java,Java,,6,3,67,76
NodeVector.java,Java,,337,133,308,778
NSInfo.java,Java,,33,15,98,146
ObjectPool.java,Java,,69,26,118,213
ObjectStack.java,Java,,88,27,136,251
ObjectVector.java,Java,,183,74,210,467
PrefixResolver.java,Java,,8,5,95,108
PrefixResolverDefault.java,Java,,65,18,106,189
QName.java,Java,,332,95,310,737
RawCharacterHandler.java,Java,,6,2,70,78
XResourceBundle.java,Java,,74,18,93,185
XResourceBundleBase.java,Java,,7,4,75,86
XResources_cy.java,Java,,45,13,78,136
XResources_de.java,Java,,29,9,87,125
XResources_el.java,Java,,45,13,83,141
XResources_en.java,Java,,29,9,86,124
XResources_es.java,Java,,29,9,87,125
XResources_fr.java,Java,,29,9,87,125
XResources_he.java,Java,,37,11,82,130
XResources_hy.java,Java,,46,10,81,137
XResources_it.java,Java,,29,9,87,125
XResources_ja_JP_A.java,Java,,43,11,81,135
XResources_ja_JP_HA.java,Java,,43,11,81,135
XResources_ja_JP_HI.java,Java,,43,11,82,136
XResources_ja_JP_I.java,Java,,43,11,82,136
XResources_ka.java,Java,,46,10,78,134
XResources_ko.java,Java,,37,11,81,129
XResources_sv.java,Java,,29,9,88,126
XResources_zh_CN.java,Java,,39,11,79,129
XResources_zh_TW.java,Java,,39,11,79,129
SAXSourceLocator.java,Java,,51,13,141,205
SerializableLocatorImpl.java,Java,,51,33,177,261
StringBufferPool.java,Java,,15,4,77,96
StringToIntTable.java,Java,,82,35,115,232
StringToStringTable.java,Java,,104,40,134,278
StringToStringTableVector.java,Java,,80,32,123,235
StringVector.java,Java,,91,41,126,258
SuballocatedByteVector.java,Java,,267,37,230,534
SuballocatedIntVector.java,Java,,271,41,241,553
SystemIDResolver.java,Java,,111,28,134,273
TreeWalker.java,Java,,300,71,152,523
Trie.java,Java,,65,23,93,181
UnImplNode.java,Java,,394,209,702,1305
URI.java,Java,,903,221,565,1689
WrappedRuntimeException.java,Java,,19,9,81,109
WrongParserException.java,Java,,8,2,65,75
XMLChar.java,Java,,308,76,297,681
XMLCharacterRecognizer.java,Java,,41,15,89,145
XMLString.java,Java,,47,40,624,711
XMLStringFactory.java,Java,,10,5,92,107
Arg.java,Java,,97,27,170,294
AttributeIterator.java,Java,,28,10,80,118
AxesWalker.java,Java,,274,80,273,627
BasicTestIterator.java,Java,,111,28,67,206
ChildIterator.java,Java,,46,16,98,160
ChildTestIterator.java,Java,,49,23,130,202
ContextNodeList.java,Java,,18,14,140,172
DescendantIterator.java,Java,,223,48,148,419
FilterExprIterator.java,Java,,98,27,78,203
FilterExprIteratorSimple.java,Java,,160,40,105,305
FilterExprWalker.java,Java,,157,44,188,389
HasPositionalPredChecker.java,Java,,55,12,37,104
IteratorPool.java,Java,,52,14,35,101
LocPathIterator.java,Java,,368,124,589,1081
MatchPatternIterator.java,Java,,196,43,117,356
NodeSequence.java,Java,,385,69,231,685
OneStepIterator.java,Java,,119,39,90,248
OneStepIteratorForward.java,Java,,48,20,83,151
PathComponent.java,Java,,5,3,64,72
PredicatedNodeTest.java,Java,,336,77,215,628
ReverseAxesWalker.java,Java,,111,40,131,282
RTFIterator.java,Java,,9,4,9,22
SelfIteratorNoPredicate.java,Java,,49,17,53,119
SubContextList.java,Java,,7,5,78,90
UnionChildIterator.java,Java,,62,12,91,165
UnionPathIterator.java,Java,,318,76,231,625
WalkerFactory.java,Java,,1245,196,429,1870
WalkingIterator.java,Java,,167,53,124,344
WalkingIteratorSorted.java,Java,,75,18,159,252
CachedXPathAPI.java,Java,,93,32,247,372
Compiler.java,Java,,592,142,534,1268
FuncLoader.java,Java,,52,19,94,165
FunctionTable.java,Java,,133,60,141,334
Keywords.java,Java,,218,69,128,415
Lexer.java,Java,,422,89,182,693
OpCodes.java,Java,,68,66,534,668
OpMap.java,Java,,192,57,242,491
OpMapVector.java,Java,,35,22,94,151
PsuedoNames.java,Java,,10,7,78,95
XPathDumper.java,Java,,8,3,60,71
XPathParser.java,Java,,1254,395,746,2395
DOM2Helper.java,Java,,94,34,228,356
XPathEvaluatorImpl.java,Java,,62,25,209,296
XPathExpressionImpl.java,Java,,60,19,139,218
XPathNamespaceImpl.java,Java,,91,34,175,300
XPathNSResolverImpl.java,Java,,12,6,79,97
XPathResultImpl.java,Java,,220,56,236,512
DOMHelper.java,Java,,604,172,568,1344
DOMOrder.java,Java,,5,2,70,77
Expression.java,Java,,198,59,376,633
ExpressionNode.java,Java,,10,6,72,88
ExpressionOwner.java,Java,,6,5,14,25
ExtensionsProvider.java,Java,,12,5,70,87
FoundIndex.java,Java,,5,2,65,72
FuncBoolean.java,Java,,13,6,69,88
FuncCeiling.java,Java,,14,6,69,89
FuncConcat.java,Java,,33,11,84,128
FuncContains.java,Java,,18,9,70,97
FuncCount.java,Java,,20,9,80,109
FuncCurrent.java,Java,,44,13,88,145
FuncDoclocation.java,Java,,29,10,74,113
FuncExtElementAvailable.java,Java,,58,10,70,138
FuncExtFunction.java,Java,,133,44,177,354
FuncExtFunctionAvailable.java,Java,,52,10,72,134
FuncFalse.java,Java,,16,7,73,96
FuncFloor.java,Java,,13,5,69,87
FuncGenerateId.java,Java,,20,7,76,103
FuncId.java,Java,,85,25,85,195
FuncLang.java,Java,,41,12,71,124
FuncLast.java,Java,,45,14,92,151
FuncLocalPart.java,Java,,23,8,70,101
FuncNamespace.java,Java,,38,12,72,122
FuncNormalizeSpace.java,Java,,43,10,81,134
FuncNot.java,Java,,13,5,69,87
FuncNumber.java,Java,,15,6,69,90
FuncPosition.java,Java,,63,16,98,177
FuncQname.java,Java,,29,9,71,109
FuncRound.java,Java,,14,5,69,88
FuncStartsWith.java,Java,,14,5,69,88
FuncString.java,Java,,15,6,69,90
FuncStringLength.java,Java,,15,6,69,90
FuncSubstring.java,Java,,62,16,86,164
FuncSubstringAfter.java,Java,,19,8,69,96
FuncSubstringBefore.java,Java,,17,7,69,93
FuncSum.java,Java,,29,10,68,107
FuncSystemProperty.java,Java,,123,35,92,250
Function.java,Java,,49,15,118,182
Function2Args.java,Java,,79,22,120,221
Function3Args.java,Java,,79,22,119,220
FunctionDef1Arg.java,Java,,69,16,123,208
FunctionMultiArgs.java,Java,,122,30,122,274
FunctionOneArg.java,Java,,71,21,119,211
FuncTranslate.java,Java,,36,13,80,129
FuncTrue.java,Java,,16,7,73,96
FuncUnparsedEntityURI.java,Java,,21,9,69,99
WrongNumberArgsException.java,Java,,8,3,67,78
NodeSet.java,Java,,596,233,580,1409
NodeSetDTM.java,Java,,399,169,727,1295
XBoolean.java,Java,,58,22,125,205
XBooleanStatic.java,Java,,24,8,77,109
XMLStringFactoryImpl.java,Java,,29,8,100,137
XNodeSet.java,Java,,407,102,491,1000
XNodeSetForDOM.java,Java,,55,15,37,107
XNull.java,Java,,40,14,117,171
XNumber.java,Java,,129,42,293,464
XObject.java,Java,,282,106,404,792
XObjectFactory.java,Java,,105,11,23,139
XRTreeFrag.java,Java,,178,37,210,425
XRTreeFragSelectWrapper.java,Java,,63,18,61,142
XString.java,Java,,406,113,692,1211
XStringForChars.java,Java,,73,25,103,201
XStringForFSB.java,Java,,401,126,504,1031
And.java,Java,,26,9,79,114
Bool.java,Java,,21,6,78,105
Div.java,Java,,17,6,79,102
Equals.java,Java,,23,6,81,110
Gt.java,Java,,11,3,70,84
Gte.java,Java,,12,3,70,85
Lt.java,Java,,11,3,70,84
Lte.java,Java,,11,3,70,84
Minus.java,Java,,17,6,80,103
Mod.java,Java,,17,6,79,102
Mult.java,Java,,17,5,79,101
Neg.java,Java,,16,6,78,100
NotEquals.java,Java,,11,3,70,84
Number.java,Java,,19,7,78,104
Operation.java,Java,,93,27,130,250
Or.java,Java,,26,9,79,114
Plus.java,Java,,17,6,79,102
Quo.java,Java,,11,4,72,87
String.java,Java,,10,3,69,82
UnaryOperation.java,Java,,60,22,119,201
Variable.java,Java,,199,57,176,432
VariableSafeAbsRef.java,Java,,26,6,24,56
ContextMatchStepPattern.java,Java,,94,26,97,217
FunctionPattern.java,Java,,114,41,135,290
NodeTest.java,Java,,299,103,329,731
NodeTestFilter.java,Java,,5,2,68,75
StepPattern.java,Java,,602,137,352,1091
UnionPattern.java,Java,,117,30,109,256
XPATHErrorResourceBundle.java,Java,,63,6,69,138
XPATHErrorResources.java,Java,,552,320,507,1379
XPATHErrorResources_de.java,Java,,431,560,397,1388
XPATHErrorResources_en.java,Java,,4,2,61,67
XPATHErrorResources_es.java,Java,,432,560,398,1390
XPATHErrorResources_fr.java,Java,,433,561,397,1391
XPATHErrorResources_it.java,Java,,441,568,404,1413
XPATHErrorResources_ja.java,Java,,436,561,492,1489
XPATHErrorResources_ko.java,Java,,645,571,437,1653
XPATHErrorResources_sv.java,Java,,433,562,397,1392
XPATHErrorResources_zh_CN.java,Java,,435,562,396,1393
XPATHErrorResources_zh_TW.java,Java,,433,559,396,1388
SourceTree.java,Java,,11,5,73,89
SourceTreeManager.java,Java,,204,61,191,456
VariableStack.java,Java,,180,78,293,551
WhitespaceStrippingElementMatcher.java,Java,,9,3,21,33
XPath.java,Java,,265,69,291,625
XPathAPI.java,Java,,81,27,221,329
XPathContext.java,Java,,545,157,629,1331
XPathException.java,Java,,154,54,142,350
XPathFactory.java,Java,,8,5,75,88
XPathProcessorException.java,Java,,12,4,73,89
XPathVisitable.java,Java,,5,2,71,78
XPathVisitor.java,Java,,63,17,159,239
ChannelBinding.java,Java,,63,23,109,195
GSSContext.java,Java,,62,45,1223,1330
GSSCredential.java,Java,,21,24,309,354
GSSException.java,Java,,107,59,218,384
GSSManager.java,Java,,38,19,655,712
GSSName.java,Java,,27,19,231,277
MessageProp.java,Java,,67,21,130,218
Oid.java,Java,,83,23,93,199
Any.java,Java,,79,58,565,702
AnyHolder.java,Java,,21,9,60,90
AnySeqHelper.java,Java,,46,10,27,83
AnySeqHolder.java,Java,,24,9,15,48
ARG_IN.java,Java,,4,4,29,37
ARG_INOUT.java,Java,,4,7,30,41
ARG_OUT.java,Java,,4,6,29,39
BAD_CONTEXT.java,Java,,15,7,47,69
BAD_INV_ORDER.java,Java,,15,8,45,68
BAD_OPERATION.java,Java,,15,7,43,65
BAD_PARAM.java,Java,,15,7,52,74
BAD_POLICY.java,Java,,4,2,16,22
BAD_POLICY_TYPE.java,Java,,4,2,16,22
BAD_POLICY_VALUE.java,Java,,4,2,18,24
BAD_TYPECODE.java,Java,,15,7,44,66
BooleanHolder.java,Java,,21,9,62,92
BooleanSeqHelper.java,Java,,44,10,27,81
BooleanSeqHolder.java,Java,,24,9,15,48
Bounds.java,Java,,9,5,22,36
ByteHolder.java,Java,,21,10,62,93
CharHolder.java,Java,,21,10,63,94
CharSeqHelper.java,Java,,44,10,27,81
CharSeqHolder.java,Java,,24,9,15,48
COMM_FAILURE.java,Java,,15,7,51,73
CompletionStatus.java,Java,,27,13,85,125
CompletionStatusHelper.java,Java,,37,10,14,61
Context.java,Java,,11,19,198,228
ContextList.java,Java,,7,12,70,89
CTX_RESTRICT_SCOPE.java,Java,,4,4,28,36
Current.java,Java,,4,3,23,30
CurrentHelper.java,Java,,43,11,15,69
CurrentHolder.java,Java,,24,8,15,47
CurrentOperations.java,Java,,4,3,16,23
CustomMarshal.java,Java,,7,3,30,40
DataInputStream.java,Java,,36,34,258,328
DataOutputStream.java,Java,,36,34,196,266
DATA_CONVERSION.java,Java,,15,7,46,68
DefinitionKind.java,Java,,114,113,256,483
DefinitionKindHelper.java,Java,,37,10,15,62
DomainManager.java,Java,,5,4,17,26
DomainManagerOperations.java,Java,,5,4,23,32
DoubleHolder.java,Java,,21,12,59,92
DoubleSeqHelper.java,Java,,44,10,27,81
DoubleSeqHolder.java,Java,,24,9,15,48
DynamicImplementation.java,Java,,10,7,12,29
DynAny.java,Java,,89,68,556,713
Invalid.java,Java,,10,5,18,33
InvalidSeq.java,Java,,10,5,19,34
InvalidValue.java,Java,,10,4,22,36
TypeMismatch.java,Java,,10,5,19,34
DynArray.java,Java,,7,6,24,37
DynEnum.java,Java,,8,7,30,45
DynFixed.java,Java,,7,5,26,38
DynSequence.java,Java,,9,7,37,53
DynStruct.java,Java,,9,7,35,51
DynUnion.java,Java,,12,11,52,75
DynValue.java,Java,,8,6,39,53
Environment.java,Java,,6,10,28,44
ExceptionList.java,Java,,9,11,73,93
FieldNameHelper.java,Java,,40,10,14,64
FixedHolder.java,Java,,21,11,49,81
FloatHolder.java,Java,,21,9,58,88
FloatSeqHelper.java,Java,,44,10,27,81
FloatSeqHolder.java,Java,,24,9,15,48
FREE_MEM.java,Java,,15,6,43,64
IdentifierHelper.java,Java,,40,10,15,65
IDLType.java,Java,,4,6,24,34
IDLTypeHelper.java,Java,,51,11,15,77
IDLTypeOperations.java,Java,,5,4,31,40
IMP_LIMIT.java,Java,,15,7,46,68
INITIALIZE.java,Java,,15,6,49,70
INTERNAL.java,Java,,15,6,49,70
INTF_REPOS.java,Java,,15,6,42,63
IntHolder.java,Java,,21,9,65,95
INVALID_TRANSACTION.java,Java,,15,6,44,65
INV_FLAG.java,Java,,15,6,44,65
INV_IDENT.java,Java,,15,6,45,66
INV_OBJREF.java,Java,,15,6,51,72
INV_POLICY.java,Java,,15,6,42,63
IRObject.java,Java,,5,2,17,24
IRObjectOperations.java,Java,,6,6,53,65
LocalObject.java,Java,,89,39,361,489
LongHolder.java,Java,,21,10,60,91
LongLongSeqHelper.java,Java,,44,10,27,81
LongLongSeqHolder.java,Java,,24,9,15,48
LongSeqHelper.java,Java,,44,10,27,81
LongSeqHolder.java,Java,,24,9,15,48
MARSHAL.java,Java,,15,6,49,70
NamedValue.java,Java,,6,10,92,108
NameValuePair.java,Java,,10,8,27,45
NameValuePairHelper.java,Java,,67,10,14,91
NO_IMPLEMENT.java,Java,,15,6,48,69
NO_MEMORY.java,Java,,15,7,41,63
NO_PERMISSION.java,Java,,15,6,41,62
NO_RESOURCES.java,Java,,15,6,42,63
NO_RESPONSE.java,Java,,15,6,42,63
NVList.java,Java,,9,16,136,161
Object.java,Java,,25,35,204,264
ObjectHelper.java,Java,,37,11,19,67
ObjectHolder.java,Java,,21,9,64,94
OBJECT_NOT_EXIST.java,Java,,15,6,51,72
OBJ_ADAPTER.java,Java,,15,6,46,67
OctetSeqHelper.java,Java,,44,10,27,81
OctetSeqHolder.java,Java,,24,9,15,48
OMGVMCID.java,Java,,4,5,16,25
ORB.java,Java,,293,103,909,1305
InconsistentTypeCode.java,Java,,10,4,20,34
InvalidName.java,Java,,9,4,23,36
ParameterMode.java,Java,,29,8,14,51
ParameterModeHelper.java,Java,,37,11,14,62
ParameterModeHolder.java,Java,,24,9,14,47
PERSIST_STORE.java,Java,,15,6,41,62
Policy.java,Java,,4,3,22,29
PolicyError.java,Java,,15,7,31,53
PolicyErrorCodeHelper.java,Java,,40,11,11,62
PolicyErrorHelper.java,Java,,62,11,12,85
PolicyErrorHolder.java,Java,,24,9,10,43
PolicyHelper.java,Java,,51,11,15,77
PolicyHolder.java,Java,,24,8,15,47
PolicyListHelper.java,Java,,46,10,15,71
PolicyListHolder.java,Java,,24,9,15,48
PolicyOperations.java,Java,,7,6,41,54
PolicyTypeHelper.java,Java,,40,11,16,67
ApplicationException.java,Java,,16,6,24,46
BoxedValueHelper.java,Java,,7,2,14,23
CustomValue.java,Java,,4,5,20,29
Delegate.java,Java,,84,30,275,389
IDLEntity.java,Java,,3,3,13,19
IndirectionException.java,Java,,9,4,39,52
InputStream.java,Java,,67,12,223,302
InvokeHandler.java,Java,,6,4,45,55
ObjectImpl.java,Java,,155,38,324,517
OutputStream.java,Java,,65,11,193,269
RemarshalException.java,Java,,6,2,20,28
ResponseHandler.java,Java,,5,3,28,36
ServantObject.java,Java,,5,4,22,31
Streamable.java,Java,,7,4,32,43
StreamableValue.java,Java,,3,5,17,25
UnknownException.java,Java,,8,1,33,42
ValueBase.java,Java,,4,2,29,35
ValueFactory.java,Java,,5,3,33,41
Principal.java,Java,,9,5,24,38
PrincipalHolder.java,Java,,21,11,44,76
PRIVATE_MEMBER.java,Java,,4,2,23,29
PUBLIC_MEMBER.java,Java,,4,2,24,30
RepositoryIdHelper.java,Java,,40,10,16,66
Request.java,Java,,25,50,209,284
ServerRequest.java,Java,,35,19,239,293
ServiceDetail.java,Java,,11,5,35,51
ServiceDetailHelper.java,Java,,50,6,11,67
ServiceInformation.java,Java,,13,7,24,44
ServiceInformationHelper.java,Java,,58,7,11,76
ServiceInformationHolder.java,Java,,20,10,63,93
SetOverrideType.java,Java,,25,11,69,105
SetOverrideTypeHelper.java,Java,,37,10,14,61
ShortHolder.java,Java,,21,9,63,93
ShortSeqHelper.java,Java,,44,10,27,81
ShortSeqHolder.java,Java,,24,9,15,48
StringHolder.java,Java,,21,9,62,92
StringSeqHelper.java,Java,,46,11,7,64
StringSeqHolder.java,Java,,24,10,7,41
StringValueHelper.java,Java,,73,14,35,122
StructMember.java,Java,,12,8,51,71
StructMemberHelper.java,Java,,74,10,15,99
SystemException.java,Java,,45,11,45,101
TCKind.java,Java,,148,79,310,537
TRANSACTION_REQUIRED.java,Java,,15,6,41,62
TRANSACTION_ROLLEDBACK.java,Java,,15,6,45,66
TRANSIENT.java,Java,,15,6,44,65
TypeCode.java,Java,,29,39,449,517
TypeCodeHolder.java,Java,,21,9,63,93
BadKind.java,Java,,9,4,25,38
Bounds.java,Java,,9,5,24,38
ULongLongSeqHelper.java,Java,,44,10,27,81
ULongLongSeqHolder.java,Java,,24,9,15,48
ULongSeqHelper.java,Java,,44,10,27,81
ULongSeqHolder.java,Java,,24,9,15,48
UnionMember.java,Java,,14,9,54,77
UnionMemberHelper.java,Java,,81,10,15,106
UNKNOWN.java,Java,,15,6,50,71
UnknownUserException.java,Java,,11,7,31,49
UnknownUserExceptionHelper.java,Java,,61,10,17,88
UnknownUserExceptionHolder.java,Java,,24,8,15,47
UNSUPPORTED_POLICY.java,Java,,4,2,17,23
UNSUPPORTED_POLICY_VALUE.java,Java,,4,2,18,24
UserException.java,Java,,9,5,27,41
UShortSeqHelper.java,Java,,44,10,27,81
UShortSeqHolder.java,Java,,24,9,15,48
ValueBaseHelper.java,Java,,37,12,22,71
ValueBaseHolder.java,Java,,21,10,58,89
ValueMember.java,Java,,20,12,71,103
ValueMemberHelper.java,Java,,106,10,15,131
VersionSpecHelper.java,Java,,40,10,15,65
VisibilityHelper.java,Java,,40,11,16,67
VM_ABSTRACT.java,Java,,4,2,16,22
VM_CUSTOM.java,Java,,4,2,16,22
VM_NONE.java,Java,,4,4,19,27
VM_TRUNCATABLE.java,Java,,4,2,18,24
WCharSeqHelper.java,Java,,44,10,27,81
WCharSeqHolder.java,Java,,24,9,15,48
WrongTransaction.java,Java,,9,4,25,38
WrongTransactionHelper.java,Java,,54,9,17,80
WrongTransactionHolder.java,Java,,24,8,15,47
WStringSeqHelper.java,Java,,46,11,7,64
WStringSeqHolder.java,Java,,24,10,7,41
WStringValueHelper.java,Java,,73,16,38,127
_IDLTypeStub.java,Java,,90,13,32,135
_PolicyStub.java,Java,,89,14,43,146
ORB.java,Java,,23,13,40,76
Delegate.java,Java,,6,4,29,39
InputStream.java,Java,,24,11,61,96
ObjectImpl.java,Java,,10,6,28,44
OutputStream.java,Java,,18,9,49,76
Binding.java,Java,,14,8,10,32
BindingHelper.java,Java,,68,11,9,88
BindingHolder.java,Java,,24,9,9,42
BindingIterator.java,Java,,4,4,14,22
BindingIteratorHelper.java,Java,,53,12,14,79
BindingIteratorHolder.java,Java,,24,9,14,47
BindingIteratorOperations.java,Java,,7,7,30,44
BindingIteratorPOA.java,Java,,70,21,32,123
BindingListHelper.java,Java,,46,11,9,66
BindingListHolder.java,Java,,24,10,9,43
BindingType.java,Java,,27,8,10,45
BindingTypeHelper.java,Java,,37,11,10,58
BindingTypeHolder.java,Java,,24,9,10,43
IstringHelper.java,Java,,40,10,6,56
NameComponent.java,Java,,14,7,23,44
NameComponentHelper.java,Java,,68,11,23,102
NameComponentHolder.java,Java,,24,9,23,56
NameHelper.java,Java,,46,11,9,66
NameHolder.java,Java,,24,10,9,43
NamingContext.java,Java,,4,4,15,23
NamingContextExt.java,Java,,4,4,19,27
NamingContextExtHelper.java,Java,,53,12,19,84
NamingContextExtHolder.java,Java,,24,9,19,52
NamingContextExtOperations.java,Java,,8,8,67,83
AddressHelper.java,Java,,40,11,9,60
InvalidAddress.java,Java,,12,7,6,25
InvalidAddressHelper.java,Java,,54,10,8,72
InvalidAddressHolder.java,Java,,24,8,6,38
StringNameHelper.java,Java,,40,11,10,61
URLStringHelper.java,Java,,40,11,10,61
NamingContextExtPOA.java,Java,,294,43,230,567
NamingContextHelper.java,Java,,53,12,15,80
NamingContextHolder.java,Java,,24,9,15,48
NamingContextOperations.java,Java,,14,14,176,204
AlreadyBound.java,Java,,12,7,6,25
AlreadyBoundHelper.java,Java,,54,10,8,72
AlreadyBoundHolder.java,Java,,24,8,6,38
CannotProceed.java,Java,,22,8,6,36
CannotProceedHelper.java,Java,,70,10,8,88
CannotProceedHolder.java,Java,,24,8,6,38
InvalidName.java,Java,,12,7,6,25
InvalidNameHelper.java,Java,,54,10,8,72
InvalidNameHolder.java,Java,,24,8,6,38
NotEmpty.java,Java,,12,7,6,25
NotEmptyHelper.java,Java,,54,10,8,72
NotEmptyHolder.java,Java,,24,8,6,38
NotFound.java,Java,,22,8,6,36
NotFoundHelper.java,Java,,70,10,8,88
NotFoundHolder.java,Java,,24,8,6,38
NotFoundReason.java,Java,,29,8,9,46
NotFoundReasonHelper.java,Java,,37,11,9,57
NotFoundReasonHolder.java,Java,,24,9,9,42
NamingContextPOA.java,Java,,223,35,178,436
_BindingIteratorImplBase.java,Java,,71,3,16,90
_BindingIteratorStub.java,Java,,82,14,31,127
_NamingContextExtStub.java,Java,,367,36,229,632
_NamingContextImplBase.java,Java,,370,3,16,389
_NamingContextStub.java,Java,,271,28,177,476
Parameter.java,Java,,14,7,11,32
AnySeqHelper.java,Java,,46,10,6,62
DynAny.java,Java,,4,4,73,81
DynAnyFactory.java,Java,,4,4,27,35
DynAnyFactoryHelper.java,Java,,53,12,27,92
DynAnyFactoryOperations.java,Java,,6,6,68,80
InconsistentTypeCode.java,Java,,12,7,6,25
InconsistentTypeCodeHelper.java,Java,,54,10,8,72
DynAnyHelper.java,Java,,53,12,73,138
DynAnyOperations.java,Java,,54,54,461,569
InvalidValue.java,Java,,12,7,6,25
InvalidValueHelper.java,Java,,54,10,8,72
TypeMismatch.java,Java,,12,7,6,25
TypeMismatchHelper.java,Java,,54,10,8,72
DynAnySeqHelper.java,Java,,46,10,6,62
DynArray.java,Java,,4,4,11,19
DynArrayHelper.java,Java,,53,12,11,76
DynArrayOperations.java,Java,,8,8,29,45
DynEnum.java,Java,,4,4,10,18
DynEnumHelper.java,Java,,53,12,10,75
DynEnumOperations.java,Java,,8,8,30,46
DynFixed.java,Java,,4,4,11,19
DynFixedHelper.java,Java,,53,12,11,76
DynFixedOperations.java,Java,,6,6,26,38
DynSequence.java,Java,,4,4,9,17
DynSequenceHelper.java,Java,,53,12,9,74
DynSequenceOperations.java,Java,,10,10,57,77
DynStruct.java,Java,,4,4,10,18
DynStructHelper.java,Java,,53,12,10,75
DynStructOperations.java,Java,,10,10,66,86
DynUnion.java,Java,,4,4,16,24
DynUnionHelper.java,Java,,53,12,16,81
DynUnionOperations.java,Java,,13,13,75,101
DynValue.java,Java,,4,4,18,26
DynValueBox.java,Java,,4,4,13,21
DynValueBoxOperations.java,Java,,8,8,37,53
DynValueCommon.java,Java,,4,4,9,17
DynValueCommonOperations.java,Java,,7,7,20,34
DynValueHelper.java,Java,,53,12,18,83
DynValueOperations.java,Java,,10,10,80,100
FieldNameHelper.java,Java,,40,10,6,56
NameDynAnyPair.java,Java,,14,9,15,38
NameDynAnyPairHelper.java,Java,,67,11,9,87
NameDynAnyPairSeqHelper.java,Java,,46,10,6,62
NameValuePair.java,Java,,14,9,15,38
NameValuePairHelper.java,Java,,67,11,9,87
NameValuePairSeqHelper.java,Java,,46,10,6,62
_DynAnyFactoryStub.java,Java,,47,15,69,131
_DynAnyStub.java,Java,,527,159,462,1148
_DynArrayStub.java,Java,,568,171,418,1157
_DynEnumStub.java,Java,,568,171,419,1158
_DynFixedStub.java,Java,,548,165,415,1128
_DynSequenceStub.java,Java,,588,177,446,1211
_DynStructStub.java,Java,,588,177,455,1220
_DynUnionStub.java,Java,,618,186,464,1268
_DynValueStub.java,Java,,619,186,480,1285
Codec.java,Java,,4,4,17,25
CodecFactory.java,Java,,4,4,11,19
CodecFactoryHelper.java,Java,,46,12,11,69
CodecFactoryOperations.java,Java,,5,5,19,29
UnknownEncoding.java,Java,,12,7,6,25
UnknownEncodingHelper.java,Java,,54,10,8,72
CodecOperations.java,Java,,8,8,61,77
FormatMismatch.java,Java,,12,7,6,25
FormatMismatchHelper.java,Java,,54,10,8,72
InvalidTypeForEncoding.java,Java,,12,7,6,25
InvalidTypeForEncodingHelper.java,Java,,54,10,8,72
TypeMismatch.java,Java,,12,7,6,25
TypeMismatchHelper.java,Java,,54,10,8,72
CodeSets.java,Java,,5,4,11,20
ComponentIdHelper.java,Java,,40,11,10,61
Encoding.java,Java,,16,10,32,58
ENCODING_CDR_ENCAPS.java,Java,,5,4,10,19
IOR.java,Java,,14,9,65,88
IORHelper.java,Java,,72,11,60,143
IORHolder.java,Java,,24,9,60,93
MultipleComponentProfileHelper.java,Java,,46,11,7,64
MultipleComponentProfileHolder.java,Java,,24,10,7,41
ProfileIdHelper.java,Java,,40,11,7,58
ServiceContext.java,Java,,14,9,13,36
ServiceContextHelper.java,Java,,71,11,11,93
ServiceContextHolder.java,Java,,24,9,11,44
ServiceContextListHelper.java,Java,,46,11,7,64
ServiceContextListHolder.java,Java,,24,10,7,41
ServiceIdHelper.java,Java,,40,11,7,58
TaggedComponent.java,Java,,14,9,44,67
TaggedComponentHelper.java,Java,,71,11,42,124
TaggedComponentHolder.java,Java,,24,9,42,75
TaggedProfile.java,Java,,14,9,17,40
TaggedProfileHelper.java,Java,,71,11,15,97
TaggedProfileHolder.java,Java,,24,9,15,48
TAG_ALTERNATE_IIOP_ADDRESS.java,Java,,5,4,32,41
TAG_CODE_SETS.java,Java,,5,4,16,25
TAG_INTERNET_IOP.java,Java,,5,4,31,40
TAG_JAVA_CODEBASE.java,Java,,5,4,19,28
TAG_MULTIPLE_COMPONENTS.java,Java,,5,4,17,26
TAG_ORB_TYPE.java,Java,,5,4,24,33
TAG_POLICIES.java,Java,,5,4,10,19
TransactionService.java,Java,,5,4,11,20
SyncScopeHelper.java,Java,,40,11,7,58
SYNC_WITH_TRANSPORT.java,Java,,5,4,10,19
ClientRequestInfo.java,Java,,4,4,220,228
ClientRequestInfoOperations.java,Java,,13,13,319,345
ClientRequestInterceptor.java,Java,,4,4,22,30
ClientRequestInterceptorOperations.java,Java,,9,9,175,193
Current.java,Java,,4,4,23,31
CurrentHelper.java,Java,,46,12,23,81
CurrentOperations.java,Java,,6,6,52,64
ForwardRequest.java,Java,,19,9,9,37
ForwardRequestHelper.java,Java,,61,10,8,79
Interceptor.java,Java,,4,4,9,17
InterceptorOperations.java,Java,,6,6,38,50
InvalidSlot.java,Java,,12,7,6,25
InvalidSlotHelper.java,Java,,54,10,8,72
IORInfo.java,Java,,4,4,14,22
IORInfoOperations.java,Java,,7,7,59,73
IORInterceptor.java,Java,,4,4,20,28
IORInterceptorOperations.java,Java,,5,5,41,51
LOCATION_FORWARD.java,Java,,5,4,15,24
ORBInitializer.java,Java,,4,4,116,124
ORBInitializerOperations.java,Java,,6,6,144,156
ORBInitInfo.java,Java,,4,4,19,27
ORBInitInfoOperations.java,Java,,14,14,106,134
DuplicateName.java,Java,,19,9,9,37
DuplicateNameHelper.java,Java,,61,10,8,79
InvalidName.java,Java,,12,7,6,25
InvalidNameHelper.java,Java,,54,10,8,72
ObjectIdHelper.java,Java,,40,11,7,58
PolicyFactory.java,Java,,4,4,19,27
PolicyFactoryOperations.java,Java,,5,5,40,50
RequestInfo.java,Java,,4,4,21,29
RequestInfoOperations.java,Java,,18,18,256,292
ServerRequestInfo.java,Java,,4,4,228,236
ServerRequestInfoOperations.java,Java,,12,12,305,329
ServerRequestInterceptor.java,Java,,4,4,22,30
ServerRequestInterceptorOperations.java,Java,,9,9,180,198
SUCCESSFUL.java,Java,,5,4,15,24
SYSTEM_EXCEPTION.java,Java,,5,4,15,24
TRANSPORT_RETRY.java,Java,,5,4,15,24
USER_EXCEPTION.java,Java,,5,4,15,24
AdapterActivator.java,Java,,4,4,13,21
AdapterActivatorOperations.java,Java,,5,5,26,36
Current.java,Java,,4,4,24,32
CurrentHelper.java,Java,,52,13,30,95
CurrentOperations.java,Java,,6,6,44,56
NoContext.java,Java,,12,7,6,25
NoContextHelper.java,Java,,54,10,8,72
DynamicImplementation.java,Java,,4,2,19,25
ForwardRequest.java,Java,,19,8,6,33
ForwardRequestHelper.java,Java,,61,10,8,79
IdAssignmentPolicy.java,Java,,4,4,11,19
IdAssignmentPolicyOperations.java,Java,,5,5,14,24
IdAssignmentPolicyValue.java,Java,,27,8,15,50
IdUniquenessPolicy.java,Java,,4,4,11,19
IdUniquenessPolicyOperations.java,Java,,5,5,14,24
IdUniquenessPolicyValue.java,Java,,27,8,13,48
ID_ASSIGNMENT_POLICY_ID.java,Java,,5,4,9,18
ID_UNIQUENESS_POLICY_ID.java,Java,,5,4,9,18
ImplicitActivationPolicy.java,Java,,4,4,10,18
ImplicitActivationPolicyOperations.java,Java,,5,5,13,23
ImplicitActivationPolicyValue.java,Java,,27,8,15,50
IMPLICIT_ACTIVATION_POLICY_ID.java,Java,,5,4,9,18
LifespanPolicy.java,Java,,4,4,11,19
LifespanPolicyOperations.java,Java,,5,5,14,24
LifespanPolicyValue.java,Java,,27,8,14,49
LIFESPAN_POLICY_ID.java,Java,,5,4,9,18
POA.java,Java,,4,4,16,24
POAHelper.java,Java,,50,12,22,84
POAManager.java,Java,,4,4,12,20
POAManagerOperations.java,Java,,9,9,60,78
AdapterInactive.java,Java,,12,7,6,25
AdapterInactiveHelper.java,Java,,54,10,8,72
State.java,Java,,31,8,9,48
POAOperations.java,Java,,36,36,395,467
AdapterAlreadyExists.java,Java,,12,7,6,25
AdapterAlreadyExistsHelper.java,Java,,54,10,8,72
AdapterNonExistent.java,Java,,12,7,6,25
AdapterNonExistentHelper.java,Java,,54,10,8,72
InvalidPolicy.java,Java,,19,8,6,33
InvalidPolicyHelper.java,Java,,61,10,8,79
NoServant.java,Java,,12,7,6,25
NoServantHelper.java,Java,,54,10,8,72
ObjectAlreadyActive.java,Java,,12,7,6,25
ObjectAlreadyActiveHelper.java,Java,,54,10,8,72
ObjectNotActive.java,Java,,12,7,6,25
ObjectNotActiveHelper.java,Java,,54,10,8,72
ServantAlreadyActive.java,Java,,12,7,6,25
ServantAlreadyActiveHelper.java,Java,,54,10,8,72
ServantNotActive.java,Java,,12,7,6,25
ServantNotActiveHelper.java,Java,,54,10,8,72
WrongAdapter.java,Java,,12,7,6,25
WrongAdapterHelper.java,Java,,54,10,8,72
WrongPolicy.java,Java,,12,7,6,25
WrongPolicyHelper.java,Java,,54,10,8,72
Delegate.java,Java,,13,11,74,98
RequestProcessingPolicy.java,Java,,4,4,11,19
RequestProcessingPolicyOperations.java,Java,,5,5,14,24
RequestProcessingPolicyValue.java,Java,,29,8,24,61
REQUEST_PROCESSING_POLICY_ID.java,Java,,5,4,9,18
Servant.java,Java,,80,18,150,248
ServantActivator.java,Java,,4,4,10,18
ServantActivatorHelper.java,Java,,53,12,10,75
ServantActivatorOperations.java,Java,,6,6,48,60
ServantActivatorPOA.java,Java,,34,13,12,59
ServantLocator.java,Java,,4,4,24,32
ServantLocatorHelper.java,Java,,53,12,24,89
ServantLocatorOperations.java,Java,,6,6,55,67
CookieHolder.java,Java,,18,8,13,39
ServantLocatorPOA.java,Java,,34,13,26,73
ServantManager.java,Java,,4,4,17,25
ServantManagerOperations.java,Java,,4,4,17,25
ServantRetentionPolicy.java,Java,,4,4,10,18
ServantRetentionPolicyOperations.java,Java,,5,5,13,23
ServantRetentionPolicyValue.java,Java,,27,8,14,49
SERVANT_RETENTION_POLICY_ID.java,Java,,5,4,9,18
ThreadPolicy.java,Java,,4,4,11,19
ThreadPolicyOperations.java,Java,,5,5,14,24
ThreadPolicyValue.java,Java,,27,8,13,48
THREAD_POLICY_ID.java,Java,,5,4,9,18
_ServantActivatorStub.java,Java,,48,15,49,112
_ServantLocatorStub.java,Java,,48,15,56,119
RunTime.java,Java,,4,2,22,28
RunTimeOperations.java,Java,,4,2,22,28
_Remote_Stub.java,Java,,11,6,28,45
Attr.java,Java,,9,6,109,124
CDATASection.java,Java,,3,2,43,48
CharacterData.java,Java,,23,9,127,159
Comment.java,Java,,3,2,19,24
Counter.java,Java,,6,5,27,38
CSS2Properties.java,Java,,370,125,916,1411
CSSCharsetRule.java,Java,,7,4,37,48
CSSFontFaceRule.java,Java,,4,3,21,28
CSSImportRule.java,Java,,7,6,31,44
CSSMediaRule.java,Java,,12,7,57,76
CSSPageRule.java,Java,,8,5,28,41
CSSPrimitiveValue.java,Java,,47,12,237,296
CSSRule.java,Java,,17,8,68,93
CSSRuleList.java,Java,,5,4,34,43
CSSStyleDeclaration.java,Java,,19,12,121,152
CSSStyleRule.java,Java,,8,5,29,42
CSSStyleSheet.java,Java,,12,7,66,85
CSSUnknownRule.java,Java,,3,2,17,22
CSSValue.java,Java,,12,6,50,68
CSSValueList.java,Java,,5,4,37,46
DocumentCSS.java,Java,,7,4,39,50
DOMImplementationCSS.java,Java,,8,4,28,40
ElementCSSInlineStyle.java,Java,,4,3,25,32
Rect.java,Java,,7,6,31,44
RGBColor.java,Java,,6,5,36,47
ViewCSS.java,Java,,7,4,32,43
Document.java,Java,,33,19,376,428
DocumentFragment.java,Java,,3,2,47,52
DocumentType.java,Java,,9,8,63,80
DOMException.java,Java,,23,3,90,116
DOMImplementation.java,Java,,13,5,92,110
Element.java,Java,,34,18,270,322
Entity.java,Java,,6,5,57,68
EntityReference.java,Java,,3,2,34,39
DocumentEvent.java,Java,,6,4,46,56
Event.java,Java,,18,13,110,141
EventException.java,Java,,9,3,24,36
EventListener.java,Java,,4,3,34,41
EventTarget.java,Java,,11,5,86,102
MouseEvent.java,Java,,29,14,109,152
MutationEvent.java,Java,,20,10,78,108
UIEvent.java,Java,,11,6,41,58
HTMLAnchorElement.java,Java,,29,17,66,112
HTMLAppletElement.java,Java,,25,14,64,103
HTMLAreaElement.java,Java,,19,11,49,79
HTMLBaseElement.java,Java,,7,5,22,34
HTMLBaseFontElement.java,Java,,9,6,28,43
HTMLBodyElement.java,Java,,15,9,45,69
HTMLBRElement.java,Java,,5,4,19,28
HTMLButtonElement.java,Java,,15,10,42,67
HTMLCollection.java,Java,,7,7,43,57
HTMLDirectoryElement.java,Java,,5,4,20,29
HTMLDivElement.java,Java,,5,4,19,28
HTMLDListElement.java,Java,,5,4,19,28
HTMLDocument.java,Java,,24,20,111,155
HTMLDOMImplementation.java,Java,,5,5,26,36
HTMLElement.java,Java,,14,9,43,66
HTMLFieldSetElement.java,Java,,4,4,20,28
HTMLFontElement.java,Java,,9,6,28,43
HTMLFormElement.java,Java,,19,13,55,87
HTMLFrameElement.java,Java,,21,13,52,86
HTMLFrameSetElement.java,Java,,7,5,23,35
HTMLHeadElement.java,Java,,5,4,19,28
HTMLHeadingElement.java,Java,,5,4,20,29
HTMLHRElement.java,Java,,11,7,32,50
HTMLHtmlElement.java,Java,,5,4,20,29
HTMLIFrameElement.java,Java,,25,15,59,99
HTMLImageElement.java,Java,,29,16,65,110
HTMLInputElement.java,Java,,41,25,131,197
HTMLIsIndexElement.java,Java,,6,5,24,35
HTMLLabelElement.java,Java,,8,6,28,42
HTMLLegendElement.java,Java,,8,6,29,43
HTMLLIElement.java,Java,,7,5,24,36
HTMLLinkElement.java,Java,,21,12,51,84
HTMLMapElement.java,Java,,6,5,22,33
HTMLMenuElement.java,Java,,5,4,20,29
HTMLMetaElement.java,Java,,11,7,31,49
HTMLModElement.java,Java,,7,5,24,36
HTMLObjectElement.java,Java,,40,23,97,160
HTMLOListElement.java,Java,,9,6,27,42
HTMLOptGroupElement.java,Java,,7,5,24,36
HTMLOptionElement.java,Java,,16,11,51,78
HTMLParagraphElement.java,Java,,5,4,19,28
HTMLParamElement.java,Java,,11,7,33,51
HTMLPreElement.java,Java,,5,4,19,28
HTMLQuoteElement.java,Java,,5,4,20,29
HTMLScriptElement.java,Java,,17,10,40,67
HTMLSelectElement.java,Java,,28,19,87,134
HTMLStyleElement.java,Java,,9,6,27,42
HTMLTableCaptionElement.java,Java,,5,4,19,28
HTMLTableCellElement.java,Java,,32,18,76,126
HTMLTableColElement.java,Java,,15,9,39,63
HTMLTableElement.java,Java,,40,26,123,189
HTMLTableRowElement.java,Java,,21,14,68,103
HTMLTableSectionElement.java,Java,,17,11,57,85
HTMLTextAreaElement.java,Java,,26,17,71,114
HTMLTitleElement.java,Java,,5,4,18,27
HTMLUListElement.java,Java,,7,5,23,35
NamedNodeMap.java,Java,,17,10,147,174
Node.java,Java,,50,26,450,526
NodeList.java,Java,,5,4,32,41
Notation.java,Java,,5,4,31,40
ProcessingInstruction.java,Java,,7,4,36,47
DocumentStyle.java,Java,,4,3,27,34
LinkStyle.java,Java,,4,3,24,31
MediaList.java,Java,,13,8,60,81
StyleSheet.java,Java,,12,10,73,95
StyleSheetList.java,Java,,5,4,33,42
Text.java,Java,,5,3,48,56
DocumentTraversal.java,Java,,15,5,72,92
NodeFilter.java,Java,,21,6,117,144
NodeIterator.java,Java,,14,10,85,109
TreeWalker.java,Java,,19,15,148,182
AbstractView.java,Java,,4,3,20,27
DocumentView.java,Java,,4,3,23,30
AttributeList.java,Java,,9,21,161,191
Attributes.java,Java,,16,36,191,243
ContentHandler.java,Java,,27,26,321,374
DocumentHandler.java,Java,,18,20,192,230
DTDHandler.java,Java,,12,8,88,108
EntityResolver.java,Java,,7,8,95,110
ErrorHandler.java,Java,,9,11,103,123
DeclHandler.java,Java,,18,13,110,141
LexicalHandler.java,Java,,20,18,173,211
HandlerBase.java,Java,,61,42,265,368
AttributeListImpl.java,Java,,90,43,177,310
AttributesImpl.java,Java,,250,77,286,613
DefaultHandler.java,Java,,86,52,314,452
LocatorImpl.java,Java,,51,36,125,212
NamespaceSupport.java,Java,,243,89,357,689
NewInstance.java,Java,,34,5,22,61
ParserAdapter.java,Java,,454,138,443,1035
ParserFactory.java,Java,,34,14,84,132
XMLFilterImpl.java,Java,,274,107,388,769
XMLReaderAdapter.java,Java,,178,86,271,535
XMLReaderFactory.java,Java,,51,13,75,139
InputSource.java,Java,,65,36,220,321
Locator.java,Java,,7,13,106,126
Parser.java,Java,,16,19,172,207
SAXException.java,Java,,39,24,91,154
SAXNotRecognizedException.java,Java,,8,10,35,53
SAXNotSupportedException.java,Java,,8,9,36,53
SAXParseException.java,Java,,62,35,167,264
XMLFilter.java,Java,,6,10,49,65
XMLReader.java,Java,,25,42,348,415
Serializable.java,Java,,3,3,30,36
EventListener.java,Java,,3,3,30,36
EventObject.java,Java,,6,5,30,41
