/jdk1.1.8/java/applet/Applet.java,Java,,100,25,316,441
/jdk1.1.8/java/applet/AppletContext.java,Java,,15,9,106,130
/jdk1.1.8/java/applet/AppletStub.java,Java,,10,7,68,85
/jdk1.1.8/java/applet/AudioClip.java,Java,,6,4,32,42
/jdk1.1.8/java/awt/Adjustable.java,Java,,21,22,79,122
/jdk1.1.8/java/awt/AWTError.java,Java,,7,4,21,32
/jdk1.1.8/java/awt/AWTEvent.java,Java,,176,40,109,325
/jdk1.1.8/java/awt/AWTEventMulticaster.java,Java,,250,62,333,645
/jdk1.1.8/java/awt/AWTException.java,Java,,7,4,23,34
/jdk1.1.8/java/awt/BorderLayout.java,Java,,199,35,229,463
/jdk1.1.8/java/awt/Button.java,Java,,99,34,164,297
/jdk1.1.8/java/awt/Canvas.java,Java,,26,10,51,87
/jdk1.1.8/java/awt/CardLayout.java,Java,,211,30,199,440
/jdk1.1.8/java/awt/Checkbox.java,Java,,158,40,224,422
/jdk1.1.8/java/awt/CheckboxGroup.java,Java,,32,9,86,127
/jdk1.1.8/java/awt/CheckboxMenuItem.java,Java,,104,31,152,287
/jdk1.1.8/java/awt/Choice.java,Java,,182,48,217,447
/jdk1.1.8/java/awt/Color.java,Java,,218,43,344,605
/jdk1.1.8/java/awt/Component.java,Java,,1336,243,1463,3042
/jdk1.1.8/java/awt/Container.java,Java,,1061,179,724,1964
/jdk1.1.8/java/awt/Cursor.java,Java,,41,24,72,137
/jdk1.1.8/java/awt/datatransfer/Clipboard.java,Java,,22,13,35,70
/jdk1.1.8/java/awt/datatransfer/ClipboardOwner.java,Java,,4,5,19,28
/jdk1.1.8/java/awt/datatransfer/DataFlavor.java,Java,,64,27,127,218
/jdk1.1.8/java/awt/datatransfer/StringSelection.java,Java,,29,12,29,70
/jdk1.1.8/java/awt/datatransfer/Transferable.java,Java,,7,8,36,51
/jdk1.1.8/java/awt/datatransfer/UnsupportedFlavorException.java,Java,,7,5,20,32
/jdk1.1.8/java/awt/Dialog.java,Java,,128,20,151,299
/jdk1.1.8/java/awt/Dimension.java,Java,,36,12,99,147
/jdk1.1.8/java/awt/event/ActionEvent.java,Java,,40,19,56,115
/jdk1.1.8/java/awt/event/ActionListener.java,Java,,5,5,15,25
/jdk1.1.8/java/awt/event/AdjustmentEvent.java,Java,,64,18,64,146
/jdk1.1.8/java/awt/event/AdjustmentListener.java,Java,,5,5,15,25
/jdk1.1.8/java/awt/event/ComponentAdapter.java,Java,,7,2,15,24
/jdk1.1.8/java/awt/event/ComponentEvent.java,Java,,45,14,49,108
/jdk1.1.8/java/awt/event/ComponentListener.java,Java,,8,6,28,42
/jdk1.1.8/java/awt/event/ContainerAdapter.java,Java,,5,2,15,22
/jdk1.1.8/java/awt/event/ContainerEvent.java,Java,,36,13,47,96
/jdk1.1.8/java/awt/event/ContainerListener.java,Java,,6,5,22,33
/jdk1.1.8/java/awt/event/FocusAdapter.java,Java,,5,2,15,22
/jdk1.1.8/java/awt/event/FocusEvent.java,Java,,35,14,58,107
/jdk1.1.8/java/awt/event/FocusListener.java,Java,,6,5,19,30
/jdk1.1.8/java/awt/event/InputEvent.java,Java,,43,22,75,140
/jdk1.1.8/java/awt/event/ItemEvent.java,Java,,51,17,52,120
/jdk1.1.8/java/awt/event/ItemListener.java,Java,,5,5,16,26
/jdk1.1.8/java/awt/event/KeyAdapter.java,Java,,6,2,15,23
/jdk1.1.8/java/awt/event/KeyEvent.java,Java,,314,43,107,464
/jdk1.1.8/java/awt/event/KeyListener.java,Java,,7,6,22,35
/jdk1.1.8/java/awt/event/MouseAdapter.java,Java,,8,2,15,25
/jdk1.1.8/java/awt/event/MouseEvent.java,Java,,83,23,75,181
/jdk1.1.8/java/awt/event/MouseListener.java,Java,,9,8,27,44
/jdk1.1.8/java/awt/event/MouseMotionAdapter.java,Java,,5,2,15,22
/jdk1.1.8/java/awt/event/MouseMotionListener.java,Java,,6,6,23,35
/jdk1.1.8/java/awt/event/PaintEvent.java,Java,,36,13,49,98
/jdk1.1.8/java/awt/event/TextEvent.java,Java,,23,13,33,69
/jdk1.1.8/java/awt/event/TextListener.java,Java,,5,5,15,25
/jdk1.1.8/java/awt/event/WindowAdapter.java,Java,,10,2,16,28
/jdk1.1.8/java/awt/event/WindowEvent.java,Java,,50,17,59,126
/jdk1.1.8/java/awt/event/WindowListener.java,Java,,11,9,34,54
/jdk1.1.8/java/awt/Event.java,Java,,223,104,500,827
/jdk1.1.8/java/awt/EventDispatchThread.java,Java,,57,9,25,91
/jdk1.1.8/java/awt/EventQueue.java,Java,,176,32,90,298
/jdk1.1.8/java/awt/EventQueueListener.java,Java,,6,3,14,23
/jdk1.1.8/java/awt/FileDialog.java,Java,,88,22,145,255
/jdk1.1.8/java/awt/FlowLayout.java,Java,,145,26,191,362
/jdk1.1.8/java/awt/Font.java,Java,,118,38,186,342
/jdk1.1.8/java/awt/FontMetrics.java,Java,,68,20,242,330
/jdk1.1.8/java/awt/Frame.java,Java,,206,54,190,450
/jdk1.1.8/java/awt/Graphics.java,Java,,140,54,900,1094
/jdk1.1.8/java/awt/GridBagConstraints.java,Java,,54,32,241,327
/jdk1.1.8/java/awt/GridBagLayout.java,Java,,558,121,571,1250
/jdk1.1.8/java/awt/GridLayout.java,Java,,142,23,219,384
/jdk1.1.8/java/awt/IllegalComponentStateException.java,Java,,10,4,26,40
/jdk1.1.8/java/awt/image/AreaAveragingScaleFilter.java,Java,,151,11,61,223
/jdk1.1.8/java/awt/image/ColorModel.java,Java,,37,14,57,108
/jdk1.1.8/java/awt/image/CropImageFilter.java,Java,,77,8,48,133
/jdk1.1.8/java/awt/image/DirectColorModel.java,Java,,126,17,86,229
/jdk1.1.8/java/awt/image/FilteredImageSource.java,Java,,60,10,61,131
/jdk1.1.8/java/awt/image/ImageConsumer.java,Java,,22,18,136,176
/jdk1.1.8/java/awt/image/ImageFilter.java,Java,,52,13,97,162
/jdk1.1.8/java/awt/image/ImageObserver.java,Java,,14,11,92,117
/jdk1.1.8/java/awt/image/ImageProducer.java,Java,,8,6,69,83
/jdk1.1.8/java/awt/image/IndexColorModel.java,Java,,120,21,138,279
/jdk1.1.8/java/awt/image/MemoryImageSource.java,Java,,215,24,233,472
/jdk1.1.8/java/awt/image/PixelGrabber.java,Java,,308,28,223,559
/jdk1.1.8/java/awt/image/ReplicateScaleFilter.java,Java,,110,10,48,168
/jdk1.1.8/java/awt/image/RGBImageFilter.java,Java,,101,11,114,226
/jdk1.1.8/java/awt/Image.java,Java,,32,14,143,189
/jdk1.1.8/java/awt/images-awt/BorderLayout-1.gif,–¢‘Î‰ž,,,,,
/jdk1.1.8/java/awt/images-awt/Button-1.gif,–¢‘Î‰ž,,,,,
/jdk1.1.8/java/awt/images-awt/Checkbox-1.gif,–¢‘Î‰ž,,,,,
/jdk1.1.8/java/awt/images-awt/CheckboxGroup-1.gif,–¢‘Î‰ž,,,,,
/jdk1.1.8/java/awt/images-awt/Choice-1.gif,–¢‘Î‰ž,,,,,
/jdk1.1.8/java/awt/images-awt/FlowLayout-1.gif,–¢‘Î‰ž,,,,,
/jdk1.1.8/java/awt/images-awt/FontMetrics-1.gif,–¢‘Î‰ž,,,,,
/jdk1.1.8/java/awt/images-awt/GridBagLayout-1.gif,–¢‘Î‰ž,,,,,
/jdk1.1.8/java/awt/images-awt/GridLayout-1.gif,–¢‘Î‰ž,,,,,
/jdk1.1.8/java/awt/images-awt/Label-1.gif,–¢‘Î‰ž,,,,,
/jdk1.1.8/java/awt/images-awt/List-1.gif,–¢‘Î‰ž,,,,,
/jdk1.1.8/java/awt/images-awt/MenuBar-1.gif,–¢‘Î‰ž,,,,,
/jdk1.1.8/java/awt/images-awt/Scrollbar-1.gif,–¢‘Î‰ž,,,,,
/jdk1.1.8/java/awt/images-awt/Scrollbar-2.gif,–¢‘Î‰ž,,,,,
/jdk1.1.8/java/awt/images-awt/TextArea-1.gif,–¢‘Î‰ž,,,,,
/jdk1.1.8/java/awt/images-awt/TextField-1.gif,–¢‘Î‰ž,,,,,
/jdk1.1.8/java/awt/Insets.java,Java,,32,11,69,112
/jdk1.1.8/java/awt/ItemSelectable.java,Java,,7,8,27,42
/jdk1.1.8/java/awt/Label.java,Java,,71,19,115,205
/jdk1.1.8/java/awt/LayoutManager.java,Java,,8,5,42,55
/jdk1.1.8/java/awt/LayoutManager2.java,Java,,8,7,55,70
/jdk1.1.8/java/awt/List.java,Java,,368,79,479,926
/jdk1.1.8/java/awt/MediaTracker.java,Java,,390,55,471,916
/jdk1.1.8/java/awt/Menu.java,Java,,212,45,190,447
/jdk1.1.8/java/awt/MenuBar.java,Java,,173,28,140,341
/jdk1.1.8/java/awt/MenuComponent.java,Java,,106,22,112,240
/jdk1.1.8/java/awt/MenuContainer.java,Java,,6,3,16,25
/jdk1.1.8/java/awt/MenuItem.java,Java,,185,48,248,481
/jdk1.1.8/java/awt/MenuShortcut.java,Java,,43,11,45,99
/jdk1.1.8/java/awt/Panel.java,Java,,24,10,41,75
/jdk1.1.8/java/awt/peer/ActiveEvent.java,Java,,4,3,23,30
/jdk1.1.8/java/awt/peer/ButtonPeer.java,Java,,5,3,6,14
/jdk1.1.8/java/awt/peer/CanvasPeer.java,Java,,4,2,6,12
/jdk1.1.8/java/awt/peer/CheckboxMenuItemPeer.java,Java,,4,1,6,11
/jdk1.1.8/java/awt/peer/CheckboxPeer.java,Java,,7,2,6,15
/jdk1.1.8/java/awt/peer/ChoicePeer.java,Java,,8,3,9,20
/jdk1.1.8/java/awt/peer/ComponentPeer.java,Java,,39,12,27,78
/jdk1.1.8/java/awt/peer/ContainerPeer.java,Java,,8,3,9,20
/jdk1.1.8/java/awt/peer/DialogPeer.java,Java,,6,5,6,17
/jdk1.1.8/java/awt/peer/FileDialogPeer.java,Java,,8,3,6,17
/jdk1.1.8/java/awt/peer/FontPeer.java,Java,,3,2,6,11
/jdk1.1.8/java/awt/peer/FramePeer.java,Java,,8,5,6,19
/jdk1.1.8/java/awt/peer/LabelPeer.java,Java,,7,2,6,15
/jdk1.1.8/java/awt/peer/LightweightPeer.java,Java,,3,3,15,21
/jdk1.1.8/java/awt/peer/ListPeer.java,Java,,19,7,21,47
/jdk1.1.8/java/awt/peer/MenuBarPeer.java,Java,,7,2,6,15
/jdk1.1.8/java/awt/peer/MenuComponentPeer.java,Java,,4,1,6,11
/jdk1.1.8/java/awt/peer/MenuItemPeer.java,Java,,7,4,12,23
/jdk1.1.8/java/awt/peer/MenuPeer.java,Java,,7,2,6,15
/jdk1.1.8/java/awt/peer/PanelPeer.java,Java,,4,2,6,12
/jdk1.1.8/java/awt/peer/PopupMenuPeer.java,Java,,5,2,6,13
/jdk1.1.8/java/awt/peer/ScrollbarPeer.java,Java,,6,1,6,13
/jdk1.1.8/java/awt/peer/ScrollPanePeer.java,Java,,11,2,6,19
/jdk1.1.8/java/awt/peer/TextAreaPeer.java,Java,,12,6,18,36
/jdk1.1.8/java/awt/peer/TextComponentPeer.java,Java,,11,1,6,18
/jdk1.1.8/java/awt/peer/TextFieldPeer.java,Java,,10,5,15,30
/jdk1.1.8/java/awt/peer/WindowPeer.java,Java,,6,5,6,17
/jdk1.1.8/java/awt/Point.java,Java,,46,14,121,181
/jdk1.1.8/java/awt/Polygon.java,Java,,125,28,125,278
/jdk1.1.8/java/awt/PopupMenu.java,Java,,51,11,41,103
/jdk1.1.8/java/awt/PrintGraphics.java,Java,,4,4,16,24
/jdk1.1.8/java/awt/PrintJob.java,Java,,11,9,43,63
/jdk1.1.8/java/awt/Rectangle.java,Java,,151,41,360,552
/jdk1.1.8/java/awt/Scrollbar.java,Java,,213,58,477,748
/jdk1.1.8/java/awt/ScrollPane.java,Java,,343,77,227,647
/jdk1.1.8/java/awt/Shape.java,Java,,4,3,23,30
/jdk1.1.8/java/awt/SystemColor.java,Java,,101,62,203,366
/jdk1.1.8/java/awt/test/VisualTest.html,HTML,,3,1,0,4
/jdk1.1.8/java/awt/test/VisualTest.java,Java,,379,42,7,428
/jdk1.1.8/java/awt/TextArea.java,Java,,167,41,252,460
/jdk1.1.8/java/awt/TextComponent.java,Java,,206,48,225,479
/jdk1.1.8/java/awt/TextField.java,Java,,167,46,247,460
/jdk1.1.8/java/awt/Toolkit.java,Java,,201,89,511,801
/jdk1.1.8/java/awt/Window.java,Java,,449,80,207,736
/jdk1.1.8/java/beans/BeanDescriptor.java,Java,,23,9,32,64
/jdk1.1.8/java/beans/BeanInfo.java,Java,,15,15,115,145
/jdk1.1.8/java/beans/Beans.java,Java,,242,56,170,468
/jdk1.1.8/java/beans/Customizer.java,Java,,6,8,34,48
/jdk1.1.8/java/beans/EventSetDescriptor.java,Java,,127,36,134,297
/jdk1.1.8/java/beans/FeatureDescriptor.java,Java,,91,21,88,200
/jdk1.1.8/java/beans/IndexedPropertyDescriptor.java,Java,,109,19,91,219
/jdk1.1.8/java/beans/IntrospectionException.java,Java,,7,4,17,28
/jdk1.1.8/java/beans/Introspector.java,Java,,599,118,212,929
/jdk1.1.8/java/beans/MethodDescriptor.java,Java,,30,13,32,75
/jdk1.1.8/java/beans/ParameterDescriptor.java,Java,,3,4,14,21
/jdk1.1.8/java/beans/PropertyChangeEvent.java,Java,,29,10,55,94
/jdk1.1.8/java/beans/PropertyChangeListener.java,Java,,4,6,16,26
/jdk1.1.8/java/beans/PropertyChangeSupport.java,Java,,71,27,33,131
/jdk1.1.8/java/beans/PropertyDescriptor.java,Java,,123,22,113,258
/jdk1.1.8/java/beans/PropertyEditor.java,Java,,15,25,138,178
/jdk1.1.8/java/beans/PropertyEditorManager.java,Java,,96,20,63,179
/jdk1.1.8/java/beans/PropertyEditorSupport.java,Java,,78,33,120,231
/jdk1.1.8/java/beans/PropertyVetoException.java,Java,,12,8,14,34
/jdk1.1.8/java/beans/SimpleBeanInfo.java,Java,,36,13,60,109
/jdk1.1.8/java/beans/VetoableChangeListener.java,Java,,5,2,19,26
/jdk1.1.8/java/beans/VetoableChangeSupport.java,Java,,86,21,41,148
/jdk1.1.8/java/beans/Visibility.java,Java,,7,8,30,45
/jdk1.1.8/java/io/BufferedInputStream.java,Java,,90,18,209,317
/jdk1.1.8/java/io/BufferedOutputStream.java,Java,,41,9,78,128
/jdk1.1.8/java/io/BufferedReader.java,Java,,191,28,149,368
/jdk1.1.8/java/io/BufferedWriter.java,Java,,94,22,117,233
/jdk1.1.8/java/io/ByteArrayInputStream.java,Java,,57,14,128,199
/jdk1.1.8/java/io/ByteArrayOutputStream.java,Java,,54,18,110,182
/jdk1.1.8/java/io/CharArrayReader.java,Java,,85,16,91,192
/jdk1.1.8/java/io/CharArrayWriter.java,Java,,73,15,78,166
/jdk1.1.8/java/io/CharConversionException.java,Java,,10,1,21,32
/jdk1.1.8/java/io/DataInput.java,Java,,19,16,158,193
/jdk1.1.8/java/io/DataInputStream.java,Java,,176,26,407,609
/jdk1.1.8/java/io/DataOutput.java,Java,,18,15,119,152
/jdk1.1.8/java/io/DataOutputStream.java,Java,,123,21,183,327
/jdk1.1.8/java/io/EOFException.java,Java,,10,3,33,46
/jdk1.1.8/java/io/Externalizable.java,Java,,7,4,53,64
/jdk1.1.8/java/io/File.java,Java,,215,43,421,679
/jdk1.1.8/java/io/FileDescriptor.java,Java,,14,9,74,97
/jdk1.1.8/java/io/FileInputStream.java,Java,,54,16,145,215
/jdk1.1.8/java/io/FilenameFilter.java,Java,,5,2,30,37
/jdk1.1.8/java/io/FileNotFoundException.java,Java,,9,3,25,37
/jdk1.1.8/java/io/FileOutputStream.java,Java,,71,15,133,219
/jdk1.1.8/java/io/FileReader.java,Java,,12,8,19,39
/jdk1.1.8/java/io/FileWriter.java,Java,,15,9,19,43
/jdk1.1.8/java/io/FilterInputStream.java,Java,,35,12,193,240
/jdk1.1.8/java/io/FilterOutputStream.java,Java,,29,8,106,143
/jdk1.1.8/java/io/FilterReader.java,Java,,32,15,58,105
/jdk1.1.8/java/io/FilterWriter.java,Java,,23,12,52,87
/jdk1.1.8/java/io/InputStream.java,Java,,46,12,168,226
/jdk1.1.8/java/io/InputStreamReader.java,Java,,130,31,93,254
/jdk1.1.8/java/io/InterruptedIOException.java,Java,,11,4,35,50
/jdk1.1.8/java/io/InvalidClassException.java,Java,,17,5,34,56
/jdk1.1.8/java/io/InvalidObjectException.java,Java,,6,2,25,33
/jdk1.1.8/java/io/IOException.java,Java,,10,3,27,40
/jdk1.1.8/java/io/LineNumberInputStream.java,Java,,73,15,164,252
/jdk1.1.8/java/io/LineNumberReader.java,Java,,95,22,93,210
/jdk1.1.8/java/io/NotActiveException.java,Java,,9,3,22,34
/jdk1.1.8/java/io/NotSerializableException.java,Java,,9,3,19,31
/jdk1.1.8/java/io/ObjectInput.java,Java,,11,8,76,95
/jdk1.1.8/java/io/ObjectInputStream.java,Java,,800,148,774,1722
/jdk1.1.8/java/io/ObjectInputValidation.java,Java,,4,2,22,28
/jdk1.1.8/java/io/ObjectOutput.java,Java,,10,7,61,78
/jdk1.1.8/java/io/ObjectOutputStream.java,Java,,603,129,603,1335
/jdk1.1.8/java/io/ObjectStreamClass.java,Java,,426,111,314,851
/jdk1.1.8/java/io/ObjectStreamConstants.java,Java,,23,6,15,44
/jdk1.1.8/java/io/ObjectStreamException.java,Java,,9,3,21,33
/jdk1.1.8/java/io/ObjectStreamField.java,Java,,42,11,35,88
/jdk1.1.8/java/io/OptionalDataException.java,Java,,13,4,35,52
/jdk1.1.8/java/io/OutputStream.java,Java,,16,6,81,103
/jdk1.1.8/java/io/OutputStreamWriter.java,Java,,113,23,103,239
/jdk1.1.8/java/io/PipedInputStream.java,Java,,125,20,134,279
/jdk1.1.8/java/io/PipedOutputStream.java,Java,,40,11,77,128
/jdk1.1.8/java/io/PipedReader.java,Java,,54,14,42,110
/jdk1.1.8/java/io/PipedWriter.java,Java,,50,16,42,108
/jdk1.1.8/java/io/PrintStream.java,Java,,233,46,233,512
/jdk1.1.8/java/io/PrintWriter.java,Java,,212,47,112,371
/jdk1.1.8/java/io/PushbackInputStream.java,Java,,65,13,137,215
/jdk1.1.8/java/io/PushbackReader.java,Java,,83,19,95,197
/jdk1.1.8/java/io/RandomAccessFile.java,Java,,220,53,581,854
/jdk1.1.8/java/io/Reader.java,Java,,51,19,138,208
/jdk1.1.8/java/io/SequenceInputStream.java,Java,,69,11,95,175
/jdk1.1.8/java/io/Serializable.java,Java,,3,2,74,79
/jdk1.1.8/java/io/StreamCorruptedException.java,Java,,9,3,22,34
/jdk1.1.8/java/io/StreamTokenizer.java,Java,,345,40,356,741
/jdk1.1.8/java/io/StringBufferInputStream.java,Java,,47,11,101,159
/jdk1.1.8/java/io/StringReader.java,Java,,65,16,69,150
/jdk1.1.8/java/io/StringWriter.java,Java,,34,16,55,105
/jdk1.1.8/java/io/SyncFailedException.java,Java,,6,2,21,29
/jdk1.1.8/java/io/UnsupportedEncodingException.java,Java,,11,1,22,34
/jdk1.1.8/java/io/UTFDataFormatException.java,Java,,10,3,32,45
/jdk1.1.8/java/io/WriteAbortedException.java,Java,,14,4,28,46
/jdk1.1.8/java/io/Writer.java,Java,,33,15,100,148
/jdk1.1.8/java/lang/AbstractMethodError.java,Java,,10,3,29,42
/jdk1.1.8/java/lang/ArithmeticException.java,Java,,10,3,28,41
/jdk1.1.8/java/lang/ArrayIndexOutOfBoundsException.java,Java,,13,4,35,52
/jdk1.1.8/java/lang/ArrayStoreException.java,Java,,10,4,31,45
/jdk1.1.8/java/lang/Boolean.java,Java,,42,15,116,173
/jdk1.1.8/java/lang/Byte.java,Java,,76,24,152,252
/jdk1.1.8/java/lang/Character.java,Java,,637,49,796,1482
/jdk1.1.8/java/lang/Class.java,Java,,146,40,524,710
/jdk1.1.8/java/lang/ClassCastException.java,Java,,10,3,31,44
/jdk1.1.8/java/lang/ClassCircularityError.java,Java,,9,3,25,37
/jdk1.1.8/java/lang/ClassFormatError.java,Java,,10,3,27,40
/jdk1.1.8/java/lang/ClassLoader.java,Java,,110,24,281,415
/jdk1.1.8/java/lang/ClassNotFoundException.java,Java,,10,3,37,50
/jdk1.1.8/java/lang/Cloneable.java,Java,,3,3,21,27
/jdk1.1.8/java/lang/CloneNotSupportedException.java,Java,,10,4,35,49
/jdk1.1.8/java/lang/Compiler.java,Java,,24,9,71,104
/jdk1.1.8/java/lang/Double.java,Java,,70,29,287,386
/jdk1.1.8/java/lang/Error.java,Java,,10,3,35,48
/jdk1.1.8/java/lang/Exception.java,Java,,10,3,27,40
/jdk1.1.8/java/lang/ExceptionInInitializerError.java,Java,,17,6,38,61
/jdk1.1.8/java/lang/Float.java,Java,,70,29,281,380
/jdk1.1.8/java/lang/FloatingDecimal.java,Java,,934,57,369,1360
/jdk1.1.8/java/lang/IllegalAccessError.java,Java,,9,3,30,42
/jdk1.1.8/java/lang/IllegalAccessException.java,Java,,10,3,46,59
/jdk1.1.8/java/lang/IllegalArgumentException.java,Java,,10,3,28,41
/jdk1.1.8/java/lang/IllegalMonitorStateException.java,Java,,10,3,33,46
/jdk1.1.8/java/lang/IllegalStateException.java,Java,,10,3,30,43
/jdk1.1.8/java/lang/IllegalThreadStateException.java,Java,,9,3,31,43
/jdk1.1.8/java/lang/IncompatibleClassChangeError.java,Java,,10,3,28,41
/jdk1.1.8/java/lang/IndexOutOfBoundsException.java,Java,,10,3,29,42
/jdk1.1.8/java/lang/InstantiationError.java,Java,,10,5,30,45
/jdk1.1.8/java/lang/InstantiationException.java,Java,,10,3,29,42
/jdk1.1.8/java/lang/Integer.java,Java,,255,51,372,678
/jdk1.1.8/java/lang/InternalError.java,Java,,10,3,26,39
/jdk1.1.8/java/lang/InterruptedException.java,Java,,10,3,33,46
/jdk1.1.8/java/lang/LinkageError.java,Java,,10,3,28,41
/jdk1.1.8/java/lang/Long.java,Java,,196,38,340,574
/jdk1.1.8/java/lang/Math.java,Java,,92,41,382,515
/jdk1.1.8/java/lang/NegativeArraySizeException.java,Java,,10,3,26,39
/jdk1.1.8/java/lang/NoClassDefFoundError.java,Java,,10,3,32,45
/jdk1.1.8/java/lang/NoSuchFieldError.java,Java,,10,3,30,43
/jdk1.1.8/java/lang/NoSuchFieldException.java,Java,,9,3,23,35
/jdk1.1.8/java/lang/NoSuchMethodError.java,Java,,10,3,31,44
/jdk1.1.8/java/lang/NoSuchMethodException.java,Java,,10,3,24,37
/jdk1.1.8/java/lang/NullPointerException.java,Java,,10,3,38,51
/jdk1.1.8/java/lang/Number.java,Java,,14,8,76,98
/jdk1.1.8/java/lang/NumberFormatException.java,Java,,10,3,28,41
/jdk1.1.8/java/lang/Object.java,Java,,32,15,273,320
/jdk1.1.8/java/lang/OutOfMemoryError.java,Java,,10,3,27,40
/jdk1.1.8/java/lang/Process.java,Java,,11,8,71,90
/jdk1.1.8/java/lang/reflect/Array.java,Java,,56,29,370,455
/jdk1.1.8/java/lang/reflect/Constructor.java,Java,,75,13,140,228
/jdk1.1.8/java/lang/reflect/Field.java,Java,,93,31,304,428
/jdk1.1.8/java/lang/reflect/InvocationTargetException.java,Java,,19,8,27,54
/jdk1.1.8/java/lang/reflect/Member.java,Java,,9,8,42,59
/jdk1.1.8/java/lang/reflect/Method.java,Java,,91,15,165,271
/jdk1.1.8/java/lang/reflect/Modifier.java,Java,,66,20,74,160
/jdk1.1.8/java/lang/Runnable.java,Java,,5,2,42,49
/jdk1.1.8/java/lang/Runtime.java,Java,,139,34,310,483
/jdk1.1.8/java/lang/RuntimeException.java,Java,,10,3,32,45
/jdk1.1.8/java/lang/SecurityException.java,Java,,9,2,26,37
/jdk1.1.8/java/lang/SecurityManager.java,Java,,158,47,626,831
/jdk1.1.8/java/lang/Short.java,Java,,76,23,150,249
/jdk1.1.8/java/lang/StackOverflowError.java,Java,,10,3,26,39
/jdk1.1.8/java/lang/String.java,Java,,625,95,804,1524
/jdk1.1.8/java/lang/StringBuffer.java,Java,,220,45,533,798
/jdk1.1.8/java/lang/StringIndexOutOfBoundsException.java,Java,,13,4,37,54
/jdk1.1.8/java/lang/System.java,Java,,114,34,441,589
/jdk1.1.8/java/lang/Thread.java,Java,,229,68,670,967
/jdk1.1.8/java/lang/ThreadDeath.java,Java,,2,3,30,35
/jdk1.1.8/java/lang/ThreadGroup.java,Java,,413,42,374,829
/jdk1.1.8/java/lang/Throwable.java,Java,,38,15,117,170
/jdk1.1.8/java/lang/UnknownError.java,Java,,10,3,26,39
/jdk1.1.8/java/lang/UnsatisfiedLinkError.java,Java,,10,3,27,40
/jdk1.1.8/java/lang/VerifyError.java,Java,,10,3,26,39
/jdk1.1.8/java/lang/VirtualMachineError.java,Java,,10,3,27,40
/jdk1.1.8/java/lang/Void.java,Java,,6,4,23,33
/jdk1.1.8/java/math/BigDecimal.java,Java,,267,75,312,654
/jdk1.1.8/java/math/BigInteger.java,Java,,743,202,512,1457
/jdk1.1.8/java/net/BindException.java,Java,,7,5,25,37
/jdk1.1.8/java/net/ConnectException.java,Java,,7,3,26,36
/jdk1.1.8/java/net/ContentHandler.java,Java,,5,3,43,51
/jdk1.1.8/java/net/ContentHandlerFactory.java,Java,,4,2,32,38
/jdk1.1.8/java/net/DatagramPacket.java,Java,,60,12,90,162
/jdk1.1.8/java/net/DatagramSocket.java,Java,,117,27,138,282
/jdk1.1.8/java/net/DatagramSocketImpl.java,Java,,24,18,70,112
/jdk1.1.8/java/net/FileNameMap.java,Java,,4,2,17,23
/jdk1.1.8/java/net/HttpURLConnection.java,Java,,98,27,111,236
/jdk1.1.8/java/net/InetAddress.java,Java,,252,51,224,527
/jdk1.1.8/java/net/MalformedURLException.java,Java,,9,4,27,40
/jdk1.1.8/java/net/MulticastSocket.java,Java,,71,17,135,223
/jdk1.1.8/java/net/NoRouteToHostException.java,Java,,7,3,26,36
/jdk1.1.8/java/net/PlainDatagramSocketImpl.java,Java,,76,25,67,168
/jdk1.1.8/java/net/PlainSocketImpl.java,Java,,245,68,117,430
/jdk1.1.8/java/net/ProtocolException.java,Java,,10,4,26,40
/jdk1.1.8/java/net/ServerSocket.java,Java,,104,22,169,295
/jdk1.1.8/java/net/Socket.java,Java,,142,32,249,423
/jdk1.1.8/java/net/SocketException.java,Java,,10,4,26,40
/jdk1.1.8/java/net/SocketImpl.java,Java,,43,22,157,222
/jdk1.1.8/java/net/SocketImplFactory.java,Java,,5,2,25,32
/jdk1.1.8/java/net/SocketInputStream.java,Java,,62,14,67,143
/jdk1.1.8/java/net/SocketOptions.java,Java,,12,27,177,216
/jdk1.1.8/java/net/SocketOutputStream.java,Java,,28,10,52,90
/jdk1.1.8/java/net/UnknownHostException.java,Java,,10,4,26,40
/jdk1.1.8/java/net/UnknownServiceException.java,Java,,9,4,29,42
/jdk1.1.8/java/net/URL.java,Java,,218,47,438,703
/jdk1.1.8/java/net/URLConnection.java,Java,,293,72,731,1096
/jdk1.1.8/java/net/URLEncoder.java,Java,,67,9,42,118
/jdk1.1.8/java/net/URLStreamHandler.java,Java,,98,9,123,230
/jdk1.1.8/java/net/URLStreamHandlerFactory.java,Java,,4,2,29,35
/jdk1.1.8/java/rmi/AccessException.java,Java,,11,5,12,28
/jdk1.1.8/java/rmi/AlreadyBoundException.java,Java,,11,4,6,21
/jdk1.1.8/java/rmi/ConnectException.java,Java,,10,5,13,28
/jdk1.1.8/java/rmi/ConnectIOException.java,Java,,10,5,13,28
/jdk1.1.8/java/rmi/dgc/DGC.java,Java,,9,4,72,85
/jdk1.1.8/java/rmi/dgc/Lease.java,Java,,19,6,21,46
/jdk1.1.8/java/rmi/dgc/VMID.java,Java,,73,13,45,131
/jdk1.1.8/java/rmi/MarshalException.java,Java,,10,5,13,28
/jdk1.1.8/java/rmi/Naming.java,Java,,104,24,58,186
/jdk1.1.8/java/rmi/NoSuchObjectException.java,Java,,8,4,9,21
/jdk1.1.8/java/rmi/NotBoundException.java,Java,,11,4,6,21
/jdk1.1.8/java/rmi/registry/LocateRegistry.java,Java,,57,13,60,130
/jdk1.1.8/java/rmi/registry/Registry.java,Java,,15,8,53,76
/jdk1.1.8/java/rmi/registry/RegistryHandler.java,Java,,9,6,18,33
/jdk1.1.8/java/rmi/Remote.java,Java,,2,3,23,28
/jdk1.1.8/java/rmi/RemoteException.java,Java,,21,8,20,49
/jdk1.1.8/java/rmi/RMISecurityException.java,Java,,16,4,18,38
/jdk1.1.8/java/rmi/RMISecurityManager.java,Java,,236,45,154,435
/jdk1.1.8/java/rmi/server/ExportException.java,Java,,10,6,13,29
/jdk1.1.8/java/rmi/server/LoaderHandler.java,Java,,12,7,29,48
/jdk1.1.8/java/rmi/server/LogStream.java,Java,,107,25,67,199
/jdk1.1.8/java/rmi/server/ObjID.java,Java,,57,14,50,121
/jdk1.1.8/java/rmi/server/Operation.java,Java,,13,5,15,33
/jdk1.1.8/java/rmi/server/RemoteCall.java,Java,,16,10,55,81
/jdk1.1.8/java/rmi/server/RemoteObject.java,Java,,60,15,52,127
/jdk1.1.8/java/rmi/server/RemoteRef.java,Java,,14,12,65,91
/jdk1.1.8/java/rmi/server/RemoteServer.java,Java,,48,8,34,90
/jdk1.1.8/java/rmi/server/RemoteStub.java,Java,,14,5,19,38
/jdk1.1.8/java/rmi/server/RMIClassLoader.java,Java,,34,8,47,89
/jdk1.1.8/java/rmi/server/RMIFailureHandler.java,Java,,4,5,33,42
/jdk1.1.8/java/rmi/server/RMISocketFactory.java,Java,,35,13,48,96
/jdk1.1.8/java/rmi/server/ServerCloneException.java,Java,,20,7,17,44
/jdk1.1.8/java/rmi/server/ServerNotActiveException.java,Java,,9,5,9,23
/jdk1.1.8/java/rmi/server/ServerRef.java,Java,,7,5,23,35
/jdk1.1.8/java/rmi/server/Skeleton.java,Java,,7,3,17,27
/jdk1.1.8/java/rmi/server/SkeletonMismatchException.java,Java,,8,6,16,30
/jdk1.1.8/java/rmi/server/SkeletonNotFoundException.java,Java,,11,6,12,29
/jdk1.1.8/java/rmi/server/SocketSecurityException.java,Java,,10,6,13,29
/jdk1.1.8/java/rmi/server/UID.java,Java,,85,15,39,139
/jdk1.1.8/java/rmi/server/UnicastRemoteObject.java,Java,,43,7,43,93
/jdk1.1.8/java/rmi/server/Unreferenced.java,Java,,4,2,13,19
/jdk1.1.8/java/rmi/ServerError.java,Java,,7,4,10,21
/jdk1.1.8/java/rmi/ServerException.java,Java,,10,5,13,28
/jdk1.1.8/java/rmi/ServerRuntimeException.java,Java,,7,4,10,21
/jdk1.1.8/java/rmi/StubNotFoundException.java,Java,,10,5,12,27
/jdk1.1.8/java/rmi/UnexpectedException.java,Java,,10,5,13,28
/jdk1.1.8/java/rmi/UnknownHostException.java,Java,,10,5,13,28
/jdk1.1.8/java/rmi/UnmarshalException.java,Java,,10,5,13,28
/jdk1.1.8/java/security/acl/Acl.java,Java,,16,28,192,236
/jdk1.1.8/java/security/acl/AclEntry.java,Java,,15,15,104,134
/jdk1.1.8/java/security/acl/AclNotFoundException.java,Java,,5,4,15,24
/jdk1.1.8/java/security/acl/Group.java,Java,,9,9,51,69
/jdk1.1.8/java/security/acl/LastOwnerException.java,Java,,5,3,17,25
/jdk1.1.8/java/security/acl/NotOwnerException.java,Java,,5,3,16,24
/jdk1.1.8/java/security/acl/Owner.java,Java,,9,7,61,77
/jdk1.1.8/java/security/acl/Permission.java,Java,,5,6,25,36
/jdk1.1.8/java/security/Certificate.java,Java,,14,12,106,132
/jdk1.1.8/java/security/DigestException.java,Java,,9,4,24,37
/jdk1.1.8/java/security/DigestInputStream.java,Java,,41,18,113,172
/jdk1.1.8/java/security/DigestOutputStream.java,Java,,39,17,99,155
/jdk1.1.8/java/security/Identity.java,Java,,173,38,183,394
/jdk1.1.8/java/security/IdentityScope.java,Java,,56,23,130,209
/jdk1.1.8/java/security/interfaces/DSAKey.java,Java,,4,3,26,33
/jdk1.1.8/java/security/interfaces/DSAKeyPairGenerator.java,Java,,8,5,79,92
/jdk1.1.8/java/security/interfaces/DSAParams.java,Java,,7,6,34,47
/jdk1.1.8/java/security/interfaces/DSAPrivateKey.java,Java,,5,6,24,35
/jdk1.1.8/java/security/interfaces/DSAPublicKey.java,Java,,5,6,22,33
/jdk1.1.8/java/security/InvalidKeyException.java,Java,,9,6,25,40
/jdk1.1.8/java/security/InvalidParameterException.java,Java,,9,5,25,39
/jdk1.1.8/java/security/Key.java,Java,,6,6,81,93
/jdk1.1.8/java/security/KeyException.java,Java,,9,5,27,41
/jdk1.1.8/java/security/KeyManagementException.java,Java,,9,5,35,49
/jdk1.1.8/java/security/KeyPair.java,Java,,17,6,34,57
/jdk1.1.8/java/security/KeyPairGenerator.java,Java,,33,11,137,181
/jdk1.1.8/java/security/MessageDigest.java,Java,,114,35,232,381
/jdk1.1.8/java/security/NoSuchAlgorithmException.java,Java,,9,5,26,40
/jdk1.1.8/java/security/NoSuchProviderException.java,Java,,9,5,25,39
/jdk1.1.8/java/security/Principal.java,Java,,7,6,46,59
/jdk1.1.8/java/security/PrivateKey.java,Java,,3,4,25,32
/jdk1.1.8/java/security/Provider.java,Java,,46,20,70,136
/jdk1.1.8/java/security/ProviderException.java,Java,,9,5,24,38
/jdk1.1.8/java/security/PublicKey.java,Java,,4,3,24,31
/jdk1.1.8/java/security/SecureRandom.java,Java,,111,33,145,289
/jdk1.1.8/java/security/Security.java,Java,,256,80,199,535
/jdk1.1.8/java/security/SeedGenerator.java,Java,,185,43,85,313
/jdk1.1.8/java/security/Signature.java,Java,,129,44,408,581
/jdk1.1.8/java/security/SignatureException.java,Java,,9,6,24,39
/jdk1.1.8/java/security/Signer.java,Java,,43,15,59,117
/jdk1.1.8/java/sql/CallableStatement.java,Java,,25,24,194,243
/jdk1.1.8/java/sql/Connection.java,Java,,28,27,244,299
/jdk1.1.8/java/sql/DatabaseMetaData.java,Java,,205,184,1621,2010
/jdk1.1.8/java/sql/DataTruncation.java,Java,,38,11,56,105
/jdk1.1.8/java/sql/Date.java,Java,,82,23,43,148
/jdk1.1.8/java/sql/Driver.java,Java,,11,12,99,122
/jdk1.1.8/java/sql/DriverManager.java,Java,,210,46,153,409
/jdk1.1.8/java/sql/DriverPropertyInfo.java,Java,,12,9,39,60
/jdk1.1.8/java/sql/PreparedStatement.java,Java,,35,29,268,332
/jdk1.1.8/java/sql/ResultSet.java,Java,,48,53,468,569
/jdk1.1.8/java/sql/ResultSetMetaData.java,Java,,26,26,159,211
/jdk1.1.8/java/sql/SQLException.java,Java,,65,12,66,143
/jdk1.1.8/java/sql/SQLWarning.java,Java,,32,11,53,96
/jdk1.1.8/java/sql/Statement.java,Java,,21,22,214,257
/jdk1.1.8/java/sql/Time.java,Java,,91,18,43,152
/jdk1.1.8/java/sql/Timestamp.java,Java,,199,26,84,309
/jdk1.1.8/java/sql/Types.java,Java,,25,11,17,53
/jdk1.1.8/java/text/BreakIterator.java,Java,,70,24,303,397
/jdk1.1.8/java/text/CharacterBreakData.java,Java,,168,22,78,268
/jdk1.1.8/java/text/CharacterIterator.java,Java,,15,16,142,173
/jdk1.1.8/java/text/ChoiceFormat.java,Java,,187,26,232,445
/jdk1.1.8/java/text/CollationElementIterator.java,Java,,173,12,156,341
/jdk1.1.8/java/text/CollationKey.java,Java,,42,15,126,183
/jdk1.1.8/java/text/CollationRules.java,Java,,193,10,50,253
/jdk1.1.8/java/text/Collator.java,Java,,113,27,322,462
/jdk1.1.8/java/text/CompactByteArray.java,Java,,267,13,125,405
/jdk1.1.8/java/text/CompactCharArray.java,Java,,269,26,125,420
/jdk1.1.8/java/text/CompactIntArray.java,Java,,266,27,125,418
/jdk1.1.8/java/text/CompactShortArray.java,Java,,268,13,124,405
/jdk1.1.8/java/text/CompactStringArray.java,Java,,306,12,132,450
/jdk1.1.8/java/text/DateFormat.java,Java,,180,39,402,621
/jdk1.1.8/java/text/DateFormatSymbols.java,Java,,182,37,231,450
/jdk1.1.8/java/text/DecimalFormat.java,Java,,868,147,633,1648
/jdk1.1.8/java/text/DecimalFormatSymbols.java,Java,,197,47,145,389
/jdk1.1.8/java/text/DecompositionIterator.java,Java,,1288,41,216,1545
/jdk1.1.8/java/text/DigitList.java,Java,,237,56,243,536
/jdk1.1.8/java/text/EntryPair.java,Java,,12,4,34,50
/jdk1.1.8/java/text/FieldPosition.java,Java,,24,12,92,128
/jdk1.1.8/java/text/Format.java,Java,,27,6,181,214
/jdk1.1.8/java/text/LineBreakData.java,Java,,295,15,106,416
/jdk1.1.8/java/text/MergeCollation.java,Java,,198,19,100,317
/jdk1.1.8/java/text/MessageFormat.java,Java,,469,44,334,847
/jdk1.1.8/java/text/NumberFormat.java,Java,,177,46,340,563
/jdk1.1.8/java/text/ParseException.java,Java,,12,5,49,66
/jdk1.1.8/java/text/ParsePosition.java,Java,,13,9,61,83
/jdk1.1.8/java/text/PatternEntry.java,Java,,202,18,61,281
/jdk1.1.8/java/text/resources/DateFormatZoneData.java,Java,,33,6,56,95
/jdk1.1.8/java/text/resources/DateFormatZoneData_ar.java,Java,,16,6,60,82
/jdk1.1.8/java/text/resources/DateFormatZoneData_be.java,Java,,16,6,60,82
/jdk1.1.8/java/text/resources/DateFormatZoneData_bg.java,Java,,16,6,60,82
/jdk1.1.8/java/text/resources/DateFormatZoneData_ca.java,Java,,16,6,60,82
/jdk1.1.8/java/text/resources/DateFormatZoneData_cs.java,Java,,16,6,60,82
/jdk1.1.8/java/text/resources/DateFormatZoneData_da.java,Java,,16,6,60,82
/jdk1.1.8/java/text/resources/DateFormatZoneData_de.java,Java,,16,6,60,82
/jdk1.1.8/java/text/resources/DateFormatZoneData_de_AT.java,Java,,16,6,60,82
/jdk1.1.8/java/text/resources/DateFormatZoneData_de_CH.java,Java,,16,6,60,82
/jdk1.1.8/java/text/resources/DateFormatZoneData_el.java,Java,,16,6,60,82
/jdk1.1.8/java/text/resources/DateFormatZoneData_en.java,Java,,73,6,190,269
/jdk1.1.8/java/text/resources/DateFormatZoneData_en_CA.java,Java,,53,7,64,124
/jdk1.1.8/java/text/resources/DateFormatZoneData_en_GB.java,Java,,17,6,61,84
/jdk1.1.8/java/text/resources/DateFormatZoneData_en_IE.java,Java,,17,6,61,84
/jdk1.1.8/java/text/resources/DateFormatZoneData_es.java,Java,,16,6,60,82
/jdk1.1.8/java/text/resources/DateFormatZoneData_et.java,Java,,16,6,60,82
/jdk1.1.8/java/text/resources/DateFormatZoneData_fi.java,Java,,16,6,60,82
/jdk1.1.8/java/text/resources/DateFormatZoneData_fr.java,Java,,16,6,60,82
/jdk1.1.8/java/text/resources/DateFormatZoneData_fr_BE.java,Java,,16,6,60,82
/jdk1.1.8/java/text/resources/DateFormatZoneData_fr_CA.java,Java,,16,6,60,82
/jdk1.1.8/java/text/resources/DateFormatZoneData_fr_CH.java,Java,,16,6,60,82
/jdk1.1.8/java/text/resources/DateFormatZoneData_hr.java,Java,,16,6,60,82
/jdk1.1.8/java/text/resources/DateFormatZoneData_hu.java,Java,,16,6,60,82
/jdk1.1.8/java/text/resources/DateFormatZoneData_is.java,Java,,16,6,60,82
/jdk1.1.8/java/text/resources/DateFormatZoneData_it.java,Java,,16,6,60,82
/jdk1.1.8/java/text/resources/DateFormatZoneData_it_CH.java,Java,,16,6,60,82
/jdk1.1.8/java/text/resources/DateFormatZoneData_iw.java,Java,,16,6,60,82
/jdk1.1.8/java/text/resources/DateFormatZoneData_ja.java,Java,,19,6,60,85
/jdk1.1.8/java/text/resources/DateFormatZoneData_ko.java,Java,,16,6,60,82
/jdk1.1.8/java/text/resources/DateFormatZoneData_lt.java,Java,,16,6,60,82
/jdk1.1.8/java/text/resources/DateFormatZoneData_lv.java,Java,,16,6,60,82
/jdk1.1.8/java/text/resources/DateFormatZoneData_mk.java,Java,,16,6,60,82
/jdk1.1.8/java/text/resources/DateFormatZoneData_nl.java,Java,,16,6,60,82
/jdk1.1.8/java/text/resources/DateFormatZoneData_nl_BE.java,Java,,16,6,60,82
/jdk1.1.8/java/text/resources/DateFormatZoneData_no.java,Java,,16,6,60,82
/jdk1.1.8/java/text/resources/DateFormatZoneData_no_NO_NY.java,Java,,16,6,60,82
/jdk1.1.8/java/text/resources/DateFormatZoneData_pl.java,Java,,16,6,60,82
/jdk1.1.8/java/text/resources/DateFormatZoneData_pt.java,Java,,16,6,60,82
/jdk1.1.8/java/text/resources/DateFormatZoneData_ro.java,Java,,16,6,60,82
/jdk1.1.8/java/text/resources/DateFormatZoneData_ru.java,Java,,16,6,60,82
/jdk1.1.8/java/text/resources/DateFormatZoneData_sh.java,Java,,16,6,60,82
/jdk1.1.8/java/text/resources/DateFormatZoneData_sk.java,Java,,16,6,60,82
/jdk1.1.8/java/text/resources/DateFormatZoneData_sl.java,Java,,16,6,60,82
/jdk1.1.8/java/text/resources/DateFormatZoneData_sq.java,Java,,16,6,60,82
/jdk1.1.8/java/text/resources/DateFormatZoneData_sr.java,Java,,16,6,60,82
/jdk1.1.8/java/text/resources/DateFormatZoneData_sv.java,Java,,16,6,60,82
/jdk1.1.8/java/text/resources/DateFormatZoneData_th.java,Java,,17,6,52,75
/jdk1.1.8/java/text/resources/DateFormatZoneData_tr.java,Java,,16,6,60,82
/jdk1.1.8/java/text/resources/DateFormatZoneData_uk.java,Java,,16,6,60,82
/jdk1.1.8/java/text/resources/DateFormatZoneData_zh.java,Java,,16,6,60,82
/jdk1.1.8/java/text/resources/DateFormatZoneData_zh_TW.java,Java,,16,6,60,82
/jdk1.1.8/java/text/resources/LocaleData.java,Java,,100,6,42,148
/jdk1.1.8/java/text/resources/LocaleElements.java,Java,,479,5,50,534
/jdk1.1.8/java/text/resources/LocaleElements_ar.java,Java,,309,5,49,363
/jdk1.1.8/java/text/resources/LocaleElements_be.java,Java,,223,5,45,273
/jdk1.1.8/java/text/resources/LocaleElements_bg.java,Java,,223,5,46,274
/jdk1.1.8/java/text/resources/LocaleElements_ca.java,Java,,121,5,45,171
/jdk1.1.8/java/text/resources/LocaleElements_cs.java,Java,,140,5,50,195
/jdk1.1.8/java/text/resources/LocaleElements_da.java,Java,,137,5,45,187
/jdk1.1.8/java/text/resources/LocaleElements_de.java,Java,,161,5,45,211
/jdk1.1.8/java/text/resources/LocaleElements_de_AT.java,Java,,78,5,45,128
/jdk1.1.8/java/text/resources/LocaleElements_de_AT_EURO.java,Java,,15,5,12,32
/jdk1.1.8/java/text/resources/LocaleElements_de_CH.java,Java,,40,5,45,90
/jdk1.1.8/java/text/resources/LocaleElements_de_DE_EURO.java,Java,,15,5,12,32
/jdk1.1.8/java/text/resources/LocaleElements_de_LU.java,Java,,17,5,13,35
/jdk1.1.8/java/text/resources/LocaleElements_de_LU_EURO.java,Java,,15,5,12,32
/jdk1.1.8/java/text/resources/LocaleElements_el.java,Java,,197,5,47,249
/jdk1.1.8/java/text/resources/LocaleElements_en.java,Java,,21,5,45,71
/jdk1.1.8/java/text/resources/LocaleElements_en_AU.java,Java,,53,5,45,103
/jdk1.1.8/java/text/resources/LocaleElements_en_CA.java,Java,,53,5,45,103
/jdk1.1.8/java/text/resources/LocaleElements_en_GB.java,Java,,59,5,45,109
/jdk1.1.8/java/text/resources/LocaleElements_en_IE.java,Java,,59,5,45,109
/jdk1.1.8/java/text/resources/LocaleElements_en_IE_EURO.java,Java,,15,5,12,32
/jdk1.1.8/java/text/resources/LocaleElements_en_NZ.java,Java,,53,5,45,103
/jdk1.1.8/java/text/resources/LocaleElements_en_ZA.java,Java,,52,5,45,102
/jdk1.1.8/java/text/resources/LocaleElements_es.java,Java,,145,5,45,195
/jdk1.1.8/java/text/resources/LocaleElements_es_AR.java,Java,,38,5,45,88
/jdk1.1.8/java/text/resources/LocaleElements_es_BO.java,Java,,53,5,45,103
/jdk1.1.8/java/text/resources/LocaleElements_es_CL.java,Java,,38,5,45,88
/jdk1.1.8/java/text/resources/LocaleElements_es_CO.java,Java,,53,5,45,103
/jdk1.1.8/java/text/resources/LocaleElements_es_CR.java,Java,,53,5,45,103
/jdk1.1.8/java/text/resources/LocaleElements_es_DO.java,Java,,53,5,45,103
/jdk1.1.8/java/text/resources/LocaleElements_es_EC.java,Java,,53,5,45,103
/jdk1.1.8/java/text/resources/LocaleElements_es_ES_EURO.java,Java,,15,5,12,32
/jdk1.1.8/java/text/resources/LocaleElements_es_GT.java,Java,,53,5,45,103
/jdk1.1.8/java/text/resources/LocaleElements_es_HN.java,Java,,53,5,45,103
/jdk1.1.8/java/text/resources/LocaleElements_es_MX.java,Java,,53,5,45,103
/jdk1.1.8/java/text/resources/LocaleElements_es_NI.java,Java,,53,5,45,103
/jdk1.1.8/java/text/resources/LocaleElements_es_PA.java,Java,,53,5,45,103
/jdk1.1.8/java/text/resources/LocaleElements_es_PE.java,Java,,38,5,45,88
/jdk1.1.8/java/text/resources/LocaleElements_es_PR.java,Java,,53,5,45,103
/jdk1.1.8/java/text/resources/LocaleElements_es_PY.java,Java,,38,5,45,88
/jdk1.1.8/java/text/resources/LocaleElements_es_SV.java,Java,,53,5,45,103
/jdk1.1.8/java/text/resources/LocaleElements_es_UY.java,Java,,38,5,45,88
/jdk1.1.8/java/text/resources/LocaleElements_es_VE.java,Java,,38,5,45,88
/jdk1.1.8/java/text/resources/LocaleElements_et.java,Java,,136,5,46,187
/jdk1.1.8/java/text/resources/LocaleElements_fi.java,Java,,134,5,45,184
/jdk1.1.8/java/text/resources/LocaleElements_fi_FI_EURO.java,Java,,15,5,12,32
/jdk1.1.8/java/text/resources/LocaleElements_fr.java,Java,,163,5,45,213
/jdk1.1.8/java/text/resources/LocaleElements_fr_BE.java,Java,,53,5,45,103
/jdk1.1.8/java/text/resources/LocaleElements_fr_BE_EURO.java,Java,,15,5,12,32
/jdk1.1.8/java/text/resources/LocaleElements_fr_CA.java,Java,,44,5,45,94
/jdk1.1.8/java/text/resources/LocaleElements_fr_CH.java,Java,,59,5,45,109
/jdk1.1.8/java/text/resources/LocaleElements_fr_FR_EURO.java,Java,,15,5,12,32
/jdk1.1.8/java/text/resources/LocaleElements_fr_LU.java,Java,,17,5,13,35
/jdk1.1.8/java/text/resources/LocaleElements_fr_LU_EURO.java,Java,,15,5,12,32
/jdk1.1.8/java/text/resources/LocaleElements_hr.java,Java,,134,6,52,192
/jdk1.1.8/java/text/resources/LocaleElements_hu.java,Java,,144,5,54,203
/jdk1.1.8/java/text/resources/LocaleElements_is.java,Java,,132,6,52,190
/jdk1.1.8/java/text/resources/LocaleElements_it.java,Java,,133,5,45,183
/jdk1.1.8/java/text/resources/LocaleElements_it_CH.java,Java,,53,5,45,103
/jdk1.1.8/java/text/resources/LocaleElements_it_IT_EURO.java,Java,,15,5,12,32
/jdk1.1.8/java/text/resources/LocaleElements_iw.java,Java,,186,5,49,240
/jdk1.1.8/java/text/resources/LocaleElements_ja.java,Java,,1399,49,61,1509
/jdk1.1.8/java/text/resources/LocaleElements_ko.java,Java,,1290,5,47,1342
/jdk1.1.8/java/text/resources/LocaleElements_lt.java,Java,,135,5,46,186
/jdk1.1.8/java/text/resources/LocaleElements_lv.java,Java,,137,6,46,189
/jdk1.1.8/java/text/resources/LocaleElements_mk.java,Java,,223,6,46,275
/jdk1.1.8/java/text/resources/LocaleElements_nl.java,Java,,127,5,45,177
/jdk1.1.8/java/text/resources/LocaleElements_nl_BE.java,Java,,44,5,45,94
/jdk1.1.8/java/text/resources/LocaleElements_nl_BE_EURO.java,Java,,15,5,12,32
/jdk1.1.8/java/text/resources/LocaleElements_nl_NL_EURO.java,Java,,15,5,12,32
/jdk1.1.8/java/text/resources/LocaleElements_no.java,Java,,135,5,45,185
/jdk1.1.8/java/text/resources/LocaleElements_no_NO_NY.java,Java,,37,5,45,87
/jdk1.1.8/java/text/resources/LocaleElements_pl.java,Java,,138,5,49,192
/jdk1.1.8/java/text/resources/LocaleElements_pt.java,Java,,127,5,45,177
/jdk1.1.8/java/text/resources/LocaleElements_pt_BR.java,Java,,38,5,45,88
/jdk1.1.8/java/text/resources/LocaleElements_pt_PT_EURO.java,Java,,15,5,12,32
/jdk1.1.8/java/text/resources/LocaleElements_ro.java,Java,,134,5,45,184
/jdk1.1.8/java/text/resources/LocaleElements_ru.java,Java,,229,5,46,280
/jdk1.1.8/java/text/resources/LocaleElements_sh.java,Java,,132,7,52,191
/jdk1.1.8/java/text/resources/LocaleElements_sk.java,Java,,139,6,50,195
/jdk1.1.8/java/text/resources/LocaleElements_sl.java,Java,,140,6,50,196
/jdk1.1.8/java/text/resources/LocaleElements_sq.java,Java,,133,5,45,183
/jdk1.1.8/java/text/resources/LocaleElements_sr.java,Java,,223,5,46,274
/jdk1.1.8/java/text/resources/LocaleElements_sv.java,Java,,135,5,45,185
/jdk1.1.8/java/text/resources/LocaleElements_th.java,Java,,117,5,45,167
/jdk1.1.8/java/text/resources/LocaleElements_tr.java,Java,,136,5,45,186
/jdk1.1.8/java/text/resources/LocaleElements_uk.java,Java,,223,5,46,274
/jdk1.1.8/java/text/resources/LocaleElements_zh.java,Java,,1187,5,47,1239
/jdk1.1.8/java/text/resources/LocaleElements_zh_TW.java,Java,,2006,5,47,2058
/jdk1.1.8/java/text/RuleBasedCollator.java,Java,,572,64,564,1200
/jdk1.1.8/java/text/SentenceBreakData.java,Java,,234,38,103,375
/jdk1.1.8/java/text/SimpleDateFormat.java,Java,,747,85,456,1288
/jdk1.1.8/java/text/SimpleTextBoundary.java,Java,,170,28,108,306
/jdk1.1.8/java/text/SpecialMapping.java,Java,,17,5,54,76
/jdk1.1.8/java/text/StringCharacterIterator.java,Java,,116,25,155,296
/jdk1.1.8/java/text/TextBoundaryData.java,Java,,237,5,37,279
/jdk1.1.8/java/text/UnicodeClassMapping.java,Java,,43,7,51,101
/jdk1.1.8/java/text/Utility.java,Java,,273,29,151,453
/jdk1.1.8/java/text/WordBreakData.java,Java,,294,39,104,437
/jdk1.1.8/java/text/WordBreakTable.java,Java,,31,8,62,101
/jdk1.1.8/java/util/BitSet.java,Java,,217,20,90,327
/jdk1.1.8/java/util/Calendar.java,Java,,338,84,817,1239
/jdk1.1.8/java/util/Date.java,Java,,362,42,518,922
/jdk1.1.8/java/util/Dictionary.java,Java,,11,8,93,112
/jdk1.1.8/java/util/EmptyStackException.java,Java,,6,2,20,28
/jdk1.1.8/java/util/Enumeration.java,Java,,5,3,50,58
/jdk1.1.8/java/util/EventListener.java,Java,,3,2,9,14
/jdk1.1.8/java/util/EventObject.java,Java,,15,6,6,27
/jdk1.1.8/java/util/GregorianCalendar.java,Java,,734,160,699,1593
/jdk1.1.8/java/util/Hashtable.java,Java,,250,47,240,537
/jdk1.1.8/java/util/ListResourceBundle.java,Java,,54,11,128,193
/jdk1.1.8/java/util/Locale.java,Java,,398,102,473,973
/jdk1.1.8/java/util/MissingResourceException.java,Java,,17,7,56,80
/jdk1.1.8/java/util/NoSuchElementException.java,Java,,10,3,29,42
/jdk1.1.8/java/util/Observable.java,Java,,53,15,119,187
/jdk1.1.8/java/util/Observer.java,Java,,4,1,26,31
/jdk1.1.8/java/util/Properties.java,Java,,219,28,128,375
/jdk1.1.8/java/util/PropertyResourceBundle.java,Java,,46,10,89,145
/jdk1.1.8/java/util/Random.java,Java,,67,17,108,192
/jdk1.1.8/java/util/ResourceBundle.java,Java,,168,38,339,545
/jdk1.1.8/java/util/SimpleTimeZone.java,Java,,409,57,423,889
/jdk1.1.8/java/util/Stack.java,Java,,32,12,54,98
/jdk1.1.8/java/util/StringTokenizer.java,Java,,85,19,152,256
/jdk1.1.8/java/util/TimeZone.java,Java,,281,42,1013,1336
/jdk1.1.8/java/util/TooManyListenersException.java,Java,,9,8,36,53
/jdk1.1.8/java/util/Vector.java,Java,,219,38,293,550
/jdk1.1.8/java/util/zip/Adler32.java,Java,,22,9,33,64
/jdk1.1.8/java/util/zip/CheckedInputStream.java,Java,,42,8,43,93
/jdk1.1.8/java/util/zip/CheckedOutputStream.java,Java,,23,7,36,66
/jdk1.1.8/java/util/zip/Checksum.java,Java,,8,5,24,37
/jdk1.1.8/java/util/zip/CRC32.java,Java,,22,9,31,62
/jdk1.1.8/java/util/zip/DataFormatException.java,Java,,10,3,20,33
/jdk1.1.8/java/util/zip/Deflater.java,Java,,95,32,164,291
/jdk1.1.8/java/util/zip/DeflaterOutputStream.java,Java,,55,12,65,132
/jdk1.1.8/java/util/zip/GZIPInputStream.java,Java,,107,16,80,203
/jdk1.1.8/java/util/zip/GZIPOutputStream.java,Java,,55,13,61,129
/jdk1.1.8/java/util/zip/Inflater.java,Java,,62,22,134,218
/jdk1.1.8/java/util/zip/InflaterInputStream.java,Java,,66,12,67,145
/jdk1.1.8/java/util/zip/ZipConstants.java,Java,,43,7,31,81
/jdk1.1.8/java/util/zip/ZipEntry.java,Java,,111,25,103,239
/jdk1.1.8/java/util/zip/ZipException.java,Java,,11,4,6,21
/jdk1.1.8/java/util/zip/ZipFile.java,Java,,244,25,133,402
/jdk1.1.8/java/util/zip/ZipInputStream.java,Java,,174,15,71,260
/jdk1.1.8/java/util/zip/ZipOutputStream.java,Java,,279,22,116,417
/jdk1.1.8/sun/tools/ttydebug/TTY.java,Java,,1427,135,66,1628
/jdk1.1.8/sunw/sunw/io/Serializable.java,Java,,3,3,30,36
/jdk1.1.8/sunw/sunw/util/EventListener.java,Java,,3,3,30,36
/jdk1.1.8/sunw/sunw/util/EventObject.java,Java,,6,5,30,41
