/jdk1.7.0_80/com/sun/corba/se/impl/activation/CommandHandler.java,Java,,13,8,28,49
/jdk1.7.0_80/com/sun/corba/se/impl/activation/NameServiceStartThread.java,Java,,29,7,27,63
/jdk1.7.0_80/com/sun/corba/se/impl/activation/ORBD.java,Java,,244,50,60,354
/jdk1.7.0_80/com/sun/corba/se/impl/activation/ProcessMonitorThread.java,Java,,55,11,39,105
/jdk1.7.0_80/com/sun/corba/se/impl/activation/RepositoryImpl.java,Java,,348,78,48,474
/jdk1.7.0_80/com/sun/corba/se/impl/activation/ServerMain.java,Java,,247,71,65,383
/jdk1.7.0_80/com/sun/corba/se/impl/activation/ServerManagerImpl.java,Java,,466,109,70,645
/jdk1.7.0_80/com/sun/corba/se/impl/activation/ServerTableEntry.java,Java,,380,91,72,543
/jdk1.7.0_80/com/sun/corba/se/impl/activation/ServerTool.java,Java,,729,166,78,973
/jdk1.7.0_80/com/sun/corba/se/impl/copyobject/CopierManagerImpl.java,Java,,38,11,24,73
/jdk1.7.0_80/com/sun/corba/se/impl/copyobject/FallbackObjectCopierImpl.java,Java,,22,5,28,55
/jdk1.7.0_80/com/sun/corba/se/impl/copyobject/JavaStreamObjectCopierImpl.java,Java,,39,13,26,78
/jdk1.7.0_80/com/sun/corba/se/impl/copyobject/ORBStreamObjectCopierImpl.java,Java,,27,10,26,63
/jdk1.7.0_80/com/sun/corba/se/impl/copyobject/ReferenceObjectCopierImpl.java,Java,,9,3,24,36
/jdk1.7.0_80/com/sun/corba/se/impl/corba/AnyImpl.java,Java,,832,135,384,1351
/jdk1.7.0_80/com/sun/corba/se/impl/corba/AnyImplHelper.java,Java,,37,9,32,78
/jdk1.7.0_80/com/sun/corba/se/impl/corba/AsynchInvoke.java,Java,,25,15,52,92
/jdk1.7.0_80/com/sun/corba/se/impl/corba/ContextImpl.java,Java,,53,15,30,98
/jdk1.7.0_80/com/sun/corba/se/impl/corba/ContextListImpl.java,Java,,43,10,31,84
/jdk1.7.0_80/com/sun/corba/se/impl/corba/CORBAObjectImpl.java,Java,,8,2,33,43
/jdk1.7.0_80/com/sun/corba/se/impl/corba/EnvironmentImpl.java,Java,,22,9,30,61
/jdk1.7.0_80/com/sun/corba/se/impl/corba/ExceptionListImpl.java,Java,,40,13,30,83
/jdk1.7.0_80/com/sun/corba/se/impl/corba/NamedValueImpl.java,Java,,38,9,32,79
/jdk1.7.0_80/com/sun/corba/se/impl/corba/NVListImpl.java,Java,,65,16,32,113
/jdk1.7.0_80/com/sun/corba/se/impl/corba/PrincipalImpl.java,Java,,13,5,30,48
/jdk1.7.0_80/com/sun/corba/se/impl/corba/RequestImpl.java,Java,,249,49,76,374
/jdk1.7.0_80/com/sun/corba/se/impl/corba/ServerRequestImpl.java,Java,,139,41,77,257
/jdk1.7.0_80/com/sun/corba/se/impl/corba/TCUtility.java,Java,,233,55,41,329
/jdk1.7.0_80/com/sun/corba/se/impl/corba/TypeCodeFactory.java,Java,,7,5,24,36
/jdk1.7.0_80/com/sun/corba/se/impl/corba/TypeCodeImpl.java,Java,,1744,288,381,2413
/jdk1.7.0_80/com/sun/corba/se/impl/corba/TypeCodeImplHelper.java,Java,,41,10,30,81
/jdk1.7.0_80/com/sun/corba/se/impl/dynamicany/DynAnyBasicImpl.java,Java,,535,58,43,636
/jdk1.7.0_80/com/sun/corba/se/impl/dynamicany/DynAnyCollectionImpl.java,Java,,117,25,63,205
/jdk1.7.0_80/com/sun/corba/se/impl/dynamicany/DynAnyComplexImpl.java,Java,,278,40,103,421
/jdk1.7.0_80/com/sun/corba/se/impl/dynamicany/DynAnyConstructedImpl.java,Java,,790,72,75,937
/jdk1.7.0_80/com/sun/corba/se/impl/dynamicany/DynAnyFactoryImpl.java,Java,,36,15,36,87
/jdk1.7.0_80/com/sun/corba/se/impl/dynamicany/DynAnyImpl.java,Java,,118,27,55,200
/jdk1.7.0_80/com/sun/corba/se/impl/dynamicany/DynAnyUtil.java,Java,,214,17,107,338
/jdk1.7.0_80/com/sun/corba/se/impl/dynamicany/DynArrayImpl.java,Java,,65,18,55,138
/jdk1.7.0_80/com/sun/corba/se/impl/dynamicany/DynEnumImpl.java,Java,,110,21,59,190
/jdk1.7.0_80/com/sun/corba/se/impl/dynamicany/DynFixedImpl.java,Java,,122,11,77,210
/jdk1.7.0_80/com/sun/corba/se/impl/dynamicany/DynSequenceImpl.java,Java,,129,25,103,257
/jdk1.7.0_80/com/sun/corba/se/impl/dynamicany/DynStructImpl.java,Java,,40,10,37,87
/jdk1.7.0_80/com/sun/corba/se/impl/dynamicany/DynUnionImpl.java,Java,,249,32,104,385
/jdk1.7.0_80/com/sun/corba/se/impl/dynamicany/DynValueBoxImpl.java,Java,,88,15,30,133
/jdk1.7.0_80/com/sun/corba/se/impl/dynamicany/DynValueCommonImpl.java,Java,,79,18,50,147
/jdk1.7.0_80/com/sun/corba/se/impl/dynamicany/DynValueImpl.java,Java,,25,7,27,59
/jdk1.7.0_80/com/sun/corba/se/impl/encoding/BufferManagerFactory.java,Java,,92,14,37,143
/jdk1.7.0_80/com/sun/corba/se/impl/encoding/BufferManagerRead.java,Java,,15,13,67,95
/jdk1.7.0_80/com/sun/corba/se/impl/encoding/BufferManagerReadGrow.java,Java,,48,18,33,99
/jdk1.7.0_80/com/sun/corba/se/impl/encoding/BufferManagerReadStream.java,Java,,237,50,70,357
/jdk1.7.0_80/com/sun/corba/se/impl/encoding/BufferManagerWrite.java,Java,,29,19,102,150
/jdk1.7.0_80/com/sun/corba/se/impl/encoding/BufferManagerWriteCollect.java,Java,,128,39,64,231
/jdk1.7.0_80/com/sun/corba/se/impl/encoding/BufferManagerWriteGrow.java,Java,,38,17,37,92
/jdk1.7.0_80/com/sun/corba/se/impl/encoding/BufferManagerWriteStream.java,Java,,61,25,48,134
/jdk1.7.0_80/com/sun/corba/se/impl/encoding/BufferQueue.java,Java,,24,6,30,60
/jdk1.7.0_80/com/sun/corba/se/impl/encoding/ByteBufferWithInfo.java,Java,,153,36,68,257
/jdk1.7.0_80/com/sun/corba/se/impl/encoding/CachedCodeBase.java,Java,,108,39,61,208
/jdk1.7.0_80/com/sun/corba/se/impl/encoding/CDRInputObject.java,Java,,136,46,85,267
/jdk1.7.0_80/com/sun/corba/se/impl/encoding/CDRInputStream.java,Java,,349,109,86,544
/jdk1.7.0_80/com/sun/corba/se/impl/encoding/CDRInputStreamBase.java,Java,,111,31,59,201
/jdk1.7.0_80/com/sun/corba/se/impl/encoding/CDRInputStream_1_0.java,Java,,1456,437,505,2398
/jdk1.7.0_80/com/sun/corba/se/impl/encoding/CDRInputStream_1_1.java,Java,,75,45,69,189
/jdk1.7.0_80/com/sun/corba/se/impl/encoding/CDRInputStream_1_2.java,Java,,56,25,63,144
/jdk1.7.0_80/com/sun/corba/se/impl/encoding/CDROutputObject.java,Java,,195,42,86,323
/jdk1.7.0_80/com/sun/corba/se/impl/encoding/CDROutputStream.java,Java,,312,67,59,438
/jdk1.7.0_80/com/sun/corba/se/impl/encoding/CDROutputStreamBase.java,Java,,101,30,45,176
/jdk1.7.0_80/com/sun/corba/se/impl/encoding/CDROutputStream_1_0.java,Java,,1240,376,313,1929
/jdk1.7.0_80/com/sun/corba/se/impl/encoding/CDROutputStream_1_1.java,Java,,54,29,66,149
/jdk1.7.0_80/com/sun/corba/se/impl/encoding/CDROutputStream_1_2.java,Java,,138,69,152,359
/jdk1.7.0_80/com/sun/corba/se/impl/encoding/CodeSetCache.java,Java,,33,15,61,109
/jdk1.7.0_80/com/sun/corba/se/impl/encoding/CodeSetComponentInfo.java,Java,,197,59,84,340
/jdk1.7.0_80/com/sun/corba/se/impl/encoding/CodeSetConversion.java,Java,,314,113,280,707
/jdk1.7.0_80/com/sun/corba/se/impl/encoding/EncapsInputStream.java,Java,,93,24,67,184
/jdk1.7.0_80/com/sun/corba/se/impl/encoding/EncapsOutputStream.java,Java,,60,21,64,145
/jdk1.7.0_80/com/sun/corba/se/impl/encoding/IDLJavaSerializationInputStream.java,Java,,748,161,174,1083
/jdk1.7.0_80/com/sun/corba/se/impl/encoding/IDLJavaSerializationOutputStream.java,Java,,557,129,112,798
/jdk1.7.0_80/com/sun/corba/se/impl/encoding/MarkAndResetHandler.java,Java,,7,4,28,39
/jdk1.7.0_80/com/sun/corba/se/impl/encoding/MarshalInputStream.java,Java,,44,10,48,102
/jdk1.7.0_80/com/sun/corba/se/impl/encoding/MarshalOutputStream.java,Java,,46,13,30,89
/jdk1.7.0_80/com/sun/corba/se/impl/encoding/OSFCodeSetRegistry.java,Java,,104,21,105,230
/jdk1.7.0_80/com/sun/corba/se/impl/encoding/RestorableInputStream.java,Java,,6,2,29,37
/jdk1.7.0_80/com/sun/corba/se/impl/encoding/TypeCodeInputStream.java,Java,,120,22,53,195
/jdk1.7.0_80/com/sun/corba/se/impl/encoding/TypeCodeOutputStream.java,Java,,136,27,101,264
/jdk1.7.0_80/com/sun/corba/se/impl/encoding/TypeCodeReader.java,Java,,44,7,26,77
/jdk1.7.0_80/com/sun/corba/se/impl/encoding/WrapperInputStream.java,Java,,154,21,36,211
/jdk1.7.0_80/com/sun/corba/se/impl/interceptors/CDREncapsCodec.java,Java,,96,31,93,220
/jdk1.7.0_80/com/sun/corba/se/impl/interceptors/ClientRequestInfoImpl.java,Java,,498,135,345,978
/jdk1.7.0_80/com/sun/corba/se/impl/interceptors/CodecFactoryImpl.java,Java,,51,16,55,122
/jdk1.7.0_80/com/sun/corba/se/impl/interceptors/InterceptorInvoker.java,Java,,335,74,253,662
/jdk1.7.0_80/com/sun/corba/se/impl/interceptors/InterceptorList.java,Java,,130,29,101,260
/jdk1.7.0_80/com/sun/corba/se/impl/interceptors/IORInfoImpl.java,Java,,151,53,114,318
/jdk1.7.0_80/com/sun/corba/se/impl/interceptors/ORBInitInfoImpl.java,Java,,175,50,156,381
/jdk1.7.0_80/com/sun/corba/se/impl/interceptors/PICurrent.java,Java,,69,22,79,170
/jdk1.7.0_80/com/sun/corba/se/impl/interceptors/PIHandlerImpl.java,Java,,566,149,277,992
/jdk1.7.0_80/com/sun/corba/se/impl/interceptors/PINoOpHandlerImpl.java,Java,,121,48,30,199
/jdk1.7.0_80/com/sun/corba/se/impl/interceptors/RequestInfoImpl.java,Java,,397,121,411,929
/jdk1.7.0_80/com/sun/corba/se/impl/interceptors/ServerRequestInfoImpl.java,Java,,452,138,317,907
/jdk1.7.0_80/com/sun/corba/se/impl/interceptors/SlotTable.java,Java,,44,12,51,107
/jdk1.7.0_80/com/sun/corba/se/impl/interceptors/SlotTableStack.java,Java,,78,25,85,188
/jdk1.7.0_80/com/sun/corba/se/impl/io/FVDCodeBaseImpl.java,Java,,103,28,53,184
/jdk1.7.0_80/com/sun/corba/se/impl/io/IIOPInputStream.java,Java,,1717,371,645,2733
/jdk1.7.0_80/com/sun/corba/se/impl/io/IIOPOutputStream.java,Java,,534,126,156,816
/jdk1.7.0_80/com/sun/corba/se/impl/io/InputStreamHook.java,Java,,267,85,117,469
/jdk1.7.0_80/com/sun/corba/se/impl/io/ObjectStreamClass.java,Java,,1008,217,569,1794
/jdk1.7.0_80/com/sun/corba/se/impl/io/ObjectStreamClassCorbaExt.java,Java,,51,14,47,112
/jdk1.7.0_80/com/sun/corba/se/impl/io/ObjectStreamField.java,Java,,154,36,81,271
/jdk1.7.0_80/com/sun/corba/se/impl/io/OptionalDataException.java,Java,,13,6,56,75
/jdk1.7.0_80/com/sun/corba/se/impl/io/OutputStreamHook.java,Java,,142,65,105,312
/jdk1.7.0_80/com/sun/corba/se/impl/io/TypeMismatchException.java,Java,,12,3,30,45
/jdk1.7.0_80/com/sun/corba/se/impl/io/ValueHandlerImpl.java,Java,,630,133,163,926
/jdk1.7.0_80/com/sun/corba/se/impl/io/ValueUtility.java,Java,,336,66,81,483
/jdk1.7.0_80/com/sun/corba/se/impl/ior/ByteBuffer.java,Java,,80,18,110,208
/jdk1.7.0_80/com/sun/corba/se/impl/ior/EncapsulationUtility.java,Java,,74,19,49,142
/jdk1.7.0_80/com/sun/corba/se/impl/ior/FreezableList.java,Java,,85,24,33,142
/jdk1.7.0_80/com/sun/corba/se/impl/ior/GenericIdentifiable.java,Java,,54,16,28,98
/jdk1.7.0_80/com/sun/corba/se/impl/ior/GenericTaggedComponent.java,Java,,23,8,32,63
/jdk1.7.0_80/com/sun/corba/se/impl/ior/GenericTaggedProfile.java,Java,,59,17,28,104
/jdk1.7.0_80/com/sun/corba/se/impl/ior/IdentifiableFactoryFinderBase.java,Java,,45,14,24,83
/jdk1.7.0_80/com/sun/corba/se/impl/ior/iiop/AlternateIIOPAddressComponentImpl.java,Java,,43,15,27,85
/jdk1.7.0_80/com/sun/corba/se/impl/ior/iiop/CodeSetsComponentImpl.java,Java,,57,18,28,103
/jdk1.7.0_80/com/sun/corba/se/impl/ior/iiop/IIOPAddressBase.java,Java,,42,12,33,87
/jdk1.7.0_80/com/sun/corba/se/impl/ior/iiop/IIOPAddressClosureImpl.java,Java,,24,8,27,59
/jdk1.7.0_80/com/sun/corba/se/impl/ior/iiop/IIOPAddressImpl.java,Java,,38,13,27,78
/jdk1.7.0_80/com/sun/corba/se/impl/ior/iiop/IIOPProfileImpl.java,Java,,230,66,55,351
/jdk1.7.0_80/com/sun/corba/se/impl/ior/iiop/IIOPProfileTemplateImpl.java,Java,,102,33,37,172
/jdk1.7.0_80/com/sun/corba/se/impl/ior/iiop/JavaCodebaseComponentImpl.java,Java,,43,16,27,86
/jdk1.7.0_80/com/sun/corba/se/impl/ior/iiop/JavaSerializationComponent.java,Java,,42,13,33,88
/jdk1.7.0_80/com/sun/corba/se/impl/ior/iiop/MaxStreamFormatVersionComponentImpl.java,Java,,51,19,28,98
/jdk1.7.0_80/com/sun/corba/se/impl/ior/iiop/ORBTypeComponentImpl.java,Java,,41,15,27,83
/jdk1.7.0_80/com/sun/corba/se/impl/ior/iiop/RequestPartitioningComponentImpl.java,Java,,56,17,26,99
/jdk1.7.0_80/com/sun/corba/se/impl/ior/IORImpl.java,Java,,204,65,69,338
/jdk1.7.0_80/com/sun/corba/se/impl/ior/IORTemplateImpl.java,Java,,81,25,32,138
/jdk1.7.0_80/com/sun/corba/se/impl/ior/IORTemplateListImpl.java,Java,,84,17,28,129
/jdk1.7.0_80/com/sun/corba/se/impl/ior/JIDLObjectKeyTemplate.java,Java,,37,14,32,83
/jdk1.7.0_80/com/sun/corba/se/impl/ior/NewObjectKeyTemplateBase.java,Java,,37,12,25,74
/jdk1.7.0_80/com/sun/corba/se/impl/ior/ObjectAdapterIdArray.java,Java,,28,8,26,62
/jdk1.7.0_80/com/sun/corba/se/impl/ior/ObjectAdapterIdBase.java,Java,,57,17,24,98
/jdk1.7.0_80/com/sun/corba/se/impl/ior/ObjectAdapterIdNumber.java,Java,,15,5,30,50
/jdk1.7.0_80/com/sun/corba/se/impl/ior/ObjectIdImpl.java,Java,,35,10,27,72
/jdk1.7.0_80/com/sun/corba/se/impl/ior/ObjectKeyFactoryImpl.java,Java,,120,36,84,240
/jdk1.7.0_80/com/sun/corba/se/impl/ior/ObjectKeyImpl.java,Java,,55,18,27,100
/jdk1.7.0_80/com/sun/corba/se/impl/ior/ObjectKeyTemplateBase.java,Java,,128,38,31,197
/jdk1.7.0_80/com/sun/corba/se/impl/ior/ObjectReferenceFactoryImpl.java,Java,,75,25,42,142
/jdk1.7.0_80/com/sun/corba/se/impl/ior/ObjectReferenceProducerBase.java,Java,,26,12,24,62
/jdk1.7.0_80/com/sun/corba/se/impl/ior/ObjectReferenceTemplateImpl.java,Java,,95,28,42,165
/jdk1.7.0_80/com/sun/corba/se/impl/ior/OldJIDLObjectKeyTemplate.java,Java,,52,20,47,119
/jdk1.7.0_80/com/sun/corba/se/impl/ior/OldObjectKeyTemplateBase.java,Java,,21,7,28,56
/jdk1.7.0_80/com/sun/corba/se/impl/ior/OldPOAObjectKeyTemplate.java,Java,,49,12,32,93
/jdk1.7.0_80/com/sun/corba/se/impl/ior/POAObjectKeyTemplate.java,Java,,43,16,32,91
/jdk1.7.0_80/com/sun/corba/se/impl/ior/StubIORImpl.java,Java,,172,37,58,267
/jdk1.7.0_80/com/sun/corba/se/impl/ior/TaggedComponentFactoryFinderImpl.java,Java,,34,11,28,73
/jdk1.7.0_80/com/sun/corba/se/impl/ior/TaggedProfileFactoryFinderImpl.java,Java,,17,7,27,51
/jdk1.7.0_80/com/sun/corba/se/impl/ior/TaggedProfileTemplateFactoryFinderImpl.java,Java,,18,8,27,53
/jdk1.7.0_80/com/sun/corba/se/impl/ior/WireObjectKeyTemplate.java,Java,,91,27,37,155
/jdk1.7.0_80/com/sun/corba/se/impl/javax/rmi/CORBA/StubDelegateImpl.java,Java,,92,31,83,206
/jdk1.7.0_80/com/sun/corba/se/impl/javax/rmi/CORBA/Util.java,Java,,468,81,227,776
/jdk1.7.0_80/com/sun/corba/se/impl/javax/rmi/PortableRemoteObject.java,Java,,181,54,127,362
/jdk1.7.0_80/com/sun/corba/se/impl/legacy/connection/DefaultSocketFactory.java,Java,,88,16,26,130
/jdk1.7.0_80/com/sun/corba/se/impl/legacy/connection/EndPointInfoImpl.java,Java,,76,16,25,117
/jdk1.7.0_80/com/sun/corba/se/impl/legacy/connection/LegacyServerSocketManagerImpl.java,Java,,121,21,44,186
/jdk1.7.0_80/com/sun/corba/se/impl/legacy/connection/SocketFactoryAcceptorImpl.java,Java,,46,12,36,94
/jdk1.7.0_80/com/sun/corba/se/impl/legacy/connection/SocketFactoryConnectionImpl.java,Java,,72,13,35,120
/jdk1.7.0_80/com/sun/corba/se/impl/legacy/connection/SocketFactoryContactInfoImpl.java,Java,,56,16,40,112
/jdk1.7.0_80/com/sun/corba/se/impl/legacy/connection/SocketFactoryContactInfoListImpl.java,Java,,23,8,33,64
/jdk1.7.0_80/com/sun/corba/se/impl/legacy/connection/SocketFactoryContactInfoListIteratorImpl.java,Java,,66,15,36,117
/jdk1.7.0_80/com/sun/corba/se/impl/legacy/connection/USLPort.java,Java,,14,5,25,44
/jdk1.7.0_80/com/sun/corba/se/impl/logging/ActivationSystemException.java,Java,,186,66,13,265
/jdk1.7.0_80/com/sun/corba/se/impl/logging/InterceptorsSystemException.java,Java,,702,238,25,965
/jdk1.7.0_80/com/sun/corba/se/impl/logging/IORSystemException.java,Java,,360,123,16,499
/jdk1.7.0_80/com/sun/corba/se/impl/logging/NamingSystemException.java,Java,,523,179,16,718
/jdk1.7.0_80/com/sun/corba/se/impl/logging/OMGSystemException.java,Java,,2814,951,64,3829
/jdk1.7.0_80/com/sun/corba/se/impl/logging/ORBUtilSystemException.java,Java,,6787,2227,49,9063
/jdk1.7.0_80/com/sun/corba/se/impl/logging/POASystemException.java,Java,,1539,521,34,2094
/jdk1.7.0_80/com/sun/corba/se/impl/logging/UtilSystemException.java,Java,,686,224,25,935
/jdk1.7.0_80/com/sun/corba/se/impl/monitoring/MonitoredAttributeInfoFactoryImpl.java,Java,,14,3,24,41
/jdk1.7.0_80/com/sun/corba/se/impl/monitoring/MonitoredAttributeInfoImpl.java,Java,,27,8,24,59
/jdk1.7.0_80/com/sun/corba/se/impl/monitoring/MonitoredObjectFactoryImpl.java,Java,,10,4,24,38
/jdk1.7.0_80/com/sun/corba/se/impl/monitoring/MonitoredObjectImpl.java,Java,,91,22,33,146
/jdk1.7.0_80/com/sun/corba/se/impl/monitoring/MonitoringManagerFactoryImpl.java,Java,,21,6,24,51
/jdk1.7.0_80/com/sun/corba/se/impl/monitoring/MonitoringManagerImpl.java,Java,,26,7,24,57
/jdk1.7.0_80/com/sun/corba/se/impl/naming/cosnaming/BindingIteratorImpl.java,Java,,57,18,110,185
/jdk1.7.0_80/com/sun/corba/se/impl/naming/cosnaming/InternalBindingKey.java,Java,,52,7,42,101
/jdk1.7.0_80/com/sun/corba/se/impl/naming/cosnaming/InternalBindingValue.java,Java,,15,5,31,51
/jdk1.7.0_80/com/sun/corba/se/impl/naming/cosnaming/InterOperableNamingImpl.java,Java,,297,21,95,413
/jdk1.7.0_80/com/sun/corba/se/impl/naming/cosnaming/NamingContextDataStore.java,Java,,25,11,79,115
/jdk1.7.0_80/com/sun/corba/se/impl/naming/cosnaming/NamingContextImpl.java,Java,,502,66,460,1028
/jdk1.7.0_80/com/sun/corba/se/impl/naming/cosnaming/NamingUtils.java,Java,,52,15,65,132
/jdk1.7.0_80/com/sun/corba/se/impl/naming/cosnaming/TransientBindingIterator.java,Java,,57,10,67,134
/jdk1.7.0_80/com/sun/corba/se/impl/naming/cosnaming/TransientNameServer.java,Java,,132,32,72,236
/jdk1.7.0_80/com/sun/corba/se/impl/naming/cosnaming/TransientNameService.java,Java,,68,19,71,158
/jdk1.7.0_80/com/sun/corba/se/impl/naming/cosnaming/TransientNamingContext.java,Java,,178,29,150,357
/jdk1.7.0_80/com/sun/corba/se/impl/naming/namingutil/CorbalocURL.java,Java,,140,18,130,288
/jdk1.7.0_80/com/sun/corba/se/impl/naming/namingutil/CorbanameURL.java,Java,,55,10,56,121
/jdk1.7.0_80/com/sun/corba/se/impl/naming/namingutil/IIOPEndpointInfo.java,Java,,41,13,38,92
/jdk1.7.0_80/com/sun/corba/se/impl/naming/namingutil/INSURL.java,Java,,9,7,35,51
/jdk1.7.0_80/com/sun/corba/se/impl/naming/namingutil/INSURLBase.java,Java,,32,10,34,76
/jdk1.7.0_80/com/sun/corba/se/impl/naming/namingutil/INSURLHandler.java,Java,,25,9,31,65
/jdk1.7.0_80/com/sun/corba/se/impl/naming/namingutil/NamingConstants.java,Java,,7,5,29,41
/jdk1.7.0_80/com/sun/corba/se/impl/naming/namingutil/Utility.java,Java,,48,12,43,103
/jdk1.7.0_80/com/sun/corba/se/impl/naming/pcosnaming/InternalBindingKey.java,Java,,79,12,44,135
/jdk1.7.0_80/com/sun/corba/se/impl/naming/pcosnaming/InternalBindingValue.java,Java,,25,8,36,69
/jdk1.7.0_80/com/sun/corba/se/impl/naming/pcosnaming/NameServer.java,Java,,48,17,38,103
/jdk1.7.0_80/com/sun/corba/se/impl/naming/pcosnaming/NameService.java,Java,,129,24,81,234
/jdk1.7.0_80/com/sun/corba/se/impl/naming/pcosnaming/NamingContextImpl.java,Java,,632,118,556,1306
/jdk1.7.0_80/com/sun/corba/se/impl/naming/pcosnaming/PersistentBindingIterator.java,Java,,66,12,64,142
/jdk1.7.0_80/com/sun/corba/se/impl/naming/pcosnaming/ServantManagerImpl.java,Java,,180,49,32,261
/jdk1.7.0_80/com/sun/corba/se/impl/oa/NullServantImpl.java,Java,,15,6,24,45
/jdk1.7.0_80/com/sun/corba/se/impl/oa/poa/ActiveObjectMap.java,Java,,187,43,35,265
/jdk1.7.0_80/com/sun/corba/se/impl/oa/poa/AOMEntry.java,Java,,169,36,42,247
/jdk1.7.0_80/com/sun/corba/se/impl/oa/poa/BadServerIdHandler.java,Java,,6,3,31,40
/jdk1.7.0_80/com/sun/corba/se/impl/oa/poa/DelegateImpl.java,Java,,101,19,27,147
/jdk1.7.0_80/com/sun/corba/se/impl/oa/poa/IdAssignmentPolicyImpl.java,Java,,30,10,24,64
/jdk1.7.0_80/com/sun/corba/se/impl/oa/poa/IdUniquenessPolicyImpl.java,Java,,29,10,24,63
/jdk1.7.0_80/com/sun/corba/se/impl/oa/poa/ImplicitActivationPolicyImpl.java,Java,,31,10,24,65
/jdk1.7.0_80/com/sun/corba/se/impl/oa/poa/LifespanPolicyImpl.java,Java,,29,10,24,63
/jdk1.7.0_80/com/sun/corba/se/impl/oa/poa/POACurrent.java,Java,,115,25,42,182
/jdk1.7.0_80/com/sun/corba/se/impl/oa/poa/POAFactory.java,Java,,169,43,36,248
/jdk1.7.0_80/com/sun/corba/se/impl/oa/poa/POAImpl.java,Java,,1055,261,376,1692
/jdk1.7.0_80/com/sun/corba/se/impl/oa/poa/POAManagerImpl.java,Java,,364,80,103,547
/jdk1.7.0_80/com/sun/corba/se/impl/oa/poa/POAPolicyMediator.java,Java,,30,19,76,125
/jdk1.7.0_80/com/sun/corba/se/impl/oa/poa/POAPolicyMediatorBase.java,Java,,92,25,32,149
/jdk1.7.0_80/com/sun/corba/se/impl/oa/poa/POAPolicyMediatorBase_R.java,Java,,131,39,32,202
/jdk1.7.0_80/com/sun/corba/se/impl/oa/poa/POAPolicyMediatorFactory.java,Java,,23,2,27,52
/jdk1.7.0_80/com/sun/corba/se/impl/oa/poa/POAPolicyMediatorImpl_NR_UDS.java,Java,,81,23,31,135
/jdk1.7.0_80/com/sun/corba/se/impl/oa/poa/POAPolicyMediatorImpl_NR_USM.java,Java,,109,28,31,168
/jdk1.7.0_80/com/sun/corba/se/impl/oa/poa/POAPolicyMediatorImpl_R_AOM.java,Java,,60,14,34,108
/jdk1.7.0_80/com/sun/corba/se/impl/oa/poa/POAPolicyMediatorImpl_R_UDS.java,Java,,69,19,30,118
/jdk1.7.0_80/com/sun/corba/se/impl/oa/poa/POAPolicyMediatorImpl_R_USM.java,Java,,260,53,67,380
/jdk1.7.0_80/com/sun/corba/se/impl/oa/poa/Policies.java,Java,,243,43,66,352
/jdk1.7.0_80/com/sun/corba/se/impl/oa/poa/RequestProcessingPolicyImpl.java,Java,,40,11,24,75
/jdk1.7.0_80/com/sun/corba/se/impl/oa/poa/ServantRetentionPolicyImpl.java,Java,,29,10,24,63
/jdk1.7.0_80/com/sun/corba/se/impl/oa/poa/ThreadPolicyImpl.java,Java,,29,10,24,63
/jdk1.7.0_80/com/sun/corba/se/impl/oa/toa/TOA.java,Java,,6,4,35,45
/jdk1.7.0_80/com/sun/corba/se/impl/oa/toa/TOAFactory.java,Java,,63,21,29,113
/jdk1.7.0_80/com/sun/corba/se/impl/oa/toa/TOAImpl.java,Java,,126,32,70,228
/jdk1.7.0_80/com/sun/corba/se/impl/oa/toa/TransientObjectManager.java,Java,,132,36,37,205
/jdk1.7.0_80/com/sun/corba/se/impl/orb/AppletDataCollector.java,Java,,23,9,26,58
/jdk1.7.0_80/com/sun/corba/se/impl/orb/DataCollectorBase.java,Java,,306,81,86,473
/jdk1.7.0_80/com/sun/corba/se/impl/orb/DataCollectorFactory.java,Java,,32,10,24,66
/jdk1.7.0_80/com/sun/corba/se/impl/orb/NormalDataCollector.java,Java,,26,9,24,59
/jdk1.7.0_80/com/sun/corba/se/impl/orb/NormalParserAction.java,Java,,18,5,28,51
/jdk1.7.0_80/com/sun/corba/se/impl/orb/NormalParserData.java,Java,,22,6,24,52
/jdk1.7.0_80/com/sun/corba/se/impl/orb/ORBConfiguratorImpl.java,Java,,441,89,98,628
/jdk1.7.0_80/com/sun/corba/se/impl/orb/ORBDataParserImpl.java,Java,,298,56,64,418
/jdk1.7.0_80/com/sun/corba/se/impl/orb/ORBImpl.java,Java,,1350,280,498,2128
/jdk1.7.0_80/com/sun/corba/se/impl/orb/ORBSingleton.java,Java,,557,142,74,773
/jdk1.7.0_80/com/sun/corba/se/impl/orb/ORBVersionImpl.java,Java,,51,19,28,98
/jdk1.7.0_80/com/sun/corba/se/impl/orb/ParserAction.java,Java,,8,6,34,48
/jdk1.7.0_80/com/sun/corba/se/impl/orb/ParserActionBase.java,Java,,51,15,24,90
/jdk1.7.0_80/com/sun/corba/se/impl/orb/ParserActionFactory.java,Java,,15,5,24,44
/jdk1.7.0_80/com/sun/corba/se/impl/orb/ParserDataBase.java,Java,,25,5,24,54
/jdk1.7.0_80/com/sun/corba/se/impl/orb/ParserTable.java,Java,,845,114,120,1079
/jdk1.7.0_80/com/sun/corba/se/impl/orb/PrefixParserAction.java,Java,,72,15,35,122
/jdk1.7.0_80/com/sun/corba/se/impl/orb/PrefixParserData.java,Java,,32,10,24,66
/jdk1.7.0_80/com/sun/corba/se/impl/orb/PropertyOnlyDataCollector.java,Java,,22,9,24,55
/jdk1.7.0_80/com/sun/corba/se/impl/orbutil/CacheTable.java,Java,,124,6,33,163
/jdk1.7.0_80/com/sun/corba/se/impl/orbutil/closure/Constant.java,Java,,13,5,24,42
/jdk1.7.0_80/com/sun/corba/se/impl/orbutil/closure/Future.java,Java,,21,6,24,51
/jdk1.7.0_80/com/sun/corba/se/impl/orbutil/concurrent/CondVar.java,Java,,112,29,200,341
/jdk1.7.0_80/com/sun/corba/se/impl/orbutil/concurrent/DebugMutex.java,Java,,68,12,132,212
/jdk1.7.0_80/com/sun/corba/se/impl/orbutil/concurrent/Mutex.java,Java,,54,10,129,193
/jdk1.7.0_80/com/sun/corba/se/impl/orbutil/concurrent/ReentrantMutex.java,Java,,180,33,137,350
/jdk1.7.0_80/com/sun/corba/se/impl/orbutil/concurrent/Sync.java,Java,,13,20,330,363
/jdk1.7.0_80/com/sun/corba/se/impl/orbutil/concurrent/SyncUtil.java,Java,,17,4,28,49
/jdk1.7.0_80/com/sun/corba/se/impl/orbutil/CorbaResourceUtil.java,Java,,57,14,24,95
/jdk1.7.0_80/com/sun/corba/se/impl/orbutil/DenseIntMapImpl.java,Java,,34,9,35,78
/jdk1.7.0_80/com/sun/corba/se/impl/orbutil/fsm/GuardedAction.java,Java,,38,8,24,70
/jdk1.7.0_80/com/sun/corba/se/impl/orbutil/fsm/NameBase.java,Java,,43,9,25,77
/jdk1.7.0_80/com/sun/corba/se/impl/orbutil/fsm/StateEngineImpl.java,Java,,221,54,53,328
/jdk1.7.0_80/com/sun/corba/se/impl/orbutil/GetPropertyAction.java,Java,,16,6,66,88
/jdk1.7.0_80/com/sun/corba/se/impl/orbutil/graph/Graph.java,Java,,7,4,24,35
/jdk1.7.0_80/com/sun/corba/se/impl/orbutil/graph/GraphImpl.java,Java,,112,29,46,187
/jdk1.7.0_80/com/sun/corba/se/impl/orbutil/graph/Node.java,Java,,6,3,28,37
/jdk1.7.0_80/com/sun/corba/se/impl/orbutil/graph/NodeData.java,Java,,31,8,31,70
/jdk1.7.0_80/com/sun/corba/se/impl/orbutil/HexOutputStream.java,Java,,30,9,41,80
/jdk1.7.0_80/com/sun/corba/se/impl/orbutil/LegacyHookGetFields.java,Java,,73,24,60,157
/jdk1.7.0_80/com/sun/corba/se/impl/orbutil/LegacyHookPutFields.java,Java,,37,13,61,111
/jdk1.7.0_80/com/sun/corba/se/impl/orbutil/LogKeywords.java,Java,,48,8,41,97
/jdk1.7.0_80/com/sun/corba/se/impl/orbutil/ObjectStreamClassUtil_1_3.java,Java,,366,71,121,558
/jdk1.7.0_80/com/sun/corba/se/impl/orbutil/ObjectStreamClass_1_3_1.java,Java,,698,159,405,1262
/jdk1.7.0_80/com/sun/corba/se/impl/orbutil/ObjectStreamField.java,Java,,139,34,97,270
/jdk1.7.0_80/com/sun/corba/se/impl/orbutil/ObjectUtility.java,Java,,46,12,29,87
/jdk1.7.0_80/com/sun/corba/se/impl/orbutil/ObjectWriter.java,Java,,145,36,35,216
/jdk1.7.0_80/com/sun/corba/se/impl/orbutil/ORBConstants.java,Java,,196,95,180,471
/jdk1.7.0_80/com/sun/corba/se/impl/orbutil/ORBUtility.java,Java,,550,94,191,835
/jdk1.7.0_80/com/sun/corba/se/impl/orbutil/RepIdDelegator.java,Java,,108,33,36,177
/jdk1.7.0_80/com/sun/corba/se/impl/orbutil/RepositoryIdFactory.java,Java,,16,6,30,52
/jdk1.7.0_80/com/sun/corba/se/impl/orbutil/RepositoryIdInterface.java,Java,,14,6,28,48
/jdk1.7.0_80/com/sun/corba/se/impl/orbutil/RepositoryIdStrings.java,Java,,16,9,28,53
/jdk1.7.0_80/com/sun/corba/se/impl/orbutil/RepositoryIdUtility.java,Java,,20,6,33,59
/jdk1.7.0_80/com/sun/corba/se/impl/orbutil/StackImpl.java,Java,,35,9,35,79
/jdk1.7.0_80/com/sun/corba/se/impl/orbutil/threadpool/ThreadPoolImpl.java,Java,,331,81,135,547
/jdk1.7.0_80/com/sun/corba/se/impl/orbutil/threadpool/ThreadPoolManagerImpl.java,Java,,104,35,98,237
/jdk1.7.0_80/com/sun/corba/se/impl/orbutil/threadpool/TimeoutException.java,Java,,4,3,25,32
/jdk1.7.0_80/com/sun/corba/se/impl/orbutil/threadpool/WorkQueueImpl.java,Java,,122,36,41,199
/jdk1.7.0_80/com/sun/corba/se/impl/presentation/rmi/DynamicAccessPermission.java,Java,,12,6,44,62
/jdk1.7.0_80/com/sun/corba/se/impl/presentation/rmi/DynamicMethodMarshallerImpl.java,Java,,361,67,37,465
/jdk1.7.0_80/com/sun/corba/se/impl/presentation/rmi/DynamicStubImpl.java,Java,,106,27,27,160
/jdk1.7.0_80/com/sun/corba/se/impl/presentation/rmi/ExceptionHandler.java,Java,,10,6,41,57
/jdk1.7.0_80/com/sun/corba/se/impl/presentation/rmi/ExceptionHandlerImpl.java,Java,,192,49,54,295
/jdk1.7.0_80/com/sun/corba/se/impl/presentation/rmi/IDLNameTranslatorImpl.java,Java,,490,168,250,908
/jdk1.7.0_80/com/sun/corba/se/impl/presentation/rmi/IDLType.java,Java,,56,21,47,124
/jdk1.7.0_80/com/sun/corba/se/impl/presentation/rmi/IDLTypeException.java,Java,,7,5,28,40
/jdk1.7.0_80/com/sun/corba/se/impl/presentation/rmi/IDLTypesUtil.java,Java,,390,93,115,598
/jdk1.7.0_80/com/sun/corba/se/impl/presentation/rmi/InvocationHandlerFactoryImpl.java,Java,,90,25,53,168
/jdk1.7.0_80/com/sun/corba/se/impl/presentation/rmi/JNDIStateFactoryImpl.java,Java,,72,25,73,170
/jdk1.7.0_80/com/sun/corba/se/impl/presentation/rmi/PresentationManagerImpl.java,Java,,225,59,41,325
/jdk1.7.0_80/com/sun/corba/se/impl/presentation/rmi/ReflectiveTie.java,Java,,117,29,30,176
/jdk1.7.0_80/com/sun/corba/se/impl/presentation/rmi/StubConnectImpl.java,Java,,58,20,38,116
/jdk1.7.0_80/com/sun/corba/se/impl/presentation/rmi/StubFactoryBase.java,Java,,30,10,24,64
/jdk1.7.0_80/com/sun/corba/se/impl/presentation/rmi/StubFactoryDynamicBase.java,Java,,38,9,26,73
/jdk1.7.0_80/com/sun/corba/se/impl/presentation/rmi/StubFactoryFactoryBase.java,Java,,11,4,29,44
/jdk1.7.0_80/com/sun/corba/se/impl/presentation/rmi/StubFactoryFactoryDynamicBase.java,Java,,58,18,25,101
/jdk1.7.0_80/com/sun/corba/se/impl/presentation/rmi/StubFactoryFactoryProxyImpl.java,Java,,19,4,24,47
/jdk1.7.0_80/com/sun/corba/se/impl/presentation/rmi/StubFactoryFactoryStaticImpl.java,Java,,87,23,39,149
/jdk1.7.0_80/com/sun/corba/se/impl/presentation/rmi/StubFactoryProxyImpl.java,Java,,25,6,26,57
/jdk1.7.0_80/com/sun/corba/se/impl/presentation/rmi/StubFactoryStaticImpl.java,Java,,24,6,24,54
/jdk1.7.0_80/com/sun/corba/se/impl/presentation/rmi/StubInvocationHandlerImpl.java,Java,,141,32,40,213
/jdk1.7.0_80/com/sun/corba/se/impl/protocol/AddressingDispositionException.java,Java,,11,6,39,56
/jdk1.7.0_80/com/sun/corba/se/impl/protocol/BootstrapServerRequestDispatcher.java,Java,,73,21,55,149
/jdk1.7.0_80/com/sun/corba/se/impl/protocol/CorbaClientDelegateImpl.java,Java,,295,64,84,443
/jdk1.7.0_80/com/sun/corba/se/impl/protocol/CorbaClientRequestDispatcherImpl.java,Java,,671,172,210,1053
/jdk1.7.0_80/com/sun/corba/se/impl/protocol/CorbaInvocationInfo.java,Java,,68,21,29,118
/jdk1.7.0_80/com/sun/corba/se/impl/protocol/CorbaMessageMediatorImpl.java,Java,,1652,310,408,2370
/jdk1.7.0_80/com/sun/corba/se/impl/protocol/CorbaServerRequestDispatcherImpl.java,Java,,578,129,178,885
/jdk1.7.0_80/com/sun/corba/se/impl/protocol/FullServantCacheLocalCRDImpl.java,Java,,39,15,27,81
/jdk1.7.0_80/com/sun/corba/se/impl/protocol/giopmsgheaders/AddressingDispositionHelper.java,Java,,40,11,30,81
/jdk1.7.0_80/com/sun/corba/se/impl/protocol/giopmsgheaders/CancelRequestMessage.java,Java,,5,3,29,37
/jdk1.7.0_80/com/sun/corba/se/impl/protocol/giopmsgheaders/CancelRequestMessage_1_0.java,Java,,28,15,33,76
/jdk1.7.0_80/com/sun/corba/se/impl/protocol/giopmsgheaders/CancelRequestMessage_1_1.java,Java,,28,15,33,76
/jdk1.7.0_80/com/sun/corba/se/impl/protocol/giopmsgheaders/CancelRequestMessage_1_2.java,Java,,28,15,33,76
/jdk1.7.0_80/com/sun/corba/se/impl/protocol/giopmsgheaders/FragmentMessage.java,Java,,5,3,29,37
/jdk1.7.0_80/com/sun/corba/se/impl/protocol/giopmsgheaders/FragmentMessage_1_1.java,Java,,29,13,37,79
/jdk1.7.0_80/com/sun/corba/se/impl/protocol/giopmsgheaders/FragmentMessage_1_2.java,Java,,55,16,37,108
/jdk1.7.0_80/com/sun/corba/se/impl/protocol/giopmsgheaders/IORAddressingInfo.java,Java,,14,7,30,51
/jdk1.7.0_80/com/sun/corba/se/impl/protocol/giopmsgheaders/IORAddressingInfoHelper.java,Java,,66,11,30,107
/jdk1.7.0_80/com/sun/corba/se/impl/protocol/giopmsgheaders/KeyAddr.java,Java,,5,4,30,39
/jdk1.7.0_80/com/sun/corba/se/impl/protocol/giopmsgheaders/LocateReplyMessage.java,Java,,11,5,29,45
/jdk1.7.0_80/com/sun/corba/se/impl/protocol/giopmsgheaders/LocateReplyMessage_1_0.java,Java,,76,27,37,140
/jdk1.7.0_80/com/sun/corba/se/impl/protocol/giopmsgheaders/LocateReplyMessage_1_1.java,Java,,77,26,37,140
/jdk1.7.0_80/com/sun/corba/se/impl/protocol/giopmsgheaders/LocateReplyMessage_1_2.java,Java,,114,33,47,194
/jdk1.7.0_80/com/sun/corba/se/impl/protocol/giopmsgheaders/LocateReplyOrReplyMessage.java,Java,,10,5,25,40
/jdk1.7.0_80/com/sun/corba/se/impl/protocol/giopmsgheaders/LocateRequestMessage.java,Java,,6,4,29,39
/jdk1.7.0_80/com/sun/corba/se/impl/protocol/giopmsgheaders/LocateRequestMessage_1_0.java,Java,,48,18,34,100
/jdk1.7.0_80/com/sun/corba/se/impl/protocol/giopmsgheaders/LocateRequestMessage_1_1.java,Java,,49,19,34,102
/jdk1.7.0_80/com/sun/corba/se/impl/protocol/giopmsgheaders/LocateRequestMessage_1_2.java,Java,,46,18,34,98
/jdk1.7.0_80/com/sun/corba/se/impl/protocol/giopmsgheaders/Message.java,Java,,42,20,35,97
/jdk1.7.0_80/com/sun/corba/se/impl/protocol/giopmsgheaders/MessageBase.java,Java,,703,108,156,967
/jdk1.7.0_80/com/sun/corba/se/impl/protocol/giopmsgheaders/MessageHandler.java,Java,,21,9,42,72
/jdk1.7.0_80/com/sun/corba/se/impl/protocol/giopmsgheaders/Message_1_0.java,Java,,71,24,48,143
/jdk1.7.0_80/com/sun/corba/se/impl/protocol/giopmsgheaders/Message_1_1.java,Java,,96,32,68,196
/jdk1.7.0_80/com/sun/corba/se/impl/protocol/giopmsgheaders/Message_1_2.java,Java,,42,10,29,81
/jdk1.7.0_80/com/sun/corba/se/impl/protocol/giopmsgheaders/ProfileAddr.java,Java,,5,4,30,39
/jdk1.7.0_80/com/sun/corba/se/impl/protocol/giopmsgheaders/ReferenceAddr.java,Java,,5,4,30,39
/jdk1.7.0_80/com/sun/corba/se/impl/protocol/giopmsgheaders/ReplyMessage.java,Java,,15,6,31,52
/jdk1.7.0_80/com/sun/corba/se/impl/protocol/giopmsgheaders/ReplyMessage_1_0.java,Java,,130,32,39,201
/jdk1.7.0_80/com/sun/corba/se/impl/protocol/giopmsgheaders/ReplyMessage_1_1.java,Java,,131,31,39,201
/jdk1.7.0_80/com/sun/corba/se/impl/protocol/giopmsgheaders/ReplyMessage_1_2.java,Java,,141,37,54,232
/jdk1.7.0_80/com/sun/corba/se/impl/protocol/giopmsgheaders/RequestMessage.java,Java,,15,9,30,54
/jdk1.7.0_80/com/sun/corba/se/impl/protocol/giopmsgheaders/RequestMessage_1_0.java,Java,,97,26,38,161
/jdk1.7.0_80/com/sun/corba/se/impl/protocol/giopmsgheaders/RequestMessage_1_1.java,Java,,118,23,34,175
/jdk1.7.0_80/com/sun/corba/se/impl/protocol/giopmsgheaders/RequestMessage_1_2.java,Java,,116,28,56,200
/jdk1.7.0_80/com/sun/corba/se/impl/protocol/giopmsgheaders/TargetAddress.java,Java,,77,17,30,124
/jdk1.7.0_80/com/sun/corba/se/impl/protocol/giopmsgheaders/TargetAddressHelper.java,Java,,108,14,33,155
/jdk1.7.0_80/com/sun/corba/se/impl/protocol/InfoOnlyServantCacheLocalCRDImpl.java,Java,,29,12,27,68
/jdk1.7.0_80/com/sun/corba/se/impl/protocol/INSServerRequestDispatcher.java,Java,,40,11,48,99
/jdk1.7.0_80/com/sun/corba/se/impl/protocol/JIDLLocalCRDImpl.java,Java,,41,16,33,90
/jdk1.7.0_80/com/sun/corba/se/impl/protocol/LocalClientRequestDispatcherBase.java,Java,,66,21,53,140
/jdk1.7.0_80/com/sun/corba/se/impl/protocol/MinimalServantCacheLocalCRDImpl.java,Java,,27,10,24,61
/jdk1.7.0_80/com/sun/corba/se/impl/protocol/NotLocalLocalCRDImpl.java,Java,,25,9,33,67
/jdk1.7.0_80/com/sun/corba/se/impl/protocol/POALocalCRDImpl.java,Java,,91,24,48,163
/jdk1.7.0_80/com/sun/corba/se/impl/protocol/RequestCanceledException.java,Java,,10,5,27,42
/jdk1.7.0_80/com/sun/corba/se/impl/protocol/RequestDispatcherRegistryImpl.java,Java,,111,29,43,183
/jdk1.7.0_80/com/sun/corba/se/impl/protocol/ServantCacheLocalCRDBase.java,Java,,49,18,29,96
/jdk1.7.0_80/com/sun/corba/se/impl/protocol/SharedCDRClientRequestDispatcherImpl.java,Java,,151,27,59,237
/jdk1.7.0_80/com/sun/corba/se/impl/protocol/SpecialMethod.java,Java,,119,24,25,168
/jdk1.7.0_80/com/sun/corba/se/impl/resolver/BootstrapResolverImpl.java,Java,,85,31,49,165
/jdk1.7.0_80/com/sun/corba/se/impl/resolver/CompositeResolverImpl.java,Java,,27,7,24,58
/jdk1.7.0_80/com/sun/corba/se/impl/resolver/FileResolverImpl.java,Java,,65,16,29,110
/jdk1.7.0_80/com/sun/corba/se/impl/resolver/INSURLOperationImpl.java,Java,,211,36,82,329
/jdk1.7.0_80/com/sun/corba/se/impl/resolver/LocalResolverImpl.java,Java,,21,7,24,52
/jdk1.7.0_80/com/sun/corba/se/impl/resolver/ORBDefaultInitRefResolverImpl.java,Java,,29,10,30,69
/jdk1.7.0_80/com/sun/corba/se/impl/resolver/ORBInitRefResolverImpl.java,Java,,31,10,24,65
/jdk1.7.0_80/com/sun/corba/se/impl/resolver/SplitLocalResolverImpl.java,Java,,27,8,24,59
/jdk1.7.0_80/com/sun/corba/se/impl/transport/ByteBufferPoolImpl.java,Java,,93,25,89,207
/jdk1.7.0_80/com/sun/corba/se/impl/transport/CorbaConnectionCacheBase.java,Java,,166,36,66,268
/jdk1.7.0_80/com/sun/corba/se/impl/transport/CorbaContactInfoBase.java,Java,,189,43,60,292
/jdk1.7.0_80/com/sun/corba/se/impl/transport/CorbaContactInfoListImpl.java,Java,,139,30,71,240
/jdk1.7.0_80/com/sun/corba/se/impl/transport/CorbaContactInfoListIteratorImpl.java,Java,,147,37,75,259
/jdk1.7.0_80/com/sun/corba/se/impl/transport/CorbaInboundConnectionCacheImpl.java,Java,,133,25,44,202
/jdk1.7.0_80/com/sun/corba/se/impl/transport/CorbaOutboundConnectionCacheImpl.java,Java,,143,24,43,210
/jdk1.7.0_80/com/sun/corba/se/impl/transport/CorbaResponseWaitingRoomImpl.java,Java,,211,53,73,337
/jdk1.7.0_80/com/sun/corba/se/impl/transport/CorbaTransportManagerImpl.java,Java,,178,27,49,254
/jdk1.7.0_80/com/sun/corba/se/impl/transport/DefaultIORToSocketInfoImpl.java,Java,,47,10,30,87
/jdk1.7.0_80/com/sun/corba/se/impl/transport/DefaultSocketFactoryImpl.java,Java,,78,18,27,123
/jdk1.7.0_80/com/sun/corba/se/impl/transport/EventHandlerBase.java,Java,,95,19,36,150
/jdk1.7.0_80/com/sun/corba/se/impl/transport/ListenerThreadImpl.java,Java,,85,24,38,147
/jdk1.7.0_80/com/sun/corba/se/impl/transport/ReaderThreadImpl.java,Java,,90,24,39,153
/jdk1.7.0_80/com/sun/corba/se/impl/transport/ReadTCPTimeoutsImpl.java,Java,,23,6,29,58
/jdk1.7.0_80/com/sun/corba/se/impl/transport/SelectorImpl.java,Java,,429,50,68,547
/jdk1.7.0_80/com/sun/corba/se/impl/transport/SharedCDRContactInfoImpl.java,Java,,110,25,52,187
/jdk1.7.0_80/com/sun/corba/se/impl/transport/SocketOrChannelAcceptorImpl.java,Java,,451,81,120,652
/jdk1.7.0_80/com/sun/corba/se/impl/transport/SocketOrChannelConnectionImpl.java,Java,,1112,214,354,1680
/jdk1.7.0_80/com/sun/corba/se/impl/transport/SocketOrChannelContactInfoImpl.java,Java,,134,30,53,217
/jdk1.7.0_80/com/sun/corba/se/impl/util/IdentityHashtable.java,Java,,162,33,188,383
/jdk1.7.0_80/com/sun/corba/se/impl/util/IdentityHashtableEnumerator.java,Java,,37,7,34,78
/jdk1.7.0_80/com/sun/corba/se/impl/util/JDKBridge.java,Java,,91,19,87,197
/jdk1.7.0_80/com/sun/corba/se/impl/util/JDKClassLoader.java,Java,,86,25,81,192
/jdk1.7.0_80/com/sun/corba/se/impl/util/ORBProperties.java,Java,,29,11,32,72
/jdk1.7.0_80/com/sun/corba/se/impl/util/PackagePrefixChecker.java,Java,,35,12,29,76
/jdk1.7.0_80/com/sun/corba/se/impl/util/RepositoryId.java,Java,,677,175,141,993
/jdk1.7.0_80/com/sun/corba/se/impl/util/RepositoryIdCache.java,Java,,41,16,51,108
/jdk1.7.0_80/com/sun/corba/se/impl/util/SUNVMCID.java,Java,,4,4,33,41
/jdk1.7.0_80/com/sun/corba/se/impl/util/Utility.java,Java,,643,118,241,1002
/jdk1.7.0_80/com/sun/corba/se/impl/util/Version.java,Java,,16,5,30,51
/jdk1.7.0_80/com/sun/corba/se/internal/corba/ORBSingleton.java,Java,,8,3,29,40
/jdk1.7.0_80/com/sun/corba/se/internal/CosNaming/BootstrapServer.java,Java,,59,21,53,133
/jdk1.7.0_80/com/sun/corba/se/internal/iiop/ORB.java,Java,,9,2,27,38
/jdk1.7.0_80/com/sun/corba/se/internal/Interceptors/PIORB.java,Java,,9,3,28,40
/jdk1.7.0_80/com/sun/corba/se/internal/POA/POAORB.java,Java,,8,2,27,37
/jdk1.7.0_80/com/sun/corba/se/org/omg/CORBA/ORB.java,Java,,11,3,43,57
/jdk1.7.0_80/com/sun/corba/se/pept/broker/Broker.java,Java,,10,5,28,43
/jdk1.7.0_80/com/sun/corba/se/pept/encoding/InputObject.java,Java,,9,7,47,63
/jdk1.7.0_80/com/sun/corba/se/pept/encoding/OutputObject.java,Java,,9,7,49,65
/jdk1.7.0_80/com/sun/corba/se/pept/protocol/ClientDelegate.java,Java,,8,5,46,59
/jdk1.7.0_80/com/sun/corba/se/pept/protocol/ClientInvocationInfo.java,Java,,18,14,28,60
/jdk1.7.0_80/com/sun/corba/se/pept/protocol/ClientRequestDispatcher.java,Java,,20,6,79,105
/jdk1.7.0_80/com/sun/corba/se/pept/protocol/MessageMediator.java,Java,,21,14,95,130
/jdk1.7.0_80/com/sun/corba/se/pept/protocol/ProtocolHandler.java,Java,,6,4,43,53
/jdk1.7.0_80/com/sun/corba/se/pept/protocol/ServerRequestDispatcher.java,Java,,6,4,38,48
/jdk1.7.0_80/com/sun/corba/se/pept/transport/Acceptor.java,Java,,28,21,163,212
/jdk1.7.0_80/com/sun/corba/se/pept/transport/ByteBufferPool.java,Java,,8,4,28,40
/jdk1.7.0_80/com/sun/corba/se/pept/transport/Connection.java,Java,,29,26,172,227
/jdk1.7.0_80/com/sun/corba/se/pept/transport/ConnectionCache.java,Java,,11,9,32,52
/jdk1.7.0_80/com/sun/corba/se/pept/transport/ContactInfo.java,Java,,33,18,180,231
/jdk1.7.0_80/com/sun/corba/se/pept/transport/ContactInfoList.java,Java,,6,4,42,52
/jdk1.7.0_80/com/sun/corba/se/pept/transport/ContactInfoListIterator.java,Java,,12,7,64,83
/jdk1.7.0_80/com/sun/corba/se/pept/transport/EventHandler.java,Java,,20,13,34,67
/jdk1.7.0_80/com/sun/corba/se/pept/transport/InboundConnectionCache.java,Java,,8,5,28,41
/jdk1.7.0_80/com/sun/corba/se/pept/transport/ListenerThread.java,Java,,6,3,28,37
/jdk1.7.0_80/com/sun/corba/se/pept/transport/OutboundConnectionCache.java,Java,,8,5,28,41
/jdk1.7.0_80/com/sun/corba/se/pept/transport/ReaderThread.java,Java,,5,3,28,36
/jdk1.7.0_80/com/sun/corba/se/pept/transport/ResponseWaitingRoom.java,Java,,11,8,29,48
/jdk1.7.0_80/com/sun/corba/se/pept/transport/Selector.java,Java,,10,3,28,41
/jdk1.7.0_80/com/sun/corba/se/pept/transport/TransportManager.java,Java,,20,14,28,62
/jdk1.7.0_80/com/sun/corba/se/PortableActivationIDL/Activator.java,Java,,4,3,6,13
/jdk1.7.0_80/com/sun/corba/se/PortableActivationIDL/ActivatorHelper.java,Java,,67,12,6,85
/jdk1.7.0_80/com/sun/corba/se/PortableActivationIDL/ActivatorHolder.java,Java,,24,8,6,38
/jdk1.7.0_80/com/sun/corba/se/PortableActivationIDL/ActivatorOperations.java,Java,,16,15,42,73
/jdk1.7.0_80/com/sun/corba/se/PortableActivationIDL/BadServerDefinition.java,Java,,19,8,6,33
/jdk1.7.0_80/com/sun/corba/se/PortableActivationIDL/BadServerDefinitionHelper.java,Java,,61,10,8,79
/jdk1.7.0_80/com/sun/corba/se/PortableActivationIDL/BadServerDefinitionHolder.java,Java,,24,8,6,38
/jdk1.7.0_80/com/sun/corba/se/PortableActivationIDL/EndPointInfo.java,Java,,14,6,6,26
/jdk1.7.0_80/com/sun/corba/se/PortableActivationIDL/EndPointInfoHelper.java,Java,,67,10,6,83
/jdk1.7.0_80/com/sun/corba/se/PortableActivationIDL/EndPointInfoHolder.java,Java,,24,8,6,38
/jdk1.7.0_80/com/sun/corba/se/PortableActivationIDL/EndpointInfoListHelper.java,Java,,46,11,8,65
/jdk1.7.0_80/com/sun/corba/se/PortableActivationIDL/EndpointInfoListHolder.java,Java,,24,10,8,42
/jdk1.7.0_80/com/sun/corba/se/PortableActivationIDL/IIOP_CLEAR_TEXT.java,Java,,5,4,11,20
/jdk1.7.0_80/com/sun/corba/se/PortableActivationIDL/InitialNameService.java,Java,,4,4,9,17
/jdk1.7.0_80/com/sun/corba/se/PortableActivationIDL/InitialNameServiceHelper.java,Java,,67,13,9,89
/jdk1.7.0_80/com/sun/corba/se/PortableActivationIDL/InitialNameServiceHolder.java,Java,,24,9,9,42
/jdk1.7.0_80/com/sun/corba/se/PortableActivationIDL/InitialNameServiceOperations.java,Java,,5,5,11,21
/jdk1.7.0_80/com/sun/corba/se/PortableActivationIDL/InitialNameServicePackage/NameAlreadyBound.java,Java,,12,7,6,25
/jdk1.7.0_80/com/sun/corba/se/PortableActivationIDL/InitialNameServicePackage/NameAlreadyBoundHelper.java,Java,,54,10,8,72
/jdk1.7.0_80/com/sun/corba/se/PortableActivationIDL/InitialNameServicePackage/NameAlreadyBoundHolder.java,Java,,24,8,6,38
/jdk1.7.0_80/com/sun/corba/se/PortableActivationIDL/InvalidORBid.java,Java,,12,7,6,25
/jdk1.7.0_80/com/sun/corba/se/PortableActivationIDL/InvalidORBidHelper.java,Java,,54,10,8,72
/jdk1.7.0_80/com/sun/corba/se/PortableActivationIDL/InvalidORBidHolder.java,Java,,24,8,6,38
/jdk1.7.0_80/com/sun/corba/se/PortableActivationIDL/Locator.java,Java,,4,3,6,13
/jdk1.7.0_80/com/sun/corba/se/PortableActivationIDL/LocatorHelper.java,Java,,67,12,6,85
/jdk1.7.0_80/com/sun/corba/se/PortableActivationIDL/LocatorHolder.java,Java,,24,8,6,38
/jdk1.7.0_80/com/sun/corba/se/PortableActivationIDL/LocatorOperations.java,Java,,8,7,19,34
/jdk1.7.0_80/com/sun/corba/se/PortableActivationIDL/LocatorPackage/ServerLocationPerORB.java,Java,,14,6,6,26
/jdk1.7.0_80/com/sun/corba/se/PortableActivationIDL/LocatorPackage/ServerLocationPerORBHelper.java,Java,,68,10,6,84
/jdk1.7.0_80/com/sun/corba/se/PortableActivationIDL/LocatorPackage/ServerLocationPerORBHolder.java,Java,,24,8,6,38
/jdk1.7.0_80/com/sun/corba/se/PortableActivationIDL/LocatorPackage/ServerLocationPerType.java,Java,,14,6,6,26
/jdk1.7.0_80/com/sun/corba/se/PortableActivationIDL/LocatorPackage/ServerLocationPerTypeHelper.java,Java,,68,10,6,84
/jdk1.7.0_80/com/sun/corba/se/PortableActivationIDL/LocatorPackage/ServerLocationPerTypeHolder.java,Java,,24,8,6,38
/jdk1.7.0_80/com/sun/corba/se/PortableActivationIDL/NoSuchEndPoint.java,Java,,12,7,6,25
/jdk1.7.0_80/com/sun/corba/se/PortableActivationIDL/NoSuchEndPointHelper.java,Java,,54,10,8,72
/jdk1.7.0_80/com/sun/corba/se/PortableActivationIDL/NoSuchEndPointHolder.java,Java,,24,8,6,38
/jdk1.7.0_80/com/sun/corba/se/PortableActivationIDL/ORBAlreadyRegistered.java,Java,,19,8,6,33
/jdk1.7.0_80/com/sun/corba/se/PortableActivationIDL/ORBAlreadyRegisteredHelper.java,Java,,62,10,8,80
/jdk1.7.0_80/com/sun/corba/se/PortableActivationIDL/ORBAlreadyRegisteredHolder.java,Java,,24,8,6,38
/jdk1.7.0_80/com/sun/corba/se/PortableActivationIDL/ORBidListHelper.java,Java,,47,11,8,66
/jdk1.7.0_80/com/sun/corba/se/PortableActivationIDL/ORBidListHolder.java,Java,,24,10,8,42
/jdk1.7.0_80/com/sun/corba/se/PortableActivationIDL/ORBPortInfo.java,Java,,14,6,6,26
/jdk1.7.0_80/com/sun/corba/se/PortableActivationIDL/ORBPortInfoHelper.java,Java,,68,10,6,84
/jdk1.7.0_80/com/sun/corba/se/PortableActivationIDL/ORBPortInfoHolder.java,Java,,24,8,6,38
/jdk1.7.0_80/com/sun/corba/se/PortableActivationIDL/ORBPortInfoListHelper.java,Java,,46,11,8,65
/jdk1.7.0_80/com/sun/corba/se/PortableActivationIDL/ORBPortInfoListHolder.java,Java,,24,10,8,42
/jdk1.7.0_80/com/sun/corba/se/PortableActivationIDL/ORBProxy.java,Java,,4,4,8,16
/jdk1.7.0_80/com/sun/corba/se/PortableActivationIDL/ORBProxyHelper.java,Java,,67,13,8,88
/jdk1.7.0_80/com/sun/corba/se/PortableActivationIDL/ORBProxyHolder.java,Java,,24,9,8,41
/jdk1.7.0_80/com/sun/corba/se/PortableActivationIDL/ORBProxyOperations.java,Java,,5,5,14,24
/jdk1.7.0_80/com/sun/corba/se/PortableActivationIDL/Repository.java,Java,,4,3,6,13
/jdk1.7.0_80/com/sun/corba/se/PortableActivationIDL/RepositoryHelper.java,Java,,67,12,6,85
/jdk1.7.0_80/com/sun/corba/se/PortableActivationIDL/RepositoryHolder.java,Java,,24,8,6,38
/jdk1.7.0_80/com/sun/corba/se/PortableActivationIDL/RepositoryOperations.java,Java,,13,12,29,54
/jdk1.7.0_80/com/sun/corba/se/PortableActivationIDL/RepositoryPackage/AppNamesHelper.java,Java,,46,11,8,65
/jdk1.7.0_80/com/sun/corba/se/PortableActivationIDL/RepositoryPackage/AppNamesHolder.java,Java,,24,10,8,42
/jdk1.7.0_80/com/sun/corba/se/PortableActivationIDL/RepositoryPackage/ServerDef.java,Java,,22,11,11,44
/jdk1.7.0_80/com/sun/corba/se/PortableActivationIDL/RepositoryPackage/ServerDefHelper.java,Java,,94,10,6,110
/jdk1.7.0_80/com/sun/corba/se/PortableActivationIDL/RepositoryPackage/ServerDefHolder.java,Java,,24,8,6,38
/jdk1.7.0_80/com/sun/corba/se/PortableActivationIDL/ServerAlreadyActive.java,Java,,19,8,6,33
/jdk1.7.0_80/com/sun/corba/se/PortableActivationIDL/ServerAlreadyActiveHelper.java,Java,,62,10,8,80
/jdk1.7.0_80/com/sun/corba/se/PortableActivationIDL/ServerAlreadyActiveHolder.java,Java,,24,8,6,38
/jdk1.7.0_80/com/sun/corba/se/PortableActivationIDL/ServerAlreadyInstalled.java,Java,,19,8,6,33
/jdk1.7.0_80/com/sun/corba/se/PortableActivationIDL/ServerAlreadyInstalledHelper.java,Java,,62,10,8,80
/jdk1.7.0_80/com/sun/corba/se/PortableActivationIDL/ServerAlreadyInstalledHolder.java,Java,,24,8,6,38
/jdk1.7.0_80/com/sun/corba/se/PortableActivationIDL/ServerAlreadyRegistered.java,Java,,19,8,6,33
/jdk1.7.0_80/com/sun/corba/se/PortableActivationIDL/ServerAlreadyRegisteredHelper.java,Java,,62,10,8,80
/jdk1.7.0_80/com/sun/corba/se/PortableActivationIDL/ServerAlreadyRegisteredHolder.java,Java,,24,8,6,38
/jdk1.7.0_80/com/sun/corba/se/PortableActivationIDL/ServerAlreadyUninstalled.java,Java,,19,8,6,33
/jdk1.7.0_80/com/sun/corba/se/PortableActivationIDL/ServerAlreadyUninstalledHelper.java,Java,,62,10,8,80
/jdk1.7.0_80/com/sun/corba/se/PortableActivationIDL/ServerAlreadyUninstalledHolder.java,Java,,24,8,6,38
/jdk1.7.0_80/com/sun/corba/se/PortableActivationIDL/ServerHeldDown.java,Java,,19,8,6,33
/jdk1.7.0_80/com/sun/corba/se/PortableActivationIDL/ServerHeldDownHelper.java,Java,,62,10,8,80
/jdk1.7.0_80/com/sun/corba/se/PortableActivationIDL/ServerHeldDownHolder.java,Java,,24,8,6,38
/jdk1.7.0_80/com/sun/corba/se/PortableActivationIDL/ServerIdsHelper.java,Java,,47,11,8,66
/jdk1.7.0_80/com/sun/corba/se/PortableActivationIDL/ServerIdsHolder.java,Java,,24,10,8,42
/jdk1.7.0_80/com/sun/corba/se/PortableActivationIDL/ServerManager.java,Java,,4,4,10,18
/jdk1.7.0_80/com/sun/corba/se/PortableActivationIDL/ServerManagerHelper.java,Java,,67,13,10,90
/jdk1.7.0_80/com/sun/corba/se/PortableActivationIDL/ServerManagerHolder.java,Java,,24,9,10,43
/jdk1.7.0_80/com/sun/corba/se/PortableActivationIDL/ServerManagerOperations.java,Java,,4,4,10,18
/jdk1.7.0_80/com/sun/corba/se/PortableActivationIDL/ServerNotActive.java,Java,,19,8,6,33
/jdk1.7.0_80/com/sun/corba/se/PortableActivationIDL/ServerNotActiveHelper.java,Java,,62,10,8,80
/jdk1.7.0_80/com/sun/corba/se/PortableActivationIDL/ServerNotActiveHolder.java,Java,,24,8,6,38
/jdk1.7.0_80/com/sun/corba/se/PortableActivationIDL/ServerNotRegistered.java,Java,,19,8,6,33
/jdk1.7.0_80/com/sun/corba/se/PortableActivationIDL/ServerNotRegisteredHelper.java,Java,,62,10,8,80
/jdk1.7.0_80/com/sun/corba/se/PortableActivationIDL/ServerNotRegisteredHolder.java,Java,,24,8,6,38
/jdk1.7.0_80/com/sun/corba/se/PortableActivationIDL/ServerProxy.java,Java,,4,4,8,16
/jdk1.7.0_80/com/sun/corba/se/PortableActivationIDL/ServerProxyHelper.java,Java,,67,13,8,88
/jdk1.7.0_80/com/sun/corba/se/PortableActivationIDL/ServerProxyHolder.java,Java,,24,9,8,41
/jdk1.7.0_80/com/sun/corba/se/PortableActivationIDL/ServerProxyOperations.java,Java,,7,7,16,30
/jdk1.7.0_80/com/sun/corba/se/PortableActivationIDL/TCPPortHelper.java,Java,,40,11,11,62
/jdk1.7.0_80/com/sun/corba/se/PortableActivationIDL/_ActivatorImplBase.java,Java,,208,36,44,288
/jdk1.7.0_80/com/sun/corba/se/PortableActivationIDL/_ActivatorStub.java,Java,,294,31,43,368
/jdk1.7.0_80/com/sun/corba/se/PortableActivationIDL/_InitialNameServiceImplBase.java,Java,,48,15,13,76
/jdk1.7.0_80/com/sun/corba/se/PortableActivationIDL/_InitialNameServiceStub.java,Java,,49,10,12,71
/jdk1.7.0_80/com/sun/corba/se/PortableActivationIDL/_LocatorImplBase.java,Java,,108,20,21,149
/jdk1.7.0_80/com/sun/corba/se/PortableActivationIDL/_LocatorStub.java,Java,,125,15,20,160
/jdk1.7.0_80/com/sun/corba/se/PortableActivationIDL/_ORBProxyImplBase.java,Java,,43,15,16,74
/jdk1.7.0_80/com/sun/corba/se/PortableActivationIDL/_ORBProxyStub.java,Java,,45,10,15,70
/jdk1.7.0_80/com/sun/corba/se/PortableActivationIDL/_RepositoryImplBase.java,Java,,159,30,31,220
/jdk1.7.0_80/com/sun/corba/se/PortableActivationIDL/_RepositoryStub.java,Java,,219,25,30,274
/jdk1.7.0_80/com/sun/corba/se/PortableActivationIDL/_ServerManagerImplBase.java,Java,,285,45,61,391
/jdk1.7.0_80/com/sun/corba/se/PortableActivationIDL/_ServerManagerStub.java,Java,,395,40,60,495
/jdk1.7.0_80/com/sun/corba/se/PortableActivationIDL/_ServerProxyImplBase.java,Java,,54,19,18,91
/jdk1.7.0_80/com/sun/corba/se/PortableActivationIDL/_ServerProxyStub.java,Java,,77,14,17,108
/jdk1.7.0_80/com/sun/corba/se/spi/activation/Activator.java,Java,,4,3,6,13
/jdk1.7.0_80/com/sun/corba/se/spi/activation/ActivatorHelper.java,Java,,67,12,6,85
/jdk1.7.0_80/com/sun/corba/se/spi/activation/ActivatorHolder.java,Java,,24,8,6,38
/jdk1.7.0_80/com/sun/corba/se/spi/activation/ActivatorOperations.java,Java,,12,11,14,37
/jdk1.7.0_80/com/sun/corba/se/spi/activation/BadServerDefinition.java,Java,,19,8,6,33
/jdk1.7.0_80/com/sun/corba/se/spi/activation/BadServerDefinitionHelper.java,Java,,61,10,8,79
/jdk1.7.0_80/com/sun/corba/se/spi/activation/BadServerDefinitionHolder.java,Java,,24,8,6,38
/jdk1.7.0_80/com/sun/corba/se/spi/activation/EndPointInfo.java,Java,,14,6,6,26
/jdk1.7.0_80/com/sun/corba/se/spi/activation/EndPointInfoHelper.java,Java,,67,10,6,83
/jdk1.7.0_80/com/sun/corba/se/spi/activation/EndPointInfoHolder.java,Java,,24,8,6,38
/jdk1.7.0_80/com/sun/corba/se/spi/activation/EndpointInfoListHelper.java,Java,,46,10,6,62
/jdk1.7.0_80/com/sun/corba/se/spi/activation/EndpointInfoListHolder.java,Java,,24,9,6,39
/jdk1.7.0_80/com/sun/corba/se/spi/activation/IIOP_CLEAR_TEXT.java,Java,,5,4,7,16
/jdk1.7.0_80/com/sun/corba/se/spi/activation/InitialNameService.java,Java,,4,3,6,13
/jdk1.7.0_80/com/sun/corba/se/spi/activation/InitialNameServiceHelper.java,Java,,67,12,6,85
/jdk1.7.0_80/com/sun/corba/se/spi/activation/InitialNameServiceHolder.java,Java,,24,8,6,38
/jdk1.7.0_80/com/sun/corba/se/spi/activation/InitialNameServiceOperations.java,Java,,5,4,7,16
/jdk1.7.0_80/com/sun/corba/se/spi/activation/InitialNameServicePackage/NameAlreadyBound.java,Java,,12,7,6,25
/jdk1.7.0_80/com/sun/corba/se/spi/activation/InitialNameServicePackage/NameAlreadyBoundHelper.java,Java,,54,10,8,72
/jdk1.7.0_80/com/sun/corba/se/spi/activation/InitialNameServicePackage/NameAlreadyBoundHolder.java,Java,,24,8,6,38
/jdk1.7.0_80/com/sun/corba/se/spi/activation/InvalidORBid.java,Java,,12,7,6,25
/jdk1.7.0_80/com/sun/corba/se/spi/activation/InvalidORBidHelper.java,Java,,54,10,8,72
/jdk1.7.0_80/com/sun/corba/se/spi/activation/InvalidORBidHolder.java,Java,,24,8,6,38
/jdk1.7.0_80/com/sun/corba/se/spi/activation/Locator.java,Java,,4,3,6,13
/jdk1.7.0_80/com/sun/corba/se/spi/activation/LocatorHelper.java,Java,,67,12,6,85
/jdk1.7.0_80/com/sun/corba/se/spi/activation/LocatorHolder.java,Java,,24,8,6,38
/jdk1.7.0_80/com/sun/corba/se/spi/activation/LocatorOperations.java,Java,,8,7,10,25
/jdk1.7.0_80/com/sun/corba/se/spi/activation/LocatorPackage/ServerLocation.java,Java,,14,6,6,26
/jdk1.7.0_80/com/sun/corba/se/spi/activation/LocatorPackage/ServerLocationHelper.java,Java,,68,10,6,84
/jdk1.7.0_80/com/sun/corba/se/spi/activation/LocatorPackage/ServerLocationHolder.java,Java,,24,8,6,38
/jdk1.7.0_80/com/sun/corba/se/spi/activation/LocatorPackage/ServerLocationPerORB.java,Java,,14,6,6,26
/jdk1.7.0_80/com/sun/corba/se/spi/activation/LocatorPackage/ServerLocationPerORBHelper.java,Java,,68,10,6,84
/jdk1.7.0_80/com/sun/corba/se/spi/activation/LocatorPackage/ServerLocationPerORBHolder.java,Java,,24,8,6,38
/jdk1.7.0_80/com/sun/corba/se/spi/activation/NoSuchEndPoint.java,Java,,12,7,6,25
/jdk1.7.0_80/com/sun/corba/se/spi/activation/NoSuchEndPointHelper.java,Java,,54,10,8,72
/jdk1.7.0_80/com/sun/corba/se/spi/activation/NoSuchEndPointHolder.java,Java,,24,8,6,38
/jdk1.7.0_80/com/sun/corba/se/spi/activation/ORBAlreadyRegistered.java,Java,,19,8,6,33
/jdk1.7.0_80/com/sun/corba/se/spi/activation/ORBAlreadyRegisteredHelper.java,Java,,62,10,8,80
/jdk1.7.0_80/com/sun/corba/se/spi/activation/ORBAlreadyRegisteredHolder.java,Java,,24,8,6,38
/jdk1.7.0_80/com/sun/corba/se/spi/activation/ORBidHelper.java,Java,,40,11,7,58
/jdk1.7.0_80/com/sun/corba/se/spi/activation/ORBidListHelper.java,Java,,47,10,6,63
/jdk1.7.0_80/com/sun/corba/se/spi/activation/ORBidListHolder.java,Java,,24,9,6,39
/jdk1.7.0_80/com/sun/corba/se/spi/activation/ORBPortInfo.java,Java,,14,6,6,26
/jdk1.7.0_80/com/sun/corba/se/spi/activation/ORBPortInfoHelper.java,Java,,68,10,6,84
/jdk1.7.0_80/com/sun/corba/se/spi/activation/ORBPortInfoHolder.java,Java,,24,8,6,38
/jdk1.7.0_80/com/sun/corba/se/spi/activation/ORBPortInfoListHelper.java,Java,,46,10,6,62
/jdk1.7.0_80/com/sun/corba/se/spi/activation/ORBPortInfoListHolder.java,Java,,24,9,6,39
/jdk1.7.0_80/com/sun/corba/se/spi/activation/POANameHelper.java,Java,,46,10,6,62
/jdk1.7.0_80/com/sun/corba/se/spi/activation/POANameHolder.java,Java,,24,9,6,39
/jdk1.7.0_80/com/sun/corba/se/spi/activation/Repository.java,Java,,4,3,6,13
/jdk1.7.0_80/com/sun/corba/se/spi/activation/RepositoryHelper.java,Java,,67,12,6,85
/jdk1.7.0_80/com/sun/corba/se/spi/activation/RepositoryHolder.java,Java,,24,8,6,38
/jdk1.7.0_80/com/sun/corba/se/spi/activation/RepositoryOperations.java,Java,,13,12,15,40
/jdk1.7.0_80/com/sun/corba/se/spi/activation/RepositoryPackage/ServerDef.java,Java,,20,9,9,38
/jdk1.7.0_80/com/sun/corba/se/spi/activation/RepositoryPackage/ServerDefHelper.java,Java,,87,10,6,103
/jdk1.7.0_80/com/sun/corba/se/spi/activation/RepositoryPackage/ServerDefHolder.java,Java,,24,8,6,38
/jdk1.7.0_80/com/sun/corba/se/spi/activation/RepositoryPackage/StringSeqHelper.java,Java,,46,10,6,62
/jdk1.7.0_80/com/sun/corba/se/spi/activation/RepositoryPackage/StringSeqHolder.java,Java,,24,9,6,39
/jdk1.7.0_80/com/sun/corba/se/spi/activation/Server.java,Java,,4,4,8,16
/jdk1.7.0_80/com/sun/corba/se/spi/activation/ServerAlreadyActive.java,Java,,19,8,6,33
/jdk1.7.0_80/com/sun/corba/se/spi/activation/ServerAlreadyActiveHelper.java,Java,,62,10,8,80
/jdk1.7.0_80/com/sun/corba/se/spi/activation/ServerAlreadyActiveHolder.java,Java,,24,8,6,38
/jdk1.7.0_80/com/sun/corba/se/spi/activation/ServerAlreadyInstalled.java,Java,,19,8,6,33
/jdk1.7.0_80/com/sun/corba/se/spi/activation/ServerAlreadyInstalledHelper.java,Java,,62,10,8,80
/jdk1.7.0_80/com/sun/corba/se/spi/activation/ServerAlreadyInstalledHolder.java,Java,,24,8,6,38
/jdk1.7.0_80/com/sun/corba/se/spi/activation/ServerAlreadyRegistered.java,Java,,19,8,6,33
/jdk1.7.0_80/com/sun/corba/se/spi/activation/ServerAlreadyRegisteredHelper.java,Java,,62,10,8,80
/jdk1.7.0_80/com/sun/corba/se/spi/activation/ServerAlreadyRegisteredHolder.java,Java,,24,8,6,38
/jdk1.7.0_80/com/sun/corba/se/spi/activation/ServerAlreadyUninstalled.java,Java,,19,8,6,33
/jdk1.7.0_80/com/sun/corba/se/spi/activation/ServerAlreadyUninstalledHelper.java,Java,,62,10,8,80
/jdk1.7.0_80/com/sun/corba/se/spi/activation/ServerAlreadyUninstalledHolder.java,Java,,24,8,6,38
/jdk1.7.0_80/com/sun/corba/se/spi/activation/ServerHeldDown.java,Java,,19,8,6,33
/jdk1.7.0_80/com/sun/corba/se/spi/activation/ServerHeldDownHelper.java,Java,,62,10,8,80
/jdk1.7.0_80/com/sun/corba/se/spi/activation/ServerHeldDownHolder.java,Java,,24,8,6,38
/jdk1.7.0_80/com/sun/corba/se/spi/activation/ServerHelper.java,Java,,67,13,8,88
/jdk1.7.0_80/com/sun/corba/se/spi/activation/ServerHolder.java,Java,,24,9,8,41
/jdk1.7.0_80/com/sun/corba/se/spi/activation/ServerIdHelper.java,Java,,40,10,6,56
/jdk1.7.0_80/com/sun/corba/se/spi/activation/ServerIdsHelper.java,Java,,47,10,6,63
/jdk1.7.0_80/com/sun/corba/se/spi/activation/ServerIdsHolder.java,Java,,24,9,6,39
/jdk1.7.0_80/com/sun/corba/se/spi/activation/ServerManager.java,Java,,4,3,6,13
/jdk1.7.0_80/com/sun/corba/se/spi/activation/ServerManagerHelper.java,Java,,67,12,6,85
/jdk1.7.0_80/com/sun/corba/se/spi/activation/ServerManagerHolder.java,Java,,24,8,6,38
/jdk1.7.0_80/com/sun/corba/se/spi/activation/ServerManagerOperations.java,Java,,4,3,6,13
/jdk1.7.0_80/com/sun/corba/se/spi/activation/ServerNotActive.java,Java,,19,8,6,33
/jdk1.7.0_80/com/sun/corba/se/spi/activation/ServerNotActiveHelper.java,Java,,62,10,8,80
/jdk1.7.0_80/com/sun/corba/se/spi/activation/ServerNotActiveHolder.java,Java,,24,8,6,38
/jdk1.7.0_80/com/sun/corba/se/spi/activation/ServerNotRegistered.java,Java,,19,8,6,33
/jdk1.7.0_80/com/sun/corba/se/spi/activation/ServerNotRegisteredHelper.java,Java,,62,10,8,80
/jdk1.7.0_80/com/sun/corba/se/spi/activation/ServerNotRegisteredHolder.java,Java,,24,8,6,38
/jdk1.7.0_80/com/sun/corba/se/spi/activation/ServerOperations.java,Java,,7,7,16,30
/jdk1.7.0_80/com/sun/corba/se/spi/activation/TCPPortHelper.java,Java,,40,10,6,56
/jdk1.7.0_80/com/sun/corba/se/spi/activation/_ActivatorImplBase.java,Java,,165,28,16,209
/jdk1.7.0_80/com/sun/corba/se/spi/activation/_ActivatorStub.java,Java,,213,23,15,251
/jdk1.7.0_80/com/sun/corba/se/spi/activation/_InitialNameServiceImplBase.java,Java,,48,14,9,71
/jdk1.7.0_80/com/sun/corba/se/spi/activation/_InitialNameServiceStub.java,Java,,49,9,8,66
/jdk1.7.0_80/com/sun/corba/se/spi/activation/_LocatorImplBase.java,Java,,108,20,12,140
/jdk1.7.0_80/com/sun/corba/se/spi/activation/_LocatorStub.java,Java,,125,15,11,151
/jdk1.7.0_80/com/sun/corba/se/spi/activation/_RepositoryImplBase.java,Java,,159,30,17,206
/jdk1.7.0_80/com/sun/corba/se/spi/activation/_RepositoryStub.java,Java,,219,25,16,260
/jdk1.7.0_80/com/sun/corba/se/spi/activation/_ServerImplBase.java,Java,,54,19,18,91
/jdk1.7.0_80/com/sun/corba/se/spi/activation/_ServerManagerImplBase.java,Java,,242,36,20,298
/jdk1.7.0_80/com/sun/corba/se/spi/activation/_ServerManagerStub.java,Java,,314,31,19,364
/jdk1.7.0_80/com/sun/corba/se/spi/activation/_ServerStub.java,Java,,77,14,17,108
/jdk1.7.0_80/com/sun/corba/se/spi/copyobject/CopierManager.java,Java,,9,6,37,52
/jdk1.7.0_80/com/sun/corba/se/spi/copyobject/CopyobjectDefaults.java,Java,,52,10,38,100
/jdk1.7.0_80/com/sun/corba/se/spi/copyobject/ObjectCopier.java,Java,,4,2,32,38
/jdk1.7.0_80/com/sun/corba/se/spi/copyobject/ObjectCopierFactory.java,Java,,5,3,28,36
/jdk1.7.0_80/com/sun/corba/se/spi/copyobject/ReflectiveCopyException.java,Java,,15,3,24,42
/jdk1.7.0_80/com/sun/corba/se/spi/encoding/CorbaInputObject.java,Java,,8,3,24,35
/jdk1.7.0_80/com/sun/corba/se/spi/encoding/CorbaOutputObject.java,Java,,22,7,24,53
/jdk1.7.0_80/com/sun/corba/se/spi/extension/CopyObjectPolicy.java,Java,,31,9,27,67
/jdk1.7.0_80/com/sun/corba/se/spi/extension/RequestPartitioningPolicy.java,Java,,45,11,28,84
/jdk1.7.0_80/com/sun/corba/se/spi/extension/ServantCachingPolicy.java,Java,,73,22,66,161
/jdk1.7.0_80/com/sun/corba/se/spi/extension/ZeroPortPolicy.java,Java,,36,11,27,74
/jdk1.7.0_80/com/sun/corba/se/spi/ior/EncapsulationFactoryBase.java,Java,,20,8,24,52
/jdk1.7.0_80/com/sun/corba/se/spi/ior/Identifiable.java,Java,,5,4,33,42
/jdk1.7.0_80/com/sun/corba/se/spi/ior/IdentifiableBase.java,Java,,14,5,34,53
/jdk1.7.0_80/com/sun/corba/se/spi/ior/IdentifiableContainerBase.java,Java,,44,11,36,91
/jdk1.7.0_80/com/sun/corba/se/spi/ior/IdentifiableFactory.java,Java,,7,5,32,44
/jdk1.7.0_80/com/sun/corba/se/spi/ior/IdentifiableFactoryFinder.java,Java,,7,4,38,49
/jdk1.7.0_80/com/sun/corba/se/spi/ior/iiop/AlternateIIOPAddressComponent.java,Java,,7,3,27,37
/jdk1.7.0_80/com/sun/corba/se/spi/ior/iiop/CodeSetsComponent.java,Java,,7,4,27,38
/jdk1.7.0_80/com/sun/corba/se/spi/ior/iiop/GIOPVersion.java,Java,,134,43,42,219
/jdk1.7.0_80/com/sun/corba/se/spi/ior/iiop/IIOPAddress.java,Java,,7,4,27,38
/jdk1.7.0_80/com/sun/corba/se/spi/ior/iiop/IIOPFactories.java,Java,,182,30,29,241
/jdk1.7.0_80/com/sun/corba/se/spi/ior/iiop/IIOPProfile.java,Java,,12,8,40,60
/jdk1.7.0_80/com/sun/corba/se/spi/ior/iiop/IIOPProfileTemplate.java,Java,,12,7,34,53
/jdk1.7.0_80/com/sun/corba/se/spi/ior/iiop/JavaCodebaseComponent.java,Java,,6,3,27,36
/jdk1.7.0_80/com/sun/corba/se/spi/ior/iiop/MaxStreamFormatVersionComponent.java,Java,,6,2,26,34
/jdk1.7.0_80/com/sun/corba/se/spi/ior/iiop/ORBTypeComponent.java,Java,,6,3,27,36
/jdk1.7.0_80/com/sun/corba/se/spi/ior/iiop/RequestPartitioningComponent.java,Java,,6,2,24,32
/jdk1.7.0_80/com/sun/corba/se/spi/ior/IOR.java,Java,,19,14,53,86
/jdk1.7.0_80/com/sun/corba/se/spi/ior/IORFactories.java,Java,,114,31,58,203
/jdk1.7.0_80/com/sun/corba/se/spi/ior/IORFactory.java,Java,,6,4,35,45
/jdk1.7.0_80/com/sun/corba/se/spi/ior/IORTemplate.java,Java,,7,4,30,41
/jdk1.7.0_80/com/sun/corba/se/spi/ior/IORTemplateList.java,Java,,4,3,30,37
/jdk1.7.0_80/com/sun/corba/se/spi/ior/MakeImmutable.java,Java,,4,2,24,30
/jdk1.7.0_80/com/sun/corba/se/spi/ior/ObjectAdapterId.java,Java,,7,5,35,47
/jdk1.7.0_80/com/sun/corba/se/spi/ior/ObjectId.java,Java,,5,2,27,34
/jdk1.7.0_80/com/sun/corba/se/spi/ior/ObjectKey.java,Java,,10,7,35,52
/jdk1.7.0_80/com/sun/corba/se/spi/ior/ObjectKeyFactory.java,Java,,9,5,32,46
/jdk1.7.0_80/com/sun/corba/se/spi/ior/ObjectKeyTemplate.java,Java,,16,12,46,74
/jdk1.7.0_80/com/sun/corba/se/spi/ior/TaggedComponent.java,Java,,7,3,30,40
/jdk1.7.0_80/com/sun/corba/se/spi/ior/TaggedComponentBase.java,Java,,17,6,28,51
/jdk1.7.0_80/com/sun/corba/se/spi/ior/TaggedComponentFactoryFinder.java,Java,,6,2,27,35
/jdk1.7.0_80/com/sun/corba/se/spi/ior/TaggedProfile.java,Java,,12,9,45,66
/jdk1.7.0_80/com/sun/corba/se/spi/ior/TaggedProfileTemplate.java,Java,,19,10,49,78
/jdk1.7.0_80/com/sun/corba/se/spi/ior/TaggedProfileTemplateBase.java,Java,,32,10,24,66
/jdk1.7.0_80/com/sun/corba/se/spi/ior/Writeable.java,Java,,6,3,29,38
/jdk1.7.0_80/com/sun/corba/se/spi/ior/WriteContents.java,Java,,5,3,24,32
/jdk1.7.0_80/com/sun/corba/se/spi/legacy/connection/Connection.java,Java,,5,3,27,35
/jdk1.7.0_80/com/sun/corba/se/spi/legacy/connection/GetEndPointInfoAgainException.java,Java,,15,6,31,52
/jdk1.7.0_80/com/sun/corba/se/spi/legacy/connection/LegacyServerSocketEndPointInfo.java,Java,,13,10,42,65
/jdk1.7.0_80/com/sun/corba/se/spi/legacy/connection/LegacyServerSocketManager.java,Java,,12,7,28,47
/jdk1.7.0_80/com/sun/corba/se/spi/legacy/connection/ORBSocketFactory.java,Java,,20,13,325,358
/jdk1.7.0_80/com/sun/corba/se/spi/legacy/interceptor/IORInfoExt.java,Java,,9,5,25,39
/jdk1.7.0_80/com/sun/corba/se/spi/legacy/interceptor/ORBInitInfoExt.java,Java,,6,3,32,41
/jdk1.7.0_80/com/sun/corba/se/spi/legacy/interceptor/RequestInfoExt.java,Java,,6,4,35,45
/jdk1.7.0_80/com/sun/corba/se/spi/legacy/interceptor/UnknownType.java,Java,,14,3,24,41
/jdk1.7.0_80/com/sun/corba/se/spi/logging/CORBALogDomains.java,Java,,29,27,105,161
/jdk1.7.0_80/com/sun/corba/se/spi/logging/LogWrapperBase.java,Java,,49,12,31,92
/jdk1.7.0_80/com/sun/corba/se/spi/logging/LogWrapperFactory.java,Java,,6,4,24,34
/jdk1.7.0_80/com/sun/corba/se/spi/monitoring/LongMonitoredAttributeBase.java,Java,,12,7,51,70
/jdk1.7.0_80/com/sun/corba/se/spi/monitoring/MonitoredAttribute.java,Java,,10,7,96,113
/jdk1.7.0_80/com/sun/corba/se/spi/monitoring/MonitoredAttributeBase.java,Java,,34,12,69,115
/jdk1.7.0_80/com/sun/corba/se/spi/monitoring/MonitoredAttributeInfo.java,Java,,8,5,74,87
/jdk1.7.0_80/com/sun/corba/se/spi/monitoring/MonitoredAttributeInfoFactory.java,Java,,5,2,40,47
/jdk1.7.0_80/com/sun/corba/se/spi/monitoring/MonitoredObject.java,Java,,19,8,164,191
/jdk1.7.0_80/com/sun/corba/se/spi/monitoring/MonitoredObjectFactory.java,Java,,4,1,38,43
/jdk1.7.0_80/com/sun/corba/se/spi/monitoring/MonitoringConstants.java,Java,,72,12,31,115
/jdk1.7.0_80/com/sun/corba/se/spi/monitoring/MonitoringFactories.java,Java,,24,7,80,111
/jdk1.7.0_80/com/sun/corba/se/spi/monitoring/MonitoringManager.java,Java,,9,5,55,69
/jdk1.7.0_80/com/sun/corba/se/spi/monitoring/MonitoringManagerFactory.java,Java,,6,2,37,45
/jdk1.7.0_80/com/sun/corba/se/spi/monitoring/StatisticMonitoredAttribute.java,Java,,31,15,84,130
/jdk1.7.0_80/com/sun/corba/se/spi/monitoring/StatisticsAccumulator.java,Java,,88,29,105,222
/jdk1.7.0_80/com/sun/corba/se/spi/monitoring/StringMonitoredAttributeBase.java,Java,,14,7,52,73
/jdk1.7.0_80/com/sun/corba/se/spi/oa/NullServant.java,Java,,6,3,36,45
/jdk1.7.0_80/com/sun/corba/se/spi/oa/OADefault.java,Java,,18,4,28,50
/jdk1.7.0_80/com/sun/corba/se/spi/oa/OADestroyed.java,Java,,3,1,27,31
/jdk1.7.0_80/com/sun/corba/se/spi/oa/OAInvocationInfo.java,Java,,51,18,41,110
/jdk1.7.0_80/com/sun/corba/se/spi/oa/ObjectAdapter.java,Java,,25,25,199,249
/jdk1.7.0_80/com/sun/corba/se/spi/oa/ObjectAdapterBase.java,Java,,129,38,36,203
/jdk1.7.0_80/com/sun/corba/se/spi/oa/ObjectAdapterFactory.java,Java,,10,8,32,50
/jdk1.7.0_80/com/sun/corba/se/spi/orb/DataCollector.java,Java,,10,5,50,65
/jdk1.7.0_80/com/sun/corba/se/spi/orb/Operation.java,Java,,4,1,29,34
/jdk1.7.0_80/com/sun/corba/se/spi/orb/OperationFactory.java,Java,,407,100,60,567
/jdk1.7.0_80/com/sun/corba/se/spi/orb/ORB.java,Java,,333,101,136,570
/jdk1.7.0_80/com/sun/corba/se/spi/orb/ORBConfigurator.java,Java,,4,1,31,36
/jdk1.7.0_80/com/sun/corba/se/spi/orb/ORBData.java,Java,,65,48,45,158
/jdk1.7.0_80/com/sun/corba/se/spi/orb/ORBVersion.java,Java,,14,6,24,44
/jdk1.7.0_80/com/sun/corba/se/spi/orb/ORBVersionFactory.java,Java,,53,14,46,113
/jdk1.7.0_80/com/sun/corba/se/spi/orb/ParserData.java,Java,,11,8,24,43
/jdk1.7.0_80/com/sun/corba/se/spi/orb/ParserDataFactory.java,Java,,19,3,24,46
/jdk1.7.0_80/com/sun/corba/se/spi/orb/ParserImplBase.java,Java,,80,20,36,136
/jdk1.7.0_80/com/sun/corba/se/spi/orb/ParserImplTableBase.java,Java,,113,25,35,173
/jdk1.7.0_80/com/sun/corba/se/spi/orb/PropertyParser.java,Java,,46,11,28,85
/jdk1.7.0_80/com/sun/corba/se/spi/orb/StringPair.java,Java,,32,9,24,65
/jdk1.7.0_80/com/sun/corba/se/spi/orbutil/closure/Closure.java,Java,,4,2,24,30
/jdk1.7.0_80/com/sun/corba/se/spi/orbutil/closure/ClosureFactory.java,Java,,14,5,24,43
/jdk1.7.0_80/com/sun/corba/se/spi/orbutil/fsm/Action.java,Java,,5,3,47,55
/jdk1.7.0_80/com/sun/corba/se/spi/orbutil/fsm/ActionBase.java,Java,,5,3,24,32
/jdk1.7.0_80/com/sun/corba/se/spi/orbutil/fsm/FSM.java,Java,,6,4,46,56
/jdk1.7.0_80/com/sun/corba/se/spi/orbutil/fsm/FSMImpl.java,Java,,44,13,57,114
/jdk1.7.0_80/com/sun/corba/se/spi/orbutil/fsm/FSMTest.java,Java,,172,31,24,227
/jdk1.7.0_80/com/sun/corba/se/spi/orbutil/fsm/Guard.java,Java,,44,12,46,102
/jdk1.7.0_80/com/sun/corba/se/spi/orbutil/fsm/GuardBase.java,Java,,5,3,24,32
/jdk1.7.0_80/com/sun/corba/se/spi/orbutil/fsm/Input.java,Java,,4,3,34,41
/jdk1.7.0_80/com/sun/corba/se/spi/orbutil/fsm/InputImpl.java,Java,,5,3,24,32
/jdk1.7.0_80/com/sun/corba/se/spi/orbutil/fsm/State.java,Java,,6,4,46,56
/jdk1.7.0_80/com/sun/corba/se/spi/orbutil/fsm/StateEngine.java,Java,,17,10,82,109
/jdk1.7.0_80/com/sun/corba/se/spi/orbutil/fsm/StateEngineFactory.java,Java,,9,4,29,42
/jdk1.7.0_80/com/sun/corba/se/spi/orbutil/fsm/StateImpl.java,Java,,54,16,28,98
/jdk1.7.0_80/com/sun/corba/se/spi/orbutil/proxy/CompositeInvocationHandler.java,Java,,9,4,29,42
/jdk1.7.0_80/com/sun/corba/se/spi/orbutil/proxy/CompositeInvocationHandlerImpl.java,Java,,53,14,27,94
/jdk1.7.0_80/com/sun/corba/se/spi/orbutil/proxy/DelegateInvocationHandlerImpl.java,Java,,31,6,28,65
/jdk1.7.0_80/com/sun/corba/se/spi/orbutil/proxy/InvocationHandlerFactory.java,Java,,7,4,29,40
/jdk1.7.0_80/com/sun/corba/se/spi/orbutil/proxy/LinkedInvocationHandler.java,Java,,8,4,28,40
/jdk1.7.0_80/com/sun/corba/se/spi/orbutil/threadpool/NoSuchThreadPoolException.java,Java,,4,3,25,32
/jdk1.7.0_80/com/sun/corba/se/spi/orbutil/threadpool/NoSuchWorkQueueException.java,Java,,4,3,25,32
/jdk1.7.0_80/com/sun/corba/se/spi/orbutil/threadpool/ThreadPool.java,Java,,17,17,84,118
/jdk1.7.0_80/com/sun/corba/se/spi/orbutil/threadpool/ThreadPoolChooser.java,Java,,7,5,41,53
/jdk1.7.0_80/com/sun/corba/se/spi/orbutil/threadpool/ThreadPoolManager.java,Java,,14,12,71,97
/jdk1.7.0_80/com/sun/corba/se/spi/orbutil/threadpool/Work.java,Java,,8,8,39,55
/jdk1.7.0_80/com/sun/corba/se/spi/orbutil/threadpool/WorkQueue.java,Java,,11,10,47,68
/jdk1.7.0_80/com/sun/corba/se/spi/presentation/rmi/DynamicMethodMarshaller.java,Java,,20,15,60,95
/jdk1.7.0_80/com/sun/corba/se/spi/presentation/rmi/DynamicStub.java,Java,,15,11,43,69
/jdk1.7.0_80/com/sun/corba/se/spi/presentation/rmi/IDLNameTranslator.java,Java,,9,6,41,56
/jdk1.7.0_80/com/sun/corba/se/spi/presentation/rmi/PresentationDefaults.java,Java,,28,10,24,62
/jdk1.7.0_80/com/sun/corba/se/spi/presentation/rmi/PresentationManager.java,Java,,38,23,109,170
/jdk1.7.0_80/com/sun/corba/se/spi/presentation/rmi/StubAdapter.java,Java,,134,25,50,209
/jdk1.7.0_80/com/sun/corba/se/spi/presentation/rmi/StubWrapper.java,Java,,108,27,27,162
/jdk1.7.0_80/com/sun/corba/se/spi/protocol/ClientDelegateFactory.java,Java,,6,4,26,36
/jdk1.7.0_80/com/sun/corba/se/spi/protocol/CorbaClientDelegate.java,Java,,6,3,25,34
/jdk1.7.0_80/com/sun/corba/se/spi/protocol/CorbaMessageMediator.java,Java,,80,24,42,146
/jdk1.7.0_80/com/sun/corba/se/spi/protocol/CorbaProtocolHandler.java,Java,,39,11,28,78
/jdk1.7.0_80/com/sun/corba/se/spi/protocol/CorbaServerRequestDispatcher.java,Java,,9,6,37,52
/jdk1.7.0_80/com/sun/corba/se/spi/protocol/ForwardException.java,Java,,38,15,31,84
/jdk1.7.0_80/com/sun/corba/se/spi/protocol/InitialServerRequestDispatcher.java,Java,,7,3,32,42
/jdk1.7.0_80/com/sun/corba/se/spi/protocol/LocalClientRequestDispatcher.java,Java,,12,8,53,73
/jdk1.7.0_80/com/sun/corba/se/spi/protocol/LocalClientRequestDispatcherFactory.java,Java,,5,3,24,32
/jdk1.7.0_80/com/sun/corba/se/spi/protocol/PIHandler.java,Java,,56,41,209,306
/jdk1.7.0_80/com/sun/corba/se/spi/protocol/RequestDispatcherDefault.java,Java,,74,16,25,115
/jdk1.7.0_80/com/sun/corba/se/spi/protocol/RequestDispatcherRegistry.java,Java,,19,16,60,95
/jdk1.7.0_80/com/sun/corba/se/spi/protocol/RetryType.java,Java,,13,6,33,52
/jdk1.7.0_80/com/sun/corba/se/spi/resolver/LocalResolver.java,Java,,5,3,30,38
/jdk1.7.0_80/com/sun/corba/se/spi/resolver/Resolver.java,Java,,5,3,36,44
/jdk1.7.0_80/com/sun/corba/se/spi/resolver/ResolverDefault.java,Java,,52,12,40,104
/jdk1.7.0_80/com/sun/corba/se/spi/servicecontext/CodeSetServiceContext.java,Java,,35,9,25,69
/jdk1.7.0_80/com/sun/corba/se/spi/servicecontext/MaxStreamFormatVersionServiceContext.java,Java,,41,13,28,82
/jdk1.7.0_80/com/sun/corba/se/spi/servicecontext/ORBVersionServiceContext.java,Java,,39,14,30,83
/jdk1.7.0_80/com/sun/corba/se/spi/servicecontext/SendingContextServiceContext.java,Java,,35,9,25,69
/jdk1.7.0_80/com/sun/corba/se/spi/servicecontext/ServiceContext.java,Java,,40,11,70,121
/jdk1.7.0_80/com/sun/corba/se/spi/servicecontext/ServiceContextData.java,Java,,109,21,31,161
/jdk1.7.0_80/com/sun/corba/se/spi/servicecontext/ServiceContextRegistry.java,Java,,49,13,35,97
/jdk1.7.0_80/com/sun/corba/se/spi/servicecontext/ServiceContexts.java,Java,,210,83,122,415
/jdk1.7.0_80/com/sun/corba/se/spi/servicecontext/UEInfoServiceContext.java,Java,,38,10,25,73
/jdk1.7.0_80/com/sun/corba/se/spi/servicecontext/UnknownServiceContext.java,Java,,37,10,24,71
/jdk1.7.0_80/com/sun/corba/se/spi/transport/CorbaAcceptor.java,Java,,14,6,29,49
/jdk1.7.0_80/com/sun/corba/se/spi/transport/CorbaConnection.java,Java,,75,39,58,172
/jdk1.7.0_80/com/sun/corba/se/spi/transport/CorbaConnectionCache.java,Java,,5,3,28,36
/jdk1.7.0_80/com/sun/corba/se/spi/transport/CorbaContactInfo.java,Java,,15,5,28,48
/jdk1.7.0_80/com/sun/corba/se/spi/transport/CorbaContactInfoList.java,Java,,15,9,28,52
/jdk1.7.0_80/com/sun/corba/se/spi/transport/CorbaContactInfoListFactory.java,Java,,8,5,37,50
/jdk1.7.0_80/com/sun/corba/se/spi/transport/CorbaContactInfoListIterator.java,Java,,11,7,26,44
/jdk1.7.0_80/com/sun/corba/se/spi/transport/CorbaResponseWaitingRoom.java,Java,,11,5,28,44
/jdk1.7.0_80/com/sun/corba/se/spi/transport/CorbaTransportManager.java,Java,,20,8,30,58
/jdk1.7.0_80/com/sun/corba/se/spi/transport/IIOPPrimaryToContactInfo.java,Java,,13,8,63,84
/jdk1.7.0_80/com/sun/corba/se/spi/transport/IORToSocketInfo.java,Java,,7,5,33,45
/jdk1.7.0_80/com/sun/corba/se/spi/transport/IORTransformer.java,Java,,8,4,28,40
/jdk1.7.0_80/com/sun/corba/se/spi/transport/ORBSocketFactory.java,Java,,22,9,28,59
/jdk1.7.0_80/com/sun/corba/se/spi/transport/ReadTimeouts.java,Java,,7,3,25,35
/jdk1.7.0_80/com/sun/corba/se/spi/transport/ReadTimeoutsFactory.java,Java,,8,3,25,36
/jdk1.7.0_80/com/sun/corba/se/spi/transport/SocketInfo.java,Java,,8,7,28,43
/jdk1.7.0_80/com/sun/corba/se/spi/transport/SocketOrChannelAcceptor.java,Java,,6,4,28,38
/jdk1.7.0_80/com/sun/corba/se/spi/transport/TransportDefault.java,Java,,57,9,29,95
/jdk1.7.0_80/com/sun/image/codec/jpeg/ImageFormatException.java,Java,,10,4,39,53
/jdk1.7.0_80/com/sun/image/codec/jpeg/JPEGCodec.java,Java,,49,13,89,151
/jdk1.7.0_80/com/sun/image/codec/jpeg/JPEGDecodeParam.java,Java,,62,45,264,371
/jdk1.7.0_80/com/sun/image/codec/jpeg/JPEGEncodeParam.java,Java,,27,20,210,257
/jdk1.7.0_80/com/sun/image/codec/jpeg/JPEGHuffmanTable.java,Java,,139,31,72,242
/jdk1.7.0_80/com/sun/image/codec/jpeg/JPEGImageDecoder.java,Java,,23,13,103,139
/jdk1.7.0_80/com/sun/image/codec/jpeg/JPEGImageEncoder.java,Java,,29,18,179,226
/jdk1.7.0_80/com/sun/image/codec/jpeg/JPEGQTable.java,Java,,62,20,69,151
/jdk1.7.0_80/com/sun/image/codec/jpeg/TruncatedFileException.java,Java,,19,8,56,83
/jdk1.7.0_80/com/sun/imageio/plugins/bmp/BMPConstants.java,Java,,21,5,27,53
/jdk1.7.0_80/com/sun/imageio/plugins/bmp/BMPImageReader.java,Java,,1383,267,171,1821
/jdk1.7.0_80/com/sun/imageio/plugins/bmp/BMPImageReaderSpi.java,Java,,58,12,24,94
/jdk1.7.0_80/com/sun/imageio/plugins/bmp/BMPImageWriter.java,Java,,1122,183,227,1532
/jdk1.7.0_80/com/sun/imageio/plugins/bmp/BMPImageWriterSpi.java,Java,,66,16,24,106
/jdk1.7.0_80/com/sun/imageio/plugins/bmp/BMPMetadata.java,Java,,221,51,35,307
/jdk1.7.0_80/com/sun/imageio/plugins/bmp/BMPMetadataFormat.java,Java,,156,22,30,208
/jdk1.7.0_80/com/sun/imageio/plugins/bmp/BMPMetadataFormatResources.java,Java,,34,10,25,69
/jdk1.7.0_80/com/sun/imageio/plugins/common/BitFile.java,Java,,73,10,40,123
/jdk1.7.0_80/com/sun/imageio/plugins/common/BogusColorSpace.java,Java,,61,23,52,136
/jdk1.7.0_80/com/sun/imageio/plugins/common/I18N.java,Java,,7,2,24,33
/jdk1.7.0_80/com/sun/imageio/plugins/common/I18NImpl.java,Java,,17,4,41,62
/jdk1.7.0_80/com/sun/imageio/plugins/common/ImageUtil.java,Java,,838,118,211,1167
/jdk1.7.0_80/com/sun/imageio/plugins/common/InputStreamAdapter.java,Java,,17,8,24,49
/jdk1.7.0_80/com/sun/imageio/plugins/common/LZWCompressor.java,Java,,73,20,53,146
/jdk1.7.0_80/com/sun/imageio/plugins/common/LZWStringTable.java,Java,,110,29,79,218
/jdk1.7.0_80/com/sun/imageio/plugins/common/PaletteBuilder.java,Java,,307,67,112,486
/jdk1.7.0_80/com/sun/imageio/plugins/common/ReaderUtil.java,Java,,98,13,105,216
/jdk1.7.0_80/com/sun/imageio/plugins/common/StandardMetadataFormat.java,Java,,363,61,75,499
/jdk1.7.0_80/com/sun/imageio/plugins/common/StandardMetadataFormatResources.java,Java,,129,55,26,210
/jdk1.7.0_80/com/sun/imageio/plugins/common/SubImageInputStream.java,Java,,42,11,26,79
/jdk1.7.0_80/com/sun/imageio/plugins/gif/GIFImageMetadata.java,Java,,313,72,61,446
/jdk1.7.0_80/com/sun/imageio/plugins/gif/GIFImageMetadataFormat.java,Java,,122,16,33,171
/jdk1.7.0_80/com/sun/imageio/plugins/gif/GIFImageMetadataFormatResources.java,Java,,70,8,26,104
/jdk1.7.0_80/com/sun/imageio/plugins/gif/GIFImageReader.java,Java,,745,158,125,1028
/jdk1.7.0_80/com/sun/imageio/plugins/gif/GIFImageReaderSpi.java,Java,,58,17,24,99
/jdk1.7.0_80/com/sun/imageio/plugins/gif/GIFImageWriter.java,Java,,924,196,197,1317
/jdk1.7.0_80/com/sun/imageio/plugins/gif/GIFImageWriterSpi.java,Java,,63,17,24,104
/jdk1.7.0_80/com/sun/imageio/plugins/gif/GIFMetadata.java,Java,,234,35,48,317
/jdk1.7.0_80/com/sun/imageio/plugins/gif/GIFStreamMetadata.java,Java,,210,56,54,320
/jdk1.7.0_80/com/sun/imageio/plugins/gif/GIFStreamMetadataFormat.java,Java,,67,11,28,106
/jdk1.7.0_80/com/sun/imageio/plugins/gif/GIFStreamMetadataFormatResources.java,Java,,37,8,26,71
/jdk1.7.0_80/com/sun/imageio/plugins/gif/GIFWritableImageMetadata.java,Java,,315,51,36,402
/jdk1.7.0_80/com/sun/imageio/plugins/gif/GIFWritableStreamMetadata.java,Java,,203,28,36,267
/jdk1.7.0_80/com/sun/imageio/plugins/jpeg/AdobeMarkerSegment.java,Java,,90,14,32,136
/jdk1.7.0_80/com/sun/imageio/plugins/jpeg/COMMarkerSegment.java,Java,,57,12,64,133
/jdk1.7.0_80/com/sun/imageio/plugins/jpeg/DHTMarkerSegment.java,Java,,177,30,53,260
/jdk1.7.0_80/com/sun/imageio/plugins/jpeg/DQTMarkerSegment.java,Java,,218,25,66,309
/jdk1.7.0_80/com/sun/imageio/plugins/jpeg/DRIMarkerSegment.java,Java,,37,11,35,83
/jdk1.7.0_80/com/sun/imageio/plugins/jpeg/JFIFMarkerSegment.java,Java,,1201,130,233,1564
/jdk1.7.0_80/com/sun/imageio/plugins/jpeg/JPEG.java,Java,,204,49,118,371
/jdk1.7.0_80/com/sun/imageio/plugins/jpeg/JPEGBuffer.java,Java,,134,19,101,254
/jdk1.7.0_80/com/sun/imageio/plugins/jpeg/JPEGImageMetadataFormat.java,Java,,302,37,27,366
/jdk1.7.0_80/com/sun/imageio/plugins/jpeg/JPEGImageMetadataFormatResources.java,Java,,106,7,30,143
/jdk1.7.0_80/com/sun/imageio/plugins/jpeg/JPEGImageReader.java,Java,,1239,209,377,1825
/jdk1.7.0_80/com/sun/imageio/plugins/jpeg/JPEGImageReaderResources.java,Java,,15,7,24,46
/jdk1.7.0_80/com/sun/imageio/plugins/jpeg/JPEGImageReaderSpi.java,Java,,53,9,26,88
/jdk1.7.0_80/com/sun/imageio/plugins/jpeg/JPEGImageWriter.java,Java,,1467,194,247,1908
/jdk1.7.0_80/com/sun/imageio/plugins/jpeg/JPEGImageWriterResources.java,Java,,51,7,24,82
/jdk1.7.0_80/com/sun/imageio/plugins/jpeg/JPEGImageWriterSpi.java,Java,,59,13,26,98
/jdk1.7.0_80/com/sun/imageio/plugins/jpeg/JPEGMetadata.java,Java,,1789,186,442,2417
/jdk1.7.0_80/com/sun/imageio/plugins/jpeg/JPEGMetadataFormat.java,Java,,105,17,35,157
/jdk1.7.0_80/com/sun/imageio/plugins/jpeg/JPEGMetadataFormatResources.java,Java,,30,5,26,61
/jdk1.7.0_80/com/sun/imageio/plugins/jpeg/JPEGStreamMetadataFormat.java,Java,,17,6,24,47
/jdk1.7.0_80/com/sun/imageio/plugins/jpeg/JPEGStreamMetadataFormatResources.java,Java,,14,5,27,46
/jdk1.7.0_80/com/sun/imageio/plugins/jpeg/MarkerSegment.java,Java,,139,20,65,224
/jdk1.7.0_80/com/sun/imageio/plugins/jpeg/SOFMarkerSegment.java,Java,,219,25,40,284
/jdk1.7.0_80/com/sun/imageio/plugins/jpeg/SOSMarkerSegment.java,Java,,179,24,38,241
/jdk1.7.0_80/com/sun/imageio/plugins/png/PNGImageReader.java,Java,,1207,226,159,1592
/jdk1.7.0_80/com/sun/imageio/plugins/png/PNGImageReaderSpi.java,Java,,63,16,24,103
/jdk1.7.0_80/com/sun/imageio/plugins/png/PNGImageWriter.java,Java,,894,179,98,1171
/jdk1.7.0_80/com/sun/imageio/plugins/png/PNGImageWriterSpi.java,Java,,76,19,31,126
/jdk1.7.0_80/com/sun/imageio/plugins/png/PNGMetadata.java,Java,,1609,243,197,2049
/jdk1.7.0_80/com/sun/imageio/plugins/png/PNGMetadataFormat.java,Java,,323,118,59,500
/jdk1.7.0_80/com/sun/imageio/plugins/png/PNGMetadataFormatResources.java,Java,,169,24,26,219
/jdk1.7.0_80/com/sun/imageio/plugins/png/RowFilter.java,Java,,132,33,27,192
/jdk1.7.0_80/com/sun/imageio/plugins/wbmp/WBMPImageReader.java,Java,,214,56,52,322
/jdk1.7.0_80/com/sun/imageio/plugins/wbmp/WBMPImageReaderSpi.java,Java,,78,18,34,130
/jdk1.7.0_80/com/sun/imageio/plugins/wbmp/WBMPImageWriter.java,Java,,222,44,49,315
/jdk1.7.0_80/com/sun/imageio/plugins/wbmp/WBMPImageWriterSpi.java,Java,,57,12,24,93
/jdk1.7.0_80/com/sun/imageio/plugins/wbmp/WBMPMetadata.java,Java,,82,27,25,134
/jdk1.7.0_80/com/sun/imageio/plugins/wbmp/WBMPMetadataFormat.java,Java,,33,12,25,70
/jdk1.7.0_80/com/sun/imageio/spi/FileImageInputStreamSpi.java,Java,,30,9,24,63
/jdk1.7.0_80/com/sun/imageio/spi/FileImageOutputStreamSpi.java,Java,,31,9,24,64
/jdk1.7.0_80/com/sun/imageio/spi/InputStreamImageInputStreamSpi.java,Java,,41,12,24,77
/jdk1.7.0_80/com/sun/imageio/spi/OutputStreamImageOutputStreamSpi.java,Java,,41,11,24,76
/jdk1.7.0_80/com/sun/imageio/spi/RAFImageInputStreamSpi.java,Java,,32,9,24,65
/jdk1.7.0_80/com/sun/imageio/spi/RAFImageOutputStreamSpi.java,Java,,33,9,24,66
/jdk1.7.0_80/com/sun/imageio/stream/CloseableDisposerRecord.java,Java,,20,5,29,54
/jdk1.7.0_80/com/sun/imageio/stream/StreamCloser.java,Java,,76,13,45,134
/jdk1.7.0_80/com/sun/imageio/stream/StreamFinalizer.java,Java,,18,5,49,72
/jdk1.7.0_80/com/sun/java/swing/Painter.java,Java,,3,1,29,33
/jdk1.7.0_80/com/sun/java/swing/plaf/gtk/GTKColorChooserPanel.java,Java,,860,148,295,1303
/jdk1.7.0_80/com/sun/java/swing/plaf/gtk/GTKColorType.java,Java,,108,14,45,167
/jdk1.7.0_80/com/sun/java/swing/plaf/gtk/GTKConstants.java,Java,,54,10,54,118
/jdk1.7.0_80/com/sun/java/swing/plaf/gtk/GTKEngine.java,Java,,472,68,95,635
/jdk1.7.0_80/com/sun/java/swing/plaf/gtk/GTKFileChooserUI.java,Java,,1062,214,122,1398
/jdk1.7.0_80/com/sun/java/swing/plaf/gtk/GTKGraphicsUtils.java,Java,,85,11,48,144
/jdk1.7.0_80/com/sun/java/swing/plaf/gtk/GTKIconFactory.java,Java,,254,50,47,351
/jdk1.7.0_80/com/sun/java/swing/plaf/gtk/GTKLookAndFeel.java,Java,,1376,173,190,1739
/jdk1.7.0_80/com/sun/java/swing/plaf/gtk/GTKPainter.java,Java,,1136,154,233,1523
/jdk1.7.0_80/com/sun/java/swing/plaf/gtk/GTKRegion.java,Java,,9,3,30,42
/jdk1.7.0_80/com/sun/java/swing/plaf/gtk/GTKStyle.java,Java,,797,109,235,1141
/jdk1.7.0_80/com/sun/java/swing/plaf/gtk/GTKStyleFactory.java,Java,,116,17,55,188
/jdk1.7.0_80/com/sun/java/swing/plaf/gtk/Metacity.java,Java,,1862,241,56,2159
/jdk1.7.0_80/com/sun/java/swing/plaf/gtk/PangoFonts.java,Java,,91,21,121,233
/jdk1.7.0_80/com/sun/java/swing/plaf/gtk/XColors.java,Java,,788,16,27,831
/jdk1.7.0_80/com/sun/java/swing/plaf/motif/MotifBorders.java,Java,,505,121,108,734
/jdk1.7.0_80/com/sun/java/swing/plaf/motif/MotifButtonListener.java,Java,,14,5,30,49
/jdk1.7.0_80/com/sun/java/swing/plaf/motif/MotifButtonUI.java,Java,,75,22,53,150
/jdk1.7.0_80/com/sun/java/swing/plaf/motif/MotifCheckBoxMenuItemUI.java,Java,,62,14,31,107
/jdk1.7.0_80/com/sun/java/swing/plaf/motif/MotifCheckBoxUI.java,Java,,34,14,42,90
/jdk1.7.0_80/com/sun/java/swing/plaf/motif/MotifComboBoxUI.java,Java,,264,42,55,361
/jdk1.7.0_80/com/sun/java/swing/plaf/motif/MotifDesktopIconUI.java,Java,,262,54,49,365
/jdk1.7.0_80/com/sun/java/swing/plaf/motif/MotifDesktopPaneUI.java,Java,,177,31,59,267
/jdk1.7.0_80/com/sun/java/swing/plaf/motif/MotifEditorPaneUI.java,Java,,13,5,50,68
/jdk1.7.0_80/com/sun/java/swing/plaf/motif/MotifFileChooserUI.java,Java,,653,123,74,850
/jdk1.7.0_80/com/sun/java/swing/plaf/motif/MotifGraphicsUtils.java,Java,,317,62,97,476
/jdk1.7.0_80/com/sun/java/swing/plaf/motif/MotifIconFactory.java,Java,,350,56,54,460
/jdk1.7.0_80/com/sun/java/swing/plaf/motif/MotifInternalFrameTitlePane.java,Java,,289,50,35,374
/jdk1.7.0_80/com/sun/java/swing/plaf/motif/MotifInternalFrameUI.java,Java,,137,27,59,223
/jdk1.7.0_80/com/sun/java/swing/plaf/motif/MotifLabelUI.java,Java,,19,5,37,61
/jdk1.7.0_80/com/sun/java/swing/plaf/motif/MotifLookAndFeel.java,Java,,1089,127,64,1280
/jdk1.7.0_80/com/sun/java/swing/plaf/motif/MotifMenuBarUI.java,Java,,23,7,39,69
/jdk1.7.0_80/com/sun/java/swing/plaf/motif/MotifMenuItemUI.java,Java,,63,15,31,109
/jdk1.7.0_80/com/sun/java/swing/plaf/motif/MotifMenuMouseListener.java,Java,,17,2,29,48
/jdk1.7.0_80/com/sun/java/swing/plaf/motif/MotifMenuMouseMotionListener.java,Java,,11,3,29,43
/jdk1.7.0_80/com/sun/java/swing/plaf/motif/MotifMenuUI.java,Java,,89,18,44,151
/jdk1.7.0_80/com/sun/java/swing/plaf/motif/MotifOptionPaneUI.java,Java,,49,13,52,114
/jdk1.7.0_80/com/sun/java/swing/plaf/motif/MotifPasswordFieldUI.java,Java,,13,5,50,68
/jdk1.7.0_80/com/sun/java/swing/plaf/motif/MotifPopupMenuSeparatorUI.java,Java,,27,9,30,66
/jdk1.7.0_80/com/sun/java/swing/plaf/motif/MotifPopupMenuUI.java,Java,,63,11,40,114
/jdk1.7.0_80/com/sun/java/swing/plaf/motif/MotifProgressBarUI.java,Java,,13,6,39,58
/jdk1.7.0_80/com/sun/java/swing/plaf/motif/MotifRadioButtonMenuItemUI.java,Java,,62,14,37,113
/jdk1.7.0_80/com/sun/java/swing/plaf/motif/MotifRadioButtonUI.java,Java,,40,16,48,104
/jdk1.7.0_80/com/sun/java/swing/plaf/motif/MotifScrollBarButton.java,Java,,154,23,34,211
/jdk1.7.0_80/com/sun/java/swing/plaf/motif/MotifScrollBarUI.java,Java,,53,18,37,108
/jdk1.7.0_80/com/sun/java/swing/plaf/motif/MotifScrollPaneUI.java,Java,,86,19,38,143
/jdk1.7.0_80/com/sun/java/swing/plaf/motif/MotifSeparatorUI.java,Java,,16,5,38,59
/jdk1.7.0_80/com/sun/java/swing/plaf/motif/MotifSliderUI.java,Java,,82,28,49,159
/jdk1.7.0_80/com/sun/java/swing/plaf/motif/MotifSplitPaneDivider.java,Java,,181,36,78,295
/jdk1.7.0_80/com/sun/java/swing/plaf/motif/MotifSplitPaneUI.java,Java,,18,6,42,66
/jdk1.7.0_80/com/sun/java/swing/plaf/motif/MotifTabbedPaneUI.java,Java,,218,33,55,306
/jdk1.7.0_80/com/sun/java/swing/plaf/motif/MotifTextAreaUI.java,Java,,13,5,52,70
/jdk1.7.0_80/com/sun/java/swing/plaf/motif/MotifTextFieldUI.java,Java,,13,5,50,68
/jdk1.7.0_80/com/sun/java/swing/plaf/motif/MotifTextPaneUI.java,Java,,13,5,50,68
/jdk1.7.0_80/com/sun/java/swing/plaf/motif/MotifTextUI.java,Java,,69,13,93,175
/jdk1.7.0_80/com/sun/java/swing/plaf/motif/MotifToggleButtonUI.java,Java,,60,17,48,125
/jdk1.7.0_80/com/sun/java/swing/plaf/motif/MotifTreeCellRenderer.java,Java,,51,16,46,113
/jdk1.7.0_80/com/sun/java/swing/plaf/motif/MotifTreeUI.java,Java,,78,24,64,166
/jdk1.7.0_80/com/sun/java/swing/plaf/motif/resources/motif.java,Java,,27,2,0,29
/jdk1.7.0_80/com/sun/java/swing/plaf/motif/resources/motif_de.java,Java,,27,2,0,29
/jdk1.7.0_80/com/sun/java/swing/plaf/motif/resources/motif_es.java,Java,,27,2,0,29
/jdk1.7.0_80/com/sun/java/swing/plaf/motif/resources/motif_fr.java,Java,,27,2,0,29
/jdk1.7.0_80/com/sun/java/swing/plaf/motif/resources/motif_it.java,Java,,27,2,0,29
/jdk1.7.0_80/com/sun/java/swing/plaf/motif/resources/motif_ja.java,Java,,27,2,0,29
/jdk1.7.0_80/com/sun/java/swing/plaf/motif/resources/motif_ko.java,Java,,27,2,0,29
/jdk1.7.0_80/com/sun/java/swing/plaf/motif/resources/motif_pt_BR.java,Java,,27,2,0,29
/jdk1.7.0_80/com/sun/java/swing/plaf/motif/resources/motif_sv.java,Java,,27,2,0,29
/jdk1.7.0_80/com/sun/java/swing/plaf/motif/resources/motif_zh_CN.java,Java,,27,2,0,29
/jdk1.7.0_80/com/sun/java/swing/plaf/motif/resources/motif_zh_HK.java,Java,,27,2,0,29
/jdk1.7.0_80/com/sun/java/swing/plaf/motif/resources/motif_zh_TW.java,Java,,27,2,0,29
/jdk1.7.0_80/com/sun/java/swing/plaf/nimbus/AbstractRegionPainter.java,Java,,3,1,29,33
/jdk1.7.0_80/com/sun/java/swing/plaf/nimbus/NimbusLookAndFeel.java,Java,,3,1,29,33
/jdk1.7.0_80/com/sun/java/swing/plaf/windows/AnimationController.java,Java,,309,44,78,431
/jdk1.7.0_80/com/sun/java/swing/plaf/windows/DesktopProperty.java,Java,,129,31,125,285
/jdk1.7.0_80/com/sun/java/swing/plaf/windows/resources/windows.java,Java,,35,2,0,37
/jdk1.7.0_80/com/sun/java/swing/plaf/windows/resources/windows_de.java,Java,,35,2,0,37
/jdk1.7.0_80/com/sun/java/swing/plaf/windows/resources/windows_es.java,Java,,35,2,0,37
/jdk1.7.0_80/com/sun/java/swing/plaf/windows/resources/windows_fr.java,Java,,35,2,0,37
/jdk1.7.0_80/com/sun/java/swing/plaf/windows/resources/windows_it.java,Java,,35,2,0,37
/jdk1.7.0_80/com/sun/java/swing/plaf/windows/resources/windows_ja.java,Java,,35,2,0,37
/jdk1.7.0_80/com/sun/java/swing/plaf/windows/resources/windows_ko.java,Java,,35,2,0,37
/jdk1.7.0_80/com/sun/java/swing/plaf/windows/resources/windows_pt_BR.java,Java,,35,2,0,37
/jdk1.7.0_80/com/sun/java/swing/plaf/windows/resources/windows_sv.java,Java,,35,2,0,37
/jdk1.7.0_80/com/sun/java/swing/plaf/windows/resources/windows_zh_CN.java,Java,,35,2,0,37
/jdk1.7.0_80/com/sun/java/swing/plaf/windows/resources/windows_zh_HK.java,Java,,35,2,0,37
/jdk1.7.0_80/com/sun/java/swing/plaf/windows/resources/windows_zh_TW.java,Java,,35,2,0,37
/jdk1.7.0_80/com/sun/java/swing/plaf/windows/TMSchema.java,Java,,400,94,71,565
/jdk1.7.0_80/com/sun/java/swing/plaf/windows/WindowsBorders.java,Java,,230,42,64,336
/jdk1.7.0_80/com/sun/java/swing/plaf/windows/WindowsButtonListener.java,Java,,9,5,40,54
/jdk1.7.0_80/com/sun/java/swing/plaf/windows/WindowsButtonUI.java,Java,,204,36,80,320
/jdk1.7.0_80/com/sun/java/swing/plaf/windows/WindowsCheckBoxMenuItemUI.java,Java,,48,13,43,104
/jdk1.7.0_80/com/sun/java/swing/plaf/windows/WindowsCheckBoxUI.java,Java,,36,14,45,95
/jdk1.7.0_80/com/sun/java/swing/plaf/windows/WindowsClassicLookAndFeel.java,Java,,6,2,36,44
/jdk1.7.0_80/com/sun/java/swing/plaf/windows/WindowsComboBoxUI.java,Java,,390,52,129,571
/jdk1.7.0_80/com/sun/java/swing/plaf/windows/WindowsDesktopIconUI.java,Java,,42,14,42,98
/jdk1.7.0_80/com/sun/java/swing/plaf/windows/WindowsDesktopManager.java,Java,,48,8,47,103
/jdk1.7.0_80/com/sun/java/swing/plaf/windows/WindowsDesktopPaneUI.java,Java,,27,7,37,71
/jdk1.7.0_80/com/sun/java/swing/plaf/windows/WindowsEditorPaneUI.java,Java,,14,6,48,68
/jdk1.7.0_80/com/sun/java/swing/plaf/windows/WindowsFileChooserUI.java,Java,,934,209,163,1306
/jdk1.7.0_80/com/sun/java/swing/plaf/windows/WindowsGraphicsUtils.java,Java,,132,20,62,214
/jdk1.7.0_80/com/sun/java/swing/plaf/windows/WindowsIconFactory.java,Java,,748,84,81,913
/jdk1.7.0_80/com/sun/java/swing/plaf/windows/WindowsInternalFrameTitlePane.java,Java,,442,58,60,560
/jdk1.7.0_80/com/sun/java/swing/plaf/windows/WindowsInternalFrameUI.java,Java,,71,23,40,134
/jdk1.7.0_80/com/sun/java/swing/plaf/windows/WindowsLabelUI.java,Java,,59,14,39,112
/jdk1.7.0_80/com/sun/java/swing/plaf/windows/WindowsLookAndFeel.java,Java,,2005,245,388,2638
/jdk1.7.0_80/com/sun/java/swing/plaf/windows/WindowsMenuBarUI.java,Java,,129,12,45,186
/jdk1.7.0_80/com/sun/java/swing/plaf/windows/WindowsMenuItemUI.java,Java,,108,21,51,180
/jdk1.7.0_80/com/sun/java/swing/plaf/windows/WindowsMenuItemUIAccessor.java,Java,,11,5,30,46
/jdk1.7.0_80/com/sun/java/swing/plaf/windows/WindowsMenuUI.java,Java,,187,39,69,295
/jdk1.7.0_80/com/sun/java/swing/plaf/windows/WindowsOptionPaneUI.java,Java,,8,5,34,47
/jdk1.7.0_80/com/sun/java/swing/plaf/windows/WindowsPasswordFieldUI.java,Java,,13,8,48,69
/jdk1.7.0_80/com/sun/java/swing/plaf/windows/WindowsPopupMenuSeparatorUI.java,Java,,48,12,35,95
/jdk1.7.0_80/com/sun/java/swing/plaf/windows/WindowsPopupMenuUI.java,Java,,125,18,81,224
/jdk1.7.0_80/com/sun/java/swing/plaf/windows/WindowsPopupWindow.java,Java,,34,10,51,95
/jdk1.7.0_80/com/sun/java/swing/plaf/windows/WindowsProgressBarUI.java,Java,,277,47,83,407
/jdk1.7.0_80/com/sun/java/swing/plaf/windows/WindowsRadioButtonMenuItemUI.java,Java,,47,13,43,103
/jdk1.7.0_80/com/sun/java/swing/plaf/windows/WindowsRadioButtonUI.java,Java,,63,20,52,135
/jdk1.7.0_80/com/sun/java/swing/plaf/windows/WindowsRootPaneUI.java,Java,,144,20,41,205
/jdk1.7.0_80/com/sun/java/swing/plaf/windows/WindowsScrollBarUI.java,Java,,355,46,78,479
/jdk1.7.0_80/com/sun/java/swing/plaf/windows/WindowsScrollPaneUI.java,Java,,5,5,34,44
/jdk1.7.0_80/com/sun/java/swing/plaf/windows/WindowsSeparatorUI.java,Java,,3,3,29,35
/jdk1.7.0_80/com/sun/java/swing/plaf/windows/WindowsSliderUI.java,Java,,159,33,41,233
/jdk1.7.0_80/com/sun/java/swing/plaf/windows/WindowsSpinnerUI.java,Java,,66,12,28,106
/jdk1.7.0_80/com/sun/java/swing/plaf/windows/WindowsSplitPaneDivider.java,Java,,23,7,42,72
/jdk1.7.0_80/com/sun/java/swing/plaf/windows/WindowsSplitPaneUI.java,Java,,18,9,40,67
/jdk1.7.0_80/com/sun/java/swing/plaf/windows/WindowsTabbedPaneUI.java,Java,,151,25,51,227
/jdk1.7.0_80/com/sun/java/swing/plaf/windows/WindowsTableHeaderUI.java,Java,,184,16,46,246
/jdk1.7.0_80/com/sun/java/swing/plaf/windows/WindowsTextAreaUI.java,Java,,13,7,48,68
/jdk1.7.0_80/com/sun/java/swing/plaf/windows/WindowsTextFieldUI.java,Java,,69,17,89,175
/jdk1.7.0_80/com/sun/java/swing/plaf/windows/WindowsTextPaneUI.java,Java,,14,5,48,67
/jdk1.7.0_80/com/sun/java/swing/plaf/windows/WindowsTextUI.java,Java,,139,14,83,236
/jdk1.7.0_80/com/sun/java/swing/plaf/windows/WindowsToggleButtonUI.java,Java,,103,27,51,181
/jdk1.7.0_80/com/sun/java/swing/plaf/windows/WindowsToolBarSeparatorUI.java,Java,,75,19,30,124
/jdk1.7.0_80/com/sun/java/swing/plaf/windows/WindowsToolBarUI.java,Java,,56,15,28,99
/jdk1.7.0_80/com/sun/java/swing/plaf/windows/WindowsTreeUI.java,Java,,138,31,73,242
/jdk1.7.0_80/com/sun/java/swing/plaf/windows/XPStyle.java,Java,,467,93,202,762
/jdk1.7.0_80/com/sun/java/swing/SwingUtilities3.java,Java,,130,21,71,222
/jdk1.7.0_80/com/sun/javadoc/AnnotationDesc.java,Java,,9,9,61,79
/jdk1.7.0_80/com/sun/javadoc/AnnotationTypeDoc.java,Java,,4,4,36,44
/jdk1.7.0_80/com/sun/javadoc/AnnotationTypeElementDoc.java,Java,,4,4,36,44
/jdk1.7.0_80/com/sun/javadoc/AnnotationValue.java,Java,,5,5,49,59
/jdk1.7.0_80/com/sun/javadoc/ClassDoc.java,Java,,30,29,281,340
/jdk1.7.0_80/com/sun/javadoc/ConstructorDoc.java,Java,,3,2,30,35
/jdk1.7.0_80/com/sun/javadoc/Doc.java,Java,,29,27,209,265
/jdk1.7.0_80/com/sun/javadoc/DocErrorReporter.java,Java,,9,8,66,83
/jdk1.7.0_80/com/sun/javadoc/Doclet.java,Java,,16,6,89,111
/jdk1.7.0_80/com/sun/javadoc/ExecutableMemberDoc.java,Java,,15,14,111,140
/jdk1.7.0_80/com/sun/javadoc/FieldDoc.java,Java,,9,8,62,79
/jdk1.7.0_80/com/sun/javadoc/LanguageVersion.java,Java,,5,5,37,47
/jdk1.7.0_80/com/sun/javadoc/MemberDoc.java,Java,,4,3,40,47
/jdk1.7.0_80/com/sun/javadoc/MethodDoc.java,Java,,9,8,77,94
/jdk1.7.0_80/com/sun/javadoc/PackageDoc.java,Java,,13,12,104,129
/jdk1.7.0_80/com/sun/javadoc/Parameter.java,Java,,8,7,59,74
/jdk1.7.0_80/com/sun/javadoc/ParameterizedType.java,Java,,8,8,92,108
/jdk1.7.0_80/com/sun/javadoc/ParamTag.java,Java,,6,5,56,67
/jdk1.7.0_80/com/sun/javadoc/ProgramElementDoc.java,Java,,15,13,97,125
/jdk1.7.0_80/com/sun/javadoc/RootDoc.java,Java,,9,8,92,109
/jdk1.7.0_80/com/sun/javadoc/SeeTag.java,Java,,9,8,109,126
/jdk1.7.0_80/com/sun/javadoc/SerialFieldTag.java,Java,,8,7,72,87
/jdk1.7.0_80/com/sun/javadoc/SourcePosition.java,Java,,8,6,41,55
/jdk1.7.0_80/com/sun/javadoc/Tag.java,Java,,13,11,134,158
/jdk1.7.0_80/com/sun/javadoc/ThrowsTag.java,Java,,7,6,66,79
/jdk1.7.0_80/com/sun/javadoc/Type.java,Java,,14,13,126,153
/jdk1.7.0_80/com/sun/javadoc/TypeVariable.java,Java,,5,5,48,58
/jdk1.7.0_80/com/sun/javadoc/WildcardType.java,Java,,5,5,51,61
/jdk1.7.0_80/com/sun/java_cup/internal/runtime/lr_parser.java,Java,,490,203,558,1251
/jdk1.7.0_80/com/sun/java_cup/internal/runtime/Scanner.java,Java,,4,3,38,45
/jdk1.7.0_80/com/sun/java_cup/internal/runtime/Symbol.java,Java,,38,20,71,129
/jdk1.7.0_80/com/sun/java_cup/internal/runtime/virtual_parse_stack.java,Java,,49,33,87,169
/jdk1.7.0_80/com/sun/jmx/defaults/JmxProperties.java,Java,,55,33,144,232
/jdk1.7.0_80/com/sun/jmx/defaults/ServiceName.java,Java,,14,11,72,97
/jdk1.7.0_80/com/sun/jmx/interceptor/DefaultMBeanServerInterceptor.java,Java,,1296,259,514,2069
/jdk1.7.0_80/com/sun/jmx/interceptor/MBeanServerInterceptor.java,Java,,34,11,85,130
/jdk1.7.0_80/com/sun/jmx/mbeanserver/ClassLoaderRepositorySupport.java,Java,,189,36,95,320
/jdk1.7.0_80/com/sun/jmx/mbeanserver/ConvertingMethod.java,Java,,161,26,42,229
/jdk1.7.0_80/com/sun/jmx/mbeanserver/DefaultMXBeanMappingFactory.java,Java,,1123,157,219,1499
/jdk1.7.0_80/com/sun/jmx/mbeanserver/DescriptorCache.java,Java,,35,8,24,67
/jdk1.7.0_80/com/sun/jmx/mbeanserver/DynamicMBean2.java,Java,,11,6,60,77
/jdk1.7.0_80/com/sun/jmx/mbeanserver/GetPropertyAction.java,Java,,11,5,30,46
/jdk1.7.0_80/com/sun/jmx/mbeanserver/Introspector.java,Java,,473,63,258,794
/jdk1.7.0_80/com/sun/jmx/mbeanserver/JmxMBeanServer.java,Java,,459,121,942,1522
/jdk1.7.0_80/com/sun/jmx/mbeanserver/JmxMBeanServerBuilder.java,Java,,15,5,94,114
/jdk1.7.0_80/com/sun/jmx/mbeanserver/MBeanAnalyzer.java,Java,,153,27,90,270
/jdk1.7.0_80/com/sun/jmx/mbeanserver/MBeanInstantiator.java,Java,,446,82,258,786
/jdk1.7.0_80/com/sun/jmx/mbeanserver/MBeanIntrospector.java,Java,,264,43,164,471
/jdk1.7.0_80/com/sun/jmx/mbeanserver/MBeanServerDelegateImpl.java,Java,,170,29,122,321
/jdk1.7.0_80/com/sun/jmx/mbeanserver/MBeanSupport.java,Java,,129,25,122,276
/jdk1.7.0_80/com/sun/jmx/mbeanserver/ModifiableClassLoaderRepository.java,Java,,11,9,50,70
/jdk1.7.0_80/com/sun/jmx/mbeanserver/MXBeanIntrospector.java,Java,,262,35,68,365
/jdk1.7.0_80/com/sun/jmx/mbeanserver/MXBeanLookup.java,Java,,101,13,74,188
/jdk1.7.0_80/com/sun/jmx/mbeanserver/MXBeanMapping.java,Java,,41,12,157,210
/jdk1.7.0_80/com/sun/jmx/mbeanserver/MXBeanMappingFactory.java,Java,,12,5,107,124
/jdk1.7.0_80/com/sun/jmx/mbeanserver/MXBeanProxy.java,Java,,117,24,34,175
/jdk1.7.0_80/com/sun/jmx/mbeanserver/MXBeanSupport.java,Java,,95,14,69,178
/jdk1.7.0_80/com/sun/jmx/mbeanserver/NamedObject.java,Java,,37,17,68,122
/jdk1.7.0_80/com/sun/jmx/mbeanserver/ObjectInputStreamWithLoader.java,Java,,25,8,36,69
/jdk1.7.0_80/com/sun/jmx/mbeanserver/PerInterface.java,Java,,196,25,59,280
/jdk1.7.0_80/com/sun/jmx/mbeanserver/Repository.java,Java,,345,80,253,678
/jdk1.7.0_80/com/sun/jmx/mbeanserver/SecureClassLoaderRepository.java,Java,,23,3,38,64
/jdk1.7.0_80/com/sun/jmx/mbeanserver/StandardMBeanIntrospector.java,Java,,130,24,39,193
/jdk1.7.0_80/com/sun/jmx/mbeanserver/StandardMBeanSupport.java,Java,,36,10,49,95
/jdk1.7.0_80/com/sun/jmx/mbeanserver/SunJmxMBeanServer.java,Java,,11,10,69,90
/jdk1.7.0_80/com/sun/jmx/mbeanserver/Util.java,Java,,122,23,96,241
/jdk1.7.0_80/com/sun/jmx/mbeanserver/WeakIdentityHashMap.java,Java,,64,19,54,137
/jdk1.7.0_80/com/sun/jmx/remote/internal/ArrayNotificationBuffer.java,Java,,551,92,209,852
/jdk1.7.0_80/com/sun/jmx/remote/internal/ArrayQueue.java,Java,,67,10,25,102
/jdk1.7.0_80/com/sun/jmx/remote/internal/ClientCommunicatorAdmin.java,Java,,150,45,57,252
/jdk1.7.0_80/com/sun/jmx/remote/internal/ClientListenerInfo.java,Java,,57,19,30,106
/jdk1.7.0_80/com/sun/jmx/remote/internal/ClientNotifForwarder.java,Java,,591,149,170,910
/jdk1.7.0_80/com/sun/jmx/remote/internal/IIOPHelper.java,Java,,90,22,76,188
/jdk1.7.0_80/com/sun/jmx/remote/internal/IIOPProxy.java,Java,,20,17,73,110
/jdk1.7.0_80/com/sun/jmx/remote/internal/NotificationBuffer.java,Java,,13,4,55,72
/jdk1.7.0_80/com/sun/jmx/remote/internal/NotificationBufferFilter.java,Java,,9,3,28,40
/jdk1.7.0_80/com/sun/jmx/remote/internal/ProxyRef.java,Java,,54,16,33,103
/jdk1.7.0_80/com/sun/jmx/remote/internal/RMIExporter.java,Java,,18,5,36,59
/jdk1.7.0_80/com/sun/jmx/remote/internal/ServerCommunicatorAdmin.java,Java,,135,38,59,232
/jdk1.7.0_80/com/sun/jmx/remote/internal/ServerNotifForwarder.java,Java,,365,63,74,502
/jdk1.7.0_80/com/sun/jmx/remote/internal/Unmarshal.java,Java,,7,3,24,34
/jdk1.7.0_80/com/sun/jmx/remote/protocol/iiop/ClientProvider.java,Java,,19,5,24,48
/jdk1.7.0_80/com/sun/jmx/remote/protocol/iiop/IIOPProxyImpl.java,Java,,105,22,30,157
/jdk1.7.0_80/com/sun/jmx/remote/protocol/iiop/ProxyInputStream.java,Java,,165,49,27,241
/jdk1.7.0_80/com/sun/jmx/remote/protocol/iiop/ServerProvider.java,Java,,21,6,24,51
/jdk1.7.0_80/com/sun/jmx/remote/protocol/rmi/ClientProvider.java,Java,,19,5,24,48
/jdk1.7.0_80/com/sun/jmx/remote/protocol/rmi/ServerProvider.java,Java,,21,6,24,51
/jdk1.7.0_80/com/sun/jmx/remote/security/FileLoginModule.java,Java,,295,64,211,570
/jdk1.7.0_80/com/sun/jmx/remote/security/JMXPluggableAuthenticator.java,Java,,187,37,122,346
/jdk1.7.0_80/com/sun/jmx/remote/security/JMXSubjectDomainCombiner.java,Java,,42,9,55,106
/jdk1.7.0_80/com/sun/jmx/remote/security/MBeanServerAccessController.java,Java,,377,51,237,665
/jdk1.7.0_80/com/sun/jmx/remote/security/MBeanServerFileAccessController.java,Java,,300,36,208,544
/jdk1.7.0_80/com/sun/jmx/remote/security/NotificationAccessController.java,Java,,19,6,85,110
/jdk1.7.0_80/com/sun/jmx/remote/security/SubjectDelegator.java,Java,,66,12,47,125
/jdk1.7.0_80/com/sun/jmx/remote/util/ClassLoaderWithRepository.java,Java,,24,7,24,55
/jdk1.7.0_80/com/sun/jmx/remote/util/ClassLogger.java,Java,,171,44,31,246
/jdk1.7.0_80/com/sun/jmx/remote/util/EnvHelp.java,Java,,386,78,304,768
/jdk1.7.0_80/com/sun/jmx/remote/util/OrderClassLoaders.java,Java,,21,6,24,51
/jdk1.7.0_80/com/sun/jmx/snmp/agent/SnmpEntryOid.java,Java,,12,3,36,51
/jdk1.7.0_80/com/sun/jmx/snmp/agent/SnmpErrorHandlerAgent.java,Java,,73,37,96,206
/jdk1.7.0_80/com/sun/jmx/snmp/agent/SnmpGenericMetaServer.java,Java,,15,9,108,132
/jdk1.7.0_80/com/sun/jmx/snmp/agent/SnmpGenericObjectServer.java,Java,,260,54,259,573
/jdk1.7.0_80/com/sun/jmx/snmp/agent/SnmpIndex.java,Java,,67,21,102,190
/jdk1.7.0_80/com/sun/jmx/snmp/agent/SnmpMib.java,Java,,469,136,421,1026
/jdk1.7.0_80/com/sun/jmx/snmp/agent/SnmpMibAgent.java,Java,,287,67,403,757
/jdk1.7.0_80/com/sun/jmx/snmp/agent/SnmpMibAgentMBean.java,Java,,38,29,249,316
/jdk1.7.0_80/com/sun/jmx/snmp/agent/SnmpMibEntry.java,Java,,26,12,148,186
/jdk1.7.0_80/com/sun/jmx/snmp/agent/SnmpMibGroup.java,Java,,155,61,303,519
/jdk1.7.0_80/com/sun/jmx/snmp/agent/SnmpMibHandler.java,Java,,17,13,125,155
/jdk1.7.0_80/com/sun/jmx/snmp/agent/SnmpMibNode.java,Java,,110,43,250,403
/jdk1.7.0_80/com/sun/jmx/snmp/agent/SnmpMibOid.java,Java,,269,80,212,561
/jdk1.7.0_80/com/sun/jmx/snmp/agent/SnmpMibRequest.java,Java,,23,12,140,175
/jdk1.7.0_80/com/sun/jmx/snmp/agent/SnmpMibRequestImpl.java,Java,,79,25,138,242
/jdk1.7.0_80/com/sun/jmx/snmp/agent/SnmpMibSubRequest.java,Java,,22,10,177,209
/jdk1.7.0_80/com/sun/jmx/snmp/agent/SnmpMibTable.java,Java,,870,219,1481,2570
/jdk1.7.0_80/com/sun/jmx/snmp/agent/SnmpRequestTree.java,Java,,531,163,377,1071
/jdk1.7.0_80/com/sun/jmx/snmp/agent/SnmpStandardMetaServer.java,Java,,11,6,102,119
/jdk1.7.0_80/com/sun/jmx/snmp/agent/SnmpStandardObjectServer.java,Java,,55,14,195,264
/jdk1.7.0_80/com/sun/jmx/snmp/agent/SnmpTableCallbackHandler.java,Java,,13,3,60,76
/jdk1.7.0_80/com/sun/jmx/snmp/agent/SnmpTableEntryFactory.java,Java,,10,5,76,91
/jdk1.7.0_80/com/sun/jmx/snmp/agent/SnmpTableEntryNotification.java,Java,,25,18,98,141
/jdk1.7.0_80/com/sun/jmx/snmp/agent/SnmpTableSupport.java,Java,,125,51,395,571
/jdk1.7.0_80/com/sun/jmx/snmp/agent/SnmpUserDataFactory.java,Java,,10,4,110,124
/jdk1.7.0_80/com/sun/jmx/snmp/BerDecoder.java,Java,,380,119,258,757
/jdk1.7.0_80/com/sun/jmx/snmp/BerEncoder.java,Java,,196,92,189,477
/jdk1.7.0_80/com/sun/jmx/snmp/BerException.java,Java,,18,13,32,63
/jdk1.7.0_80/com/sun/jmx/snmp/daemon/ClientHandler.java,Java,,57,21,55,133
/jdk1.7.0_80/com/sun/jmx/snmp/daemon/CommunicationException.java,Java,,20,10,47,77
/jdk1.7.0_80/com/sun/jmx/snmp/daemon/CommunicatorServer.java,Java,,633,130,612,1375
/jdk1.7.0_80/com/sun/jmx/snmp/daemon/CommunicatorServerMBean.java,Java,,13,16,142,171
/jdk1.7.0_80/com/sun/jmx/snmp/daemon/SnmpAdaptorServer.java,Java,,1204,268,1187,2659
/jdk1.7.0_80/com/sun/jmx/snmp/daemon/SnmpAdaptorServerMBean.java,Java,,98,73,529,700
/jdk1.7.0_80/com/sun/jmx/snmp/daemon/SnmpInformHandler.java,Java,,8,7,65,80
/jdk1.7.0_80/com/sun/jmx/snmp/daemon/SnmpInformRequest.java,Java,,689,144,346,1179
/jdk1.7.0_80/com/sun/jmx/snmp/daemon/SnmpMibTree.java,Java,,159,46,64,269
/jdk1.7.0_80/com/sun/jmx/snmp/daemon/SnmpQManager.java,Java,,232,52,29,313
/jdk1.7.0_80/com/sun/jmx/snmp/daemon/SnmpRequestCounter.java,Java,,10,5,20,35
/jdk1.7.0_80/com/sun/jmx/snmp/daemon/SnmpRequestHandler.java,Java,,753,125,271,1149
/jdk1.7.0_80/com/sun/jmx/snmp/daemon/SnmpResponseHandler.java,Java,,71,18,22,111
/jdk1.7.0_80/com/sun/jmx/snmp/daemon/SnmpSendServer.java,Java,,127,25,32,184
/jdk1.7.0_80/com/sun/jmx/snmp/daemon/SnmpSession.java,Java,,275,53,149,477
/jdk1.7.0_80/com/sun/jmx/snmp/daemon/SnmpSocket.java,Java,,167,41,88,296
/jdk1.7.0_80/com/sun/jmx/snmp/daemon/SnmpSubBulkRequestHandler.java,Java,,210,40,95,345
/jdk1.7.0_80/com/sun/jmx/snmp/daemon/SnmpSubNextRequestHandler.java,Java,,153,25,94,272
/jdk1.7.0_80/com/sun/jmx/snmp/daemon/SnmpSubRequestHandler.java,Java,,326,85,219,630
/jdk1.7.0_80/com/sun/jmx/snmp/daemon/SnmpTimerServer.java,Java,,73,18,19,110
/jdk1.7.0_80/com/sun/jmx/snmp/defaults/DefaultPaths.java,Java,,105,20,120,245
/jdk1.7.0_80/com/sun/jmx/snmp/defaults/SnmpProperties.java,Java,,32,19,127,178
/jdk1.7.0_80/com/sun/jmx/snmp/Enumerated.java,Java,,60,39,120,219
/jdk1.7.0_80/com/sun/jmx/snmp/EnumRowStatus.java,Java,,92,30,186,308
/jdk1.7.0_80/com/sun/jmx/snmp/InetAddressAcl.java,Java,,15,14,99,128
/jdk1.7.0_80/com/sun/jmx/snmp/internal/SnmpAccessControlModel.java,Java,,25,3,64,92
/jdk1.7.0_80/com/sun/jmx/snmp/internal/SnmpAccessControlSubSystem.java,Java,,21,2,53,76
/jdk1.7.0_80/com/sun/jmx/snmp/internal/SnmpDecryptedPdu.java,Java,,7,1,42,50
/jdk1.7.0_80/com/sun/jmx/snmp/internal/SnmpEngineImpl.java,Java,,185,45,194,424
/jdk1.7.0_80/com/sun/jmx/snmp/internal/SnmpIncomingRequest.java,Java,,36,9,119,164
/jdk1.7.0_80/com/sun/jmx/snmp/internal/SnmpIncomingResponse.java,Java,,29,9,84,122
/jdk1.7.0_80/com/sun/jmx/snmp/internal/SnmpLcd.java,Java,,56,16,64,136
/jdk1.7.0_80/com/sun/jmx/snmp/internal/SnmpModel.java,Java,,5,1,38,44
/jdk1.7.0_80/com/sun/jmx/snmp/internal/SnmpModelLcd.java,Java,,3,2,30,35
/jdk1.7.0_80/com/sun/jmx/snmp/internal/SnmpMsgProcessingModel.java,Java,,38,9,100,147
/jdk1.7.0_80/com/sun/jmx/snmp/internal/SnmpMsgProcessingSubSystem.java,Java,,51,7,104,162
/jdk1.7.0_80/com/sun/jmx/snmp/internal/SnmpOutgoingRequest.java,Java,,21,5,62,88
/jdk1.7.0_80/com/sun/jmx/snmp/internal/SnmpSecurityCache.java,Java,,3,1,30,34
/jdk1.7.0_80/com/sun/jmx/snmp/internal/SnmpSecurityModel.java,Java,,64,4,108,176
/jdk1.7.0_80/com/sun/jmx/snmp/internal/SnmpSecuritySubSystem.java,Java,,65,4,109,178
/jdk1.7.0_80/com/sun/jmx/snmp/internal/SnmpSubSystem.java,Java,,12,6,55,73
/jdk1.7.0_80/com/sun/jmx/snmp/internal/SnmpTools.java,Java,,67,7,51,125
/jdk1.7.0_80/com/sun/jmx/snmp/IPAcl/AclEntryImpl.java,Java,,96,30,137,263
/jdk1.7.0_80/com/sun/jmx/snmp/IPAcl/AclImpl.java,Java,,89,25,173,287
/jdk1.7.0_80/com/sun/jmx/snmp/IPAcl/ASCII_CharStream.java,Java,,306,56,40,402
/jdk1.7.0_80/com/sun/jmx/snmp/IPAcl/GroupImpl.java,Java,,44,19,79,142
/jdk1.7.0_80/com/sun/jmx/snmp/IPAcl/Host.java,Java,,120,25,36,181
/jdk1.7.0_80/com/sun/jmx/snmp/IPAcl/JDMAccess.java,Java,,25,10,29,64
/jdk1.7.0_80/com/sun/jmx/snmp/IPAcl/JDMAclBlock.java,Java,,18,10,33,61
/jdk1.7.0_80/com/sun/jmx/snmp/IPAcl/JDMAclItem.java,Java,,23,10,25,58
/jdk1.7.0_80/com/sun/jmx/snmp/IPAcl/JDMCommunities.java,Java,,19,9,25,53
/jdk1.7.0_80/com/sun/jmx/snmp/IPAcl/JDMCommunity.java,Java,,19,9,25,53
/jdk1.7.0_80/com/sun/jmx/snmp/IPAcl/JDMEnterprise.java,Java,,16,8,25,49
/jdk1.7.0_80/com/sun/jmx/snmp/IPAcl/JDMHost.java,Java,,15,11,25,51
/jdk1.7.0_80/com/sun/jmx/snmp/IPAcl/JDMHostInform.java,Java,,16,7,25,48
/jdk1.7.0_80/com/sun/jmx/snmp/IPAcl/JDMHostName.java,Java,,25,12,25,62
/jdk1.7.0_80/com/sun/jmx/snmp/IPAcl/JDMHostTrap.java,Java,,16,8,25,49
/jdk1.7.0_80/com/sun/jmx/snmp/IPAcl/JDMInformBlock.java,Java,,18,9,33,60
/jdk1.7.0_80/com/sun/jmx/snmp/IPAcl/JDMInformCommunity.java,Java,,19,7,25,51
/jdk1.7.0_80/com/sun/jmx/snmp/IPAcl/JDMInformInterestedHost.java,Java,,15,6,25,46
/jdk1.7.0_80/com/sun/jmx/snmp/IPAcl/JDMInformItem.java,Java,,19,7,25,51
/jdk1.7.0_80/com/sun/jmx/snmp/IPAcl/JDMIpAddress.java,Java,,26,12,25,63
/jdk1.7.0_80/com/sun/jmx/snmp/IPAcl/JDMIpMask.java,Java,,26,12,25,63
/jdk1.7.0_80/com/sun/jmx/snmp/IPAcl/JDMIpV6Address.java,Java,,10,6,25,41
/jdk1.7.0_80/com/sun/jmx/snmp/IPAcl/JDMManagers.java,Java,,15,7,25,47
/jdk1.7.0_80/com/sun/jmx/snmp/IPAcl/JDMNetMask.java,Java,,26,7,25,58
/jdk1.7.0_80/com/sun/jmx/snmp/IPAcl/JDMNetMaskV6.java,Java,,15,6,25,46
/jdk1.7.0_80/com/sun/jmx/snmp/IPAcl/JDMSecurityDefs.java,Java,,15,7,25,47
/jdk1.7.0_80/com/sun/jmx/snmp/IPAcl/JDMTrapBlock.java,Java,,18,10,33,61
/jdk1.7.0_80/com/sun/jmx/snmp/IPAcl/JDMTrapCommunity.java,Java,,19,8,25,52
/jdk1.7.0_80/com/sun/jmx/snmp/IPAcl/JDMTrapInterestedHost.java,Java,,15,7,25,47
/jdk1.7.0_80/com/sun/jmx/snmp/IPAcl/JDMTrapItem.java,Java,,19,9,25,53
/jdk1.7.0_80/com/sun/jmx/snmp/IPAcl/JDMTrapNum.java,Java,,17,8,25,50
/jdk1.7.0_80/com/sun/jmx/snmp/IPAcl/JJTParserState.java,Java,,82,20,47,149
/jdk1.7.0_80/com/sun/jmx/snmp/IPAcl/NetMaskImpl.java,Java,,160,26,80,266
/jdk1.7.0_80/com/sun/jmx/snmp/IPAcl/Node.java,Java,,10,11,39,60
/jdk1.7.0_80/com/sun/jmx/snmp/IPAcl/OwnerImpl.java,Java,,45,19,73,137
/jdk1.7.0_80/com/sun/jmx/snmp/IPAcl/ParseError.java,Java,,9,4,25,38
/jdk1.7.0_80/com/sun/jmx/snmp/IPAcl/ParseException.java,Java,,110,14,93,217
/jdk1.7.0_80/com/sun/jmx/snmp/IPAcl/Parser.java,Java,,1175,57,53,1285
/jdk1.7.0_80/com/sun/jmx/snmp/IPAcl/ParserConstants.java,Java,,80,6,25,111
/jdk1.7.0_80/com/sun/jmx/snmp/IPAcl/ParserTokenManager.java,Java,,1481,8,25,1514
/jdk1.7.0_80/com/sun/jmx/snmp/IPAcl/ParserTreeConstants.java,Java,,58,5,25,88
/jdk1.7.0_80/com/sun/jmx/snmp/IPAcl/PermissionImpl.java,Java,,25,14,50,89
/jdk1.7.0_80/com/sun/jmx/snmp/IPAcl/PrincipalImpl.java,Java,,50,18,80,148
/jdk1.7.0_80/com/sun/jmx/snmp/IPAcl/SimpleNode.java,Java,,87,23,45,155
/jdk1.7.0_80/com/sun/jmx/snmp/IPAcl/SnmpAcl.java,Java,,248,41,197,486
/jdk1.7.0_80/com/sun/jmx/snmp/IPAcl/Token.java,Java,,19,12,76,107
/jdk1.7.0_80/com/sun/jmx/snmp/IPAcl/TokenMgrError.java,Java,,73,15,72,160
/jdk1.7.0_80/com/sun/jmx/snmp/mpm/SnmpMsgTranslator.java,Java,,19,1,72,92
/jdk1.7.0_80/com/sun/jmx/snmp/ServiceName.java,Java,,24,23,123,170
/jdk1.7.0_80/com/sun/jmx/snmp/SnmpAckPdu.java,Java,,4,0,35,39
/jdk1.7.0_80/com/sun/jmx/snmp/SnmpBadSecurityLevelException.java,Java,,7,1,30,38
/jdk1.7.0_80/com/sun/jmx/snmp/SnmpCounter.java,Java,,20,12,67,99
/jdk1.7.0_80/com/sun/jmx/snmp/SnmpCounter64.java,Java,,71,23,120,214
/jdk1.7.0_80/com/sun/jmx/snmp/SnmpDataTypeEnums.java,Java,,25,30,84,139
/jdk1.7.0_80/com/sun/jmx/snmp/SnmpDefinitions.java,Java,,82,78,341,501
/jdk1.7.0_80/com/sun/jmx/snmp/SnmpEngine.java,Java,,7,3,60,70
/jdk1.7.0_80/com/sun/jmx/snmp/SnmpEngineFactory.java,Java,,6,2,50,58
/jdk1.7.0_80/com/sun/jmx/snmp/SnmpEngineId.java,Java,,239,49,201,489
/jdk1.7.0_80/com/sun/jmx/snmp/SnmpEngineParameters.java,Java,,36,12,69,117
/jdk1.7.0_80/com/sun/jmx/snmp/SnmpGauge.java,Java,,20,12,67,99
/jdk1.7.0_80/com/sun/jmx/snmp/SnmpInt.java,Java,,99,29,154,282
/jdk1.7.0_80/com/sun/jmx/snmp/SnmpIpAddress.java,Java,,92,22,103,217
/jdk1.7.0_80/com/sun/jmx/snmp/SnmpMessage.java,Java,,202,27,133,362
/jdk1.7.0_80/com/sun/jmx/snmp/SnmpMsg.java,Java,,272,36,168,476
/jdk1.7.0_80/com/sun/jmx/snmp/SnmpNull.java,Java,,65,22,96,183
/jdk1.7.0_80/com/sun/jmx/snmp/SnmpOid.java,Java,,336,62,258,656
/jdk1.7.0_80/com/sun/jmx/snmp/SnmpOidDatabase.java,Java,,13,11,51,75
/jdk1.7.0_80/com/sun/jmx/snmp/SnmpOidDatabaseSupport.java,Java,,68,15,57,140
/jdk1.7.0_80/com/sun/jmx/snmp/SnmpOidRecord.java,Java,,20,9,61,90
/jdk1.7.0_80/com/sun/jmx/snmp/SnmpOidTable.java,Java,,9,10,45,64
/jdk1.7.0_80/com/sun/jmx/snmp/SnmpOidTableSupport.java,Java,,72,21,77,170
/jdk1.7.0_80/com/sun/jmx/snmp/SnmpOpaque.java,Java,,27,12,61,100
/jdk1.7.0_80/com/sun/jmx/snmp/SnmpParameters.java,Java,,90,23,112,225
/jdk1.7.0_80/com/sun/jmx/snmp/SnmpParams.java,Java,,16,5,55,76
/jdk1.7.0_80/com/sun/jmx/snmp/SnmpPdu.java,Java,,34,10,80,124
/jdk1.7.0_80/com/sun/jmx/snmp/SnmpPduBulk.java,Java,,31,12,76,119
/jdk1.7.0_80/com/sun/jmx/snmp/SnmpPduBulkType.java,Java,,7,5,46,58
/jdk1.7.0_80/com/sun/jmx/snmp/SnmpPduFactory.java,Java,,6,9,79,94
/jdk1.7.0_80/com/sun/jmx/snmp/SnmpPduFactoryBER.java,Java,,35,10,86,131
/jdk1.7.0_80/com/sun/jmx/snmp/SnmpPduPacket.java,Java,,6,4,31,41
/jdk1.7.0_80/com/sun/jmx/snmp/SnmpPduRequest.java,Java,,27,12,70,109
/jdk1.7.0_80/com/sun/jmx/snmp/SnmpPduRequestType.java,Java,,7,1,52,60
/jdk1.7.0_80/com/sun/jmx/snmp/SnmpPduTrap.java,Java,,13,14,66,93
/jdk1.7.0_80/com/sun/jmx/snmp/SnmpPeer.java,Java,,140,58,252,450
/jdk1.7.0_80/com/sun/jmx/snmp/SnmpScopedPduBulk.java,Java,,37,10,63,110
/jdk1.7.0_80/com/sun/jmx/snmp/SnmpScopedPduPacket.java,Java,,17,11,76,104
/jdk1.7.0_80/com/sun/jmx/snmp/SnmpScopedPduRequest.java,Java,,33,5,57,95
/jdk1.7.0_80/com/sun/jmx/snmp/SnmpSecurityException.java,Java,,13,2,52,67
/jdk1.7.0_80/com/sun/jmx/snmp/SnmpSecurityParameters.java,Java,,8,2,44,54
/jdk1.7.0_80/com/sun/jmx/snmp/SnmpStatusException.java,Java,,33,24,89,146
/jdk1.7.0_80/com/sun/jmx/snmp/SnmpString.java,Java,,118,27,133,278
/jdk1.7.0_80/com/sun/jmx/snmp/SnmpStringFixed.java,Java,,76,16,101,193
/jdk1.7.0_80/com/sun/jmx/snmp/SnmpTimeticks.java,Java,,45,15,69,129
/jdk1.7.0_80/com/sun/jmx/snmp/SnmpTooBigException.java,Java,,14,10,58,82
/jdk1.7.0_80/com/sun/jmx/snmp/SnmpUnknownAccContrModelException.java,Java,,8,3,36,47
/jdk1.7.0_80/com/sun/jmx/snmp/SnmpUnknownModelException.java,Java,,7,1,34,42
/jdk1.7.0_80/com/sun/jmx/snmp/SnmpUnknownModelLcdException.java,Java,,7,1,34,42
/jdk1.7.0_80/com/sun/jmx/snmp/SnmpUnknownMsgProcModelException.java,Java,,8,3,34,45
/jdk1.7.0_80/com/sun/jmx/snmp/SnmpUnknownSecModelException.java,Java,,8,3,34,45
/jdk1.7.0_80/com/sun/jmx/snmp/SnmpUnknownSubSystemException.java,Java,,7,1,34,42
/jdk1.7.0_80/com/sun/jmx/snmp/SnmpUnsignedInt.java,Java,,32,15,78,125
/jdk1.7.0_80/com/sun/jmx/snmp/SnmpUsmKeyHandler.java,Java,,10,8,80,98
/jdk1.7.0_80/com/sun/jmx/snmp/SnmpV3Message.java,Java,,301,39,171,511
/jdk1.7.0_80/com/sun/jmx/snmp/SnmpValue.java,Java,,19,14,63,96
/jdk1.7.0_80/com/sun/jmx/snmp/SnmpVarBind.java,Java,,271,83,381,735
/jdk1.7.0_80/com/sun/jmx/snmp/SnmpVarBindList.java,Java,,245,51,255,551
/jdk1.7.0_80/com/sun/jmx/snmp/tasks/Task.java,Java,,4,1,62,67
/jdk1.7.0_80/com/sun/jmx/snmp/tasks/TaskServer.java,Java,,4,4,49,57
/jdk1.7.0_80/com/sun/jmx/snmp/tasks/ThreadService.java,Java,,142,42,62,246
/jdk1.7.0_80/com/sun/jmx/snmp/ThreadContext.java,Java,,81,22,223,326
/jdk1.7.0_80/com/sun/jmx/snmp/Timestamp.java,Java,,42,21,70,133
/jdk1.7.0_80/com/sun/jmx/snmp/UserAcl.java,Java,,11,11,75,97
/jdk1.7.0_80/com/sun/jmx/trace/Trace.java,Java,,87,19,90,196
/jdk1.7.0_80/com/sun/jmx/trace/TraceDestination.java,Java,,17,6,50,73
/jdk1.7.0_80/com/sun/jmx/trace/TraceImplementation.java,Java,,136,34,87,257
/jdk1.7.0_80/com/sun/jmx/trace/TraceManager.java,Java,,96,13,166,275
/jdk1.7.0_80/com/sun/jmx/trace/TraceTags.java,Java,,17,16,52,85
/jdk1.7.0_80/com/sun/mirror/apt/AnnotationProcessor.java,Java,,8,6,56,70
/jdk1.7.0_80/com/sun/mirror/apt/AnnotationProcessorEnvironment.java,Java,,22,20,140,182
/jdk1.7.0_80/com/sun/mirror/apt/AnnotationProcessorFactory.java,Java,,12,9,88,109
/jdk1.7.0_80/com/sun/mirror/apt/AnnotationProcessorListener.java,Java,,4,2,36,42
/jdk1.7.0_80/com/sun/mirror/apt/AnnotationProcessors.java,Java,,33,12,78,123
/jdk1.7.0_80/com/sun/mirror/apt/Filer.java,Java,,20,11,131,162
/jdk1.7.0_80/com/sun/mirror/apt/Messager.java,Java,,12,9,71,92
/jdk1.7.0_80/com/sun/mirror/apt/package-info.java,Java,,1,1,36,38
/jdk1.7.0_80/com/sun/mirror/apt/RoundCompleteEvent.java,Java,,17,5,53,75
/jdk1.7.0_80/com/sun/mirror/apt/RoundCompleteListener.java,Java,,6,2,41,49
/jdk1.7.0_80/com/sun/mirror/apt/RoundState.java,Java,,9,5,52,66
/jdk1.7.0_80/com/sun/mirror/declaration/AnnotationMirror.java,Java,,11,7,69,87
/jdk1.7.0_80/com/sun/mirror/declaration/AnnotationTypeDeclaration.java,Java,,7,6,44,57
/jdk1.7.0_80/com/sun/mirror/declaration/AnnotationTypeElementDeclaration.java,Java,,7,5,45,57
/jdk1.7.0_80/com/sun/mirror/declaration/AnnotationValue.java,Java,,9,6,67,82
/jdk1.7.0_80/com/sun/mirror/declaration/ClassDeclaration.java,Java,,10,9,70,89
/jdk1.7.0_80/com/sun/mirror/declaration/ConstructorDeclaration.java,Java,,5,3,36,44
/jdk1.7.0_80/com/sun/mirror/declaration/Declaration.java,Java,,17,14,138,169
/jdk1.7.0_80/com/sun/mirror/declaration/EnumConstantDeclaration.java,Java,,6,3,39,48
/jdk1.7.0_80/com/sun/mirror/declaration/EnumDeclaration.java,Java,,7,6,42,55
/jdk1.7.0_80/com/sun/mirror/declaration/ExecutableDeclaration.java,Java,,11,10,64,85
/jdk1.7.0_80/com/sun/mirror/declaration/FieldDeclaration.java,Java,,9,8,62,79
/jdk1.7.0_80/com/sun/mirror/declaration/InterfaceDeclaration.java,Java,,6,5,46,57
/jdk1.7.0_80/com/sun/mirror/declaration/MemberDeclaration.java,Java,,6,4,47,57
/jdk1.7.0_80/com/sun/mirror/declaration/MethodDeclaration.java,Java,,8,6,45,59
/jdk1.7.0_80/com/sun/mirror/declaration/Modifier.java,Java,,23,8,46,77
/jdk1.7.0_80/com/sun/mirror/declaration/package-info.java,Java,,1,1,38,40
/jdk1.7.0_80/com/sun/mirror/declaration/PackageDeclaration.java,Java,,11,10,80,101
/jdk1.7.0_80/com/sun/mirror/declaration/ParameterDeclaration.java,Java,,7,6,41,54
/jdk1.7.0_80/com/sun/mirror/declaration/TypeDeclaration.java,Java,,14,13,119,146
/jdk1.7.0_80/com/sun/mirror/declaration/TypeParameterDeclaration.java,Java,,9,8,52,69
/jdk1.7.0_80/com/sun/mirror/type/AnnotationType.java,Java,,7,6,39,52
/jdk1.7.0_80/com/sun/mirror/type/ArrayType.java,Java,,6,4,43,53
/jdk1.7.0_80/com/sun/mirror/type/ClassType.java,Java,,8,7,59,74
/jdk1.7.0_80/com/sun/mirror/type/DeclaredType.java,Java,,11,10,90,111
/jdk1.7.0_80/com/sun/mirror/type/EnumType.java,Java,,7,6,39,52
/jdk1.7.0_80/com/sun/mirror/type/InterfaceType.java,Java,,7,6,46,59
/jdk1.7.0_80/com/sun/mirror/type/MirroredTypeException.java,Java,,21,11,56,88
/jdk1.7.0_80/com/sun/mirror/type/MirroredTypesException.java,Java,,29,11,57,97
/jdk1.7.0_80/com/sun/mirror/type/package-info.java,Java,,1,1,35,37
/jdk1.7.0_80/com/sun/mirror/type/PrimitiveType.java,Java,,17,5,51,73
/jdk1.7.0_80/com/sun/mirror/type/ReferenceType.java,Java,,5,3,37,45
/jdk1.7.0_80/com/sun/mirror/type/TypeMirror.java,Java,,11,8,66,85
/jdk1.7.0_80/com/sun/mirror/type/TypeVariable.java,Java,,7,6,44,57
/jdk1.7.0_80/com/sun/mirror/type/VoidType.java,Java,,6,5,38,49
/jdk1.7.0_80/com/sun/mirror/type/WildcardType.java,Java,,8,7,59,74
/jdk1.7.0_80/com/sun/mirror/util/DeclarationFilter.java,Java,,108,38,173,319
/jdk1.7.0_80/com/sun/mirror/util/Declarations.java,Java,,8,7,54,69
/jdk1.7.0_80/com/sun/mirror/util/DeclarationScanner.java,Java,,105,37,125,267
/jdk1.7.0_80/com/sun/mirror/util/DeclarationVisitor.java,Java,,23,20,106,149
/jdk1.7.0_80/com/sun/mirror/util/DeclarationVisitors.java,Java,,15,5,84,104
/jdk1.7.0_80/com/sun/mirror/util/package-info.java,Java,,1,1,35,37
/jdk1.7.0_80/com/sun/mirror/util/SimpleDeclarationVisitor.java,Java,,55,22,139,216
/jdk1.7.0_80/com/sun/mirror/util/SimpleTypeVisitor.java,Java,,42,18,115,175
/jdk1.7.0_80/com/sun/mirror/util/SourceOrderDeclScanner.java,Java,,150,50,58,258
/jdk1.7.0_80/com/sun/mirror/util/SourcePosition.java,Java,,9,8,58,75
/jdk1.7.0_80/com/sun/mirror/util/Types.java,Java,,22,16,151,189
/jdk1.7.0_80/com/sun/mirror/util/TypeVisitor.java,Java,,18,17,102,137
/jdk1.7.0_80/com/sun/naming/internal/FactoryEnumeration.java,Java,,51,10,53,114
/jdk1.7.0_80/com/sun/naming/internal/NamedWeakReference.java,Java,,11,8,29,48
/jdk1.7.0_80/com/sun/naming/internal/ResourceManager.java,Java,,307,56,260,623
/jdk1.7.0_80/com/sun/naming/internal/VersionHelper.java,Java,,65,21,69,155
/jdk1.7.0_80/com/sun/naming/internal/VersionHelper12.java,Java,,174,28,66,268
/jdk1.7.0_80/com/sun/org/apache/bcel/internal/classfile/AccessFlags.java,Java,,74,22,78,174
/jdk1.7.0_80/com/sun/org/apache/bcel/internal/classfile/Attribute.java,Java,,113,41,154,308
/jdk1.7.0_80/com/sun/org/apache/bcel/internal/classfile/AttributeReader.java,Java,,7,2,91,100
/jdk1.7.0_80/com/sun/org/apache/bcel/internal/classfile/ClassFormatException.java,Java,,5,2,64,71
/jdk1.7.0_80/com/sun/org/apache/bcel/internal/classfile/ClassParser.java,Java,,120,41,170,331
/jdk1.7.0_80/com/sun/org/apache/bcel/internal/classfile/Code.java,Java,,152,50,174,376
/jdk1.7.0_80/com/sun/org/apache/bcel/internal/classfile/CodeException.java,Java,,74,21,137,232
/jdk1.7.0_80/com/sun/org/apache/bcel/internal/classfile/Constant.java,Java,,43,13,95,151
/jdk1.7.0_80/com/sun/org/apache/bcel/internal/classfile/ConstantClass.java,Java,,39,14,104,157
/jdk1.7.0_80/com/sun/org/apache/bcel/internal/classfile/ConstantCP.java,Java,,40,12,105,157
/jdk1.7.0_80/com/sun/org/apache/bcel/internal/classfile/ConstantDouble.java,Java,,36,8,101,145
/jdk1.7.0_80/com/sun/org/apache/bcel/internal/classfile/ConstantFieldref.java,Java,,19,6,82,107
/jdk1.7.0_80/com/sun/org/apache/bcel/internal/classfile/ConstantFloat.java,Java,,36,6,102,144
/jdk1.7.0_80/com/sun/org/apache/bcel/internal/classfile/ConstantInteger.java,Java,,36,14,101,151
/jdk1.7.0_80/com/sun/org/apache/bcel/internal/classfile/ConstantInterfaceMethodref.java,Java,,19,6,82,107
/jdk1.7.0_80/com/sun/org/apache/bcel/internal/classfile/ConstantLong.java,Java,,36,5,101,142
/jdk1.7.0_80/com/sun/org/apache/bcel/internal/classfile/ConstantMethodref.java,Java,,19,6,82,107
/jdk1.7.0_80/com/sun/org/apache/bcel/internal/classfile/ConstantNameAndType.java,Java,,48,15,111,174
/jdk1.7.0_80/com/sun/org/apache/bcel/internal/classfile/ConstantObject.java,Java,,4,2,66,72
/jdk1.7.0_80/com/sun/org/apache/bcel/internal/classfile/ConstantPool.java,Java,,160,42,173,375
/jdk1.7.0_80/com/sun/org/apache/bcel/internal/classfile/ConstantString.java,Java,,41,6,103,150
/jdk1.7.0_80/com/sun/org/apache/bcel/internal/classfile/ConstantUtf8.java,Java,,37,14,99,150
/jdk1.7.0_80/com/sun/org/apache/bcel/internal/classfile/ConstantValue.java,Java,,58,14,109,181
/jdk1.7.0_80/com/sun/org/apache/bcel/internal/classfile/Deprecated.java,Java,,48,16,108,172
/jdk1.7.0_80/com/sun/org/apache/bcel/internal/classfile/DescendingVisitor.java,Java,,232,58,80,370
/jdk1.7.0_80/com/sun/org/apache/bcel/internal/classfile/EmptyVisitor.java,Java,,39,4,66,109
/jdk1.7.0_80/com/sun/org/apache/bcel/internal/classfile/ExceptionTable.java,Java,,70,17,118,205
/jdk1.7.0_80/com/sun/org/apache/bcel/internal/classfile/Field.java,Java,,51,16,101,168
/jdk1.7.0_80/com/sun/org/apache/bcel/internal/classfile/FieldOrMethod.java,Java,,83,25,118,226
/jdk1.7.0_80/com/sun/org/apache/bcel/internal/classfile/InnerClass.java,Java,,84,15,125,224
/jdk1.7.0_80/com/sun/org/apache/bcel/internal/classfile/InnerClasses.java,Java,,56,17,111,184
/jdk1.7.0_80/com/sun/org/apache/bcel/internal/classfile/JavaClass.java,Java,,420,122,284,826
/jdk1.7.0_80/com/sun/org/apache/bcel/internal/classfile/LineNumber.java,Java,,44,15,108,167
/jdk1.7.0_80/com/sun/org/apache/bcel/internal/classfile/LineNumberTable.java,Java,,91,28,124,243
/jdk1.7.0_80/com/sun/org/apache/bcel/internal/classfile/LocalVariable.java,Java,,89,28,145,262
/jdk1.7.0_80/com/sun/org/apache/bcel/internal/classfile/LocalVariableTable.java,Java,,70,22,107,199
/jdk1.7.0_80/com/sun/org/apache/bcel/internal/classfile/LocalVariableTypeTable.java,Java,,72,23,51,146
/jdk1.7.0_80/com/sun/org/apache/bcel/internal/classfile/Method.java,Java,,84,26,121,231
/jdk1.7.0_80/com/sun/org/apache/bcel/internal/classfile/Node.java,Java,,4,2,62,68
/jdk1.7.0_80/com/sun/org/apache/bcel/internal/classfile/PMGClass.java,Java,,56,16,120,192
/jdk1.7.0_80/com/sun/org/apache/bcel/internal/classfile/Signature.java,Java,,134,44,121,299
/jdk1.7.0_80/com/sun/org/apache/bcel/internal/classfile/SourceFile.java,Java,,44,13,119,176
/jdk1.7.0_80/com/sun/org/apache/bcel/internal/classfile/StackMap.java,Java,,56,22,110,188
/jdk1.7.0_80/com/sun/org/apache/bcel/internal/classfile/StackMapEntry.java,Java,,90,26,96,212
/jdk1.7.0_80/com/sun/org/apache/bcel/internal/classfile/StackMapType.java,Java,,59,18,98,175
/jdk1.7.0_80/com/sun/org/apache/bcel/internal/classfile/Synthetic.java,Java,,51,14,114,179
/jdk1.7.0_80/com/sun/org/apache/bcel/internal/classfile/Unknown.java,Java,,73,21,122,216
/jdk1.7.0_80/com/sun/org/apache/bcel/internal/classfile/Utility.java,Java,,780,215,402,1397
/jdk1.7.0_80/com/sun/org/apache/bcel/internal/classfile/Visitor.java,Java,,36,2,67,105
/jdk1.7.0_80/com/sun/org/apache/bcel/internal/Constants.java,Java,,630,35,125,790
/jdk1.7.0_80/com/sun/org/apache/bcel/internal/ExceptionConstants.java,Java,,36,12,78,126
/jdk1.7.0_80/com/sun/org/apache/bcel/internal/generic/AALOAD.java,Java,,13,4,73,90
/jdk1.7.0_80/com/sun/org/apache/bcel/internal/generic/AASTORE.java,Java,,13,4,73,90
/jdk1.7.0_80/com/sun/org/apache/bcel/internal/generic/ACONST_NULL.java,Java,,16,5,76,97
/jdk1.7.0_80/com/sun/org/apache/bcel/internal/generic/AllocationInstruction.java,Java,,2,2,62,66
/jdk1.7.0_80/com/sun/org/apache/bcel/internal/generic/ALOAD.java,Java,,13,4,78,95
/jdk1.7.0_80/com/sun/org/apache/bcel/internal/generic/ANEWARRAY.java,Java,,33,9,75,117
/jdk1.7.0_80/com/sun/org/apache/bcel/internal/generic/ARETURN.java,Java,,13,4,74,91
/jdk1.7.0_80/com/sun/org/apache/bcel/internal/generic/ArithmeticInstruction.java,Java,,31,7,71,109
/jdk1.7.0_80/com/sun/org/apache/bcel/internal/generic/ArrayInstruction.java,Java,,32,6,71,109
/jdk1.7.0_80/com/sun/org/apache/bcel/internal/generic/ARRAYLENGTH.java,Java,,15,5,75,95
/jdk1.7.0_80/com/sun/org/apache/bcel/internal/generic/ArrayType.java,Java,,53,17,89,159
/jdk1.7.0_80/com/sun/org/apache/bcel/internal/generic/ASTORE.java,Java,,13,4,78,95
/jdk1.7.0_80/com/sun/org/apache/bcel/internal/generic/ATHROW.java,Java,,14,5,76,95
/jdk1.7.0_80/com/sun/org/apache/bcel/internal/generic/BALOAD.java,Java,,13,4,73,90
/jdk1.7.0_80/com/sun/org/apache/bcel/internal/generic/BasicType.java,Java,,33,7,70,110
/jdk1.7.0_80/com/sun/org/apache/bcel/internal/generic/BASTORE.java,Java,,13,4,73,90
/jdk1.7.0_80/com/sun/org/apache/bcel/internal/generic/BIPUSH.java,Java,,34,11,89,134
/jdk1.7.0_80/com/sun/org/apache/bcel/internal/generic/BranchHandle.java,Java,,48,17,88,153
/jdk1.7.0_80/com/sun/org/apache/bcel/internal/generic/BranchInstruction.java,Java,,99,27,143,269
/jdk1.7.0_80/com/sun/org/apache/bcel/internal/generic/BREAKPOINT.java,Java,,9,3,70,82
/jdk1.7.0_80/com/sun/org/apache/bcel/internal/generic/CALOAD.java,Java,,13,4,73,90
/jdk1.7.0_80/com/sun/org/apache/bcel/internal/generic/CASTORE.java,Java,,13,4,73,90
/jdk1.7.0_80/com/sun/org/apache/bcel/internal/generic/CHECKCAST.java,Java,,32,8,80,120
/jdk1.7.0_80/com/sun/org/apache/bcel/internal/generic/ClassGen.java,Java,,224,69,161,454
/jdk1.7.0_80/com/sun/org/apache/bcel/internal/generic/ClassGenException.java,Java,,5,2,63,70
/jdk1.7.0_80/com/sun/org/apache/bcel/internal/generic/ClassObserver.java,Java,,4,2,63,69
/jdk1.7.0_80/com/sun/org/apache/bcel/internal/generic/CodeExceptionGen.java,Java,,78,20,113,211
/jdk1.7.0_80/com/sun/org/apache/bcel/internal/generic/CompoundInstruction.java,Java,,4,2,72,78
/jdk1.7.0_80/com/sun/org/apache/bcel/internal/generic/ConstantPoolGen.java,Java,,374,152,263,789
/jdk1.7.0_80/com/sun/org/apache/bcel/internal/generic/ConstantPushInstruction.java,Java,,4,2,66,72
/jdk1.7.0_80/com/sun/org/apache/bcel/internal/generic/ConversionInstruction.java,Java,,29,4,71,104
/jdk1.7.0_80/com/sun/org/apache/bcel/internal/generic/CPInstruction.java,Java,,48,17,104,169
/jdk1.7.0_80/com/sun/org/apache/bcel/internal/generic/D2F.java,Java,,13,4,73,90
/jdk1.7.0_80/com/sun/org/apache/bcel/internal/generic/D2I.java,Java,,13,4,73,90
/jdk1.7.0_80/com/sun/org/apache/bcel/internal/generic/D2L.java,Java,,13,4,73,90
/jdk1.7.0_80/com/sun/org/apache/bcel/internal/generic/DADD.java,Java,,13,4,74,91
/jdk1.7.0_80/com/sun/org/apache/bcel/internal/generic/DALOAD.java,Java,,13,4,73,90
/jdk1.7.0_80/com/sun/org/apache/bcel/internal/generic/DASTORE.java,Java,,13,4,73,90
/jdk1.7.0_80/com/sun/org/apache/bcel/internal/generic/DCMPG.java,Java,,16,6,74,96
/jdk1.7.0_80/com/sun/org/apache/bcel/internal/generic/DCMPL.java,Java,,16,5,74,95
/jdk1.7.0_80/com/sun/org/apache/bcel/internal/generic/DCONST.java,Java,,27,9,78,114
/jdk1.7.0_80/com/sun/org/apache/bcel/internal/generic/DDIV.java,Java,,13,4,74,91
/jdk1.7.0_80/com/sun/org/apache/bcel/internal/generic/DLOAD.java,Java,,13,4,78,95
/jdk1.7.0_80/com/sun/org/apache/bcel/internal/generic/DMUL.java,Java,,13,4,74,91
/jdk1.7.0_80/com/sun/org/apache/bcel/internal/generic/DNEG.java,Java,,13,4,71,88
/jdk1.7.0_80/com/sun/org/apache/bcel/internal/generic/DREM.java,Java,,13,4,74,91
/jdk1.7.0_80/com/sun/org/apache/bcel/internal/generic/DRETURN.java,Java,,13,4,73,90
/jdk1.7.0_80/com/sun/org/apache/bcel/internal/generic/DSTORE.java,Java,,13,4,78,95
/jdk1.7.0_80/com/sun/org/apache/bcel/internal/generic/DSUB.java,Java,,13,4,74,91
/jdk1.7.0_80/com/sun/org/apache/bcel/internal/generic/DUP.java,Java,,12,4,71,87
/jdk1.7.0_80/com/sun/org/apache/bcel/internal/generic/DUP2.java,Java,,12,4,71,87
/jdk1.7.0_80/com/sun/org/apache/bcel/internal/generic/DUP2_X1.java,Java,,10,4,71,85
/jdk1.7.0_80/com/sun/org/apache/bcel/internal/generic/DUP2_X2.java,Java,,10,4,71,85
/jdk1.7.0_80/com/sun/org/apache/bcel/internal/generic/DUP_X1.java,Java,,10,4,71,85
/jdk1.7.0_80/com/sun/org/apache/bcel/internal/generic/DUP_X2.java,Java,,10,4,71,85
/jdk1.7.0_80/com/sun/org/apache/bcel/internal/generic/EmptyVisitor.java,Java,,183,2,62,247
/jdk1.7.0_80/com/sun/org/apache/bcel/internal/generic/ExceptionThrower.java,Java,,4,2,76,82
/jdk1.7.0_80/com/sun/org/apache/bcel/internal/generic/F2D.java,Java,,13,4,73,90
/jdk1.7.0_80/com/sun/org/apache/bcel/internal/generic/F2I.java,Java,,13,4,73,90
/jdk1.7.0_80/com/sun/org/apache/bcel/internal/generic/F2L.java,Java,,13,4,73,90
/jdk1.7.0_80/com/sun/org/apache/bcel/internal/generic/FADD.java,Java,,13,4,73,90
/jdk1.7.0_80/com/sun/org/apache/bcel/internal/generic/FALOAD.java,Java,,13,4,73,90
/jdk1.7.0_80/com/sun/org/apache/bcel/internal/generic/FASTORE.java,Java,,13,4,73,90
/jdk1.7.0_80/com/sun/org/apache/bcel/internal/generic/FCMPG.java,Java,,16,5,73,94
/jdk1.7.0_80/com/sun/org/apache/bcel/internal/generic/FCMPL.java,Java,,16,5,73,94
/jdk1.7.0_80/com/sun/org/apache/bcel/internal/generic/FCONST.java,Java,,29,9,78,116
/jdk1.7.0_80/com/sun/org/apache/bcel/internal/generic/FDIV.java,Java,,13,4,73,90
/jdk1.7.0_80/com/sun/org/apache/bcel/internal/generic/FieldGen.java,Java,,154,53,106,313
/jdk1.7.0_80/com/sun/org/apache/bcel/internal/generic/FieldGenOrMethodGen.java,Java,,40,14,84,138
/jdk1.7.0_80/com/sun/org/apache/bcel/internal/generic/FieldInstruction.java,Java,,29,9,80,118
/jdk1.7.0_80/com/sun/org/apache/bcel/internal/generic/FieldObserver.java,Java,,4,2,63,69
/jdk1.7.0_80/com/sun/org/apache/bcel/internal/generic/FieldOrMethod.java,Java,,31,9,80,120
/jdk1.7.0_80/com/sun/org/apache/bcel/internal/generic/FLOAD.java,Java,,13,4,78,95
/jdk1.7.0_80/com/sun/org/apache/bcel/internal/generic/FMUL.java,Java,,13,4,73,90
/jdk1.7.0_80/com/sun/org/apache/bcel/internal/generic/FNEG.java,Java,,13,4,71,88
/jdk1.7.0_80/com/sun/org/apache/bcel/internal/generic/FREM.java,Java,,13,4,73,90
/jdk1.7.0_80/com/sun/org/apache/bcel/internal/generic/FRETURN.java,Java,,13,4,73,90
/jdk1.7.0_80/com/sun/org/apache/bcel/internal/generic/FSTORE.java,Java,,13,4,78,95
/jdk1.7.0_80/com/sun/org/apache/bcel/internal/generic/FSUB.java,Java,,13,4,73,90
/jdk1.7.0_80/com/sun/org/apache/bcel/internal/generic/GETFIELD.java,Java,,32,11,77,120
/jdk1.7.0_80/com/sun/org/apache/bcel/internal/generic/GETSTATIC.java,Java,,29,10,77,116
/jdk1.7.0_80/com/sun/org/apache/bcel/internal/generic/GOTO.java,Java,,35,9,81,125
/jdk1.7.0_80/com/sun/org/apache/bcel/internal/generic/GotoInstruction.java,Java,,9,3,66,78
/jdk1.7.0_80/com/sun/org/apache/bcel/internal/generic/GOTO_W.java,Java,,26,6,81,113
/jdk1.7.0_80/com/sun/org/apache/bcel/internal/generic/I2B.java,Java,,13,4,73,90
/jdk1.7.0_80/com/sun/org/apache/bcel/internal/generic/I2C.java,Java,,13,4,73,90
/jdk1.7.0_80/com/sun/org/apache/bcel/internal/generic/I2D.java,Java,,13,4,73,90
/jdk1.7.0_80/com/sun/org/apache/bcel/internal/generic/I2F.java,Java,,13,4,73,90
/jdk1.7.0_80/com/sun/org/apache/bcel/internal/generic/I2L.java,Java,,13,4,73,90
/jdk1.7.0_80/com/sun/org/apache/bcel/internal/generic/I2S.java,Java,,13,4,71,88
/jdk1.7.0_80/com/sun/org/apache/bcel/internal/generic/IADD.java,Java,,13,4,73,90
/jdk1.7.0_80/com/sun/org/apache/bcel/internal/generic/IALOAD.java,Java,,13,4,74,91
/jdk1.7.0_80/com/sun/org/apache/bcel/internal/generic/IAND.java,Java,,13,4,71,88
/jdk1.7.0_80/com/sun/org/apache/bcel/internal/generic/IASTORE.java,Java,,13,4,74,91
/jdk1.7.0_80/com/sun/org/apache/bcel/internal/generic/ICONST.java,Java,,26,8,78,112
/jdk1.7.0_80/com/sun/org/apache/bcel/internal/generic/IDIV.java,Java,,17,5,75,97
/jdk1.7.0_80/com/sun/org/apache/bcel/internal/generic/IFEQ.java,Java,,16,6,79,101
/jdk1.7.0_80/com/sun/org/apache/bcel/internal/generic/IFGE.java,Java,,16,6,79,101
/jdk1.7.0_80/com/sun/org/apache/bcel/internal/generic/IFGT.java,Java,,16,6,79,101
/jdk1.7.0_80/com/sun/org/apache/bcel/internal/generic/IfInstruction.java,Java,,8,4,72,84
/jdk1.7.0_80/com/sun/org/apache/bcel/internal/generic/IFLE.java,Java,,16,6,79,101
/jdk1.7.0_80/com/sun/org/apache/bcel/internal/generic/IFLT.java,Java,,16,6,79,101
/jdk1.7.0_80/com/sun/org/apache/bcel/internal/generic/IFNE.java,Java,,16,6,79,101
/jdk1.7.0_80/com/sun/org/apache/bcel/internal/generic/IFNONNULL.java,Java,,16,5,79,100
/jdk1.7.0_80/com/sun/org/apache/bcel/internal/generic/IFNULL.java,Java,,16,6,79,101
/jdk1.7.0_80/com/sun/org/apache/bcel/internal/generic/IF_ACMPEQ.java,Java,,16,5,79,100
/jdk1.7.0_80/com/sun/org/apache/bcel/internal/generic/IF_ACMPNE.java,Java,,16,6,79,101
/jdk1.7.0_80/com/sun/org/apache/bcel/internal/generic/IF_ICMPEQ.java,Java,,16,6,79,101
/jdk1.7.0_80/com/sun/org/apache/bcel/internal/generic/IF_ICMPGE.java,Java,,16,6,79,101
/jdk1.7.0_80/com/sun/org/apache/bcel/internal/generic/IF_ICMPGT.java,Java,,16,6,79,101
/jdk1.7.0_80/com/sun/org/apache/bcel/internal/generic/IF_ICMPLE.java,Java,,16,6,79,101
/jdk1.7.0_80/com/sun/org/apache/bcel/internal/generic/IF_ICMPLT.java,Java,,16,6,79,101
/jdk1.7.0_80/com/sun/org/apache/bcel/internal/generic/IF_ICMPNE.java,Java,,16,6,79,101
/jdk1.7.0_80/com/sun/org/apache/bcel/internal/generic/IINC.java,Java,,68,19,99,186
/jdk1.7.0_80/com/sun/org/apache/bcel/internal/generic/ILOAD.java,Java,,13,4,78,95
/jdk1.7.0_80/com/sun/org/apache/bcel/internal/generic/IMPDEP1.java,Java,,9,4,70,83
/jdk1.7.0_80/com/sun/org/apache/bcel/internal/generic/IMPDEP2.java,Java,,9,4,70,83
/jdk1.7.0_80/com/sun/org/apache/bcel/internal/generic/IMUL.java,Java,,13,4,73,90
/jdk1.7.0_80/com/sun/org/apache/bcel/internal/generic/IndexedInstruction.java,Java,,5,2,63,70
/jdk1.7.0_80/com/sun/org/apache/bcel/internal/generic/INEG.java,Java,,13,4,71,88
/jdk1.7.0_80/com/sun/org/apache/bcel/internal/generic/INSTANCEOF.java,Java,,26,8,75,109
/jdk1.7.0_80/com/sun/org/apache/bcel/internal/generic/Instruction.java,Java,,108,39,161,308
/jdk1.7.0_80/com/sun/org/apache/bcel/internal/generic/InstructionComparator.java,Java,,37,6,69,112
/jdk1.7.0_80/com/sun/org/apache/bcel/internal/generic/InstructionConstants.java,Java,,237,8,84,329
/jdk1.7.0_80/com/sun/org/apache/bcel/internal/generic/InstructionFactory.java,Java,,421,66,139,626
/jdk1.7.0_80/com/sun/org/apache/bcel/internal/generic/InstructionHandle.java,Java,,110,35,142,287
/jdk1.7.0_80/com/sun/org/apache/bcel/internal/generic/InstructionList.java,Java,,612,194,483,1289
/jdk1.7.0_80/com/sun/org/apache/bcel/internal/generic/InstructionListObserver.java,Java,,4,2,63,69
/jdk1.7.0_80/com/sun/org/apache/bcel/internal/generic/InstructionTargeter.java,Java,,5,2,66,73
/jdk1.7.0_80/com/sun/org/apache/bcel/internal/generic/InvokeInstruction.java,Java,,45,14,90,149
/jdk1.7.0_80/com/sun/org/apache/bcel/internal/generic/INVOKEINTERFACE.java,Java,,59,18,89,166
/jdk1.7.0_80/com/sun/org/apache/bcel/internal/generic/INVOKESPECIAL.java,Java,,30,9,77,116
/jdk1.7.0_80/com/sun/org/apache/bcel/internal/generic/INVOKESTATIC.java,Java,,28,9,76,113
/jdk1.7.0_80/com/sun/org/apache/bcel/internal/generic/INVOKEVIRTUAL.java,Java,,30,9,76,115
/jdk1.7.0_80/com/sun/org/apache/bcel/internal/generic/IOR.java,Java,,13,4,71,88
/jdk1.7.0_80/com/sun/org/apache/bcel/internal/generic/IREM.java,Java,,17,5,75,97
/jdk1.7.0_80/com/sun/org/apache/bcel/internal/generic/IRETURN.java,Java,,13,4,73,90
/jdk1.7.0_80/com/sun/org/apache/bcel/internal/generic/ISHL.java,Java,,13,4,71,88
/jdk1.7.0_80/com/sun/org/apache/bcel/internal/generic/ISHR.java,Java,,13,4,71,88
/jdk1.7.0_80/com/sun/org/apache/bcel/internal/generic/ISTORE.java,Java,,13,4,78,95
/jdk1.7.0_80/com/sun/org/apache/bcel/internal/generic/ISUB.java,Java,,13,4,73,90
/jdk1.7.0_80/com/sun/org/apache/bcel/internal/generic/IUSHR.java,Java,,13,4,71,88
/jdk1.7.0_80/com/sun/org/apache/bcel/internal/generic/IXOR.java,Java,,13,4,71,88
/jdk1.7.0_80/com/sun/org/apache/bcel/internal/generic/JSR.java,Java,,35,9,78,122
/jdk1.7.0_80/com/sun/org/apache/bcel/internal/generic/JsrInstruction.java,Java,,26,10,82,118
/jdk1.7.0_80/com/sun/org/apache/bcel/internal/generic/JSR_W.java,Java,,26,6,81,113
/jdk1.7.0_80/com/sun/org/apache/bcel/internal/generic/L2D.java,Java,,13,4,71,88
/jdk1.7.0_80/com/sun/org/apache/bcel/internal/generic/L2F.java,Java,,13,4,71,88
/jdk1.7.0_80/com/sun/org/apache/bcel/internal/generic/L2I.java,Java,,13,4,71,88
/jdk1.7.0_80/com/sun/org/apache/bcel/internal/generic/LADD.java,Java,,13,4,72,89
/jdk1.7.0_80/com/sun/org/apache/bcel/internal/generic/LALOAD.java,Java,,13,4,73,90
/jdk1.7.0_80/com/sun/org/apache/bcel/internal/generic/LAND.java,Java,,13,4,72,89
/jdk1.7.0_80/com/sun/org/apache/bcel/internal/generic/LASTORE.java,Java,,13,4,73,90
/jdk1.7.0_80/com/sun/org/apache/bcel/internal/generic/LCMP.java,Java,,17,4,74,95
/jdk1.7.0_80/com/sun/org/apache/bcel/internal/generic/LCONST.java,Java,,27,9,78,114
/jdk1.7.0_80/com/sun/org/apache/bcel/internal/generic/LDC.java,Java,,72,16,87,175
/jdk1.7.0_80/com/sun/org/apache/bcel/internal/generic/LDC2_W.java,Java,,34,9,76,119
/jdk1.7.0_80/com/sun/org/apache/bcel/internal/generic/LDC_W.java,Java,,15,4,72,91
/jdk1.7.0_80/com/sun/org/apache/bcel/internal/generic/LDIV.java,Java,,17,5,72,94
/jdk1.7.0_80/com/sun/org/apache/bcel/internal/generic/LineNumberGen.java,Java,,43,10,83,136
/jdk1.7.0_80/com/sun/org/apache/bcel/internal/generic/LLOAD.java,Java,,13,4,75,92
/jdk1.7.0_80/com/sun/org/apache/bcel/internal/generic/LMUL.java,Java,,13,4,72,89
/jdk1.7.0_80/com/sun/org/apache/bcel/internal/generic/LNEG.java,Java,,13,4,71,88
/jdk1.7.0_80/com/sun/org/apache/bcel/internal/generic/LoadClass.java,Java,,5,3,81,89
/jdk1.7.0_80/com/sun/org/apache/bcel/internal/generic/LoadInstruction.java,Java,,18,4,81,103
/jdk1.7.0_80/com/sun/org/apache/bcel/internal/generic/LocalVariableGen.java,Java,,115,34,141,290
/jdk1.7.0_80/com/sun/org/apache/bcel/internal/generic/LocalVariableInstruction.java,Java,,99,21,109,229
/jdk1.7.0_80/com/sun/org/apache/bcel/internal/generic/LOOKUPSWITCH.java,Java,,40,12,84,136
/jdk1.7.0_80/com/sun/org/apache/bcel/internal/generic/LOR.java,Java,,13,4,71,88
/jdk1.7.0_80/com/sun/org/apache/bcel/internal/generic/LREM.java,Java,,15,5,71,91
/jdk1.7.0_80/com/sun/org/apache/bcel/internal/generic/LRETURN.java,Java,,13,4,71,88
/jdk1.7.0_80/com/sun/org/apache/bcel/internal/generic/LSHL.java,Java,,13,4,71,88
/jdk1.7.0_80/com/sun/org/apache/bcel/internal/generic/LSHR.java,Java,,13,4,71,88
/jdk1.7.0_80/com/sun/org/apache/bcel/internal/generic/LSTORE.java,Java,,13,4,75,92
/jdk1.7.0_80/com/sun/org/apache/bcel/internal/generic/LSUB.java,Java,,13,4,72,89
/jdk1.7.0_80/com/sun/org/apache/bcel/internal/generic/LUSHR.java,Java,,13,4,71,88
/jdk1.7.0_80/com/sun/org/apache/bcel/internal/generic/LXOR.java,Java,,13,4,71,88
/jdk1.7.0_80/com/sun/org/apache/bcel/internal/generic/MethodGen.java,Java,,597,166,326,1089
/jdk1.7.0_80/com/sun/org/apache/bcel/internal/generic/MethodObserver.java,Java,,4,2,63,69
/jdk1.7.0_80/com/sun/org/apache/bcel/internal/generic/MONITORENTER.java,Java,,15,5,71,91
/jdk1.7.0_80/com/sun/org/apache/bcel/internal/generic/MONITOREXIT.java,Java,,15,5,71,91
/jdk1.7.0_80/com/sun/org/apache/bcel/internal/generic/MULTIANEWARRAY.java,Java,,59,20,96,175
/jdk1.7.0_80/com/sun/org/apache/bcel/internal/generic/NamedAndTyped.java,Java,,7,3,63,73
/jdk1.7.0_80/com/sun/org/apache/bcel/internal/generic/NEW.java,Java,,30,9,75,114
/jdk1.7.0_80/com/sun/org/apache/bcel/internal/generic/NEWARRAY.java,Java,,40,11,92,143
/jdk1.7.0_80/com/sun/org/apache/bcel/internal/generic/NOP.java,Java,,9,4,70,83
/jdk1.7.0_80/com/sun/org/apache/bcel/internal/generic/ObjectType.java,Java,,45,12,82,139
/jdk1.7.0_80/com/sun/org/apache/bcel/internal/generic/POP.java,Java,,12,4,72,88
/jdk1.7.0_80/com/sun/org/apache/bcel/internal/generic/POP2.java,Java,,12,4,72,88
/jdk1.7.0_80/com/sun/org/apache/bcel/internal/generic/PopInstruction.java,Java,,3,2,65,70
/jdk1.7.0_80/com/sun/org/apache/bcel/internal/generic/PUSH.java,Java,,80,14,104,198
/jdk1.7.0_80/com/sun/org/apache/bcel/internal/generic/PushInstruction.java,Java,,3,2,70,75
/jdk1.7.0_80/com/sun/org/apache/bcel/internal/generic/PUTFIELD.java,Java,,33,11,77,121
/jdk1.7.0_80/com/sun/org/apache/bcel/internal/generic/PUTSTATIC.java,Java,,30,10,77,117
/jdk1.7.0_80/com/sun/org/apache/bcel/internal/generic/ReferenceType.java,Java,,140,40,172,352
/jdk1.7.0_80/com/sun/org/apache/bcel/internal/generic/RET.java,Java,,54,16,94,164
/jdk1.7.0_80/com/sun/org/apache/bcel/internal/generic/RETURN.java,Java,,13,4,71,88
/jdk1.7.0_80/com/sun/org/apache/bcel/internal/generic/ReturnaddressType.java,Java,,27,9,75,111
/jdk1.7.0_80/com/sun/org/apache/bcel/internal/generic/ReturnInstruction.java,Java,,28,7,71,106
/jdk1.7.0_80/com/sun/org/apache/bcel/internal/generic/SALOAD.java,Java,,13,4,71,88
/jdk1.7.0_80/com/sun/org/apache/bcel/internal/generic/SASTORE.java,Java,,13,4,71,88
/jdk1.7.0_80/com/sun/org/apache/bcel/internal/generic/Select.java,Java,,106,36,125,267
/jdk1.7.0_80/com/sun/org/apache/bcel/internal/generic/SIPUSH.java,Java,,34,10,87,131
/jdk1.7.0_80/com/sun/org/apache/bcel/internal/generic/StackConsumer.java,Java,,4,2,64,70
/jdk1.7.0_80/com/sun/org/apache/bcel/internal/generic/StackInstruction.java,Java,,10,4,71,85
/jdk1.7.0_80/com/sun/org/apache/bcel/internal/generic/StackProducer.java,Java,,4,2,65,71
/jdk1.7.0_80/com/sun/org/apache/bcel/internal/generic/StoreInstruction.java,Java,,18,4,81,103
/jdk1.7.0_80/com/sun/org/apache/bcel/internal/generic/SWAP.java,Java,,12,4,71,87
/jdk1.7.0_80/com/sun/org/apache/bcel/internal/generic/SWITCH.java,Java,,79,22,85,186
/jdk1.7.0_80/com/sun/org/apache/bcel/internal/generic/TABLESWITCH.java,Java,,44,16,90,150
/jdk1.7.0_80/com/sun/org/apache/bcel/internal/generic/TargetLostException.java,Java,,9,4,90,103
/jdk1.7.0_80/com/sun/org/apache/bcel/internal/generic/Type.java,Java,,147,33,110,290
/jdk1.7.0_80/com/sun/org/apache/bcel/internal/generic/TypedInstruction.java,Java,,4,2,63,69
/jdk1.7.0_80/com/sun/org/apache/bcel/internal/generic/UnconditionalBranch.java,Java,,2,2,65,69
/jdk1.7.0_80/com/sun/org/apache/bcel/internal/generic/VariableLengthInstruction.java,Java,,2,2,68,72
/jdk1.7.0_80/com/sun/org/apache/bcel/internal/generic/Visitor.java,Java,,183,2,65,250
/jdk1.7.0_80/com/sun/org/apache/bcel/internal/Repository.java,Java,,85,25,140,250
/jdk1.7.0_80/com/sun/org/apache/bcel/internal/util/AttributeHTML.java,Java,,138,47,73,258
/jdk1.7.0_80/com/sun/org/apache/bcel/internal/util/BCELFactory.java,Java,,231,64,65,360
/jdk1.7.0_80/com/sun/org/apache/bcel/internal/util/BCELifier.java,Java,,183,51,73,307
/jdk1.7.0_80/com/sun/org/apache/bcel/internal/util/ByteSequence.java,Java,,16,5,64,85
/jdk1.7.0_80/com/sun/org/apache/bcel/internal/util/Class2HTML.java,Java,,138,31,97,266
/jdk1.7.0_80/com/sun/org/apache/bcel/internal/util/ClassLoader.java,Java,,91,26,107,224
/jdk1.7.0_80/com/sun/org/apache/bcel/internal/util/ClassLoaderRepository.java,Java,,56,18,83,157
/jdk1.7.0_80/com/sun/org/apache/bcel/internal/util/ClassPath.java,Java,,189,66,129,384
/jdk1.7.0_80/com/sun/org/apache/bcel/internal/util/ClassQueue.java,Java,,14,6,64,84
/jdk1.7.0_80/com/sun/org/apache/bcel/internal/util/ClassSet.java,Java,,26,8,65,99
/jdk1.7.0_80/com/sun/org/apache/bcel/internal/util/ClassStack.java,Java,,10,3,63,76
/jdk1.7.0_80/com/sun/org/apache/bcel/internal/util/ClassVector.java,Java,,14,4,64,82
/jdk1.7.0_80/com/sun/org/apache/bcel/internal/util/CodeHTML.java,Java,,381,100,140,621
/jdk1.7.0_80/com/sun/org/apache/bcel/internal/util/ConstantHTML.java,Java,,151,39,75,265
/jdk1.7.0_80/com/sun/org/apache/bcel/internal/util/InstructionFinder.java,Java,,203,59,181,443
/jdk1.7.0_80/com/sun/org/apache/bcel/internal/util/JavaWrapper.java,Java,,54,16,85,155
/jdk1.7.0_80/com/sun/org/apache/bcel/internal/util/MethodHTML.java,Java,,94,27,81,202
/jdk1.7.0_80/com/sun/org/apache/bcel/internal/util/Objects.java,Java,,12,4,29,45
/jdk1.7.0_80/com/sun/org/apache/bcel/internal/util/Repository.java,Java,,12,8,85,105
/jdk1.7.0_80/com/sun/org/apache/bcel/internal/util/SecuritySupport.java,Java,,147,21,55,223
/jdk1.7.0_80/com/sun/org/apache/bcel/internal/util/SyntheticRepository.java,Java,,82,28,97,207
/jdk1.7.0_80/com/sun/org/apache/regexp/internal/CharacterArrayCharacterIterator.java,Java,,37,7,32,76
/jdk1.7.0_80/com/sun/org/apache/regexp/internal/CharacterIterator.java,Java,,8,5,29,42
/jdk1.7.0_80/com/sun/org/apache/regexp/internal/RE.java,Java,,895,166,699,1760
/jdk1.7.0_80/com/sun/org/apache/regexp/internal/ReaderCharacterIterator.java,Java,,112,17,35,164
/jdk1.7.0_80/com/sun/org/apache/regexp/internal/recompile.java,Java,,56,11,70,137
/jdk1.7.0_80/com/sun/org/apache/regexp/internal/RECompiler.java,Java,,993,181,346,1520
/jdk1.7.0_80/com/sun/org/apache/regexp/internal/REDebugCompiler.java,Java,,103,25,97,225
/jdk1.7.0_80/com/sun/org/apache/regexp/internal/REProgram.java,Java,,73,15,70,158
/jdk1.7.0_80/com/sun/org/apache/regexp/internal/RESyntaxException.java,Java,,8,2,33,43
/jdk1.7.0_80/com/sun/org/apache/regexp/internal/RETest.java,Java,,640,82,161,883
/jdk1.7.0_80/com/sun/org/apache/regexp/internal/REUtil.java,Java,,17,4,40,61
/jdk1.7.0_80/com/sun/org/apache/regexp/internal/StreamCharacterIterator.java,Java,,109,17,35,161
/jdk1.7.0_80/com/sun/org/apache/regexp/internal/StringCharacterIterator.java,Java,,25,7,30,62
/jdk1.7.0_80/com/sun/org/apache/xalan/internal/extensions/ExpressionContext.java,Java,,17,11,67,95
/jdk1.7.0_80/com/sun/org/apache/xalan/internal/lib/ExsltBase.java,Java,,43,4,39,86
/jdk1.7.0_80/com/sun/org/apache/xalan/internal/lib/ExsltCommon.java,Java,,31,4,73,108
/jdk1.7.0_80/com/sun/org/apache/xalan/internal/lib/ExsltDatetime.java,Java,,564,81,477,1122
/jdk1.7.0_80/com/sun/org/apache/xalan/internal/lib/ExsltDynamic.java,Java,,296,70,250,616
/jdk1.7.0_80/com/sun/org/apache/xalan/internal/lib/ExsltMath.java,Java,,157,36,198,391
/jdk1.7.0_80/com/sun/org/apache/xalan/internal/lib/ExsltSets.java,Java,,103,28,110,241
/jdk1.7.0_80/com/sun/org/apache/xalan/internal/lib/ExsltStrings.java,Java,,158,33,160,351
/jdk1.7.0_80/com/sun/org/apache/xalan/internal/lib/Extensions.java,Java,,169,41,182,392
/jdk1.7.0_80/com/sun/org/apache/xalan/internal/lib/NodeInfo.java,Java,,105,24,121,250
/jdk1.7.0_80/com/sun/org/apache/xalan/internal/res/XSLMessages.java,Java,,31,8,54,93
/jdk1.7.0_80/com/sun/org/apache/xalan/internal/res/XSLTErrorResources.java,Java,,966,284,200,1450
/jdk1.7.0_80/com/sun/org/apache/xalan/internal/res/XSLTErrorResources_de.java,Java,,966,284,200,1450
/jdk1.7.0_80/com/sun/org/apache/xalan/internal/res/XSLTErrorResources_en.java,Java,,4,2,27,33
/jdk1.7.0_80/com/sun/org/apache/xalan/internal/res/XSLTErrorResources_es.java,Java,,966,284,200,1450
/jdk1.7.0_80/com/sun/org/apache/xalan/internal/res/XSLTErrorResources_fr.java,Java,,966,284,200,1450
/jdk1.7.0_80/com/sun/org/apache/xalan/internal/res/XSLTErrorResources_it.java,Java,,966,284,200,1450
/jdk1.7.0_80/com/sun/org/apache/xalan/internal/res/XSLTErrorResources_ja.java,Java,,966,284,200,1450
/jdk1.7.0_80/com/sun/org/apache/xalan/internal/res/XSLTErrorResources_ko.java,Java,,966,284,200,1450
/jdk1.7.0_80/com/sun/org/apache/xalan/internal/res/XSLTErrorResources_pt_BR.java,Java,,966,284,200,1450
/jdk1.7.0_80/com/sun/org/apache/xalan/internal/res/XSLTErrorResources_sv.java,Java,,966,284,200,1450
/jdk1.7.0_80/com/sun/org/apache/xalan/internal/res/XSLTErrorResources_zh_CN.java,Java,,966,284,200,1450
/jdk1.7.0_80/com/sun/org/apache/xalan/internal/res/XSLTErrorResources_zh_TW.java,Java,,966,284,200,1450
/jdk1.7.0_80/com/sun/org/apache/xalan/internal/templates/Constants.java,Java,,278,36,87,401
/jdk1.7.0_80/com/sun/org/apache/xalan/internal/utils/ConfigurationError.java,Java,,12,9,40,61
/jdk1.7.0_80/com/sun/org/apache/xalan/internal/utils/FactoryImpl.java,Java,,23,6,28,57
/jdk1.7.0_80/com/sun/org/apache/xalan/internal/utils/FeatureManager.java,Java,,48,17,59,124
/jdk1.7.0_80/com/sun/org/apache/xalan/internal/utils/FeaturePropertyBase.java,Java,,86,21,108,215
/jdk1.7.0_80/com/sun/org/apache/xalan/internal/utils/ObjectFactory.java,Java,,328,51,267,646
/jdk1.7.0_80/com/sun/org/apache/xalan/internal/utils/Objects.java,Java,,12,4,29,45
/jdk1.7.0_80/com/sun/org/apache/xalan/internal/utils/SecuritySupport.java,Java,,223,31,91,345
/jdk1.7.0_80/com/sun/org/apache/xalan/internal/utils/XMLSecurityManager.java,Java,,223,46,168,437
/jdk1.7.0_80/com/sun/org/apache/xalan/internal/utils/XMLSecurityPropertyManager.java,Java,,44,14,44,102
/jdk1.7.0_80/com/sun/org/apache/xalan/internal/Version.java,Java,,46,11,98,155
/jdk1.7.0_80/com/sun/org/apache/xalan/internal/XalanConstants.java,Java,,62,31,158,251
/jdk1.7.0_80/com/sun/org/apache/xalan/internal/xslt/EnvironmentCheck.java,Java,,718,172,413,1303
/jdk1.7.0_80/com/sun/org/apache/xalan/internal/xslt/Process.java,Java,,796,116,314,1226
/jdk1.7.0_80/com/sun/org/apache/xalan/internal/xsltc/cmdline/Compile.java,Java,,111,17,43,171
/jdk1.7.0_80/com/sun/org/apache/xalan/internal/xsltc/cmdline/getopt/GetOpt.java,Java,,144,18,96,258
/jdk1.7.0_80/com/sun/org/apache/xalan/internal/xsltc/cmdline/getopt/GetOptsException.java,Java,,7,2,25,34
/jdk1.7.0_80/com/sun/org/apache/xalan/internal/xsltc/cmdline/getopt/IllegalArgumentException.java,Java,,7,3,22,32
/jdk1.7.0_80/com/sun/org/apache/xalan/internal/xsltc/cmdline/getopt/MissingOptArgException.java,Java,,7,3,25,35
/jdk1.7.0_80/com/sun/org/apache/xalan/internal/xsltc/cmdline/Transform.java,Java,,224,30,43,297
/jdk1.7.0_80/com/sun/org/apache/xalan/internal/xsltc/CollatorFactory.java,Java,,7,4,26,37
/jdk1.7.0_80/com/sun/org/apache/xalan/internal/xsltc/compiler/AbsoluteLocationPath.java,Java,,79,13,38,130
/jdk1.7.0_80/com/sun/org/apache/xalan/internal/xsltc/compiler/AbsolutePathPattern.java,Java,,94,17,31,142
/jdk1.7.0_80/com/sun/org/apache/xalan/internal/xsltc/compiler/AlternativePattern.java,Java,,54,15,33,102
/jdk1.7.0_80/com/sun/org/apache/xalan/internal/xsltc/compiler/AncestorPattern.java,Java,,121,26,37,184
/jdk1.7.0_80/com/sun/org/apache/xalan/internal/xsltc/compiler/ApplyImports.java,Java,,83,22,56,161
/jdk1.7.0_80/com/sun/org/apache/xalan/internal/xsltc/compiler/ApplyTemplates.java,Java,,141,22,41,204
/jdk1.7.0_80/com/sun/org/apache/xalan/internal/xsltc/compiler/ArgumentList.java,Java,,14,4,26,44
/jdk1.7.0_80/com/sun/org/apache/xalan/internal/xsltc/compiler/Attribute.java,Java,,14,5,28,47
/jdk1.7.0_80/com/sun/org/apache/xalan/internal/xsltc/compiler/AttributeSet.java,Java,,114,29,66,209
/jdk1.7.0_80/com/sun/org/apache/xalan/internal/xsltc/compiler/AttributeValue.java,Java,,19,5,26,50
/jdk1.7.0_80/com/sun/org/apache/xalan/internal/xsltc/compiler/AttributeValueTemplate.java,Java,,201,19,43,263
/jdk1.7.0_80/com/sun/org/apache/xalan/internal/xsltc/compiler/BinOpExpr.java,Java,,85,14,33,132
/jdk1.7.0_80/com/sun/org/apache/xalan/internal/xsltc/compiler/BooleanCall.java,Java,,25,8,26,59
/jdk1.7.0_80/com/sun/org/apache/xalan/internal/xsltc/compiler/BooleanExpr.java,Java,,43,10,28,81
/jdk1.7.0_80/com/sun/org/apache/xalan/internal/xsltc/compiler/CallTemplate.java,Java,,143,28,71,242
/jdk1.7.0_80/com/sun/org/apache/xalan/internal/xsltc/compiler/CastCall.java,Java,,48,13,41,102
/jdk1.7.0_80/com/sun/org/apache/xalan/internal/xsltc/compiler/CastExpr.java,Java,,160,28,51,239
/jdk1.7.0_80/com/sun/org/apache/xalan/internal/xsltc/compiler/CeilingCall.java,Java,,19,5,26,50
/jdk1.7.0_80/com/sun/org/apache/xalan/internal/xsltc/compiler/Choose.java,Java,,100,19,49,168
/jdk1.7.0_80/com/sun/org/apache/xalan/internal/xsltc/compiler/Closure.java,Java,,7,6,39,52
/jdk1.7.0_80/com/sun/org/apache/xalan/internal/xsltc/compiler/Comment.java,Java,,68,12,38,118
/jdk1.7.0_80/com/sun/org/apache/xalan/internal/xsltc/compiler/CompilerException.java,Java,,23,8,25,56
/jdk1.7.0_80/com/sun/org/apache/xalan/internal/xsltc/compiler/ConcatCall.java,Java,,59,11,27,97
/jdk1.7.0_80/com/sun/org/apache/xalan/internal/xsltc/compiler/Constants.java,Java,,429,41,38,508
/jdk1.7.0_80/com/sun/org/apache/xalan/internal/xsltc/compiler/ContainsCall.java,Java,,50,14,45,109
/jdk1.7.0_80/com/sun/org/apache/xalan/internal/xsltc/compiler/Copy.java,Java,,103,15,41,159
/jdk1.7.0_80/com/sun/org/apache/xalan/internal/xsltc/compiler/CopyOf.java,Java,,97,15,31,143
/jdk1.7.0_80/com/sun/org/apache/xalan/internal/xsltc/compiler/CurrentCall.java,Java,,11,4,26,41
/jdk1.7.0_80/com/sun/org/apache/xalan/internal/xsltc/compiler/DecimalFormatting.java,Java,,170,28,60,258
/jdk1.7.0_80/com/sun/org/apache/xalan/internal/xsltc/compiler/DocumentCall.java,Java,,88,23,47,158
/jdk1.7.0_80/com/sun/org/apache/xalan/internal/xsltc/compiler/ElementAvailableCall.java,Java,,44,9,42,95
/jdk1.7.0_80/com/sun/org/apache/xalan/internal/xsltc/compiler/EqualityExpr.java,Java,,273,42,46,361
/jdk1.7.0_80/com/sun/org/apache/xalan/internal/xsltc/compiler/Expression.java,Java,,121,26,77,224
/jdk1.7.0_80/com/sun/org/apache/xalan/internal/xsltc/compiler/Fallback.java,Java,,32,10,39,81
/jdk1.7.0_80/com/sun/org/apache/xalan/internal/xsltc/compiler/FilteredAbsoluteLocationPath.java,Java,,77,14,36,127
/jdk1.7.0_80/com/sun/org/apache/xalan/internal/xsltc/compiler/FilterExpr.java,Java,,149,31,74,254
/jdk1.7.0_80/com/sun/org/apache/xalan/internal/xsltc/compiler/FilterParentPath.java,Java,,106,21,49,176
/jdk1.7.0_80/com/sun/org/apache/xalan/internal/xsltc/compiler/FloorCall.java,Java,,17,5,26,48
/jdk1.7.0_80/com/sun/org/apache/xalan/internal/xsltc/compiler/FlowList.java,Java,,72,14,33,119
/jdk1.7.0_80/com/sun/org/apache/xalan/internal/xsltc/compiler/ForEach.java,Java,,114,28,56,198
/jdk1.7.0_80/com/sun/org/apache/xalan/internal/xsltc/compiler/FormatNumberCall.java,Java,,75,13,28,116
/jdk1.7.0_80/com/sun/org/apache/xalan/internal/xsltc/compiler/FunctionAvailableCall.java,Java,,111,25,60,196
/jdk1.7.0_80/com/sun/org/apache/xalan/internal/xsltc/compiler/FunctionCall.java,Java,,802,148,177,1127
/jdk1.7.0_80/com/sun/org/apache/xalan/internal/xsltc/compiler/GenerateIdCall.java,Java,,25,5,27,57
/jdk1.7.0_80/com/sun/org/apache/xalan/internal/xsltc/compiler/IdKeyPattern.java,Java,,73,20,36,129
/jdk1.7.0_80/com/sun/org/apache/xalan/internal/xsltc/compiler/IdPattern.java,Java,,6,5,26,37
/jdk1.7.0_80/com/sun/org/apache/xalan/internal/xsltc/compiler/If.java,Java,,53,11,48,112
/jdk1.7.0_80/com/sun/org/apache/xalan/internal/xsltc/compiler/IllegalCharException.java,Java,,7,2,26,35
/jdk1.7.0_80/com/sun/org/apache/xalan/internal/xsltc/compiler/Import.java,Java,,116,19,33,168
/jdk1.7.0_80/com/sun/org/apache/xalan/internal/xsltc/compiler/Include.java,Java,,115,19,34,168
/jdk1.7.0_80/com/sun/org/apache/xalan/internal/xsltc/compiler/Instruction.java,Java,,16,4,32,52
/jdk1.7.0_80/com/sun/org/apache/xalan/internal/xsltc/compiler/IntExpr.java,Java,,25,7,26,58
/jdk1.7.0_80/com/sun/org/apache/xalan/internal/xsltc/compiler/Key.java,Java,,169,51,83,303
/jdk1.7.0_80/com/sun/org/apache/xalan/internal/xsltc/compiler/KeyCall.java,Java,,111,26,101,238
/jdk1.7.0_80/com/sun/org/apache/xalan/internal/xsltc/compiler/KeyPattern.java,Java,,6,4,26,36
/jdk1.7.0_80/com/sun/org/apache/xalan/internal/xsltc/compiler/LangCall.java,Java,,45,9,39,93
/jdk1.7.0_80/com/sun/org/apache/xalan/internal/xsltc/compiler/LastCall.java,Java,,37,8,26,71
/jdk1.7.0_80/com/sun/org/apache/xalan/internal/xsltc/compiler/LiteralAttribute.java,Java,,84,21,54,159
/jdk1.7.0_80/com/sun/org/apache/xalan/internal/xsltc/compiler/LiteralElement.java,Java,,354,59,136,549
/jdk1.7.0_80/com/sun/org/apache/xalan/internal/xsltc/compiler/LiteralExpr.java,Java,,40,12,35,87
/jdk1.7.0_80/com/sun/org/apache/xalan/internal/xsltc/compiler/LocalNameCall.java,Java,,31,9,36,76
/jdk1.7.0_80/com/sun/org/apache/xalan/internal/xsltc/compiler/LocationPathPattern.java,Java,,58,15,36,109
/jdk1.7.0_80/com/sun/org/apache/xalan/internal/xsltc/compiler/LogicalExpr.java,Java,,115,33,87,235
/jdk1.7.0_80/com/sun/org/apache/xalan/internal/xsltc/compiler/Message.java,Java,,104,22,43,169
/jdk1.7.0_80/com/sun/org/apache/xalan/internal/xsltc/compiler/Mode.java,Java,,958,212,355,1525
/jdk1.7.0_80/com/sun/org/apache/xalan/internal/xsltc/compiler/NameBase.java,Java,,69,16,45,130
/jdk1.7.0_80/com/sun/org/apache/xalan/internal/xsltc/compiler/NameCall.java,Java,,24,8,36,68
/jdk1.7.0_80/com/sun/org/apache/xalan/internal/xsltc/compiler/NamespaceAlias.java,Java,,19,7,31,57
/jdk1.7.0_80/com/sun/org/apache/xalan/internal/xsltc/compiler/NamespaceUriCall.java,Java,,25,8,36,69
/jdk1.7.0_80/com/sun/org/apache/xalan/internal/xsltc/compiler/NodeTest.java,Java,,13,5,27,45
/jdk1.7.0_80/com/sun/org/apache/xalan/internal/xsltc/compiler/NotCall.java,Java,,28,6,26,60
/jdk1.7.0_80/com/sun/org/apache/xalan/internal/xsltc/compiler/Number.java,Java,,436,76,88,600
/jdk1.7.0_80/com/sun/org/apache/xalan/internal/xsltc/compiler/NumberCall.java,Java,,35,9,26,70
/jdk1.7.0_80/com/sun/org/apache/xalan/internal/xsltc/compiler/Otherwise.java,Java,,24,5,26,55
/jdk1.7.0_80/com/sun/org/apache/xalan/internal/xsltc/compiler/Output.java,Java,,289,53,79,421
/jdk1.7.0_80/com/sun/org/apache/xalan/internal/xsltc/compiler/Param.java,Java,,153,24,81,258
/jdk1.7.0_80/com/sun/org/apache/xalan/internal/xsltc/compiler/ParameterRef.java,Java,,62,12,37,111
/jdk1.7.0_80/com/sun/org/apache/xalan/internal/xsltc/compiler/ParentLocationPath.java,Java,,162,37,53,252
/jdk1.7.0_80/com/sun/org/apache/xalan/internal/xsltc/compiler/ParentPattern.java,Java,,99,24,30,153
/jdk1.7.0_80/com/sun/org/apache/xalan/internal/xsltc/compiler/Parser.java,Java,,1055,152,243,1450
/jdk1.7.0_80/com/sun/org/apache/xalan/internal/xsltc/compiler/Pattern.java,Java,,11,5,46,62
/jdk1.7.0_80/com/sun/org/apache/xalan/internal/xsltc/compiler/PositionCall.java,Java,,34,8,27,69
/jdk1.7.0_80/com/sun/org/apache/xalan/internal/xsltc/compiler/Predicate.java,Java,,352,78,189,619
/jdk1.7.0_80/com/sun/org/apache/xalan/internal/xsltc/compiler/ProcessingInstruction.java,Java,,86,19,37,142
/jdk1.7.0_80/com/sun/org/apache/xalan/internal/xsltc/compiler/ProcessingInstructionPattern.java,Java,,97,19,44,160
/jdk1.7.0_80/com/sun/org/apache/xalan/internal/xsltc/compiler/QName.java,Java,,46,14,27,87
/jdk1.7.0_80/com/sun/org/apache/xalan/internal/xsltc/compiler/RealExpr.java,Java,,25,7,26,58
/jdk1.7.0_80/com/sun/org/apache/xalan/internal/xsltc/compiler/RelationalExpr.java,Java,,203,36,44,283
/jdk1.7.0_80/com/sun/org/apache/xalan/internal/xsltc/compiler/RelativeLocationPath.java,Java,,5,2,26,33
/jdk1.7.0_80/com/sun/org/apache/xalan/internal/xsltc/compiler/RelativePathPattern.java,Java,,2,2,26,30
/jdk1.7.0_80/com/sun/org/apache/xalan/internal/xsltc/compiler/RoundCall.java,Java,,19,7,27,53
/jdk1.7.0_80/com/sun/org/apache/xalan/internal/xsltc/compiler/SimpleAttributeValue.java,Java,,28,9,40,77
/jdk1.7.0_80/com/sun/org/apache/xalan/internal/xsltc/compiler/Sort.java,Java,,506,107,137,750
/jdk1.7.0_80/com/sun/org/apache/xalan/internal/xsltc/compiler/SourceLoader.java,Java,,5,5,34,44
/jdk1.7.0_80/com/sun/org/apache/xalan/internal/xsltc/compiler/StartsWithCall.java,Java,,42,12,39,93
/jdk1.7.0_80/com/sun/org/apache/xalan/internal/xsltc/compiler/Step.java,Java,,334,53,151,538
/jdk1.7.0_80/com/sun/org/apache/xalan/internal/xsltc/compiler/StepPattern.java,Java,,379,78,77,534
/jdk1.7.0_80/com/sun/org/apache/xalan/internal/xsltc/compiler/StringCall.java,Java,,41,9,26,76
/jdk1.7.0_80/com/sun/org/apache/xalan/internal/xsltc/compiler/StringLengthCall.java,Java,,27,5,26,58
/jdk1.7.0_80/com/sun/org/apache/xalan/internal/xsltc/compiler/Stylesheet.java,Java,,904,203,339,1446
/jdk1.7.0_80/com/sun/org/apache/xalan/internal/xsltc/compiler/sym.java,Java,,57,3,6,66
/jdk1.7.0_80/com/sun/org/apache/xalan/internal/xsltc/compiler/SymbolTable.java,Java,,175,38,82,295
/jdk1.7.0_80/com/sun/org/apache/xalan/internal/xsltc/compiler/SyntaxTreeNode.java,Java,,460,97,362,919
/jdk1.7.0_80/com/sun/org/apache/xalan/internal/xsltc/compiler/Template.java,Java,,233,58,52,343
/jdk1.7.0_80/com/sun/org/apache/xalan/internal/xsltc/compiler/TestSeq.java,Java,,135,39,115,289
/jdk1.7.0_80/com/sun/org/apache/xalan/internal/xsltc/compiler/Text.java,Java,,148,27,72,247
/jdk1.7.0_80/com/sun/org/apache/xalan/internal/xsltc/compiler/TopLevelElement.java,Java,,44,12,44,100
/jdk1.7.0_80/com/sun/org/apache/xalan/internal/xsltc/compiler/TransletOutput.java,Java,,76,22,50,148
/jdk1.7.0_80/com/sun/org/apache/xalan/internal/xsltc/compiler/UnaryOpExpr.java,Java,,45,12,33,90
/jdk1.7.0_80/com/sun/org/apache/xalan/internal/xsltc/compiler/UnionPathExpr.java,Java,,97,17,34,148
/jdk1.7.0_80/com/sun/org/apache/xalan/internal/xsltc/compiler/UnparsedEntityUriCall.java,Java,,35,7,30,72
/jdk1.7.0_80/com/sun/org/apache/xalan/internal/xsltc/compiler/UnresolvedRef.java,Java,,62,14,28,104
/jdk1.7.0_80/com/sun/org/apache/xalan/internal/xsltc/compiler/UnsupportedElement.java,Java,,79,16,57,152
/jdk1.7.0_80/com/sun/org/apache/xalan/internal/xsltc/compiler/UseAttributeSets.java,Java,,58,12,48,118
/jdk1.7.0_80/com/sun/org/apache/xalan/internal/xsltc/compiler/util/AttributeSetMethodGenerator.java,Java,,44,10,25,79
/jdk1.7.0_80/com/sun/org/apache/xalan/internal/xsltc/compiler/util/BooleanType.java,Java,,137,22,66,225
/jdk1.7.0_80/com/sun/org/apache/xalan/internal/xsltc/compiler/util/ClassGenerator.java,Java,,81,16,47,144
/jdk1.7.0_80/com/sun/org/apache/xalan/internal/xsltc/compiler/util/CompareGenerator.java,Java,,76,17,27,120
/jdk1.7.0_80/com/sun/org/apache/xalan/internal/xsltc/compiler/util/ErrorMessages.java,Java,,282,124,619,1025
/jdk1.7.0_80/com/sun/org/apache/xalan/internal/xsltc/compiler/util/ErrorMessages_ca.java,Java,,203,107,553,863
/jdk1.7.0_80/com/sun/org/apache/xalan/internal/xsltc/compiler/util/ErrorMessages_cs.java,Java,,203,107,553,863
/jdk1.7.0_80/com/sun/org/apache/xalan/internal/xsltc/compiler/util/ErrorMessages_de.java,Java,,232,123,619,974
/jdk1.7.0_80/com/sun/org/apache/xalan/internal/xsltc/compiler/util/ErrorMessages_es.java,Java,,232,123,619,974
/jdk1.7.0_80/com/sun/org/apache/xalan/internal/xsltc/compiler/util/ErrorMessages_fr.java,Java,,232,123,619,974
/jdk1.7.0_80/com/sun/org/apache/xalan/internal/xsltc/compiler/util/ErrorMessages_it.java,Java,,232,123,619,974
/jdk1.7.0_80/com/sun/org/apache/xalan/internal/xsltc/compiler/util/ErrorMessages_ja.java,Java,,232,123,619,974
/jdk1.7.0_80/com/sun/org/apache/xalan/internal/xsltc/compiler/util/ErrorMessages_ko.java,Java,,232,123,619,974
/jdk1.7.0_80/com/sun/org/apache/xalan/internal/xsltc/compiler/util/ErrorMessages_pt_BR.java,Java,,232,123,619,974
/jdk1.7.0_80/com/sun/org/apache/xalan/internal/xsltc/compiler/util/ErrorMessages_sk.java,Java,,203,107,553,863
/jdk1.7.0_80/com/sun/org/apache/xalan/internal/xsltc/compiler/util/ErrorMessages_sv.java,Java,,232,123,619,974
/jdk1.7.0_80/com/sun/org/apache/xalan/internal/xsltc/compiler/util/ErrorMessages_zh_CN.java,Java,,232,123,619,974
/jdk1.7.0_80/com/sun/org/apache/xalan/internal/xsltc/compiler/util/ErrorMessages_zh_TW.java,Java,,232,123,619,974
/jdk1.7.0_80/com/sun/org/apache/xalan/internal/xsltc/compiler/util/ErrorMsg.java,Java,,242,33,51,326
/jdk1.7.0_80/com/sun/org/apache/xalan/internal/xsltc/compiler/util/FilterGenerator.java,Java,,22,7,37,66
/jdk1.7.0_80/com/sun/org/apache/xalan/internal/xsltc/compiler/util/InternalError.java,Java,,6,1,30,37
/jdk1.7.0_80/com/sun/org/apache/xalan/internal/xsltc/compiler/util/IntType.java,Java,,196,29,77,302
/jdk1.7.0_80/com/sun/org/apache/xalan/internal/xsltc/compiler/util/MarkerInstruction.java,Java,,25,6,67,98
/jdk1.7.0_80/com/sun/org/apache/xalan/internal/xsltc/compiler/util/MatchGenerator.java,Java,,51,15,38,104
/jdk1.7.0_80/com/sun/org/apache/xalan/internal/xsltc/compiler/util/MethodGenerator.java,Java,,1156,254,739,2149
/jdk1.7.0_80/com/sun/org/apache/xalan/internal/xsltc/compiler/util/MethodType.java,Java,,126,17,30,173
/jdk1.7.0_80/com/sun/org/apache/xalan/internal/xsltc/compiler/util/MultiHashtable.java,Java,,27,4,26,57
/jdk1.7.0_80/com/sun/org/apache/xalan/internal/xsltc/compiler/util/NamedMethodGenerator.java,Java,,30,8,29,67
/jdk1.7.0_80/com/sun/org/apache/xalan/internal/xsltc/compiler/util/NodeCounterGenerator.java,Java,,25,7,43,75
/jdk1.7.0_80/com/sun/org/apache/xalan/internal/xsltc/compiler/util/NodeSetType.java,Java,,194,30,107,331
/jdk1.7.0_80/com/sun/org/apache/xalan/internal/xsltc/compiler/util/NodeSortRecordFactGenerator.java,Java,,14,5,30,49
/jdk1.7.0_80/com/sun/org/apache/xalan/internal/xsltc/compiler/util/NodeSortRecordGenerator.java,Java,,22,7,36,65
/jdk1.7.0_80/com/sun/org/apache/xalan/internal/xsltc/compiler/util/NodeType.java,Java,,201,32,91,324
/jdk1.7.0_80/com/sun/org/apache/xalan/internal/xsltc/compiler/util/NumberType.java,Java,,9,4,26,39
/jdk1.7.0_80/com/sun/org/apache/xalan/internal/xsltc/compiler/util/ObjectType.java,Java,,101,22,56,179
/jdk1.7.0_80/com/sun/org/apache/xalan/internal/xsltc/compiler/util/OutlineableChunkEnd.java,Java,,17,5,48,70
/jdk1.7.0_80/com/sun/org/apache/xalan/internal/xsltc/compiler/util/OutlineableChunkStart.java,Java,,17,6,57,80
/jdk1.7.0_80/com/sun/org/apache/xalan/internal/xsltc/compiler/util/RealType.java,Java,,225,33,85,343
/jdk1.7.0_80/com/sun/org/apache/xalan/internal/xsltc/compiler/util/ReferenceType.java,Java,,257,31,91,379
/jdk1.7.0_80/com/sun/org/apache/xalan/internal/xsltc/compiler/util/ResultTreeType.java,Java,,272,46,147,465
/jdk1.7.0_80/com/sun/org/apache/xalan/internal/xsltc/compiler/util/RtMethodGenerator.java,Java,,33,9,28,70
/jdk1.7.0_80/com/sun/org/apache/xalan/internal/xsltc/compiler/util/SlotAllocator.java,Java,,63,13,26,102
/jdk1.7.0_80/com/sun/org/apache/xalan/internal/xsltc/compiler/util/StringStack.java,Java,,14,5,26,45
/jdk1.7.0_80/com/sun/org/apache/xalan/internal/xsltc/compiler/util/StringType.java,Java,,129,23,79,231
/jdk1.7.0_80/com/sun/org/apache/xalan/internal/xsltc/compiler/util/TestGenerator.java,Java,,72,17,28,117
/jdk1.7.0_80/com/sun/org/apache/xalan/internal/xsltc/compiler/util/Type.java,Java,,164,38,96,298
/jdk1.7.0_80/com/sun/org/apache/xalan/internal/xsltc/compiler/util/TypeCheckError.java,Java,,41,12,26,79
/jdk1.7.0_80/com/sun/org/apache/xalan/internal/xsltc/compiler/util/Util.java,Java,,126,29,49,204
/jdk1.7.0_80/com/sun/org/apache/xalan/internal/xsltc/compiler/util/VoidType.java,Java,,47,11,42,100
/jdk1.7.0_80/com/sun/org/apache/xalan/internal/xsltc/compiler/ValueOf.java,Java,,81,14,45,140
/jdk1.7.0_80/com/sun/org/apache/xalan/internal/xsltc/compiler/Variable.java,Java,,121,21,63,205
/jdk1.7.0_80/com/sun/org/apache/xalan/internal/xsltc/compiler/VariableBase.java,Java,,156,32,100,288
/jdk1.7.0_80/com/sun/org/apache/xalan/internal/xsltc/compiler/VariableRef.java,Java,,57,10,30,97
/jdk1.7.0_80/com/sun/org/apache/xalan/internal/xsltc/compiler/VariableRefBase.java,Java,,79,22,64,165
/jdk1.7.0_80/com/sun/org/apache/xalan/internal/xsltc/compiler/When.java,Java,,50,14,43,107
/jdk1.7.0_80/com/sun/org/apache/xalan/internal/xsltc/compiler/Whitespace.java,Java,,337,63,132,532
/jdk1.7.0_80/com/sun/org/apache/xalan/internal/xsltc/compiler/WithParam.java,Java,,104,22,85,211
/jdk1.7.0_80/com/sun/org/apache/xalan/internal/xsltc/compiler/XPathLexer.java,Java,,1557,19,43,1619
/jdk1.7.0_80/com/sun/org/apache/xalan/internal/xsltc/compiler/XPathParser.java,Java,,2639,259,248,3146
/jdk1.7.0_80/com/sun/org/apache/xalan/internal/xsltc/compiler/XslAttribute.java,Java,,184,41,70,295
/jdk1.7.0_80/com/sun/org/apache/xalan/internal/xsltc/compiler/XslElement.java,Java,,189,40,66,295
/jdk1.7.0_80/com/sun/org/apache/xalan/internal/xsltc/compiler/XSLTC.java,Java,,597,117,323,1037
/jdk1.7.0_80/com/sun/org/apache/xalan/internal/xsltc/dom/AbsoluteIterator.java,Java,,50,12,39,101
/jdk1.7.0_80/com/sun/org/apache/xalan/internal/xsltc/dom/AdaptiveResultTreeImpl.java,Java,,1108,152,84,1344
/jdk1.7.0_80/com/sun/org/apache/xalan/internal/xsltc/dom/AnyNodeCounter.java,Java,,82,9,40,131
/jdk1.7.0_80/com/sun/org/apache/xalan/internal/xsltc/dom/ArrayNodeListIterator.java,Java,,48,21,22,91
/jdk1.7.0_80/com/sun/org/apache/xalan/internal/xsltc/dom/BitArray.java,Java,,159,33,76,268
/jdk1.7.0_80/com/sun/org/apache/xalan/internal/xsltc/dom/CachedNodeListIterator.java,Java,,66,16,33,115
/jdk1.7.0_80/com/sun/org/apache/xalan/internal/xsltc/dom/ClonedNodeListIterator.java,Java,,37,14,32,83
/jdk1.7.0_80/com/sun/org/apache/xalan/internal/xsltc/dom/CollatorFactoryBase.java,Java,,19,8,25,52
/jdk1.7.0_80/com/sun/org/apache/xalan/internal/xsltc/dom/CurrentNodeListFilter.java,Java,,7,3,27,37
/jdk1.7.0_80/com/sun/org/apache/xalan/internal/xsltc/dom/CurrentNodeListIterator.java,Java,,117,28,56,201
/jdk1.7.0_80/com/sun/org/apache/xalan/internal/xsltc/dom/DocumentCache.java,Java,,213,48,80,341
/jdk1.7.0_80/com/sun/org/apache/xalan/internal/xsltc/dom/DOMAdapter.java,Java,,357,71,40,468
/jdk1.7.0_80/com/sun/org/apache/xalan/internal/xsltc/dom/DOMBuilder.java,Java,,2,2,25,29
/jdk1.7.0_80/com/sun/org/apache/xalan/internal/xsltc/dom/DOMWSFilter.java,Java,,62,14,56,132
/jdk1.7.0_80/com/sun/org/apache/xalan/internal/xsltc/dom/DupFilterIterator.java,Java,,85,22,59,166
/jdk1.7.0_80/com/sun/org/apache/xalan/internal/xsltc/dom/EmptyFilter.java,Java,,6,2,26,34
/jdk1.7.0_80/com/sun/org/apache/xalan/internal/xsltc/dom/ExtendedSAX.java,Java,,9,2,25,36
/jdk1.7.0_80/com/sun/org/apache/xalan/internal/xsltc/dom/Filter.java,Java,,4,2,26,32
/jdk1.7.0_80/com/sun/org/apache/xalan/internal/xsltc/dom/FilteredStepIterator.java,Java,,20,7,29,56
/jdk1.7.0_80/com/sun/org/apache/xalan/internal/xsltc/dom/FilterIterator.java,Java,,62,18,40,120
/jdk1.7.0_80/com/sun/org/apache/xalan/internal/xsltc/dom/ForwardPositionIterator.java,Java,,41,11,57,109
/jdk1.7.0_80/com/sun/org/apache/xalan/internal/xsltc/dom/KeyIndex.java,Java,,381,116,404,901
/jdk1.7.0_80/com/sun/org/apache/xalan/internal/xsltc/dom/LoadDocument.java,Java,,195,35,75,305
/jdk1.7.0_80/com/sun/org/apache/xalan/internal/xsltc/dom/MatchingIterator.java,Java,,61,18,50,129
/jdk1.7.0_80/com/sun/org/apache/xalan/internal/xsltc/dom/MultiDOM.java,Java,,504,102,65,671
/jdk1.7.0_80/com/sun/org/apache/xalan/internal/xsltc/dom/MultipleNodeCounter.java,Java,,75,14,31,120
/jdk1.7.0_80/com/sun/org/apache/xalan/internal/xsltc/dom/MultiValuedNodeHeapIterator.java,Java,,165,35,96,296
/jdk1.7.0_80/com/sun/org/apache/xalan/internal/xsltc/dom/NodeCounter.java,Java,,271,48,97,416
/jdk1.7.0_80/com/sun/org/apache/xalan/internal/xsltc/dom/NodeIteratorBase.java,Java,,65,19,88,172
/jdk1.7.0_80/com/sun/org/apache/xalan/internal/xsltc/dom/NodeSortRecord.java,Java,,136,30,86,252
/jdk1.7.0_80/com/sun/org/apache/xalan/internal/xsltc/dom/NodeSortRecordFactory.java,Java,,92,21,53,166
/jdk1.7.0_80/com/sun/org/apache/xalan/internal/xsltc/dom/NthIterator.java,Java,,61,13,43,117
/jdk1.7.0_80/com/sun/org/apache/xalan/internal/xsltc/dom/SAXImpl.java,Java,,1182,238,487,1907
/jdk1.7.0_80/com/sun/org/apache/xalan/internal/xsltc/dom/SimpleResultTreeImpl.java,Java,,733,175,112,1020
/jdk1.7.0_80/com/sun/org/apache/xalan/internal/xsltc/dom/SingleNodeCounter.java,Java,,109,18,31,158
/jdk1.7.0_80/com/sun/org/apache/xalan/internal/xsltc/dom/SingletonIterator.java,Java,,53,11,30,94
/jdk1.7.0_80/com/sun/org/apache/xalan/internal/xsltc/dom/SortingIterator.java,Java,,99,18,34,151
/jdk1.7.0_80/com/sun/org/apache/xalan/internal/xsltc/dom/SortSettings.java,Java,,39,16,85,140
/jdk1.7.0_80/com/sun/org/apache/xalan/internal/xsltc/dom/StepIterator.java,Java,,68,16,56,140
/jdk1.7.0_80/com/sun/org/apache/xalan/internal/xsltc/dom/StripWhitespaceFilter.java,Java,,5,3,26,34
/jdk1.7.0_80/com/sun/org/apache/xalan/internal/xsltc/dom/UnionIterator.java,Java,,53,14,33,100
/jdk1.7.0_80/com/sun/org/apache/xalan/internal/xsltc/dom/XSLTCDTMManager.java,Java,,249,49,187,485
/jdk1.7.0_80/com/sun/org/apache/xalan/internal/xsltc/DOM.java,Java,,66,11,30,107
/jdk1.7.0_80/com/sun/org/apache/xalan/internal/xsltc/DOMCache.java,Java,,4,5,49,58
/jdk1.7.0_80/com/sun/org/apache/xalan/internal/xsltc/DOMEnhancedForDTM.java,Java,,12,1,34,47
/jdk1.7.0_80/com/sun/org/apache/xalan/internal/xsltc/NodeIterator.java,Java,,15,14,57,86
/jdk1.7.0_80/com/sun/org/apache/xalan/internal/xsltc/ProcessorVersion.java,Java,,10,4,37,51
/jdk1.7.0_80/com/sun/org/apache/xalan/internal/xsltc/runtime/AbstractTranslet.java,Java,,451,109,235,795
/jdk1.7.0_80/com/sun/org/apache/xalan/internal/xsltc/runtime/Attributes.java,Java,,29,10,26,65
/jdk1.7.0_80/com/sun/org/apache/xalan/internal/xsltc/runtime/BasisLibrary.java,Java,,1198,158,318,1674
/jdk1.7.0_80/com/sun/org/apache/xalan/internal/xsltc/runtime/Constants.java,Java,,19,6,28,53
/jdk1.7.0_80/com/sun/org/apache/xalan/internal/xsltc/runtime/ErrorMessages.java,Java,,57,32,198,287
/jdk1.7.0_80/com/sun/org/apache/xalan/internal/xsltc/runtime/ErrorMessages_ca.java,Java,,43,24,167,234
/jdk1.7.0_80/com/sun/org/apache/xalan/internal/xsltc/runtime/ErrorMessages_cs.java,Java,,43,24,167,234
/jdk1.7.0_80/com/sun/org/apache/xalan/internal/xsltc/runtime/ErrorMessages_de.java,Java,,57,32,198,287
/jdk1.7.0_80/com/sun/org/apache/xalan/internal/xsltc/runtime/ErrorMessages_es.java,Java,,57,32,198,287
/jdk1.7.0_80/com/sun/org/apache/xalan/internal/xsltc/runtime/ErrorMessages_fr.java,Java,,57,32,198,287
/jdk1.7.0_80/com/sun/org/apache/xalan/internal/xsltc/runtime/ErrorMessages_it.java,Java,,57,32,198,287
/jdk1.7.0_80/com/sun/org/apache/xalan/internal/xsltc/runtime/ErrorMessages_ja.java,Java,,57,32,198,287
/jdk1.7.0_80/com/sun/org/apache/xalan/internal/xsltc/runtime/ErrorMessages_ko.java,Java,,57,32,198,287
/jdk1.7.0_80/com/sun/org/apache/xalan/internal/xsltc/runtime/ErrorMessages_pt_BR.java,Java,,57,32,198,287
/jdk1.7.0_80/com/sun/org/apache/xalan/internal/xsltc/runtime/ErrorMessages_sk.java,Java,,43,24,167,234
/jdk1.7.0_80/com/sun/org/apache/xalan/internal/xsltc/runtime/ErrorMessages_sv.java,Java,,57,32,198,287
/jdk1.7.0_80/com/sun/org/apache/xalan/internal/xsltc/runtime/ErrorMessages_zh_CN.java,Java,,57,32,198,287
/jdk1.7.0_80/com/sun/org/apache/xalan/internal/xsltc/runtime/ErrorMessages_zh_TW.java,Java,,57,32,198,287
/jdk1.7.0_80/com/sun/org/apache/xalan/internal/xsltc/runtime/Hashtable.java,Java,,198,42,105,345
/jdk1.7.0_80/com/sun/org/apache/xalan/internal/xsltc/runtime/InternalRuntimeError.java,Java,,6,4,26,36
/jdk1.7.0_80/com/sun/org/apache/xalan/internal/xsltc/runtime/MessageHandler.java,Java,,6,2,25,33
/jdk1.7.0_80/com/sun/org/apache/xalan/internal/xsltc/runtime/Node.java,Java,,9,3,28,40
/jdk1.7.0_80/com/sun/org/apache/xalan/internal/xsltc/runtime/Operators.java,Java,,26,7,27,60
/jdk1.7.0_80/com/sun/org/apache/xalan/internal/xsltc/runtime/output/OutputBuffer.java,Java,,7,4,25,36
/jdk1.7.0_80/com/sun/org/apache/xalan/internal/xsltc/runtime/output/StringOutputBuffer.java,Java,,22,8,25,55
/jdk1.7.0_80/com/sun/org/apache/xalan/internal/xsltc/runtime/output/TransletOutputHandlerFactory.java,Java,,199,46,27,272
/jdk1.7.0_80/com/sun/org/apache/xalan/internal/xsltc/runtime/output/WriterOutputBuffer.java,Java,,55,10,32,97
/jdk1.7.0_80/com/sun/org/apache/xalan/internal/xsltc/runtime/Parameter.java,Java,,16,5,27,48
/jdk1.7.0_80/com/sun/org/apache/xalan/internal/xsltc/runtime/StringValueHandler.java,Java,,76,18,33,127
/jdk1.7.0_80/com/sun/org/apache/xalan/internal/xsltc/StripFilter.java,Java,,4,3,26,33
/jdk1.7.0_80/com/sun/org/apache/xalan/internal/xsltc/Translet.java,Java,,24,7,26,57
/jdk1.7.0_80/com/sun/org/apache/xalan/internal/xsltc/TransletException.java,Java,,15,6,27,48
/jdk1.7.0_80/com/sun/org/apache/xalan/internal/xsltc/trax/DOM2SAX.java,Java,,307,56,122,485
/jdk1.7.0_80/com/sun/org/apache/xalan/internal/xsltc/trax/DOM2TO.java,Java,,260,58,118,436
/jdk1.7.0_80/com/sun/org/apache/xalan/internal/xsltc/trax/OutputSettings.java,Java,,17,7,25,49
/jdk1.7.0_80/com/sun/org/apache/xalan/internal/xsltc/trax/SAX2DOM.java,Java,,216,45,75,336
/jdk1.7.0_80/com/sun/org/apache/xalan/internal/xsltc/trax/SAX2StAXBaseWriter.java,Java,,155,50,43,248
/jdk1.7.0_80/com/sun/org/apache/xalan/internal/xsltc/trax/SAX2StAXEventWriter.java,Java,,223,151,46,420
/jdk1.7.0_80/com/sun/org/apache/xalan/internal/xsltc/trax/SAX2StAXStreamWriter.java,Java,,139,110,53,302
/jdk1.7.0_80/com/sun/org/apache/xalan/internal/xsltc/trax/SmartTransformerFactoryImpl.java,Java,,289,35,131,455
/jdk1.7.0_80/com/sun/org/apache/xalan/internal/xsltc/trax/StAXEvent2SAX.java,Java,,372,76,153,601
/jdk1.7.0_80/com/sun/org/apache/xalan/internal/xsltc/trax/StAXStream2SAX.java,Java,,325,78,147,550
/jdk1.7.0_80/com/sun/org/apache/xalan/internal/xsltc/trax/TemplatesHandlerImpl.java,Java,,174,47,131,352
/jdk1.7.0_80/com/sun/org/apache/xalan/internal/xsltc/trax/TemplatesImpl.java,Java,,246,58,176,480
/jdk1.7.0_80/com/sun/org/apache/xalan/internal/xsltc/trax/TransformerFactoryImpl.java,Java,,975,157,470,1602
/jdk1.7.0_80/com/sun/org/apache/xalan/internal/xsltc/trax/TransformerHandlerImpl.java,Java,,271,55,161,487
/jdk1.7.0_80/com/sun/org/apache/xalan/internal/xsltc/trax/TransformerImpl.java,Java,,875,133,422,1430
/jdk1.7.0_80/com/sun/org/apache/xalan/internal/xsltc/trax/TrAXFilter.java,Java,,99,20,29,148
/jdk1.7.0_80/com/sun/org/apache/xalan/internal/xsltc/trax/Util.java,Java,,178,34,45,257
/jdk1.7.0_80/com/sun/org/apache/xalan/internal/xsltc/trax/XSLTCSource.java,Java,,75,19,48,142
/jdk1.7.0_80/com/sun/org/apache/xalan/internal/xsltc/util/IntegerArray.java,Java,,158,33,37,228
/jdk1.7.0_80/com/sun/org/apache/xerces/internal/dom/AttributeMap.java,Java,,362,70,174,606
/jdk1.7.0_80/com/sun/org/apache/xerces/internal/dom/AttrImpl.java,Java,,573,159,507,1239
/jdk1.7.0_80/com/sun/org/apache/xerces/internal/dom/AttrNSImpl.java,Java,,182,34,136,352
/jdk1.7.0_80/com/sun/org/apache/xerces/internal/dom/CDATASectionImpl.java,Java,,17,11,61,89
/jdk1.7.0_80/com/sun/org/apache/xerces/internal/dom/CharacterDataImpl.java,Java,,163,75,187,425
/jdk1.7.0_80/com/sun/org/apache/xerces/internal/dom/ChildNode.java,Java,,35,24,91,150
/jdk1.7.0_80/com/sun/org/apache/xerces/internal/dom/CommentImpl.java,Java,,18,11,42,71
/jdk1.7.0_80/com/sun/org/apache/xerces/internal/dom/CoreDocumentImpl.java,Java,,1317,331,1118,2766
/jdk1.7.0_80/com/sun/org/apache/xerces/internal/dom/CoreDOMImplementationImpl.java,Java,,257,24,207,488
/jdk1.7.0_80/com/sun/org/apache/xerces/internal/dom/DeepNodeListImpl.java,Java,,113,31,103,247
/jdk1.7.0_80/com/sun/org/apache/xerces/internal/dom/DeferredAttrImpl.java,Java,,32,20,93,145
/jdk1.7.0_80/com/sun/org/apache/xerces/internal/dom/DeferredAttrNSImpl.java,Java,,40,24,66,130
/jdk1.7.0_80/com/sun/org/apache/xerces/internal/dom/DeferredCDATASectionImpl.java,Java,,21,18,70,109
/jdk1.7.0_80/com/sun/org/apache/xerces/internal/dom/DeferredCommentImpl.java,Java,,21,18,51,90
/jdk1.7.0_80/com/sun/org/apache/xerces/internal/dom/DeferredDocumentImpl.java,Java,,1295,370,493,2158
/jdk1.7.0_80/com/sun/org/apache/xerces/internal/dom/DeferredDocumentTypeImpl.java,Java,,75,34,78,187
/jdk1.7.0_80/com/sun/org/apache/xerces/internal/dom/DeferredDOMImplementationImpl.java,Java,,9,8,41,58
/jdk1.7.0_80/com/sun/org/apache/xerces/internal/dom/DeferredElementDefinitionImpl.java,Java,,39,26,61,126
/jdk1.7.0_80/com/sun/org/apache/xerces/internal/dom/DeferredElementImpl.java,Java,,40,25,73,138
/jdk1.7.0_80/com/sun/org/apache/xerces/internal/dom/DeferredElementNSImpl.java,Java,,61,29,71,161
/jdk1.7.0_80/com/sun/org/apache/xerces/internal/dom/DeferredEntityImpl.java,Java,,40,27,86,153
/jdk1.7.0_80/com/sun/org/apache/xerces/internal/dom/DeferredEntityReferenceImpl.java,Java,,31,22,102,155
/jdk1.7.0_80/com/sun/org/apache/xerces/internal/dom/DeferredNode.java,Java,,6,8,29,43
/jdk1.7.0_80/com/sun/org/apache/xerces/internal/dom/DeferredNotationImpl.java,Java,,27,20,70,117
/jdk1.7.0_80/com/sun/org/apache/xerces/internal/dom/DeferredProcessingInstructionImpl.java,Java,,23,18,53,94
/jdk1.7.0_80/com/sun/org/apache/xerces/internal/dom/DeferredTextImpl.java,Java,,22,20,65,107
/jdk1.7.0_80/com/sun/org/apache/xerces/internal/dom/DocumentFragmentImpl.java,Java,,48,17,90,155
/jdk1.7.0_80/com/sun/org/apache/xerces/internal/dom/DocumentImpl.java,Java,,643,124,538,1305
/jdk1.7.0_80/com/sun/org/apache/xerces/internal/dom/DocumentTypeImpl.java,Java,,231,73,181,485
/jdk1.7.0_80/com/sun/org/apache/xerces/internal/dom/DOMConfigurationImpl.java,Java,,651,140,312,1103
/jdk1.7.0_80/com/sun/org/apache/xerces/internal/dom/DOMErrorImpl.java,Java,,47,27,62,136
/jdk1.7.0_80/com/sun/org/apache/xerces/internal/dom/DOMImplementationImpl.java,Java,,51,19,81,151
/jdk1.7.0_80/com/sun/org/apache/xerces/internal/dom/DOMImplementationListImpl.java,Java,,23,8,44,75
/jdk1.7.0_80/com/sun/org/apache/xerces/internal/dom/DOMImplementationSourceImpl.java,Java,,73,10,53,136
/jdk1.7.0_80/com/sun/org/apache/xerces/internal/dom/DOMInputImpl.java,Java,,96,45,250,391
/jdk1.7.0_80/com/sun/org/apache/xerces/internal/dom/DOMLocatorImpl.java,Java,,57,29,76,162
/jdk1.7.0_80/com/sun/org/apache/xerces/internal/dom/DOMMessageFormatter.java,Java,,82,10,51,143
/jdk1.7.0_80/com/sun/org/apache/xerces/internal/dom/DOMNormalizer.java,Java,,1172,250,626,2048
/jdk1.7.0_80/com/sun/org/apache/xerces/internal/dom/DOMOutputImpl.java,Java,,35,24,114,173
/jdk1.7.0_80/com/sun/org/apache/xerces/internal/dom/DOMStringListImpl.java,Java,,28,12,50,90
/jdk1.7.0_80/com/sun/org/apache/xerces/internal/dom/DOMXSImplementationSourceImpl.java,Java,,39,9,52,100
/jdk1.7.0_80/com/sun/org/apache/xerces/internal/dom/ElementDefinitionImpl.java,Java,,35,20,66,121
/jdk1.7.0_80/com/sun/org/apache/xerces/internal/dom/ElementImpl.java,Java,,577,144,457,1178
/jdk1.7.0_80/com/sun/org/apache/xerces/internal/dom/ElementNSImpl.java,Java,,263,58,168,489
/jdk1.7.0_80/com/sun/org/apache/xerces/internal/dom/EntityImpl.java,Java,,136,65,166,367
/jdk1.7.0_80/com/sun/org/apache/xerces/internal/dom/EntityReferenceImpl.java,Java,,139,41,222,402
/jdk1.7.0_80/com/sun/org/apache/xerces/internal/dom/events/EventImpl.java,Java,,56,15,64,135
/jdk1.7.0_80/com/sun/org/apache/xerces/internal/dom/events/MutationEventImpl.java,Java,,49,12,51,112
/jdk1.7.0_80/com/sun/org/apache/xerces/internal/dom/LCount.java,Java,,13,4,40,57
/jdk1.7.0_80/com/sun/org/apache/xerces/internal/dom/NamedNodeMapImpl.java,Java,,325,81,224,630
/jdk1.7.0_80/com/sun/org/apache/xerces/internal/dom/NodeImpl.java,Java,,878,214,932,2024
/jdk1.7.0_80/com/sun/org/apache/xerces/internal/dom/NodeIteratorImpl.java,Java,,179,68,127,374
/jdk1.7.0_80/com/sun/org/apache/xerces/internal/dom/NodeListCache.java,Java,,13,10,36,59
/jdk1.7.0_80/com/sun/org/apache/xerces/internal/dom/NotationImpl.java,Java,,81,33,98,212
/jdk1.7.0_80/com/sun/org/apache/xerces/internal/dom/ParentNode.java,Java,,505,120,412,1037
/jdk1.7.0_80/com/sun/org/apache/xerces/internal/dom/ProcessingInstructionImpl.java,Java,,44,24,93,161
/jdk1.7.0_80/com/sun/org/apache/xerces/internal/dom/PSVIAttrNSImpl.java,Java,,91,38,124,253
/jdk1.7.0_80/com/sun/org/apache/xerces/internal/dom/PSVIDocumentImpl.java,Java,,55,21,74,150
/jdk1.7.0_80/com/sun/org/apache/xerces/internal/dom/PSVIDOMImplementationImpl.java,Java,,32,13,79,124
/jdk1.7.0_80/com/sun/org/apache/xerces/internal/dom/PSVIElementNSImpl.java,Java,,106,44,146,296
/jdk1.7.0_80/com/sun/org/apache/xerces/internal/dom/RangeExceptionImpl.java,Java,,8,5,24,37
/jdk1.7.0_80/com/sun/org/apache/xerces/internal/dom/RangeImpl.java,Java,,1273,181,631,2085
/jdk1.7.0_80/com/sun/org/apache/xerces/internal/dom/TextImpl.java,Java,,318,92,255,665
/jdk1.7.0_80/com/sun/org/apache/xerces/internal/dom/TreeWalkerImpl.java,Java,,279,93,135,507
/jdk1.7.0_80/com/sun/org/apache/xerces/internal/impl/Constants.java,Java,,342,206,378,926
/jdk1.7.0_80/com/sun/org/apache/xerces/internal/impl/dtd/BalancedDTDGrammar.java,Java,,114,27,147,288
/jdk1.7.0_80/com/sun/org/apache/xerces/internal/impl/dtd/DTDGrammar.java,Java,,1504,407,880,2791
/jdk1.7.0_80/com/sun/org/apache/xerces/internal/impl/dtd/DTDGrammarBucket.java,Java,,35,17,100,152
/jdk1.7.0_80/com/sun/org/apache/xerces/internal/impl/dtd/models/CMAny.java,Java,,63,25,104,192
/jdk1.7.0_80/com/sun/org/apache/xerces/internal/impl/dtd/models/CMBinOp.java,Java,,71,15,105,191
/jdk1.7.0_80/com/sun/org/apache/xerces/internal/impl/dtd/models/CMLeaf.java,Java,,66,25,95,186
/jdk1.7.0_80/com/sun/org/apache/xerces/internal/impl/dtd/models/CMNode.java,Java,,53,16,121,190
/jdk1.7.0_80/com/sun/org/apache/xerces/internal/impl/dtd/models/CMStateSet.java,Java,,189,27,127,343
/jdk1.7.0_80/com/sun/org/apache/xerces/internal/impl/dtd/models/CMUniOp.java,Java,,36,14,93,143
/jdk1.7.0_80/com/sun/org/apache/xerces/internal/impl/dtd/models/ContentModelValidator.java,Java,,5,6,77,88
/jdk1.7.0_80/com/sun/org/apache/xerces/internal/impl/dtd/models/DFAContentModel.java,Java,,368,118,547,1033
/jdk1.7.0_80/com/sun/org/apache/xerces/internal/impl/dtd/models/MixedContentModel.java,Java,,91,26,141,258
/jdk1.7.0_80/com/sun/org/apache/xerces/internal/impl/dtd/models/SimpleContentModel.java,Java,,92,35,193,320
/jdk1.7.0_80/com/sun/org/apache/xerces/internal/impl/dtd/XML11DTDProcessor.java,Java,,40,14,74,128
/jdk1.7.0_80/com/sun/org/apache/xerces/internal/impl/dtd/XML11DTDValidator.java,Java,,33,13,80,126
/jdk1.7.0_80/com/sun/org/apache/xerces/internal/impl/dtd/XML11NSDTDValidator.java,Java,,130,23,113,266
/jdk1.7.0_80/com/sun/org/apache/xerces/internal/impl/dtd/XMLAttributeDecl.java,Java,,17,11,82,110
/jdk1.7.0_80/com/sun/org/apache/xerces/internal/impl/dtd/XMLContentSpec.java,Java,,72,43,221,336
/jdk1.7.0_80/com/sun/org/apache/xerces/internal/impl/dtd/XMLDTDDescription.java,Java,,107,18,104,229
/jdk1.7.0_80/com/sun/org/apache/xerces/internal/impl/dtd/XMLDTDLoader.java,Java,,298,49,212,559
/jdk1.7.0_80/com/sun/org/apache/xerces/internal/impl/dtd/XMLDTDProcessor.java,Java,,766,233,753,1752
/jdk1.7.0_80/com/sun/org/apache/xerces/internal/impl/dtd/XMLDTDValidator.java,Java,,1061,288,720,2069
/jdk1.7.0_80/com/sun/org/apache/xerces/internal/impl/dtd/XMLDTDValidatorFilter.java,Java,,7,7,79,93
/jdk1.7.0_80/com/sun/org/apache/xerces/internal/impl/dtd/XMLElementDecl.java,Java,,29,19,93,141
/jdk1.7.0_80/com/sun/org/apache/xerces/internal/impl/dtd/XMLEntityDecl.java,Java,,38,17,103,158
/jdk1.7.0_80/com/sun/org/apache/xerces/internal/impl/dtd/XMLNotationDecl.java,Java,,19,11,82,112
/jdk1.7.0_80/com/sun/org/apache/xerces/internal/impl/dtd/XMLNSDTDValidator.java,Java,,133,29,113,275
/jdk1.7.0_80/com/sun/org/apache/xerces/internal/impl/dtd/XMLSimpleType.java,Java,,69,34,109,212
/jdk1.7.0_80/com/sun/org/apache/xerces/internal/impl/dv/DatatypeException.java,Java,,41,12,57,110
/jdk1.7.0_80/com/sun/org/apache/xerces/internal/impl/dv/DatatypeValidator.java,Java,,6,5,34,45
/jdk1.7.0_80/com/sun/org/apache/xerces/internal/impl/dv/dtd/DTDDVFactoryImpl.java,Java,,31,11,39,81
/jdk1.7.0_80/com/sun/org/apache/xerces/internal/impl/dv/dtd/ENTITYDatatypeValidator.java,Java,,10,8,50,68
/jdk1.7.0_80/com/sun/org/apache/xerces/internal/impl/dv/dtd/IDDatatypeValidator.java,Java,,23,9,52,84
/jdk1.7.0_80/com/sun/org/apache/xerces/internal/impl/dv/dtd/IDREFDatatypeValidator.java,Java,,20,9,49,78
/jdk1.7.0_80/com/sun/org/apache/xerces/internal/impl/dv/dtd/ListDatatypeValidator.java,Java,,19,8,41,68
/jdk1.7.0_80/com/sun/org/apache/xerces/internal/impl/dv/dtd/NMTOKENDatatypeValidator.java,Java,,12,6,39,57
/jdk1.7.0_80/com/sun/org/apache/xerces/internal/impl/dv/dtd/NOTATIONDatatypeValidator.java,Java,,8,6,41,55
/jdk1.7.0_80/com/sun/org/apache/xerces/internal/impl/dv/dtd/StringDatatypeValidator.java,Java,,8,6,46,60
/jdk1.7.0_80/com/sun/org/apache/xerces/internal/impl/dv/dtd/XML11DTDDVFactoryImpl.java,Java,,31,10,41,82
/jdk1.7.0_80/com/sun/org/apache/xerces/internal/impl/dv/dtd/XML11IDDatatypeValidator.java,Java,,24,9,53,86
/jdk1.7.0_80/com/sun/org/apache/xerces/internal/impl/dv/dtd/XML11IDREFDatatypeValidator.java,Java,,21,9,50,80
/jdk1.7.0_80/com/sun/org/apache/xerces/internal/impl/dv/dtd/XML11NMTOKENDatatypeValidator.java,Java,,13,6,40,59
/jdk1.7.0_80/com/sun/org/apache/xerces/internal/impl/dv/DTDDVFactory.java,Java,,21,10,58,89
/jdk1.7.0_80/com/sun/org/apache/xerces/internal/impl/dv/DVFactoryException.java,Java,,10,5,27,42
/jdk1.7.0_80/com/sun/org/apache/xerces/internal/impl/dv/InvalidDatatypeFacetException.java,Java,,7,5,36,48
/jdk1.7.0_80/com/sun/org/apache/xerces/internal/impl/dv/InvalidDatatypeValueException.java,Java,,7,5,76,88
/jdk1.7.0_80/com/sun/org/apache/xerces/internal/impl/dv/SchemaDVFactory.java,Java,,29,16,104,149
/jdk1.7.0_80/com/sun/org/apache/xerces/internal/impl/dv/util/Base64.java,Java,,198,52,57,307
/jdk1.7.0_80/com/sun/org/apache/xerces/internal/impl/dv/util/ByteListImpl.java,Java,,38,13,55,106
/jdk1.7.0_80/com/sun/org/apache/xerces/internal/impl/dv/util/HexBin.java,Java,,67,8,40,115
/jdk1.7.0_80/com/sun/org/apache/xerces/internal/impl/dv/ValidatedInfo.java,Java,,22,11,65,98
/jdk1.7.0_80/com/sun/org/apache/xerces/internal/impl/dv/ValidationContext.java,Java,,16,13,38,67
/jdk1.7.0_80/com/sun/org/apache/xerces/internal/impl/dv/xs/AbstractDateTimeDV.java,Java,,775,119,284,1178
/jdk1.7.0_80/com/sun/org/apache/xerces/internal/impl/dv/xs/AnyAtomicDV.java,Java,,11,6,27,44
/jdk1.7.0_80/com/sun/org/apache/xerces/internal/impl/dv/xs/AnySimpleDV.java,Java,,11,6,29,46
/jdk1.7.0_80/com/sun/org/apache/xerces/internal/impl/dv/xs/AnyURIDV.java,Java,,105,14,52,171
/jdk1.7.0_80/com/sun/org/apache/xerces/internal/impl/dv/xs/Base64BinaryDV.java,Java,,50,11,33,94
/jdk1.7.0_80/com/sun/org/apache/xerces/internal/impl/dv/xs/BaseDVFactory.java,Java,,138,30,82,250
/jdk1.7.0_80/com/sun/org/apache/xerces/internal/impl/dv/xs/BaseSchemaDVFactory.java,Java,,217,45,67,329
/jdk1.7.0_80/com/sun/org/apache/xerces/internal/impl/dv/xs/BooleanDV.java,Java,,19,8,28,55
/jdk1.7.0_80/com/sun/org/apache/xerces/internal/impl/dv/xs/DateDV.java,Java,,42,13,40,95
/jdk1.7.0_80/com/sun/org/apache/xerces/internal/impl/dv/xs/DateTimeDV.java,Java,,39,15,42,96
/jdk1.7.0_80/com/sun/org/apache/xerces/internal/impl/dv/xs/DayDV.java,Java,,55,17,47,119
/jdk1.7.0_80/com/sun/org/apache/xerces/internal/impl/dv/xs/DayTimeDurationDV.java,Java,,29,6,28,63
/jdk1.7.0_80/com/sun/org/apache/xerces/internal/impl/dv/xs/DecimalDV.java,Java,,287,45,60,392
/jdk1.7.0_80/com/sun/org/apache/xerces/internal/impl/dv/xs/DoubleDV.java,Java,,159,25,76,260
/jdk1.7.0_80/com/sun/org/apache/xerces/internal/impl/dv/xs/DurationDV.java,Java,,251,55,84,390
/jdk1.7.0_80/com/sun/org/apache/xerces/internal/impl/dv/xs/EntityDV.java,Java,,20,8,28,56
/jdk1.7.0_80/com/sun/org/apache/xerces/internal/impl/dv/xs/ExtendedSchemaDVFactoryImpl.java,Java,,26,10,50,86
/jdk1.7.0_80/com/sun/org/apache/xerces/internal/impl/dv/xs/FloatDV.java,Java,,144,26,71,241
/jdk1.7.0_80/com/sun/org/apache/xerces/internal/impl/dv/xs/FullDVFactory.java,Java,,94,25,49,168
/jdk1.7.0_80/com/sun/org/apache/xerces/internal/impl/dv/xs/HexBinaryDV.java,Java,,50,11,30,91
/jdk1.7.0_80/com/sun/org/apache/xerces/internal/impl/dv/xs/IDDV.java,Java,,21,6,28,55
/jdk1.7.0_80/com/sun/org/apache/xerces/internal/impl/dv/xs/IDREFDV.java,Java,,18,7,28,53
/jdk1.7.0_80/com/sun/org/apache/xerces/internal/impl/dv/xs/IntegerDV.java,Java,,12,5,27,44
/jdk1.7.0_80/com/sun/org/apache/xerces/internal/impl/dv/xs/ListDV.java,Java,,84,17,36,137
/jdk1.7.0_80/com/sun/org/apache/xerces/internal/impl/dv/xs/MonthDayDV.java,Java,,60,18,53,131
/jdk1.7.0_80/com/sun/org/apache/xerces/internal/impl/dv/xs/MonthDV.java,Java,,58,14,96,168
/jdk1.7.0_80/com/sun/org/apache/xerces/internal/impl/dv/xs/PrecisionDecimalDV.java,Java,,292,59,95,446
/jdk1.7.0_80/com/sun/org/apache/xerces/internal/impl/dv/xs/QNameDV.java,Java,,56,16,39,111
/jdk1.7.0_80/com/sun/org/apache/xerces/internal/impl/dv/xs/SchemaDateTimeException.java,Java,,10,5,24,39
/jdk1.7.0_80/com/sun/org/apache/xerces/internal/impl/dv/xs/SchemaDVFactoryImpl.java,Java,,18,11,48,77
/jdk1.7.0_80/com/sun/org/apache/xerces/internal/impl/dv/xs/StringDV.java,Java,,12,6,28,46
/jdk1.7.0_80/com/sun/org/apache/xerces/internal/impl/dv/xs/TimeDV.java,Java,,45,14,54,113
/jdk1.7.0_80/com/sun/org/apache/xerces/internal/impl/dv/xs/TypeValidator.java,Java,,35,16,59,110
/jdk1.7.0_80/com/sun/org/apache/xerces/internal/impl/dv/xs/UnionDV.java,Java,,11,6,30,47
/jdk1.7.0_80/com/sun/org/apache/xerces/internal/impl/dv/xs/XSSimpleTypeDecl.java,Java,,2387,349,662,3398
/jdk1.7.0_80/com/sun/org/apache/xerces/internal/impl/dv/xs/XSSimpleTypeDelegate.java,Java,,147,45,27,219
/jdk1.7.0_80/com/sun/org/apache/xerces/internal/impl/dv/xs/YearDV.java,Java,,58,16,53,127
/jdk1.7.0_80/com/sun/org/apache/xerces/internal/impl/dv/xs/YearMonthDurationDV.java,Java,,30,6,28,64
/jdk1.7.0_80/com/sun/org/apache/xerces/internal/impl/dv/xs/YearMonthDV.java,Java,,42,13,46,101
/jdk1.7.0_80/com/sun/org/apache/xerces/internal/impl/dv/XSFacets.java,Java,,46,21,69,136
/jdk1.7.0_80/com/sun/org/apache/xerces/internal/impl/dv/XSSimpleType.java,Java,,39,14,150,203
/jdk1.7.0_80/com/sun/org/apache/xerces/internal/impl/ExternalSubsetResolver.java,Java,,11,7,48,66
/jdk1.7.0_80/com/sun/org/apache/xerces/internal/impl/io/ASCIIReader.java,Java,,78,24,145,247
/jdk1.7.0_80/com/sun/org/apache/xerces/internal/impl/io/MalformedByteSequenceException.java,Java,,38,19,82,139
/jdk1.7.0_80/com/sun/org/apache/xerces/internal/impl/io/UCSReader.java,Java,,131,25,155,311
/jdk1.7.0_80/com/sun/org/apache/xerces/internal/impl/io/UTF8Reader.java,Java,,436,67,203,706
/jdk1.7.0_80/com/sun/org/apache/xerces/internal/impl/msg/XMLMessageFormatter.java,Java,,54,12,55,121
/jdk1.7.0_80/com/sun/org/apache/xerces/internal/impl/msg/XMLMessageFormatter_de.java,Java,,55,13,55,123
/jdk1.7.0_80/com/sun/org/apache/xerces/internal/impl/msg/XMLMessageFormatter_es.java,Java,,55,13,55,123
/jdk1.7.0_80/com/sun/org/apache/xerces/internal/impl/msg/XMLMessageFormatter_fr.java,Java,,55,13,55,123
/jdk1.7.0_80/com/sun/org/apache/xerces/internal/impl/msg/XMLMessageFormatter_it.java,Java,,55,13,55,123
/jdk1.7.0_80/com/sun/org/apache/xerces/internal/impl/msg/XMLMessageFormatter_ja.java,Java,,55,13,55,123
/jdk1.7.0_80/com/sun/org/apache/xerces/internal/impl/msg/XMLMessageFormatter_ko.java,Java,,55,13,55,123
/jdk1.7.0_80/com/sun/org/apache/xerces/internal/impl/msg/XMLMessageFormatter_pt_BR.java,Java,,55,13,55,123
/jdk1.7.0_80/com/sun/org/apache/xerces/internal/impl/msg/XMLMessageFormatter_sv.java,Java,,55,13,55,123
/jdk1.7.0_80/com/sun/org/apache/xerces/internal/impl/msg/XMLMessageFormatter_zh_CN.java,Java,,55,13,55,123
/jdk1.7.0_80/com/sun/org/apache/xerces/internal/impl/msg/XMLMessageFormatter_zh_TW.java,Java,,55,13,55,123
/jdk1.7.0_80/com/sun/org/apache/xerces/internal/impl/PropertyManager.java,Java,,127,29,64,220
/jdk1.7.0_80/com/sun/org/apache/xerces/internal/impl/RevalidationHandler.java,Java,,6,5,73,84
/jdk1.7.0_80/com/sun/org/apache/xerces/internal/impl/validation/EntityState.java,Java,,5,4,40,49
/jdk1.7.0_80/com/sun/org/apache/xerces/internal/impl/validation/ValidationManager.java,Java,,32,13,40,85
/jdk1.7.0_80/com/sun/org/apache/xerces/internal/impl/validation/ValidationState.java,Java,,123,30,59,212
/jdk1.7.0_80/com/sun/org/apache/xerces/internal/impl/Version.java,Java,,11,10,81,102
/jdk1.7.0_80/com/sun/org/apache/xerces/internal/impl/XML11DocumentScannerImpl.java,Java,,344,34,210,588
/jdk1.7.0_80/com/sun/org/apache/xerces/internal/impl/XML11DTDScannerImpl.java,Java,,115,26,166,307
/jdk1.7.0_80/com/sun/org/apache/xerces/internal/impl/XML11EntityScanner.java,Java,,1089,91,373,1553
/jdk1.7.0_80/com/sun/org/apache/xerces/internal/impl/XML11NamespaceBinder.java,Java,,8,10,88,106
/jdk1.7.0_80/com/sun/org/apache/xerces/internal/impl/XML11NSDocumentScannerImpl.java,Java,,531,106,291,928
/jdk1.7.0_80/com/sun/org/apache/xerces/internal/impl/XMLDocumentFragmentScannerImpl.java,Java,aa,1662,443,1218,3323
/jdk1.7.0_80/com/sun/org/apache/xerces/internal/impl/XMLDocumentScannerImpl.java,Java,,779,233,489,1501
/jdk1.7.0_80/com/sun/org/apache/xerces/internal/impl/XMLDTDScannerImpl.java,Java,,1356,212,631,2199
/jdk1.7.0_80/com/sun/org/apache/xerces/internal/impl/XMLEntityDescription.java,Java,,6,6,38,50
/jdk1.7.0_80/com/sun/org/apache/xerces/internal/impl/XMLEntityHandler.java,Java,,11,7,101,119
/jdk1.7.0_80/com/sun/org/apache/xerces/internal/impl/XMLEntityManager.java,Java,,1697,367,970,3034
/jdk1.7.0_80/com/sun/org/apache/xerces/internal/impl/XMLEntityScanner.java,Java,,1346,184,628,2158
/jdk1.7.0_80/com/sun/org/apache/xerces/internal/impl/XMLErrorReporter.java,Java,,203,73,377,653
/jdk1.7.0_80/com/sun/org/apache/xerces/internal/impl/XMLNamespaceBinder.java,Java,,350,108,431,889
/jdk1.7.0_80/com/sun/org/apache/xerces/internal/impl/XMLNSDocumentScannerImpl.java,Java,,347,92,201,640
/jdk1.7.0_80/com/sun/org/apache/xerces/internal/impl/XMLScanner.java,Java,,880,171,423,1474
/jdk1.7.0_80/com/sun/org/apache/xerces/internal/impl/XMLStreamFilterImpl.java,Java,,223,57,253,533
/jdk1.7.0_80/com/sun/org/apache/xerces/internal/impl/XMLStreamReaderImpl.java,Java,,797,143,431,1371
/jdk1.7.0_80/com/sun/org/apache/xerces/internal/impl/XMLVersionDetector.java,Java,,116,33,125,274
/jdk1.7.0_80/com/sun/org/apache/xerces/internal/impl/xpath/regex/BMPattern.java,Java,,170,12,55,237
/jdk1.7.0_80/com/sun/org/apache/xerces/internal/impl/xpath/regex/CaseInsensitiveMap.java,Java,,120,28,28,176
/jdk1.7.0_80/com/sun/org/apache/xerces/internal/impl/xpath/regex/Match.java,Java,,98,14,74,186
/jdk1.7.0_80/com/sun/org/apache/xerces/internal/impl/xpath/regex/Op.java,Java,,211,11,32,254
/jdk1.7.0_80/com/sun/org/apache/xerces/internal/impl/xpath/regex/ParseException.java,Java,,12,6,37,55
/jdk1.7.0_80/com/sun/org/apache/xerces/internal/impl/xpath/regex/ParserForXMLSchema.java,Java,,429,31,52,512
/jdk1.7.0_80/com/sun/org/apache/xerces/internal/impl/xpath/regex/RangeToken.java,Java,,492,29,102,623
/jdk1.7.0_80/com/sun/org/apache/xerces/internal/impl/xpath/regex/RegexParser.java,Java,,1062,82,97,1241
/jdk1.7.0_80/com/sun/org/apache/xerces/internal/impl/xpath/regex/RegularExpression.java,Java,,1472,203,771,2446
/jdk1.7.0_80/com/sun/org/apache/xerces/internal/impl/xpath/regex/REUtil.java,Java,,260,25,50,335
/jdk1.7.0_80/com/sun/org/apache/xerces/internal/impl/xpath/regex/Token.java,Java,,1267,157,109,1533
/jdk1.7.0_80/com/sun/org/apache/xerces/internal/impl/xpath/XPath.java,Java,,1355,157,508,2020
/jdk1.7.0_80/com/sun/org/apache/xerces/internal/impl/xpath/XPathException.java,Java,,17,9,35,61
/jdk1.7.0_80/com/sun/org/apache/xerces/internal/impl/xs/AttributePSVImpl.java,Java,,78,31,113,222
/jdk1.7.0_80/com/sun/org/apache/xerces/internal/impl/xs/ElementPSVImpl.java,Java,,98,39,140,277
/jdk1.7.0_80/com/sun/org/apache/xerces/internal/impl/xs/identity/Field.java,Java,,117,37,95,249
/jdk1.7.0_80/com/sun/org/apache/xerces/internal/impl/xs/identity/FieldActivator.java,Java,,9,10,69,88
/jdk1.7.0_80/com/sun/org/apache/xerces/internal/impl/xs/identity/IdentityConstraint.java,Java,,120,38,92,250
/jdk1.7.0_80/com/sun/org/apache/xerces/internal/impl/xs/identity/KeyRef.java,Java,,18,11,43,72
/jdk1.7.0_80/com/sun/org/apache/xerces/internal/impl/xs/identity/Selector.java,Java,,107,42,108,257
/jdk1.7.0_80/com/sun/org/apache/xerces/internal/impl/xs/identity/UniqueOrKey.java,Java,,9,6,36,51
/jdk1.7.0_80/com/sun/org/apache/xerces/internal/impl/xs/identity/ValueStore.java,Java,,6,9,55,70
/jdk1.7.0_80/com/sun/org/apache/xerces/internal/impl/xs/identity/XPathMatcher.java,Java,,275,59,188,522
/jdk1.7.0_80/com/sun/org/apache/xerces/internal/impl/xs/models/CMBuilder.java,Java,,271,37,142,450
/jdk1.7.0_80/com/sun/org/apache/xerces/internal/impl/xs/models/CMNodeFactory.java,Java,,81,28,59,168
/jdk1.7.0_80/com/sun/org/apache/xerces/internal/impl/xs/models/XSAllCM.java,Java,,98,36,90,224
/jdk1.7.0_80/com/sun/org/apache/xerces/internal/impl/xs/models/XSCMBinOp.java,Java,,60,15,66,141
/jdk1.7.0_80/com/sun/org/apache/xerces/internal/impl/xs/models/XSCMLeaf.java,Java,,54,25,56,135
/jdk1.7.0_80/com/sun/org/apache/xerces/internal/impl/xs/models/XSCMRepeatingLeaf.java,Java,,17,6,28,51
/jdk1.7.0_80/com/sun/org/apache/xerces/internal/impl/xs/models/XSCMUniOp.java,Java,,36,15,61,112
/jdk1.7.0_80/com/sun/org/apache/xerces/internal/impl/xs/models/XSCMValidator.java,Java,,16,16,79,111
/jdk1.7.0_80/com/sun/org/apache/xerces/internal/impl/xs/models/XSDFACM.java,Java,,585,135,522,1242
/jdk1.7.0_80/com/sun/org/apache/xerces/internal/impl/xs/models/XSEmptyCM.java,Java,,38,24,79,141
/jdk1.7.0_80/com/sun/org/apache/xerces/internal/impl/xs/opti/AttrImpl.java,Java,,50,16,86,152
/jdk1.7.0_80/com/sun/org/apache/xerces/internal/impl/xs/opti/DefaultDocument.java,Java,,115,63,113,291
/jdk1.7.0_80/com/sun/org/apache/xerces/internal/impl/xs/opti/DefaultElement.java,Java,,75,45,31,151
/jdk1.7.0_80/com/sun/org/apache/xerces/internal/impl/xs/opti/DefaultNode.java,Java,,121,65,32,218
/jdk1.7.0_80/com/sun/org/apache/xerces/internal/impl/xs/opti/DefaultText.java,Java,,54,16,168,238
/jdk1.7.0_80/com/sun/org/apache/xerces/internal/impl/xs/opti/DefaultXMLDocumentHandler.java,Java,,174,69,628,871
/jdk1.7.0_80/com/sun/org/apache/xerces/internal/impl/xs/opti/ElementImpl.java,Java,,178,57,39,274
/jdk1.7.0_80/com/sun/org/apache/xerces/internal/impl/xs/opti/NamedNodeMapImpl.java,Java,,48,15,25,88
/jdk1.7.0_80/com/sun/org/apache/xerces/internal/impl/xs/opti/NodeImpl.java,Java,,39,22,26,87
/jdk1.7.0_80/com/sun/org/apache/xerces/internal/impl/xs/opti/SchemaDOM.java,Java,,319,55,87,461
/jdk1.7.0_80/com/sun/org/apache/xerces/internal/impl/xs/opti/SchemaDOMImplementation.java,Java,,31,10,26,67
/jdk1.7.0_80/com/sun/org/apache/xerces/internal/impl/xs/opti/SchemaDOMParser.java,Java,,287,68,256,611
/jdk1.7.0_80/com/sun/org/apache/xerces/internal/impl/xs/opti/SchemaParsingConfig.java,Java,,500,156,375,1031
/jdk1.7.0_80/com/sun/org/apache/xerces/internal/impl/xs/opti/TextImpl.java,Java,,50,16,64,130
/jdk1.7.0_80/com/sun/org/apache/xerces/internal/impl/xs/SchemaGrammar.java,Java,,1074,218,396,1688
/jdk1.7.0_80/com/sun/org/apache/xerces/internal/impl/xs/SchemaNamespaceSupport.java,Java,,50,8,54,112
/jdk1.7.0_80/com/sun/org/apache/xerces/internal/impl/xs/SchemaSymbols.java,Java,,164,14,39,217
/jdk1.7.0_80/com/sun/org/apache/xerces/internal/impl/xs/SubstitutionGroupHandler.java,Java,,197,36,119,352
/jdk1.7.0_80/com/sun/org/apache/xerces/internal/impl/xs/traversers/SchemaContentHandler.java,Java,,255,36,91,382
/jdk1.7.0_80/com/sun/org/apache/xerces/internal/impl/xs/traversers/StAXSchemaParser.java,Java,,338,31,56,425
/jdk1.7.0_80/com/sun/org/apache/xerces/internal/impl/xs/traversers/XSAnnotationInfo.java,Java,,30,9,33,72
/jdk1.7.0_80/com/sun/org/apache/xerces/internal/impl/xs/traversers/XSAttributeChecker.java,Java,,1234,130,462,1826
/jdk1.7.0_80/com/sun/org/apache/xerces/internal/impl/xs/traversers/XSDAbstractIDConstraintTraverser.java,Java,,132,18,44,194
/jdk1.7.0_80/com/sun/org/apache/xerces/internal/impl/xs/traversers/XSDAbstractParticleTraverser.java,Java,,229,45,111,385
/jdk1.7.0_80/com/sun/org/apache/xerces/internal/impl/xs/traversers/XSDAbstractTraverser.java,Java,,669,58,126,853
/jdk1.7.0_80/com/sun/org/apache/xerces/internal/impl/xs/traversers/XSDAttributeGroupTraverser.java,Java,,119,36,54,209
/jdk1.7.0_80/com/sun/org/apache/xerces/internal/impl/xs/traversers/XSDAttributeTraverser.java,Java,,314,61,113,488
/jdk1.7.0_80/com/sun/org/apache/xerces/internal/impl/xs/traversers/XSDComplexTypeTraverser.java,Java,,896,141,222,1259
/jdk1.7.0_80/com/sun/org/apache/xerces/internal/impl/xs/traversers/XSDElementTraverser.java,Java,,357,67,141,565
/jdk1.7.0_80/com/sun/org/apache/xerces/internal/impl/xs/traversers/XSDGroupTraverser.java,Java,,185,30,54,269
/jdk1.7.0_80/com/sun/org/apache/xerces/internal/impl/xs/traversers/XSDHandler.java,Java,,3141,423,778,4342
/jdk1.7.0_80/com/sun/org/apache/xerces/internal/impl/xs/traversers/XSDKeyrefTraverser.java,Java,,69,14,42,125
/jdk1.7.0_80/com/sun/org/apache/xerces/internal/impl/xs/traversers/XSDNotationTraverser.java,Java,,77,15,42,134
/jdk1.7.0_80/com/sun/org/apache/xerces/internal/impl/xs/traversers/XSDocumentInfo.java,Java,,132,39,81,252
/jdk1.7.0_80/com/sun/org/apache/xerces/internal/impl/xs/traversers/XSDSimpleTypeTraverser.java,Java,,360,35,127,522
/jdk1.7.0_80/com/sun/org/apache/xerces/internal/impl/xs/traversers/XSDUniqueOrKeyTraverser.java,Java,,49,14,39,102
/jdk1.7.0_80/com/sun/org/apache/xerces/internal/impl/xs/traversers/XSDWildcardTraverser.java,Java,,94,22,86,202
/jdk1.7.0_80/com/sun/org/apache/xerces/internal/impl/xs/util/LSInputListImpl.java,Java,,54,16,56,126
/jdk1.7.0_80/com/sun/org/apache/xerces/internal/impl/xs/util/ObjectListImpl.java,Java,,68,16,35,119
/jdk1.7.0_80/com/sun/org/apache/xerces/internal/impl/xs/util/ShortListImpl.java,Java,,54,16,54,124
/jdk1.7.0_80/com/sun/org/apache/xerces/internal/impl/xs/util/SimpleLocator.java,Java,,73,24,50,147
/jdk1.7.0_80/com/sun/org/apache/xerces/internal/impl/xs/util/StringListImpl.java,Java,,91,19,56,166
/jdk1.7.0_80/com/sun/org/apache/xerces/internal/impl/xs/util/XInt.java,Java,,19,9,24,52
/jdk1.7.0_80/com/sun/org/apache/xerces/internal/impl/xs/util/XIntPool.java,Java,,15,4,24,43
/jdk1.7.0_80/com/sun/org/apache/xerces/internal/impl/xs/util/XSGrammarPool.java,Java,,32,9,33,74
/jdk1.7.0_80/com/sun/org/apache/xerces/internal/impl/xs/util/XSInputSource.java,Java,,30,11,25,66
/jdk1.7.0_80/com/sun/org/apache/xerces/internal/impl/xs/util/XSNamedMap4Types.java,Java,,59,11,74,144
/jdk1.7.0_80/com/sun/org/apache/xerces/internal/impl/xs/util/XSNamedMapImpl.java,Java,,179,21,102,302
/jdk1.7.0_80/com/sun/org/apache/xerces/internal/impl/xs/util/XSObjectListImpl.java,Java,,182,29,56,267
/jdk1.7.0_80/com/sun/org/apache/xerces/internal/impl/xs/XMLSchemaException.java,Java,,16,7,30,53
/jdk1.7.0_80/com/sun/org/apache/xerces/internal/impl/xs/XMLSchemaLoader.java,Java,,931,145,319,1395
/jdk1.7.0_80/com/sun/org/apache/xerces/internal/impl/xs/XMLSchemaValidator.java,Java,,2521,574,1218,4313
/jdk1.7.0_80/com/sun/org/apache/xerces/internal/impl/xs/XSAnnotationImpl.java,Java,,91,17,79,187
/jdk1.7.0_80/com/sun/org/apache/xerces/internal/impl/xs/XSAttributeDecl.java,Java,,107,24,84,215
/jdk1.7.0_80/com/sun/org/apache/xerces/internal/impl/xs/XSAttributeGroupDecl.java,Java,,212,54,136,402
/jdk1.7.0_80/com/sun/org/apache/xerces/internal/impl/xs/XSAttributeUseImpl.java,Java,,67,18,68,153
/jdk1.7.0_80/com/sun/org/apache/xerces/internal/impl/xs/XSComplexTypeDecl.java,Java,,382,99,238,719
/jdk1.7.0_80/com/sun/org/apache/xerces/internal/impl/xs/XSConstraints.java,Java,,1030,208,295,1533
/jdk1.7.0_80/com/sun/org/apache/xerces/internal/impl/xs/XSDDescription.java,Java,,111,23,140,274
/jdk1.7.0_80/com/sun/org/apache/xerces/internal/impl/xs/XSDeclarationPool.java,Java,,218,53,47,318
/jdk1.7.0_80/com/sun/org/apache/xerces/internal/impl/xs/XSElementDecl.java,Java,,199,40,149,388
/jdk1.7.0_80/com/sun/org/apache/xerces/internal/impl/xs/XSGrammarBucket.java,Java,,112,23,106,241
/jdk1.7.0_80/com/sun/org/apache/xerces/internal/impl/xs/XSGroupDecl.java,Java,,39,14,58,111
/jdk1.7.0_80/com/sun/org/apache/xerces/internal/impl/xs/XSImplementationImpl.java,Java,,41,17,61,119
/jdk1.7.0_80/com/sun/org/apache/xerces/internal/impl/xs/XSLoaderImpl.java,Java,,174,32,116,322
/jdk1.7.0_80/com/sun/org/apache/xerces/internal/impl/xs/XSMessageFormatter.java,Java,,36,11,48,95
/jdk1.7.0_80/com/sun/org/apache/xerces/internal/impl/xs/XSModelGroupImpl.java,Java,,136,28,82,246
/jdk1.7.0_80/com/sun/org/apache/xerces/internal/impl/xs/XSModelImpl.java,Java,,514,69,226,809
/jdk1.7.0_80/com/sun/org/apache/xerces/internal/impl/xs/XSNotationDecl.java,Java,,42,16,63,121
/jdk1.7.0_80/com/sun/org/apache/xerces/internal/impl/xs/XSParticleDecl.java,Java,,135,26,87,248
/jdk1.7.0_80/com/sun/org/apache/xerces/internal/impl/xs/XSWildcardDecl.java,Java,,311,81,207,599
/jdk1.7.0_80/com/sun/org/apache/xerces/internal/jaxp/datatype/DatatypeFactoryImpl.java,Java,,133,34,485,652
/jdk1.7.0_80/com/sun/org/apache/xerces/internal/jaxp/datatype/DurationDayTimeImpl.java,Java,,69,20,107,196
/jdk1.7.0_80/com/sun/org/apache/xerces/internal/jaxp/datatype/DurationImpl.java,Java,,838,184,998,2020
/jdk1.7.0_80/com/sun/org/apache/xerces/internal/jaxp/datatype/DurationYearMonthImpl.java,Java,,51,18,131,200
/jdk1.7.0_80/com/sun/org/apache/xerces/internal/jaxp/datatype/XMLGregorianCalendarImpl.java,Java,,1367,267,1456,3090
/jdk1.7.0_80/com/sun/org/apache/xerces/internal/jaxp/DefaultValidationErrorHandler.java,Java,,31,7,24,62
/jdk1.7.0_80/com/sun/org/apache/xerces/internal/jaxp/DocumentBuilderFactoryImpl.java,Java,,142,22,59,223
/jdk1.7.0_80/com/sun/org/apache/xerces/internal/jaxp/DocumentBuilderImpl.java,Java,,286,50,85,421
/jdk1.7.0_80/com/sun/org/apache/xerces/internal/jaxp/JAXPConstants.java,Java,,9,4,28,41
/jdk1.7.0_80/com/sun/org/apache/xerces/internal/jaxp/JAXPValidatorComponent.java,Java,,364,85,150,599
/jdk1.7.0_80/com/sun/org/apache/xerces/internal/jaxp/SAXParserFactoryImpl.java,Java,,128,28,58,214
/jdk1.7.0_80/com/sun/org/apache/xerces/internal/jaxp/SAXParserImpl.java,Java,,523,70,150,743
/jdk1.7.0_80/com/sun/org/apache/xerces/internal/jaxp/SchemaValidatorConfiguration.java,Java,,96,27,69,192
/jdk1.7.0_80/com/sun/org/apache/xerces/internal/jaxp/TeeXMLDocumentFilterImpl.java,Java,,106,30,40,176
/jdk1.7.0_80/com/sun/org/apache/xerces/internal/jaxp/UnparsedEntityHandler.java,Java,,179,40,43,262
/jdk1.7.0_80/com/sun/org/apache/xerces/internal/jaxp/validation/AbstractXMLSchema.java,Java,,32,16,61,109
/jdk1.7.0_80/com/sun/org/apache/xerces/internal/jaxp/validation/DOMDocumentHandler.java,Java,,18,12,59,89
/jdk1.7.0_80/com/sun/org/apache/xerces/internal/jaxp/validation/DOMResultAugmentor.java,Java,,183,41,34,258
/jdk1.7.0_80/com/sun/org/apache/xerces/internal/jaxp/validation/DOMResultBuilder.java,Java,,274,49,50,373
/jdk1.7.0_80/com/sun/org/apache/xerces/internal/jaxp/validation/DOMValidatorHelper.java,Java,,412,70,131,613
/jdk1.7.0_80/com/sun/org/apache/xerces/internal/jaxp/validation/DraconianErrorHandler.java,Java,,20,10,32,62
/jdk1.7.0_80/com/sun/org/apache/xerces/internal/jaxp/validation/EmptyXMLSchema.java,Java,,24,16,33,73
/jdk1.7.0_80/com/sun/org/apache/xerces/internal/jaxp/validation/ErrorHandlerAdaptor.java,Java,,35,8,79,122
/jdk1.7.0_80/com/sun/org/apache/xerces/internal/jaxp/validation/JAXPValidationMessageFormatter.java,Java,,51,8,43,102
/jdk1.7.0_80/com/sun/org/apache/xerces/internal/jaxp/validation/ReadOnlyGrammarPool.java,Java,,24,12,29,65
/jdk1.7.0_80/com/sun/org/apache/xerces/internal/jaxp/validation/SimpleXMLSchema.java,Java,,32,17,32,81
/jdk1.7.0_80/com/sun/org/apache/xerces/internal/jaxp/validation/SoftReferenceGrammarPool.java,Java,,221,41,173,435
/jdk1.7.0_80/com/sun/org/apache/xerces/internal/jaxp/validation/StAXValidatorHelper.java,Java,,73,14,32,119
/jdk1.7.0_80/com/sun/org/apache/xerces/internal/jaxp/validation/StreamValidatorHelper.java,Java,,122,29,47,198
/jdk1.7.0_80/com/sun/org/apache/xerces/internal/jaxp/validation/Util.java,Java,,36,9,32,77
/jdk1.7.0_80/com/sun/org/apache/xerces/internal/jaxp/validation/ValidatorHandlerImpl.java,Java,,771,141,175,1087
/jdk1.7.0_80/com/sun/org/apache/xerces/internal/jaxp/validation/ValidatorHelper.java,Java,,9,6,25,40
/jdk1.7.0_80/com/sun/org/apache/xerces/internal/jaxp/validation/ValidatorImpl.java,Java,,198,31,52,281
/jdk1.7.0_80/com/sun/org/apache/xerces/internal/jaxp/validation/WeakReferenceXMLSchema.java,Java,,18,10,34,62
/jdk1.7.0_80/com/sun/org/apache/xerces/internal/jaxp/validation/WrappedSAXException.java,Java,,8,3,76,87
/jdk1.7.0_80/com/sun/org/apache/xerces/internal/jaxp/validation/XMLSchema.java,Java,,14,9,43,66
/jdk1.7.0_80/com/sun/org/apache/xerces/internal/jaxp/validation/XMLSchemaFactory.java,Java,,396,62,86,544
/jdk1.7.0_80/com/sun/org/apache/xerces/internal/jaxp/validation/XMLSchemaValidatorComponentManager.java,Java,,317,83,161,561
/jdk1.7.0_80/com/sun/org/apache/xerces/internal/jaxp/validation/XSGrammarPoolContainer.java,Java,,10,10,55,75
/jdk1.7.0_80/com/sun/org/apache/xerces/internal/parsers/AbstractDOMParser.java,Java,,1597,298,762,2657
/jdk1.7.0_80/com/sun/org/apache/xerces/internal/parsers/AbstractSAXParser.java,Java,,1128,282,1007,2417
/jdk1.7.0_80/com/sun/org/apache/xerces/internal/parsers/AbstractXMLDocumentParser.java,Java,,170,73,569,812
/jdk1.7.0_80/com/sun/org/apache/xerces/internal/parsers/BasicParserConfiguration.java,Java,,207,80,299,586
/jdk1.7.0_80/com/sun/org/apache/xerces/internal/parsers/CachingParserPool.java,Java,,117,56,257,430
/jdk1.7.0_80/com/sun/org/apache/xerces/internal/parsers/DOMParser.java,Java,,369,72,226,667
/jdk1.7.0_80/com/sun/org/apache/xerces/internal/parsers/DOMParserImpl.java,Java,,995,156,241,1392
/jdk1.7.0_80/com/sun/org/apache/xerces/internal/parsers/DTDConfiguration.java,Java,,436,127,317,880
/jdk1.7.0_80/com/sun/org/apache/xerces/internal/parsers/DTDParser.java,Java,,100,40,341,481
/jdk1.7.0_80/com/sun/org/apache/xerces/internal/parsers/IntegratedParserConfiguration.java,Java,,111,31,109,251
/jdk1.7.0_80/com/sun/org/apache/xerces/internal/parsers/NonValidatingConfiguration.java,Java,,388,125,290,803
/jdk1.7.0_80/com/sun/org/apache/xerces/internal/parsers/SAXParser.java,Java,,82,25,72,179
/jdk1.7.0_80/com/sun/org/apache/xerces/internal/parsers/SecurityConfiguration.java,Java,,27,12,75,114
/jdk1.7.0_80/com/sun/org/apache/xerces/internal/parsers/StandardParserConfiguration.java,Java,,148,62,175,385
/jdk1.7.0_80/com/sun/org/apache/xerces/internal/parsers/XIncludeAwareParserConfiguration.java,Java,,177,34,86,297
/jdk1.7.0_80/com/sun/org/apache/xerces/internal/parsers/XIncludeParserConfiguration.java,Java,,119,31,71,221
/jdk1.7.0_80/com/sun/org/apache/xerces/internal/parsers/XML11Configurable.java,Java,,2,2,26,30
/jdk1.7.0_80/com/sun/org/apache/xerces/internal/parsers/XML11Configuration.java,Java,,832,223,514,1569
/jdk1.7.0_80/com/sun/org/apache/xerces/internal/parsers/XML11DTDConfiguration.java,Java,,671,189,475,1335
/jdk1.7.0_80/com/sun/org/apache/xerces/internal/parsers/XML11NonValidatingConfiguration.java,Java,,607,184,439,1230
/jdk1.7.0_80/com/sun/org/apache/xerces/internal/parsers/XMLDocumentParser.java,Java,,24,9,46,79
/jdk1.7.0_80/com/sun/org/apache/xerces/internal/parsers/XMLGrammarCachingConfiguration.java,Java,,111,40,161,312
/jdk1.7.0_80/com/sun/org/apache/xerces/internal/parsers/XMLGrammarParser.java,Java,,12,8,34,54
/jdk1.7.0_80/com/sun/org/apache/xerces/internal/parsers/XMLGrammarPreparser.java,Java,,155,38,148,341
/jdk1.7.0_80/com/sun/org/apache/xerces/internal/parsers/XMLParser.java,Java,,46,29,80,155
/jdk1.7.0_80/com/sun/org/apache/xerces/internal/parsers/XPointerParserConfiguration.java,Java,,127,43,73,243
/jdk1.7.0_80/com/sun/org/apache/xerces/internal/util/AttributesProxy.java,Java,,110,33,49,192
/jdk1.7.0_80/com/sun/org/apache/xerces/internal/util/AugmentationsImpl.java,Java,,175,56,58,289
/jdk1.7.0_80/com/sun/org/apache/xerces/internal/util/DatatypeMessageFormatter.java,Java,,52,9,43,104
/jdk1.7.0_80/com/sun/org/apache/xerces/internal/util/DefaultErrorHandler.java,Java,,48,18,50,116
/jdk1.7.0_80/com/sun/org/apache/xerces/internal/util/DOMEntityResolverWrapper.java,Java,,79,25,66,170
/jdk1.7.0_80/com/sun/org/apache/xerces/internal/util/DOMErrorHandlerWrapper.java,Java,,254,49,117,420
/jdk1.7.0_80/com/sun/org/apache/xerces/internal/util/DOMInputSource.java,Java,,37,11,28,76
/jdk1.7.0_80/com/sun/org/apache/xerces/internal/util/DOMUtil.java,Java,,562,147,193,902
/jdk1.7.0_80/com/sun/org/apache/xerces/internal/util/DraconianErrorHandler.java,Java,,17,4,69,90
/jdk1.7.0_80/com/sun/org/apache/xerces/internal/util/EncodingMap.java,Java,,447,39,544,1030
/jdk1.7.0_80/com/sun/org/apache/xerces/internal/util/EntityResolver2Wrapper.java,Java,,91,32,92,215
/jdk1.7.0_80/com/sun/org/apache/xerces/internal/util/EntityResolverWrapper.java,Java,,59,20,62,141
/jdk1.7.0_80/com/sun/org/apache/xerces/internal/util/ErrorHandlerProxy.java,Java,,35,7,38,80
/jdk1.7.0_80/com/sun/org/apache/xerces/internal/util/ErrorHandlerWrapper.java,Java,,96,28,108,232
/jdk1.7.0_80/com/sun/org/apache/xerces/internal/util/FeatureState.java,Java,,25,10,29,64
/jdk1.7.0_80/com/sun/org/apache/xerces/internal/util/HTTPInputSource.java,Java,,46,20,129,195
/jdk1.7.0_80/com/sun/org/apache/xerces/internal/util/IntStack.java,Java,,52,17,47,116
/jdk1.7.0_80/com/sun/org/apache/xerces/internal/util/JAXPNamespaceContextWrapper.java,Java,,90,26,34,150
/jdk1.7.0_80/com/sun/org/apache/xerces/internal/util/LocatorProxy.java,Java,,28,16,44,88
/jdk1.7.0_80/com/sun/org/apache/xerces/internal/util/LocatorWrapper.java,Java,,20,8,82,110
/jdk1.7.0_80/com/sun/org/apache/xerces/internal/util/MessageFormatter.java,Java,,7,6,47,60
/jdk1.7.0_80/com/sun/org/apache/xerces/internal/util/NamespaceContextWrapper.java,Java,,35,10,45,90
/jdk1.7.0_80/com/sun/org/apache/xerces/internal/util/NamespaceSupport.java,Java,,216,71,197,484
/jdk1.7.0_80/com/sun/org/apache/xerces/internal/util/ParserConfigurationSettings.java,Java,,135,51,146,332
/jdk1.7.0_80/com/sun/org/apache/xerces/internal/util/PropertyState.java,Java,,23,10,29,62
/jdk1.7.0_80/com/sun/org/apache/xerces/internal/util/SAX2XNI.java,Java,,138,33,85,256
/jdk1.7.0_80/com/sun/org/apache/xerces/internal/util/SAXInputSource.java,Java,,88,18,58,164
/jdk1.7.0_80/com/sun/org/apache/xerces/internal/util/SAXLocatorWrapper.java,Java,,63,19,29,111
/jdk1.7.0_80/com/sun/org/apache/xerces/internal/util/SAXMessageFormatter.java,Java,,51,7,44,102
/jdk1.7.0_80/com/sun/org/apache/xerces/internal/util/SecurityManager.java,Java,,66,22,127,215
/jdk1.7.0_80/com/sun/org/apache/xerces/internal/util/ShadowedSymbolTable.java,Java,,26,18,77,121
/jdk1.7.0_80/com/sun/org/apache/xerces/internal/util/Status.java,Java,,22,8,29,59
/jdk1.7.0_80/com/sun/org/apache/xerces/internal/util/StAXInputSource.java,Java,,55,15,25,95
/jdk1.7.0_80/com/sun/org/apache/xerces/internal/util/StAXLocationWrapper.java,Java,,55,20,31,106
/jdk1.7.0_80/com/sun/org/apache/xerces/internal/util/SymbolHash.java,Java,,101,27,97,225
/jdk1.7.0_80/com/sun/org/apache/xerces/internal/util/SymbolTable.java,Java,,114,45,161,320
/jdk1.7.0_80/com/sun/org/apache/xerces/internal/util/SynchronizedSymbolTable.java,Java,,34,23,72,129
/jdk1.7.0_80/com/sun/org/apache/xerces/internal/util/TeeXMLDocumentFilterImpl.java,Java,,106,29,82,217
/jdk1.7.0_80/com/sun/org/apache/xerces/internal/util/TypeInfoImpl.java,Java,,42,11,81,134
/jdk1.7.0_80/com/sun/org/apache/xerces/internal/util/URI.java,Java,,1178,209,823,2210
/jdk1.7.0_80/com/sun/org/apache/xerces/internal/util/XML11Char.java,Java,,211,35,169,415
/jdk1.7.0_80/com/sun/org/apache/xerces/internal/util/XMLAttributesImpl.java,Java,,472,110,610,1192
/jdk1.7.0_80/com/sun/org/apache/xerces/internal/util/XMLAttributesIteratorImpl.java,Java,,33,14,55,102
/jdk1.7.0_80/com/sun/org/apache/xerces/internal/util/XMLCatalogResolver.java,Java,,228,59,299,586
/jdk1.7.0_80/com/sun/org/apache/xerces/internal/util/XMLChar.java,Java,,790,49,226,1065
/jdk1.7.0_80/com/sun/org/apache/xerces/internal/util/XMLDocumentFilterImpl.java,Java,,83,28,71,182
/jdk1.7.0_80/com/sun/org/apache/xerces/internal/util/XMLEntityDescriptionImpl.java,Java,,69,19,93,181
/jdk1.7.0_80/com/sun/org/apache/xerces/internal/util/XMLErrorCode.java,Java,,22,9,53,84
/jdk1.7.0_80/com/sun/org/apache/xerces/internal/util/XMLGrammarPoolImpl.java,Java,,157,32,177,366
/jdk1.7.0_80/com/sun/org/apache/xerces/internal/util/XMLInputSourceAdaptor.java,Java,,22,6,79,107
/jdk1.7.0_80/com/sun/org/apache/xerces/internal/util/XMLResourceIdentifierImpl.java,Java,,116,32,82,230
/jdk1.7.0_80/com/sun/org/apache/xerces/internal/util/XMLStringBuffer.java,Java,,77,23,130,230
/jdk1.7.0_80/com/sun/org/apache/xerces/internal/util/XMLSymbols.java,Java,,21,25,57,103
/jdk1.7.0_80/com/sun/org/apache/xerces/internal/utils/ConfigurationError.java,Java,,12,9,37,58
/jdk1.7.0_80/com/sun/org/apache/xerces/internal/utils/ObjectFactory.java,Java,,207,44,183,434
/jdk1.7.0_80/com/sun/org/apache/xerces/internal/utils/Objects.java,Java,,12,4,29,45
/jdk1.7.0_80/com/sun/org/apache/xerces/internal/utils/SecuritySupport.java,Java,,223,28,88,339
/jdk1.7.0_80/com/sun/org/apache/xerces/internal/utils/XMLLimitAnalyzer.java,Java,,118,23,100,241
/jdk1.7.0_80/com/sun/org/apache/xerces/internal/utils/XMLSecurityManager.java,Java,,282,57,203,542
/jdk1.7.0_80/com/sun/org/apache/xerces/internal/utils/XMLSecurityPropertyManager.java,Java,,98,24,103,225
/jdk1.7.0_80/com/sun/org/apache/xerces/internal/xinclude/MultipleScopeNamespaceSupport.java,Java,,109,21,66,196
/jdk1.7.0_80/com/sun/org/apache/xerces/internal/xinclude/SecuritySupport.java,Java,,106,16,30,152
/jdk1.7.0_80/com/sun/org/apache/xerces/internal/xinclude/XInclude11TextReader.java,Java,,14,5,43,62
/jdk1.7.0_80/com/sun/org/apache/xerces/internal/xinclude/XIncludeHandler.java,Java,,2048,293,739,3080
/jdk1.7.0_80/com/sun/org/apache/xerces/internal/xinclude/XIncludeMessageFormatter.java,Java,,36,10,44,90
/jdk1.7.0_80/com/sun/org/apache/xerces/internal/xinclude/XIncludeNamespaceSupport.java,Java,,30,9,56,95
/jdk1.7.0_80/com/sun/org/apache/xerces/internal/xinclude/XIncludeTextReader.java,Java,,301,44,171,516
/jdk1.7.0_80/com/sun/org/apache/xerces/internal/xinclude/XPointerElementHandler.java,Java,,455,123,185,763
/jdk1.7.0_80/com/sun/org/apache/xerces/internal/xinclude/XPointerFramework.java,Java,,122,23,64,209
/jdk1.7.0_80/com/sun/org/apache/xerces/internal/xinclude/XPointerSchema.java,Java,,13,12,20,45
/jdk1.7.0_80/com/sun/org/apache/xerces/internal/xni/Augmentations.java,Java,,9,15,65,89
/jdk1.7.0_80/com/sun/org/apache/xerces/internal/xni/grammars/Grammar.java,Java,,4,4,47,55
/jdk1.7.0_80/com/sun/org/apache/xerces/internal/xni/grammars/XMLDTDDescription.java,Java,,4,4,29,37
/jdk1.7.0_80/com/sun/org/apache/xerces/internal/xni/grammars/XMLGrammarDescription.java,Java,,7,8,44,59
/jdk1.7.0_80/com/sun/org/apache/xerces/internal/xni/grammars/XMLGrammarLoader.java,Java,,28,18,101,147
/jdk1.7.0_80/com/sun/org/apache/xerces/internal/xni/grammars/XMLGrammarPool.java,Java,,9,9,87,105
/jdk1.7.0_80/com/sun/org/apache/xerces/internal/xni/grammars/XMLSchemaDescription.java,Java,,19,11,108,138
/jdk1.7.0_80/com/sun/org/apache/xerces/internal/xni/grammars/XSGrammar.java,Java,,6,6,43,55
/jdk1.7.0_80/com/sun/org/apache/xerces/internal/xni/NamespaceContext.java,Java,,16,20,143,179
/jdk1.7.0_80/com/sun/org/apache/xerces/internal/xni/parser/XMLComponent.java,Java,,13,11,102,126
/jdk1.7.0_80/com/sun/org/apache/xerces/internal/xni/parser/XMLComponentManager.java,Java,,13,11,66,90
/jdk1.7.0_80/com/sun/org/apache/xerces/internal/xni/parser/XMLConfigurationException.java,Java,,26,14,59,99
/jdk1.7.0_80/com/sun/org/apache/xerces/internal/xni/parser/XMLDocumentFilter.java,Java,,5,5,26,36
/jdk1.7.0_80/com/sun/org/apache/xerces/internal/xni/parser/XMLDocumentScanner.java,Java,,10,7,58,75
/jdk1.7.0_80/com/sun/org/apache/xerces/internal/xni/parser/XMLDocumentSource.java,Java,,6,7,36,49
/jdk1.7.0_80/com/sun/org/apache/xerces/internal/xni/parser/XMLDTDContentModelFilter.java,Java,,5,4,26,35
/jdk1.7.0_80/com/sun/org/apache/xerces/internal/xni/parser/XMLDTDContentModelSource.java,Java,,6,7,77,90
/jdk1.7.0_80/com/sun/org/apache/xerces/internal/xni/parser/XMLDTDFilter.java,Java,,5,4,26,35
/jdk1.7.0_80/com/sun/org/apache/xerces/internal/xni/parser/XMLDTDScanner.java,Java,,14,8,78,100
/jdk1.7.0_80/com/sun/org/apache/xerces/internal/xni/parser/XMLDTDSource.java,Java,,6,7,36,49
/jdk1.7.0_80/com/sun/org/apache/xerces/internal/xni/parser/XMLEntityResolver.java,Java,,8,7,46,61
/jdk1.7.0_80/com/sun/org/apache/xerces/internal/xni/parser/XMLErrorHandler.java,Java,,10,8,88,106
/jdk1.7.0_80/com/sun/org/apache/xerces/internal/xni/parser/XMLInputSource.java,Java,,77,31,146,254
/jdk1.7.0_80/com/sun/org/apache/xerces/internal/xni/parser/XMLParseException.java,Java,,96,28,57,181
/jdk1.7.0_80/com/sun/org/apache/xerces/internal/xni/parser/XMLParserConfiguration.java,Java,,34,29,190,253
/jdk1.7.0_80/com/sun/org/apache/xerces/internal/xni/parser/XMLPullParserConfiguration.java,Java,,10,10,77,97
/jdk1.7.0_80/com/sun/org/apache/xerces/internal/xni/QName.java,Java,,90,25,128,243
/jdk1.7.0_80/com/sun/org/apache/xerces/internal/xni/XMLAttributes.java,Java,,33,40,366,439
/jdk1.7.0_80/com/sun/org/apache/xerces/internal/xni/XMLDocumentFragmentHandler.java,Java,,35,18,206,259
/jdk1.7.0_80/com/sun/org/apache/xerces/internal/xni/XMLDocumentHandler.java,Java,,33,25,238,296
/jdk1.7.0_80/com/sun/org/apache/xerces/internal/xni/XMLDTDContentModelHandler.java,Java,,25,25,223,273
/jdk1.7.0_80/com/sun/org/apache/xerces/internal/xni/XMLDTDHandler.java,Java,,59,30,289,378
/jdk1.7.0_80/com/sun/org/apache/xerces/internal/xni/XMLLocator.java,Java,,12,14,53,79
/jdk1.7.0_80/com/sun/org/apache/xerces/internal/xni/XMLResourceIdentifier.java,Java,,13,14,37,64
/jdk1.7.0_80/com/sun/org/apache/xerces/internal/xni/XMLString.java,Java,,58,22,111,191
/jdk1.7.0_80/com/sun/org/apache/xerces/internal/xni/XNIException.java,Java,,23,12,61,96
/jdk1.7.0_80/com/sun/org/apache/xerces/internal/xpointer/ElementSchemePointer.java,Java,,430,131,318,879
/jdk1.7.0_80/com/sun/org/apache/xerces/internal/xpointer/ShortHandPointer.java,Java,,121,38,137,296
/jdk1.7.0_80/com/sun/org/apache/xerces/internal/xpointer/XPointerErrorHandler.java,Java,,47,17,51,115
/jdk1.7.0_80/com/sun/org/apache/xerces/internal/xpointer/XPointerHandler.java,Java,,656,152,440,1248
/jdk1.7.0_80/com/sun/org/apache/xerces/internal/xpointer/XPointerMessageFormatter.java,Java,,40,10,47,97
/jdk1.7.0_80/com/sun/org/apache/xerces/internal/xpointer/XPointerPart.java,Java,,19,14,99,132
/jdk1.7.0_80/com/sun/org/apache/xerces/internal/xpointer/XPointerProcessor.java,Java,,15,11,78,104
/jdk1.7.0_80/com/sun/org/apache/xerces/internal/xs/AttributePSVI.java,Java,,4,3,26,33
/jdk1.7.0_80/com/sun/org/apache/xerces/internal/xs/datatypes/ByteList.java,Java,,8,7,49,64
/jdk1.7.0_80/com/sun/org/apache/xerces/internal/xs/datatypes/ObjectList.java,Java,,7,6,49,62
/jdk1.7.0_80/com/sun/org/apache/xerces/internal/xs/datatypes/XSDateTime.java,Java,,19,16,258,293
/jdk1.7.0_80/com/sun/org/apache/xerces/internal/xs/datatypes/XSDecimal.java,Java,,11,8,48,67
/jdk1.7.0_80/com/sun/org/apache/xerces/internal/xs/datatypes/XSDouble.java,Java,,4,3,28,35
/jdk1.7.0_80/com/sun/org/apache/xerces/internal/xs/datatypes/XSFloat.java,Java,,4,3,28,35
/jdk1.7.0_80/com/sun/org/apache/xerces/internal/xs/datatypes/XSQName.java,Java,,5,4,30,39
/jdk1.7.0_80/com/sun/org/apache/xerces/internal/xs/ElementPSVI.java,Java,,7,6,37,50
/jdk1.7.0_80/com/sun/org/apache/xerces/internal/xs/ItemPSVI.java,Java,,24,14,151,189
/jdk1.7.0_80/com/sun/org/apache/xerces/internal/xs/LSInputList.java,Java,,7,6,37,50
/jdk1.7.0_80/com/sun/org/apache/xerces/internal/xs/PSVIProvider.java,Java,,7,5,81,93
/jdk1.7.0_80/com/sun/org/apache/xerces/internal/xs/ShortList.java,Java,,8,6,45,59
/jdk1.7.0_80/com/sun/org/apache/xerces/internal/xs/StringList.java,Java,,7,6,44,57
/jdk1.7.0_80/com/sun/org/apache/xerces/internal/xs/XSAnnotation.java,Java,,9,5,49,63
/jdk1.7.0_80/com/sun/org/apache/xerces/internal/xs/XSAttributeDeclaration.java,Java,,16,11,84,111
/jdk1.7.0_80/com/sun/org/apache/xerces/internal/xs/XSAttributeGroupDefinition.java,Java,,7,5,36,48
/jdk1.7.0_80/com/sun/org/apache/xerces/internal/xs/XSAttributeUse.java,Java,,14,9,76,99
/jdk1.7.0_80/com/sun/org/apache/xerces/internal/xs/XSComplexTypeDefinition.java,Java,,17,13,86,116
/jdk1.7.0_80/com/sun/org/apache/xerces/internal/xs/XSConstants.java,Java,,84,7,254,345
/jdk1.7.0_80/com/sun/org/apache/xerces/internal/xs/XSElementDeclaration.java,Java,,24,19,137,180
/jdk1.7.0_80/com/sun/org/apache/xerces/internal/xs/XSException.java,Java,,11,5,40,56
/jdk1.7.0_80/com/sun/org/apache/xerces/internal/xs/XSFacet.java,Java,,8,6,40,54
/jdk1.7.0_80/com/sun/org/apache/xerces/internal/xs/XSIDCDefinition.java,Java,,11,8,53,72
/jdk1.7.0_80/com/sun/org/apache/xerces/internal/xs/XSImplementation.java,Java,,6,5,40,51
/jdk1.7.0_80/com/sun/org/apache/xerces/internal/xs/XSLoader.java,Java,,10,8,75,93
/jdk1.7.0_80/com/sun/org/apache/xerces/internal/xs/XSModel.java,Java,,22,14,125,161
/jdk1.7.0_80/com/sun/org/apache/xerces/internal/xs/XSModelGroup.java,Java,,10,6,50,66
/jdk1.7.0_80/com/sun/org/apache/xerces/internal/xs/XSModelGroupDefinition.java,Java,,6,4,32,42
/jdk1.7.0_80/com/sun/org/apache/xerces/internal/xs/XSMultiValueFacet.java,Java,,6,5,32,43
/jdk1.7.0_80/com/sun/org/apache/xerces/internal/xs/XSNamedMap.java,Java,,8,6,55,69
/jdk1.7.0_80/com/sun/org/apache/xerces/internal/xs/XSNamespaceItem.java,Java,,13,12,85,110
/jdk1.7.0_80/com/sun/org/apache/xerces/internal/xs/XSNamespaceItemList.java,Java,,6,5,37,48
/jdk1.7.0_80/com/sun/org/apache/xerces/internal/xs/XSNotationDeclaration.java,Java,,7,5,37,49
/jdk1.7.0_80/com/sun/org/apache/xerces/internal/xs/XSObject.java,Java,,7,6,45,58
/jdk1.7.0_80/com/sun/org/apache/xerces/internal/xs/XSObjectList.java,Java,,6,5,37,48
/jdk1.7.0_80/com/sun/org/apache/xerces/internal/xs/XSParticle.java,Java,,8,6,41,55
/jdk1.7.0_80/com/sun/org/apache/xerces/internal/xs/XSSimpleTypeDefinition.java,Java,,42,23,177,242
/jdk1.7.0_80/com/sun/org/apache/xerces/internal/xs/XSTerm.java,Java,,3,2,25,30
/jdk1.7.0_80/com/sun/org/apache/xerces/internal/xs/XSTypeDefinition.java,Java,,15,9,81,105
/jdk1.7.0_80/com/sun/org/apache/xerces/internal/xs/XSWildcard.java,Java,,14,8,68,90
/jdk1.7.0_80/com/sun/org/apache/xml/internal/dtm/Axis.java,Java,,74,29,119,222
/jdk1.7.0_80/com/sun/org/apache/xml/internal/dtm/DTM.java,Java,,95,95,779,969
/jdk1.7.0_80/com/sun/org/apache/xml/internal/dtm/DTMAxisIterator.java,Java,,17,15,80,112
/jdk1.7.0_80/com/sun/org/apache/xml/internal/dtm/DTMAxisTraverser.java,Java,,14,5,99,118
/jdk1.7.0_80/com/sun/org/apache/xml/internal/dtm/DTMConfigurationException.java,Java,,26,8,67,101
/jdk1.7.0_80/com/sun/org/apache/xml/internal/dtm/DTMDOMException.java,Java,,13,2,41,56
/jdk1.7.0_80/com/sun/org/apache/xml/internal/dtm/DTMException.java,Java,,175,64,146,385
/jdk1.7.0_80/com/sun/org/apache/xml/internal/dtm/DTMFilter.java,Java,,21,20,149,190
/jdk1.7.0_80/com/sun/org/apache/xml/internal/dtm/DTMIterator.java,Java,,32,33,281,346
/jdk1.7.0_80/com/sun/org/apache/xml/internal/dtm/DTMManager.java,Java,,127,52,321,500
/jdk1.7.0_80/com/sun/org/apache/xml/internal/dtm/DTMWSFilter.java,Java,,8,5,45,58
/jdk1.7.0_80/com/sun/org/apache/xml/internal/dtm/ref/ChunkedIntArray.java,Java,,146,22,140,308
/jdk1.7.0_80/com/sun/org/apache/xml/internal/dtm/ref/CoroutineManager.java,Java,,91,23,232,346
/jdk1.7.0_80/com/sun/org/apache/xml/internal/dtm/ref/CoroutineParser.java,Java,,14,13,115,142
/jdk1.7.0_80/com/sun/org/apache/xml/internal/dtm/ref/CustomStringPool.java,Java,,32,6,52,90
/jdk1.7.0_80/com/sun/org/apache/xml/internal/dtm/ref/dom2dtm/DOM2DTM.java,Java,,904,190,671,1765
/jdk1.7.0_80/com/sun/org/apache/xml/internal/dtm/ref/dom2dtm/DOM2DTMdefaultNamespaceDeclarationNode.java,Java,,219,42,419,680
/jdk1.7.0_80/com/sun/org/apache/xml/internal/dtm/ref/DTMAxisIteratorBase.java,Java,,101,40,142,283
/jdk1.7.0_80/com/sun/org/apache/xml/internal/dtm/ref/DTMAxisIterNodeList.java,Java,,57,10,77,144
/jdk1.7.0_80/com/sun/org/apache/xml/internal/dtm/ref/DTMChildIterNodeList.java,Java,,32,8,81,121
/jdk1.7.0_80/com/sun/org/apache/xml/internal/dtm/ref/DTMDefaultBase.java,Java,,1026,291,1054,2371
/jdk1.7.0_80/com/sun/org/apache/xml/internal/dtm/ref/DTMDefaultBaseIterators.java,Java,,1140,327,728,2195
/jdk1.7.0_80/com/sun/org/apache/xml/internal/dtm/ref/DTMDefaultBaseTraversers.java,Java,,744,212,791,1747
/jdk1.7.0_80/com/sun/org/apache/xml/internal/dtm/ref/DTMDocumentImpl.java,Java,,728,238,1447,2413
/jdk1.7.0_80/com/sun/org/apache/xml/internal/dtm/ref/DTMManagerDefault.java,Java,,388,104,369,861
/jdk1.7.0_80/com/sun/org/apache/xml/internal/dtm/ref/DTMNamedNodeMap.java,Java,,101,26,175,302
/jdk1.7.0_80/com/sun/org/apache/xml/internal/dtm/ref/DTMNodeIterator.java,Java,,66,20,102,188
/jdk1.7.0_80/com/sun/org/apache/xml/internal/dtm/ref/DTMNodeList.java,Java,,40,8,81,129
/jdk1.7.0_80/com/sun/org/apache/xml/internal/dtm/ref/DTMNodeListBase.java,Java,,12,4,67,83
/jdk1.7.0_80/com/sun/org/apache/xml/internal/dtm/ref/DTMNodeProxy.java,Java,,946,190,1279,2415
/jdk1.7.0_80/com/sun/org/apache/xml/internal/dtm/ref/DTMSafeStringPool.java,Java,,60,14,38,112
/jdk1.7.0_80/com/sun/org/apache/xml/internal/dtm/ref/DTMStringPool.java,Java,,100,25,68,193
/jdk1.7.0_80/com/sun/org/apache/xml/internal/dtm/ref/DTMTreeWalker.java,Java,,237,55,113,405
/jdk1.7.0_80/com/sun/org/apache/xml/internal/dtm/ref/EmptyIterator.java,Java,,21,18,25,64
/jdk1.7.0_80/com/sun/org/apache/xml/internal/dtm/ref/ExpandedNameTable.java,Java,,168,50,175,393
/jdk1.7.0_80/com/sun/org/apache/xml/internal/dtm/ref/ExtendedType.java,Java,,65,11,71,147
/jdk1.7.0_80/com/sun/org/apache/xml/internal/dtm/ref/IncrementalSAXSource.java,Java,,12,11,68,91
/jdk1.7.0_80/com/sun/org/apache/xml/internal/dtm/ref/IncrementalSAXSource_Filter.java,Java,,428,63,322,813
/jdk1.7.0_80/com/sun/org/apache/xml/internal/dtm/ref/IncrementalSAXSource_Xerces.java,Java,,263,46,148,457
/jdk1.7.0_80/com/sun/org/apache/xml/internal/dtm/ref/NodeLocator.java,Java,,39,9,64,112
/jdk1.7.0_80/com/sun/org/apache/xml/internal/dtm/ref/sax2dtm/SAX2DTM.java,Java,,1110,358,1055,2523
/jdk1.7.0_80/com/sun/org/apache/xml/internal/dtm/ref/sax2dtm/SAX2DTM2.java,Java,,1941,494,954,3389
/jdk1.7.0_80/com/sun/org/apache/xml/internal/dtm/ref/sax2dtm/SAX2RTFDTM.java,Java,,135,41,188,364
/jdk1.7.0_80/com/sun/org/apache/xml/internal/res/XMLErrorResources.java,Java,,244,95,114,453
/jdk1.7.0_80/com/sun/org/apache/xml/internal/res/XMLErrorResources_ca.java,Java,,239,91,113,443
/jdk1.7.0_80/com/sun/org/apache/xml/internal/res/XMLErrorResources_cs.java,Java,,239,91,113,443
/jdk1.7.0_80/com/sun/org/apache/xml/internal/res/XMLErrorResources_de.java,Java,,244,95,114,453
/jdk1.7.0_80/com/sun/org/apache/xml/internal/res/XMLErrorResources_en.java,Java,,4,2,27,33
/jdk1.7.0_80/com/sun/org/apache/xml/internal/res/XMLErrorResources_es.java,Java,,244,95,114,453
/jdk1.7.0_80/com/sun/org/apache/xml/internal/res/XMLErrorResources_fr.java,Java,,244,95,114,453
/jdk1.7.0_80/com/sun/org/apache/xml/internal/res/XMLErrorResources_it.java,Java,,244,95,114,453
/jdk1.7.0_80/com/sun/org/apache/xml/internal/res/XMLErrorResources_ja.java,Java,,244,95,114,453
/jdk1.7.0_80/com/sun/org/apache/xml/internal/res/XMLErrorResources_ko.java,Java,,244,95,114,453
/jdk1.7.0_80/com/sun/org/apache/xml/internal/res/XMLErrorResources_pt_BR.java,Java,,244,95,114,453
/jdk1.7.0_80/com/sun/org/apache/xml/internal/res/XMLErrorResources_sk.java,Java,,239,91,113,443
/jdk1.7.0_80/com/sun/org/apache/xml/internal/res/XMLErrorResources_sv.java,Java,,244,95,114,453
/jdk1.7.0_80/com/sun/org/apache/xml/internal/res/XMLErrorResources_tr.java,Java,,239,91,113,443
/jdk1.7.0_80/com/sun/org/apache/xml/internal/res/XMLErrorResources_zh_CN.java,Java,,244,95,114,453
/jdk1.7.0_80/com/sun/org/apache/xml/internal/res/XMLErrorResources_zh_HK.java,Java,,4,3,70,77
/jdk1.7.0_80/com/sun/org/apache/xml/internal/res/XMLErrorResources_zh_TW.java,Java,,244,95,114,453
/jdk1.7.0_80/com/sun/org/apache/xml/internal/res/XMLMessages.java,Java,,72,22,65,159
/jdk1.7.0_80/com/sun/org/apache/xml/internal/resolver/Catalog.java,Java,,1119,288,808,2215
/jdk1.7.0_80/com/sun/org/apache/xml/internal/resolver/CatalogEntry.java,Java,,87,27,138,252
/jdk1.7.0_80/com/sun/org/apache/xml/internal/resolver/CatalogException.java,Java,,58,13,97,168
/jdk1.7.0_80/com/sun/org/apache/xml/internal/resolver/CatalogManager.java,Java,,388,108,350,846
/jdk1.7.0_80/com/sun/org/apache/xml/internal/resolver/helpers/BootstrapResolver.java,Java,,111,29,63,203
/jdk1.7.0_80/com/sun/org/apache/xml/internal/resolver/helpers/Debug.java,Java,,29,9,73,111
/jdk1.7.0_80/com/sun/org/apache/xml/internal/resolver/helpers/FileURL.java,Java,,11,5,77,93
/jdk1.7.0_80/com/sun/org/apache/xml/internal/resolver/helpers/Namespaces.java,Java,,39,13,62,114
/jdk1.7.0_80/com/sun/org/apache/xml/internal/resolver/helpers/PublicId.java,Java,,63,20,78,161
/jdk1.7.0_80/com/sun/org/apache/xml/internal/resolver/readers/CatalogReader.java,Java,,12,6,63,81
/jdk1.7.0_80/com/sun/org/apache/xml/internal/resolver/readers/DOMCatalogParser.java,Java,,6,4,43,53
/jdk1.7.0_80/com/sun/org/apache/xml/internal/resolver/readers/DOMCatalogReader.java,Java,,99,20,124,243
/jdk1.7.0_80/com/sun/org/apache/xml/internal/resolver/readers/ExtendedXMLCatalogReader.java,Java,,108,27,52,187
/jdk1.7.0_80/com/sun/org/apache/xml/internal/resolver/readers/OASISXMLCatalogReader.java,Java,,389,78,74,541
/jdk1.7.0_80/com/sun/org/apache/xml/internal/resolver/readers/SAXCatalogParser.java,Java,,6,4,35,45
/jdk1.7.0_80/com/sun/org/apache/xml/internal/resolver/readers/SAXCatalogReader.java,Java,,315,56,132,503
/jdk1.7.0_80/com/sun/org/apache/xml/internal/resolver/readers/SAXParserHandler.java,Java,,96,21,33,150
/jdk1.7.0_80/com/sun/org/apache/xml/internal/resolver/readers/TextCatalogReader.java,Java,,179,36,88,303
/jdk1.7.0_80/com/sun/org/apache/xml/internal/resolver/readers/TR9401CatalogReader.java,Java,,70,17,56,143
/jdk1.7.0_80/com/sun/org/apache/xml/internal/resolver/readers/XCatalogReader.java,Java,,102,26,60,188
/jdk1.7.0_80/com/sun/org/apache/xml/internal/resolver/Resolver.java,Java,,355,66,273,694
/jdk1.7.0_80/com/sun/org/apache/xml/internal/resolver/tools/CatalogResolver.java,Java,,172,37,134,343
/jdk1.7.0_80/com/sun/org/apache/xml/internal/resolver/tools/ResolvingParser.java,Java,,263,57,126,446
/jdk1.7.0_80/com/sun/org/apache/xml/internal/resolver/tools/ResolvingXMLFilter.java,Java,,188,42,123,353
/jdk1.7.0_80/com/sun/org/apache/xml/internal/resolver/tools/ResolvingXMLReader.java,Java,,35,9,53,97
/jdk1.7.0_80/com/sun/org/apache/xml/internal/security/algorithms/Algorithm.java,Java,,25,12,46,83
/jdk1.7.0_80/com/sun/org/apache/xml/internal/security/algorithms/ClassLoaderUtils.java,Java,,167,26,87,280
/jdk1.7.0_80/com/sun/org/apache/xml/internal/security/algorithms/implementations/IntegrityHmac.java,Java,,281,86,244,611
/jdk1.7.0_80/com/sun/org/apache/xml/internal/security/algorithms/implementations/SignatureBaseRSA.java,Java,,205,53,121,379
/jdk1.7.0_80/com/sun/org/apache/xml/internal/security/algorithms/implementations/SignatureDSA.java,Java,,218,62,115,395
/jdk1.7.0_80/com/sun/org/apache/xml/internal/security/algorithms/implementations/SignatureECDSA.java,Java,,224,73,87,384
/jdk1.7.0_80/com/sun/org/apache/xml/internal/security/algorithms/JCEMapper.java,Java,,222,25,77,324
/jdk1.7.0_80/com/sun/org/apache/xml/internal/security/algorithms/MessageDigestAlgorithm.java,Java,,105,30,130,265
/jdk1.7.0_80/com/sun/org/apache/xml/internal/security/algorithms/SignatureAlgorithm.java,Java,,218,40,195,453
/jdk1.7.0_80/com/sun/org/apache/xml/internal/security/algorithms/SignatureAlgorithmSpi.java,Java,,37,21,125,183
/jdk1.7.0_80/com/sun/org/apache/xml/internal/security/c14n/CanonicalizationException.java,Java,,21,11,56,88
/jdk1.7.0_80/com/sun/org/apache/xml/internal/security/c14n/Canonicalizer.java,Java,,165,37,190,392
/jdk1.7.0_80/com/sun/org/apache/xml/internal/security/c14n/CanonicalizerSpi.java,Java,,53,25,124,202
/jdk1.7.0_80/com/sun/org/apache/xml/internal/security/c14n/helper/AttrCompare.java,Java,,52,15,60,127
/jdk1.7.0_80/com/sun/org/apache/xml/internal/security/c14n/helper/C14nHelper.java,Java,,64,23,77,164
/jdk1.7.0_80/com/sun/org/apache/xml/internal/security/c14n/implementations/Canonicalizer11.java,Java,,491,41,153,685
/jdk1.7.0_80/com/sun/org/apache/xml/internal/security/c14n/implementations/Canonicalizer11_OmitComments.java,Java,,13,5,23,41
/jdk1.7.0_80/com/sun/org/apache/xml/internal/security/c14n/implementations/Canonicalizer11_WithComments.java,Java,,13,5,23,41
/jdk1.7.0_80/com/sun/org/apache/xml/internal/security/c14n/implementations/Canonicalizer20010315.java,Java,,252,33,106,391
/jdk1.7.0_80/com/sun/org/apache/xml/internal/security/c14n/implementations/Canonicalizer20010315Excl.java,Java,,200,28,115,343
/jdk1.7.0_80/com/sun/org/apache/xml/internal/security/c14n/implementations/Canonicalizer20010315ExclOmitComments.java,Java,,14,6,29,49
/jdk1.7.0_80/com/sun/org/apache/xml/internal/security/c14n/implementations/Canonicalizer20010315ExclWithComments.java,Java,,14,8,31,53
/jdk1.7.0_80/com/sun/org/apache/xml/internal/security/c14n/implementations/Canonicalizer20010315OmitComments.java,Java,,13,8,30,51
/jdk1.7.0_80/com/sun/org/apache/xml/internal/security/c14n/implementations/Canonicalizer20010315WithComments.java,Java,,13,5,30,48
/jdk1.7.0_80/com/sun/org/apache/xml/internal/security/c14n/implementations/CanonicalizerBase.java,Java,,602,81,169,852
/jdk1.7.0_80/com/sun/org/apache/xml/internal/security/c14n/implementations/NameSpaceSymbTable.java,Java,,260,43,109,412
/jdk1.7.0_80/com/sun/org/apache/xml/internal/security/c14n/implementations/UtfHelpper.java,Java,,137,15,3,155
/jdk1.7.0_80/com/sun/org/apache/xml/internal/security/c14n/InvalidCanonicalizerException.java,Java,,22,11,55,88
/jdk1.7.0_80/com/sun/org/apache/xml/internal/security/encryption/AgreementMethod.java,Java,,16,13,127,156
/jdk1.7.0_80/com/sun/org/apache/xml/internal/security/encryption/CipherData.java,Java,,11,7,75,93
/jdk1.7.0_80/com/sun/org/apache/xml/internal/security/encryption/CipherReference.java,Java,,8,6,79,93
/jdk1.7.0_80/com/sun/org/apache/xml/internal/security/encryption/CipherValue.java,Java,,5,3,39,47
/jdk1.7.0_80/com/sun/org/apache/xml/internal/security/encryption/EncryptedData.java,Java,,3,2,39,44
/jdk1.7.0_80/com/sun/org/apache/xml/internal/security/encryption/EncryptedKey.java,Java,,9,8,95,112
/jdk1.7.0_80/com/sun/org/apache/xml/internal/security/encryption/EncryptedType.java,Java,,19,18,158,195
/jdk1.7.0_80/com/sun/org/apache/xml/internal/security/encryption/EncryptionMethod.java,Java,,13,11,84,108
/jdk1.7.0_80/com/sun/org/apache/xml/internal/security/encryption/EncryptionProperties.java,Java,,9,8,68,85
/jdk1.7.0_80/com/sun/org/apache/xml/internal/security/encryption/EncryptionProperty.java,Java,,14,11,94,119
/jdk1.7.0_80/com/sun/org/apache/xml/internal/security/encryption/Reference.java,Java,,10,8,74,92
/jdk1.7.0_80/com/sun/org/apache/xml/internal/security/encryption/ReferenceList.java,Java,,13,11,83,107
/jdk1.7.0_80/com/sun/org/apache/xml/internal/security/encryption/Transforms.java,Java,,4,9,62,75
/jdk1.7.0_80/com/sun/org/apache/xml/internal/security/encryption/XMLCipher.java,Java,,2071,465,1431,3967
/jdk1.7.0_80/com/sun/org/apache/xml/internal/security/encryption/XMLCipherInput.java,Java,,88,32,65,185
/jdk1.7.0_80/com/sun/org/apache/xml/internal/security/encryption/XMLCipherParameters.java,Java,,41,22,42,105
/jdk1.7.0_80/com/sun/org/apache/xml/internal/security/encryption/XMLEncryptionException.java,Java,,22,2,50,74
/jdk1.7.0_80/com/sun/org/apache/xml/internal/security/exceptions/AlgorithmAlreadyRegisteredException.java,Java,,21,9,59,89
/jdk1.7.0_80/com/sun/org/apache/xml/internal/security/exceptions/Base64DecodingException.java,Java,,21,9,56,86
/jdk1.7.0_80/com/sun/org/apache/xml/internal/security/exceptions/XMLSecurityException.java,Java,,88,46,115,249
/jdk1.7.0_80/com/sun/org/apache/xml/internal/security/exceptions/XMLSecurityRuntimeException.java,Java,,89,40,95,224
/jdk1.7.0_80/com/sun/org/apache/xml/internal/security/Init.java,Java,,258,46,74,378
/jdk1.7.0_80/com/sun/org/apache/xml/internal/security/keys/content/KeyInfoContent.java,Java,,3,5,25,33
/jdk1.7.0_80/com/sun/org/apache/xml/internal/security/keys/content/KeyName.java,Java,,21,8,43,72
/jdk1.7.0_80/com/sun/org/apache/xml/internal/security/keys/content/KeyValue.java,Java,,67,26,68,161
/jdk1.7.0_80/com/sun/org/apache/xml/internal/security/keys/content/keyvalues/DSAKeyValue.java,Java,,75,16,49,140
/jdk1.7.0_80/com/sun/org/apache/xml/internal/security/keys/content/keyvalues/KeyValueContent.java,Java,,7,6,34,47
/jdk1.7.0_80/com/sun/org/apache/xml/internal/security/keys/content/keyvalues/RSAKeyValue.java,Java,,64,17,48,129
/jdk1.7.0_80/com/sun/org/apache/xml/internal/security/keys/content/MgmtData.java,Java,,22,8,43,73
/jdk1.7.0_80/com/sun/org/apache/xml/internal/security/keys/content/PGPData.java,Java,,13,4,33,50
/jdk1.7.0_80/com/sun/org/apache/xml/internal/security/keys/content/RetrievalMethod.java,Java,,62,17,68,147
/jdk1.7.0_80/com/sun/org/apache/xml/internal/security/keys/content/SPKIData.java,Java,,14,4,33,51
/jdk1.7.0_80/com/sun/org/apache/xml/internal/security/keys/content/x509/XMLX509Certificate.java,Java,,76,24,66,166
/jdk1.7.0_80/com/sun/org/apache/xml/internal/security/keys/content/x509/XMLX509CRL.java,Java,,23,8,45,76
/jdk1.7.0_80/com/sun/org/apache/xml/internal/security/keys/content/x509/XMLX509DataContent.java,Java,,3,5,25,33
/jdk1.7.0_80/com/sun/org/apache/xml/internal/security/keys/content/x509/XMLX509IssuerSerial.java,Java,,71,22,76,169
/jdk1.7.0_80/com/sun/org/apache/xml/internal/security/keys/content/x509/XMLX509SKI.java,Java,,71,20,85,176
/jdk1.7.0_80/com/sun/org/apache/xml/internal/security/keys/content/x509/XMLX509SubjectName.java,Java,,41,14,51,106
/jdk1.7.0_80/com/sun/org/apache/xml/internal/security/keys/content/X509Data.java,Java,,197,61,226,484
/jdk1.7.0_80/com/sun/org/apache/xml/internal/security/keys/ContentHandlerAlreadyRegisteredException.java,Java,,24,11,55,90
/jdk1.7.0_80/com/sun/org/apache/xml/internal/security/keys/KeyInfo.java,Java,,535,150,407,1092
/jdk1.7.0_80/com/sun/org/apache/xml/internal/security/keys/keyresolver/implementations/DSAKeyValueResolver.java,Java,,47,15,37,99
/jdk1.7.0_80/com/sun/org/apache/xml/internal/security/keys/keyresolver/implementations/EncryptedKeyResolver.java,Java,,57,21,46,124
/jdk1.7.0_80/com/sun/org/apache/xml/internal/security/keys/keyresolver/implementations/RetrievalMethodResolver.java,Java,,200,21,95,316
/jdk1.7.0_80/com/sun/org/apache/xml/internal/security/keys/keyresolver/implementations/RSAKeyValueResolver.java,Java,,52,19,31,102
/jdk1.7.0_80/com/sun/org/apache/xml/internal/security/keys/keyresolver/implementations/X509CertificateResolver.java,Java,,57,19,54,130
/jdk1.7.0_80/com/sun/org/apache/xml/internal/security/keys/keyresolver/implementations/X509IssuerSerialResolver.java,Java,,93,27,28,148
/jdk1.7.0_80/com/sun/org/apache/xml/internal/security/keys/keyresolver/implementations/X509SKIResolver.java,Java,,80,25,53,158
/jdk1.7.0_80/com/sun/org/apache/xml/internal/security/keys/keyresolver/implementations/X509SubjectNameResolver.java,Java,,87,29,51,167
/jdk1.7.0_80/com/sun/org/apache/xml/internal/security/keys/keyresolver/InvalidKeyResolverException.java,Java,,22,11,56,89
/jdk1.7.0_80/com/sun/org/apache/xml/internal/security/keys/keyresolver/KeyResolver.java,Java,,197,43,176,416
/jdk1.7.0_80/com/sun/org/apache/xml/internal/security/keys/keyresolver/KeyResolverException.java,Java,,21,11,59,91
/jdk1.7.0_80/com/sun/org/apache/xml/internal/security/keys/keyresolver/KeyResolverSpi.java,Java,,85,19,121,225
/jdk1.7.0_80/com/sun/org/apache/xml/internal/security/keys/KeyUtils.java,Java,,38,16,33,87
/jdk1.7.0_80/com/sun/org/apache/xml/internal/security/keys/storage/implementations/CertsInFilesystemDirectoryResolver.java,Java,,122,36,68,226
/jdk1.7.0_80/com/sun/org/apache/xml/internal/security/keys/storage/implementations/KeyStoreResolver.java,Java,,62,24,61,147
/jdk1.7.0_80/com/sun/org/apache/xml/internal/security/keys/storage/implementations/SingleCertificateResolver.java,Java,,33,17,53,103
/jdk1.7.0_80/com/sun/org/apache/xml/internal/security/keys/storage/StorageResolver.java,Java,,75,29,94,198
/jdk1.7.0_80/com/sun/org/apache/xml/internal/security/keys/storage/StorageResolverException.java,Java,,21,11,55,87
/jdk1.7.0_80/com/sun/org/apache/xml/internal/security/keys/storage/StorageResolverSpi.java,Java,,5,6,29,40
/jdk1.7.0_80/com/sun/org/apache/xml/internal/security/signature/InvalidDigestValueException.java,Java,,21,9,56,86
/jdk1.7.0_80/com/sun/org/apache/xml/internal/security/signature/InvalidSignatureValueException.java,Java,,21,9,57,87
/jdk1.7.0_80/com/sun/org/apache/xml/internal/security/signature/Manifest.java,Java,,277,90,204,571
/jdk1.7.0_80/com/sun/org/apache/xml/internal/security/signature/MissingResourceFailureException.java,Java,,32,20,78,130
/jdk1.7.0_80/com/sun/org/apache/xml/internal/security/signature/NodeFilter.java,Java,,6,3,44,53
/jdk1.7.0_80/com/sun/org/apache/xml/internal/security/signature/ObjectContainer.java,Java,,51,21,76,148
/jdk1.7.0_80/com/sun/org/apache/xml/internal/security/signature/Reference.java,Java,,401,114,275,790
/jdk1.7.0_80/com/sun/org/apache/xml/internal/security/signature/ReferenceNotInitializedException.java,Java,,21,11,57,89
/jdk1.7.0_80/com/sun/org/apache/xml/internal/security/signature/SignatureProperties.java,Java,,68,19,69,156
/jdk1.7.0_80/com/sun/org/apache/xml/internal/security/signature/SignatureProperty.java,Java,,44,15,73,132
/jdk1.7.0_80/com/sun/org/apache/xml/internal/security/signature/SignedInfo.java,Java,,197,53,140,390
/jdk1.7.0_80/com/sun/org/apache/xml/internal/security/signature/XMLSignature.java,Java,,345,106,340,791
/jdk1.7.0_80/com/sun/org/apache/xml/internal/security/signature/XMLSignatureException.java,Java,,21,11,57,89
/jdk1.7.0_80/com/sun/org/apache/xml/internal/security/signature/XMLSignatureInput.java,Java,,296,66,270,632
/jdk1.7.0_80/com/sun/org/apache/xml/internal/security/signature/XMLSignatureInputDebugger.java,Java,,435,149,134,718
/jdk1.7.0_80/com/sun/org/apache/xml/internal/security/transforms/ClassLoaderUtils.java,Java,,167,26,87,280
/jdk1.7.0_80/com/sun/org/apache/xml/internal/security/transforms/implementations/FuncHere.java,Java,,67,30,64,161
/jdk1.7.0_80/com/sun/org/apache/xml/internal/security/transforms/implementations/FuncHereContext.java,Java,,42,16,85,143
/jdk1.7.0_80/com/sun/org/apache/xml/internal/security/transforms/implementations/TransformBase64Decode.java,Java,,103,19,64,186
/jdk1.7.0_80/com/sun/org/apache/xml/internal/security/transforms/implementations/TransformC14N.java,Java,,34,8,33,75
/jdk1.7.0_80/com/sun/org/apache/xml/internal/security/transforms/implementations/TransformC14N11.java,Java,,33,6,26,65
/jdk1.7.0_80/com/sun/org/apache/xml/internal/security/transforms/implementations/TransformC14N11_WithComments.java,Java,,33,8,26,67
/jdk1.7.0_80/com/sun/org/apache/xml/internal/security/transforms/implementations/TransformC14NExclusive.java,Java,,56,11,39,106
/jdk1.7.0_80/com/sun/org/apache/xml/internal/security/transforms/implementations/TransformC14NExclusiveWithComments.java,Java,,53,11,35,99
/jdk1.7.0_80/com/sun/org/apache/xml/internal/security/transforms/implementations/TransformC14NWithComments.java,Java,,34,9,30,73
/jdk1.7.0_80/com/sun/org/apache/xml/internal/security/transforms/implementations/TransformEnvelopedSignature.java,Java,,64,18,56,138
/jdk1.7.0_80/com/sun/org/apache/xml/internal/security/transforms/implementations/TransformXPath.java,Java,,87,18,63,168
/jdk1.7.0_80/com/sun/org/apache/xml/internal/security/transforms/implementations/TransformXPath2Filter.java,Java,,209,36,65,310
/jdk1.7.0_80/com/sun/org/apache/xml/internal/security/transforms/implementations/TransformXPointer.java,Java,,19,13,35,67
/jdk1.7.0_80/com/sun/org/apache/xml/internal/security/transforms/implementations/TransformXSLT.java,Java,,99,24,63,186
/jdk1.7.0_80/com/sun/org/apache/xml/internal/security/transforms/InvalidTransformException.java,Java,,21,11,55,87
/jdk1.7.0_80/com/sun/org/apache/xml/internal/security/transforms/params/InclusiveNamespaces.java,Java,,70,29,83,182
/jdk1.7.0_80/com/sun/org/apache/xml/internal/security/transforms/params/XPath2FilterContainer.java,Java,,132,52,131,315
/jdk1.7.0_80/com/sun/org/apache/xml/internal/security/transforms/params/XPath2FilterContainer04.java,Java,,113,41,113,267
/jdk1.7.0_80/com/sun/org/apache/xml/internal/security/transforms/params/XPathContainer.java,Java,,28,12,43,83
/jdk1.7.0_80/com/sun/org/apache/xml/internal/security/transforms/params/XPathFilterCHGPContainer.java,Java,,134,48,139,321
/jdk1.7.0_80/com/sun/org/apache/xml/internal/security/transforms/Transform.java,Java,,208,31,137,376
/jdk1.7.0_80/com/sun/org/apache/xml/internal/security/transforms/TransformationException.java,Java,,21,11,55,87
/jdk1.7.0_80/com/sun/org/apache/xml/internal/security/transforms/TransformParam.java,Java,,3,3,24,30
/jdk1.7.0_80/com/sun/org/apache/xml/internal/security/transforms/Transforms.java,Java,,156,34,130,320
/jdk1.7.0_80/com/sun/org/apache/xml/internal/security/transforms/TransformSpi.java,Java,,47,4,86,137
/jdk1.7.0_80/com/sun/org/apache/xml/internal/security/utils/Base64.java,Java,,452,138,203,793
/jdk1.7.0_80/com/sun/org/apache/xml/internal/security/utils/CachedXPathAPIHolder.java,Java,,29,5,31,65
/jdk1.7.0_80/com/sun/org/apache/xml/internal/security/utils/CachedXPathFuncHereAPI.java,Java,,200,48,215,463
/jdk1.7.0_80/com/sun/org/apache/xml/internal/security/utils/Constants.java,Java,,79,15,136,230
/jdk1.7.0_80/com/sun/org/apache/xml/internal/security/utils/DigesterOutputStream.java,Java,,32,8,33,73
/jdk1.7.0_80/com/sun/org/apache/xml/internal/security/utils/ElementChecker.java,Java,,9,3,5,17
/jdk1.7.0_80/com/sun/org/apache/xml/internal/security/utils/ElementCheckerImpl.java,Java,,48,9,3,60
/jdk1.7.0_80/com/sun/org/apache/xml/internal/security/utils/ElementProxy.java,Java,,265,67,201,533
/jdk1.7.0_80/com/sun/org/apache/xml/internal/security/utils/EncryptionConstants.java,Java,,61,20,99,180
/jdk1.7.0_80/com/sun/org/apache/xml/internal/security/utils/EncryptionElementProxy.java,Java,,16,8,39,63
/jdk1.7.0_80/com/sun/org/apache/xml/internal/security/utils/HelperNodeList.java,Java,,35,13,53,101
/jdk1.7.0_80/com/sun/org/apache/xml/internal/security/utils/I18n.java,Java,,71,13,84,168
/jdk1.7.0_80/com/sun/org/apache/xml/internal/security/utils/IdResolver.java,Java,,185,30,77,292
/jdk1.7.0_80/com/sun/org/apache/xml/internal/security/utils/IgnoreAllErrorHandler.java,Java,,37,14,32,83
/jdk1.7.0_80/com/sun/org/apache/xml/internal/security/utils/JavaUtils.java,Java,,71,21,61,153
/jdk1.7.0_80/com/sun/org/apache/xml/internal/security/utils/resolver/implementations/ResolverAnonymous.java,Java,,29,11,37,77
/jdk1.7.0_80/com/sun/org/apache/xml/internal/security/utils/resolver/implementations/ResolverDirectHTTP.java,Java,,169,53,81,303
/jdk1.7.0_80/com/sun/org/apache/xml/internal/security/utils/resolver/implementations/ResolverFragment.java,Java,,76,18,55,149
/jdk1.7.0_80/com/sun/org/apache/xml/internal/security/utils/resolver/implementations/ResolverLocalFilesystem.java,Java,,89,26,42,157
/jdk1.7.0_80/com/sun/org/apache/xml/internal/security/utils/resolver/implementations/ResolverXPointer.java,Java,,103,34,62,199
/jdk1.7.0_80/com/sun/org/apache/xml/internal/security/utils/resolver/ResourceResolver.java,Java,,169,31,157,357
/jdk1.7.0_80/com/sun/org/apache/xml/internal/security/utils/resolver/ResourceResolverException.java,Java,,44,22,79,145
/jdk1.7.0_80/com/sun/org/apache/xml/internal/security/utils/resolver/ResourceResolverSpi.java,Java,,78,27,88,193
/jdk1.7.0_80/com/sun/org/apache/xml/internal/security/utils/RFC2253Parser.java,Java,,286,115,173,574
/jdk1.7.0_80/com/sun/org/apache/xml/internal/security/utils/SignatureElementProxy.java,Java,,23,9,39,71
/jdk1.7.0_80/com/sun/org/apache/xml/internal/security/utils/SignerOutputStream.java,Java,,45,7,30,82
/jdk1.7.0_80/com/sun/org/apache/xml/internal/security/utils/UnsyncBufferedOutputStream.java,Java,,52,12,34,98
/jdk1.7.0_80/com/sun/org/apache/xml/internal/security/utils/UnsyncByteArrayOutputStream.java,Java,,69,10,26,105
/jdk1.7.0_80/com/sun/org/apache/xml/internal/security/utils/XMLUtils.java,Java,,498,104,245,847
/jdk1.7.0_80/com/sun/org/apache/xml/internal/security/utils/XPathFuncHereAPI.java,Java,,85,35,186,306
/jdk1.7.0_80/com/sun/org/apache/xml/internal/serialize/BaseMarkupSerializer.java,Java,,1219,264,485,1968
/jdk1.7.0_80/com/sun/org/apache/xml/internal/serialize/DOMSerializer.java,Java,,14,15,50,79
/jdk1.7.0_80/com/sun/org/apache/xml/internal/serialize/DOMSerializerImpl.java,Java,,853,75,283,1211
/jdk1.7.0_80/com/sun/org/apache/xml/internal/serialize/ElementState.java,Java,,16,30,62,108
/jdk1.7.0_80/com/sun/org/apache/xml/internal/serialize/EncodingInfo.java,Java,,143,31,97,271
/jdk1.7.0_80/com/sun/org/apache/xml/internal/serialize/Encodings.java,Java,,66,14,44,124
/jdk1.7.0_80/com/sun/org/apache/xml/internal/serialize/HTMLdtd.java,Java,,269,87,201,557
/jdk1.7.0_80/com/sun/org/apache/xml/internal/serialize/HTMLSerializer.java,Java,,523,97,261,881
/jdk1.7.0_80/com/sun/org/apache/xml/internal/serialize/IndentPrinter.java,Java,,162,58,145,365
/jdk1.7.0_80/com/sun/org/apache/xml/internal/serialize/LineSeparator.java,Java,,8,14,35,57
/jdk1.7.0_80/com/sun/org/apache/xml/internal/serialize/Method.java,Java,,9,16,38,63
/jdk1.7.0_80/com/sun/org/apache/xml/internal/serialize/OutputFormat.java,Java,,332,159,470,961
/jdk1.7.0_80/com/sun/org/apache/xml/internal/serialize/Printer.java,Java,,198,64,102,364
/jdk1.7.0_80/com/sun/org/apache/xml/internal/serialize/SecuritySupport.java,Java,,106,16,30,152
/jdk1.7.0_80/com/sun/org/apache/xml/internal/serialize/Serializer.java,Java,,18,21,84,123
/jdk1.7.0_80/com/sun/org/apache/xml/internal/serialize/SerializerFactory.java,Java,,59,27,63,149
/jdk1.7.0_80/com/sun/org/apache/xml/internal/serialize/SerializerFactoryImpl.java,Java,,64,25,27,116
/jdk1.7.0_80/com/sun/org/apache/xml/internal/serialize/TextSerializer.java,Java,,189,74,127,390
/jdk1.7.0_80/com/sun/org/apache/xml/internal/serialize/XHTMLSerializer.java,Java,,29,18,57,104
/jdk1.7.0_80/com/sun/org/apache/xml/internal/serialize/XML11Serializer.java,Java,,311,64,162,537
/jdk1.7.0_80/com/sun/org/apache/xml/internal/serialize/XMLSerializer.java,Java,,890,173,406,1469
/jdk1.7.0_80/com/sun/org/apache/xml/internal/serializer/AttributesImplSerializer.java,Java,,103,22,114,239
/jdk1.7.0_80/com/sun/org/apache/xml/internal/serializer/CharInfo.java,Java,,318,91,337,746
/jdk1.7.0_80/com/sun/org/apache/xml/internal/serializer/DOMSerializer.java,Java,,7,3,58,68
/jdk1.7.0_80/com/sun/org/apache/xml/internal/serializer/ElemContext.java,Java,,57,18,146,221
/jdk1.7.0_80/com/sun/org/apache/xml/internal/serializer/ElemDesc.java,Java,,55,36,89,180
/jdk1.7.0_80/com/sun/org/apache/xml/internal/serializer/EmptySerializer.java,Java,,447,23,296,766
/jdk1.7.0_80/com/sun/org/apache/xml/internal/serializer/EncodingInfo.java,Java,,188,45,281,514
/jdk1.7.0_80/com/sun/org/apache/xml/internal/serializer/Encodings.java,Java,,270,54,247,571
/jdk1.7.0_80/com/sun/org/apache/xml/internal/serializer/ExtendedContentHandler.java,Java,,49,17,207,273
/jdk1.7.0_80/com/sun/org/apache/xml/internal/serializer/ExtendedLexicalHandler.java,Java,,6,2,33,41
/jdk1.7.0_80/com/sun/org/apache/xml/internal/serializer/Method.java,Java,,11,7,60,78
/jdk1.7.0_80/com/sun/org/apache/xml/internal/serializer/NamespaceMappings.java,Java,,157,33,137,327
/jdk1.7.0_80/com/sun/org/apache/xml/internal/serializer/OutputPropertiesFactory.java,Java,,261,50,228,539
/jdk1.7.0_80/com/sun/org/apache/xml/internal/serializer/OutputPropertyUtils.java,Java,,21,8,56,85
/jdk1.7.0_80/com/sun/org/apache/xml/internal/serializer/SerializationHandler.java,Java,,31,14,89,134
/jdk1.7.0_80/com/sun/org/apache/xml/internal/serializer/Serializer.java,Java,,17,11,195,223
/jdk1.7.0_80/com/sun/org/apache/xml/internal/serializer/SerializerBase.java,Java,,591,152,659,1402
/jdk1.7.0_80/com/sun/org/apache/xml/internal/serializer/SerializerConstants.java,Java,,19,7,35,61
/jdk1.7.0_80/com/sun/org/apache/xml/internal/serializer/SerializerFactory.java,Java,,75,23,88,186
/jdk1.7.0_80/com/sun/org/apache/xml/internal/serializer/SerializerTrace.java,Java,,22,24,109,155
/jdk1.7.0_80/com/sun/org/apache/xml/internal/serializer/SerializerTraceWriter.java,Java,,152,44,147,343
/jdk1.7.0_80/com/sun/org/apache/xml/internal/serializer/ToHTMLSAXHandler.java,Java,,284,65,398,747
/jdk1.7.0_80/com/sun/org/apache/xml/internal/serializer/ToHTMLStream.java,Java,,1384,240,696,2320
/jdk1.7.0_80/com/sun/org/apache/xml/internal/serializer/ToSAXHandler.java,Java,,204,48,188,440
/jdk1.7.0_80/com/sun/org/apache/xml/internal/serializer/ToStream.java,Java,,1762,337,1290,3389
/jdk1.7.0_80/com/sun/org/apache/xml/internal/serializer/ToTextSAXHandler.java,Java,,215,55,144,414
/jdk1.7.0_80/com/sun/org/apache/xml/internal/serializer/ToTextStream.java,Java,,247,54,335,636
/jdk1.7.0_80/com/sun/org/apache/xml/internal/serializer/ToUnknownStream.java,Java,,674,154,510,1338
/jdk1.7.0_80/com/sun/org/apache/xml/internal/serializer/ToXMLSAXHandler.java,Java,,407,102,269,778
/jdk1.7.0_80/com/sun/org/apache/xml/internal/serializer/ToXMLStream.java,Java,,360,71,225,656
/jdk1.7.0_80/com/sun/org/apache/xml/internal/serializer/TransformStateSetter.java,Java,,8,6,44,58
/jdk1.7.0_80/com/sun/org/apache/xml/internal/serializer/TreeWalker.java,Java,,328,70,131,529
/jdk1.7.0_80/com/sun/org/apache/xml/internal/serializer/utils/AttList.java,Java,,86,22,157,265
/jdk1.7.0_80/com/sun/org/apache/xml/internal/serializer/utils/BoolStack.java,Java,,67,27,112,206
/jdk1.7.0_80/com/sun/org/apache/xml/internal/serializer/utils/DOM2Helper.java,Java,,30,14,92,136
/jdk1.7.0_80/com/sun/org/apache/xml/internal/serializer/utils/Messages.java,Java,,104,22,146,272
/jdk1.7.0_80/com/sun/org/apache/xml/internal/serializer/utils/MsgKey.java,Java,,58,6,38,102
/jdk1.7.0_80/com/sun/org/apache/xml/internal/serializer/utils/SerializerMessages.java,Java,,82,41,85,208
/jdk1.7.0_80/com/sun/org/apache/xml/internal/serializer/utils/SerializerMessages_ca.java,Java,,73,35,22,130
/jdk1.7.0_80/com/sun/org/apache/xml/internal/serializer/utils/SerializerMessages_cs.java,Java,,65,31,26,122
/jdk1.7.0_80/com/sun/org/apache/xml/internal/serializer/utils/SerializerMessages_de.java,Java,,82,41,85,208
/jdk1.7.0_80/com/sun/org/apache/xml/internal/serializer/utils/SerializerMessages_en.java,Java,,4,2,26,32
/jdk1.7.0_80/com/sun/org/apache/xml/internal/serializer/utils/SerializerMessages_es.java,Java,,82,41,85,208
/jdk1.7.0_80/com/sun/org/apache/xml/internal/serializer/utils/SerializerMessages_fr.java,Java,,82,41,85,208
/jdk1.7.0_80/com/sun/org/apache/xml/internal/serializer/utils/SerializerMessages_it.java,Java,,82,41,85,208
/jdk1.7.0_80/com/sun/org/apache/xml/internal/serializer/utils/SerializerMessages_ja.java,Java,,82,41,85,208
/jdk1.7.0_80/com/sun/org/apache/xml/internal/serializer/utils/SerializerMessages_ko.java,Java,,82,41,85,208
/jdk1.7.0_80/com/sun/org/apache/xml/internal/serializer/utils/SerializerMessages_pt_BR.java,Java,,82,41,85,208
/jdk1.7.0_80/com/sun/org/apache/xml/internal/serializer/utils/SerializerMessages_sv.java,Java,,82,41,85,208
/jdk1.7.0_80/com/sun/org/apache/xml/internal/serializer/utils/SerializerMessages_zh_CN.java,Java,,82,41,85,208
/jdk1.7.0_80/com/sun/org/apache/xml/internal/serializer/utils/SerializerMessages_zh_TW.java,Java,,82,41,85,208
/jdk1.7.0_80/com/sun/org/apache/xml/internal/serializer/utils/StringToIntTable.java,Java,,82,35,88,205
/jdk1.7.0_80/com/sun/org/apache/xml/internal/serializer/utils/SystemIDResolver.java,Java,,154,27,123,304
/jdk1.7.0_80/com/sun/org/apache/xml/internal/serializer/utils/URI.java,Java,,913,220,538,1671
/jdk1.7.0_80/com/sun/org/apache/xml/internal/serializer/utils/Utils.java,Java,,8,2,35,45
/jdk1.7.0_80/com/sun/org/apache/xml/internal/serializer/utils/WrappedRuntimeException.java,Java,,20,9,54,83
/jdk1.7.0_80/com/sun/org/apache/xml/internal/serializer/Utils.java,Java,,27,4,49,80
/jdk1.7.0_80/com/sun/org/apache/xml/internal/serializer/Version.java,Java,,46,11,95,152
/jdk1.7.0_80/com/sun/org/apache/xml/internal/serializer/WriterChain.java,Java,,14,4,66,84
/jdk1.7.0_80/com/sun/org/apache/xml/internal/serializer/WriterToASCI.java,Java,,49,15,93,157
/jdk1.7.0_80/com/sun/org/apache/xml/internal/serializer/WriterToUTF8Buffered.java,Java,,225,53,227,505
/jdk1.7.0_80/com/sun/org/apache/xml/internal/serializer/XSLOutputAttributes.java,Java,,24,12,148,184
/jdk1.7.0_80/com/sun/org/apache/xml/internal/utils/AttList.java,Java,,86,22,148,256
/jdk1.7.0_80/com/sun/org/apache/xml/internal/utils/BoolStack.java,Java,,72,29,103,204
/jdk1.7.0_80/com/sun/org/apache/xml/internal/utils/CharKey.java,Java,,24,9,53,86
/jdk1.7.0_80/com/sun/org/apache/xml/internal/utils/Constants.java,Java,,32,9,73,114
/jdk1.7.0_80/com/sun/org/apache/xml/internal/utils/DefaultErrorHandler.java,Java,,143,31,170,344
/jdk1.7.0_80/com/sun/org/apache/xml/internal/utils/DOM2Helper.java,Java,,90,32,194,316
/jdk1.7.0_80/com/sun/org/apache/xml/internal/utils/DOMBuilder.java,Java,,263,87,440,790
/jdk1.7.0_80/com/sun/org/apache/xml/internal/utils/DOMHelper.java,Java,,620,172,544,1336
/jdk1.7.0_80/com/sun/org/apache/xml/internal/utils/DOMOrder.java,Java,,5,2,36,43
/jdk1.7.0_80/com/sun/org/apache/xml/internal/utils/ElemDesc.java,Java,,56,36,99,191
/jdk1.7.0_80/com/sun/org/apache/xml/internal/utils/FastStringBuffer.java,Java,,539,192,567,1298
/jdk1.7.0_80/com/sun/org/apache/xml/internal/utils/Hashtree2Node.java,Java,,69,12,61,142
/jdk1.7.0_80/com/sun/org/apache/xml/internal/utils/IntStack.java,Java,,86,25,102,213
/jdk1.7.0_80/com/sun/org/apache/xml/internal/utils/IntVector.java,Java,,177,70,174,421
/jdk1.7.0_80/com/sun/org/apache/xml/internal/utils/ListingErrorHandler.java,Java,,236,65,266,567
/jdk1.7.0_80/com/sun/org/apache/xml/internal/utils/LocaleUtility.java,Java,,45,15,28,88
/jdk1.7.0_80/com/sun/org/apache/xml/internal/utils/MutableAttrListImpl.java,Java,,51,18,72,141
/jdk1.7.0_80/com/sun/org/apache/xml/internal/utils/NameSpace.java,Java,,14,6,41,61
/jdk1.7.0_80/com/sun/org/apache/xml/internal/utils/NamespaceSupport2.java,Java,,276,85,390,751
/jdk1.7.0_80/com/sun/org/apache/xml/internal/utils/NodeConsumer.java,Java,,6,3,33,42
/jdk1.7.0_80/com/sun/org/apache/xml/internal/utils/NodeVector.java,Java,,338,133,270,741
/jdk1.7.0_80/com/sun/org/apache/xml/internal/utils/NSInfo.java,Java,,33,15,64,112
/jdk1.7.0_80/com/sun/org/apache/xml/internal/utils/ObjectPool.java,Java,,69,22,84,175
/jdk1.7.0_80/com/sun/org/apache/xml/internal/utils/ObjectStack.java,Java,,88,27,102,217
/jdk1.7.0_80/com/sun/org/apache/xml/internal/utils/ObjectVector.java,Java,,183,74,176,433
/jdk1.7.0_80/com/sun/org/apache/xml/internal/utils/PrefixResolver.java,Java,,8,5,61,74
/jdk1.7.0_80/com/sun/org/apache/xml/internal/utils/PrefixResolverDefault.java,Java,,65,17,65,147
/jdk1.7.0_80/com/sun/org/apache/xml/internal/utils/QName.java,Java,,343,94,274,711
/jdk1.7.0_80/com/sun/org/apache/xml/internal/utils/RawCharacterHandler.java,Java,,6,2,36,44
/jdk1.7.0_80/com/sun/org/apache/xml/internal/utils/res/CharArrayWrapper.java,Java,,13,4,27,44
/jdk1.7.0_80/com/sun/org/apache/xml/internal/utils/res/IntArrayWrapper.java,Java,,13,4,27,44
/jdk1.7.0_80/com/sun/org/apache/xml/internal/utils/res/LongArrayWrapper.java,Java,,13,4,27,44
/jdk1.7.0_80/com/sun/org/apache/xml/internal/utils/res/StringArrayWrapper.java,Java,,13,4,27,44
/jdk1.7.0_80/com/sun/org/apache/xml/internal/utils/res/XResourceBundle.java,Java,,33,5,37,75
/jdk1.7.0_80/com/sun/org/apache/xml/internal/utils/res/XResourceBundleBase.java,Java,,7,4,41,52
/jdk1.7.0_80/com/sun/org/apache/xml/internal/utils/res/XResources_de.java,Java,,22,6,48,76
/jdk1.7.0_80/com/sun/org/apache/xml/internal/utils/res/XResources_en.java,Java,,22,6,48,76
/jdk1.7.0_80/com/sun/org/apache/xml/internal/utils/res/XResources_es.java,Java,,22,6,48,76
/jdk1.7.0_80/com/sun/org/apache/xml/internal/utils/res/XResources_fr.java,Java,,22,6,48,76
/jdk1.7.0_80/com/sun/org/apache/xml/internal/utils/res/XResources_it.java,Java,,22,6,48,76
/jdk1.7.0_80/com/sun/org/apache/xml/internal/utils/res/XResources_ja_JP_A.java,Java,,38,8,43,89
/jdk1.7.0_80/com/sun/org/apache/xml/internal/utils/res/XResources_ja_JP_HA.java,Java,,38,8,43,89
/jdk1.7.0_80/com/sun/org/apache/xml/internal/utils/res/XResources_ja_JP_HI.java,Java,,38,8,44,90
/jdk1.7.0_80/com/sun/org/apache/xml/internal/utils/res/XResources_ja_JP_I.java,Java,,37,8,44,89
/jdk1.7.0_80/com/sun/org/apache/xml/internal/utils/res/XResources_ko.java,Java,,34,8,41,83
/jdk1.7.0_80/com/sun/org/apache/xml/internal/utils/res/XResources_sv.java,Java,,22,6,48,76
/jdk1.7.0_80/com/sun/org/apache/xml/internal/utils/res/XResources_zh_CN.java,Java,,34,8,41,83
/jdk1.7.0_80/com/sun/org/apache/xml/internal/utils/res/XResources_zh_TW.java,Java,,34,8,41,83
/jdk1.7.0_80/com/sun/org/apache/xml/internal/utils/SAXSourceLocator.java,Java,,52,13,107,172
/jdk1.7.0_80/com/sun/org/apache/xml/internal/utils/SerializableLocatorImpl.java,Java,,52,33,142,227
/jdk1.7.0_80/com/sun/org/apache/xml/internal/utils/StopParseException.java,Java,,9,1,32,42
/jdk1.7.0_80/com/sun/org/apache/xml/internal/utils/StringBufferPool.java,Java,,15,4,43,62
/jdk1.7.0_80/com/sun/org/apache/xml/internal/utils/StringComparable.java,Java,,155,28,32,215
/jdk1.7.0_80/com/sun/org/apache/xml/internal/utils/StringToIntTable.java,Java,,82,35,81,198
/jdk1.7.0_80/com/sun/org/apache/xml/internal/utils/StringToStringTable.java,Java,,104,40,100,244
/jdk1.7.0_80/com/sun/org/apache/xml/internal/utils/StringToStringTableVector.java,Java,,80,32,89,201
/jdk1.7.0_80/com/sun/org/apache/xml/internal/utils/StringVector.java,Java,,92,41,92,225
/jdk1.7.0_80/com/sun/org/apache/xml/internal/utils/StylesheetPIHandler.java,Java,,206,33,103,342
/jdk1.7.0_80/com/sun/org/apache/xml/internal/utils/SuballocatedByteVector.java,Java,,267,37,196,500
/jdk1.7.0_80/com/sun/org/apache/xml/internal/utils/SuballocatedIntVector.java,Java,,290,47,222,559
/jdk1.7.0_80/com/sun/org/apache/xml/internal/utils/SystemIDResolver.java,Java,,154,27,116,297
/jdk1.7.0_80/com/sun/org/apache/xml/internal/utils/ThreadControllerWrapper.java,Java,,50,15,61,126
/jdk1.7.0_80/com/sun/org/apache/xml/internal/utils/TreeWalker.java,Java,,307,72,131,510
/jdk1.7.0_80/com/sun/org/apache/xml/internal/utils/Trie.java,Java,,93,24,90,207
/jdk1.7.0_80/com/sun/org/apache/xml/internal/utils/UnImplNode.java,Java,,634,274,1146,2054
/jdk1.7.0_80/com/sun/org/apache/xml/internal/utils/URI.java,Java,,924,221,547,1692
/jdk1.7.0_80/com/sun/org/apache/xml/internal/utils/WrappedRuntimeException.java,Java,,20,9,47,76
/jdk1.7.0_80/com/sun/org/apache/xml/internal/utils/WrongParserException.java,Java,,9,2,31,42
/jdk1.7.0_80/com/sun/org/apache/xml/internal/utils/XML11Char.java,Java,,222,41,169,432
/jdk1.7.0_80/com/sun/org/apache/xml/internal/utils/XMLChar.java,Java,,322,80,267,669
/jdk1.7.0_80/com/sun/org/apache/xml/internal/utils/XMLCharacterRecognizer.java,Java,,41,15,55,111
/jdk1.7.0_80/com/sun/org/apache/xml/internal/utils/XMLReaderManager.java,Java,,141,25,89,255
/jdk1.7.0_80/com/sun/org/apache/xml/internal/utils/XMLString.java,Java,,48,40,603,691
/jdk1.7.0_80/com/sun/org/apache/xml/internal/utils/XMLStringDefault.java,Java,,174,43,603,820
/jdk1.7.0_80/com/sun/org/apache/xml/internal/utils/XMLStringFactory.java,Java,,10,5,58,73
/jdk1.7.0_80/com/sun/org/apache/xml/internal/utils/XMLStringFactoryDefault.java,Java,,21,5,60,86
/jdk1.7.0_80/com/sun/org/apache/xpath/internal/Arg.java,Java,,102,28,137,267
/jdk1.7.0_80/com/sun/org/apache/xpath/internal/axes/AttributeIterator.java,Java,,23,8,46,77
/jdk1.7.0_80/com/sun/org/apache/xpath/internal/axes/AxesWalker.java,Java,,274,79,239,592
/jdk1.7.0_80/com/sun/org/apache/xpath/internal/axes/BasicTestIterator.java,Java,,111,27,89,227
/jdk1.7.0_80/com/sun/org/apache/xpath/internal/axes/ChildIterator.java,Java,,45,15,63,123
/jdk1.7.0_80/com/sun/org/apache/xpath/internal/axes/ChildTestIterator.java,Java,,54,22,104,180
/jdk1.7.0_80/com/sun/org/apache/xpath/internal/axes/ContextNodeList.java,Java,,18,14,106,138
/jdk1.7.0_80/com/sun/org/apache/xpath/internal/axes/DescendantIterator.java,Java,,226,48,109,383
/jdk1.7.0_80/com/sun/org/apache/xpath/internal/axes/FilterExprIterator.java,Java,,98,26,92,216
/jdk1.7.0_80/com/sun/org/apache/xpath/internal/axes/FilterExprIteratorSimple.java,Java,,159,38,119,316
/jdk1.7.0_80/com/sun/org/apache/xpath/internal/axes/FilterExprWalker.java,Java,,156,43,153,352
/jdk1.7.0_80/com/sun/org/apache/xpath/internal/axes/HasPositionalPredChecker.java,Java,,55,11,59,125
/jdk1.7.0_80/com/sun/org/apache/xpath/internal/axes/IteratorPool.java,Java,,51,11,59,121
/jdk1.7.0_80/com/sun/org/apache/xpath/internal/axes/LocPathIterator.java,Java,,363,123,549,1035
/jdk1.7.0_80/com/sun/org/apache/xpath/internal/axes/MatchPatternIterator.java,Java,,198,44,91,333
/jdk1.7.0_80/com/sun/org/apache/xpath/internal/axes/NodeSequence.java,Java,,496,97,368,961
/jdk1.7.0_80/com/sun/org/apache/xpath/internal/axes/OneStepIterator.java,Java,,163,52,132,347
/jdk1.7.0_80/com/sun/org/apache/xpath/internal/axes/OneStepIteratorForward.java,Java,,49,20,105,174
/jdk1.7.0_80/com/sun/org/apache/xpath/internal/axes/PathComponent.java,Java,,5,2,30,37
/jdk1.7.0_80/com/sun/org/apache/xpath/internal/axes/PredicatedNodeTest.java,Java,,333,76,240,649
/jdk1.7.0_80/com/sun/org/apache/xpath/internal/axes/ReverseAxesWalker.java,Java,,109,38,102,249
/jdk1.7.0_80/com/sun/org/apache/xpath/internal/axes/RTFIterator.java,Java,,9,4,31,44
/jdk1.7.0_80/com/sun/org/apache/xpath/internal/axes/SelfIteratorNoPredicate.java,Java,,47,15,68,130
/jdk1.7.0_80/com/sun/org/apache/xpath/internal/axes/SubContextList.java,Java,,7,4,43,54
/jdk1.7.0_80/com/sun/org/apache/xpath/internal/axes/UnionChildIterator.java,Java,,72,13,67,152
/jdk1.7.0_80/com/sun/org/apache/xpath/internal/axes/UnionPathIterator.java,Java,,323,77,186,586
/jdk1.7.0_80/com/sun/org/apache/xpath/internal/axes/WalkerFactory.java,Java,,1244,195,388,1827
/jdk1.7.0_80/com/sun/org/apache/xpath/internal/axes/WalkingIterator.java,Java,,167,52,146,365
/jdk1.7.0_80/com/sun/org/apache/xpath/internal/axes/WalkingIteratorSorted.java,Java,,73,18,125,216
/jdk1.7.0_80/com/sun/org/apache/xpath/internal/CachedXPathAPI.java,Java,,85,32,220,337
/jdk1.7.0_80/com/sun/org/apache/xpath/internal/compiler/Compiler.java,Java,,609,149,512,1270
/jdk1.7.0_80/com/sun/org/apache/xpath/internal/compiler/FuncLoader.java,Java,,40,12,57,109
/jdk1.7.0_80/com/sun/org/apache/xpath/internal/compiler/FunctionTable.java,Java,,232,58,120,410
/jdk1.7.0_80/com/sun/org/apache/xpath/internal/compiler/Keywords.java,Java,,136,67,85,288
/jdk1.7.0_80/com/sun/org/apache/xpath/internal/compiler/Lexer.java,Java,,422,88,154,664
/jdk1.7.0_80/com/sun/org/apache/xpath/internal/compiler/OpCodes.java,Java,,68,66,500,634
/jdk1.7.0_80/com/sun/org/apache/xpath/internal/compiler/OpMap.java,Java,,192,57,208,457
/jdk1.7.0_80/com/sun/org/apache/xpath/internal/compiler/OpMapVector.java,Java,,36,22,60,118
/jdk1.7.0_80/com/sun/org/apache/xpath/internal/compiler/PsuedoNames.java,Java,,10,7,44,61
/jdk1.7.0_80/com/sun/org/apache/xpath/internal/compiler/XPathDumper.java,Java,,4,3,26,33
/jdk1.7.0_80/com/sun/org/apache/xpath/internal/compiler/XPathParser.java,Java,,1264,395,744,2403
/jdk1.7.0_80/com/sun/org/apache/xpath/internal/domapi/XPathEvaluatorImpl.java,Java,,68,26,179,273
/jdk1.7.0_80/com/sun/org/apache/xpath/internal/domapi/XPathExpressionImpl.java,Java,,60,18,107,185
/jdk1.7.0_80/com/sun/org/apache/xpath/internal/domapi/XPathNamespaceImpl.java,Java,,131,49,144,324
/jdk1.7.0_80/com/sun/org/apache/xpath/internal/domapi/XPathNSResolverImpl.java,Java,,12,6,45,63
/jdk1.7.0_80/com/sun/org/apache/xpath/internal/domapi/XPathResultImpl.java,Java,,232,60,220,512
/jdk1.7.0_80/com/sun/org/apache/xpath/internal/domapi/XPathStylesheetDOM3Exception.java,Java,,9,4,50,63
/jdk1.7.0_80/com/sun/org/apache/xpath/internal/Expression.java,Java,,194,56,341,591
/jdk1.7.0_80/com/sun/org/apache/xpath/internal/ExpressionNode.java,Java,,10,5,38,53
/jdk1.7.0_80/com/sun/org/apache/xpath/internal/ExpressionOwner.java,Java,,6,4,36,46
/jdk1.7.0_80/com/sun/org/apache/xpath/internal/ExtensionsProvider.java,Java,,16,7,39,62
/jdk1.7.0_80/com/sun/org/apache/xpath/internal/FoundIndex.java,Java,,6,2,31,39
/jdk1.7.0_80/com/sun/org/apache/xpath/internal/functions/FuncBoolean.java,Java,,12,4,34,50
/jdk1.7.0_80/com/sun/org/apache/xpath/internal/functions/FuncCeiling.java,Java,,12,3,34,49
/jdk1.7.0_80/com/sun/org/apache/xpath/internal/functions/FuncConcat.java,Java,,33,10,49,92
/jdk1.7.0_80/com/sun/org/apache/xpath/internal/functions/FuncContains.java,Java,,17,7,35,59
/jdk1.7.0_80/com/sun/org/apache/xpath/internal/functions/FuncCount.java,Java,,16,6,44,66
/jdk1.7.0_80/com/sun/org/apache/xpath/internal/functions/FuncCurrent.java,Java,,37,8,39,84
/jdk1.7.0_80/com/sun/org/apache/xpath/internal/functions/FuncDoclocation.java,Java,,27,8,38,73
/jdk1.7.0_80/com/sun/org/apache/xpath/internal/functions/FuncExtElementAvailable.java,Java,,41,8,50,99
/jdk1.7.0_80/com/sun/org/apache/xpath/internal/functions/FuncExtFunction.java,Java,,146,43,153,342
/jdk1.7.0_80/com/sun/org/apache/xpath/internal/functions/FuncExtFunctionAvailable.java,Java,,55,9,42,106
/jdk1.7.0_80/com/sun/org/apache/xpath/internal/functions/FuncFalse.java,Java,,15,5,38,58
/jdk1.7.0_80/com/sun/org/apache/xpath/internal/functions/FuncFloor.java,Java,,12,3,34,49
/jdk1.7.0_80/com/sun/org/apache/xpath/internal/functions/FuncGenerateId.java,Java,,19,5,40,64
/jdk1.7.0_80/com/sun/org/apache/xpath/internal/functions/FuncId.java,Java,,82,22,49,153
/jdk1.7.0_80/com/sun/org/apache/xpath/internal/functions/FuncLang.java,Java,,39,10,35,84
/jdk1.7.0_80/com/sun/org/apache/xpath/internal/functions/FuncLast.java,Java,,40,12,56,108
/jdk1.7.0_80/com/sun/org/apache/xpath/internal/functions/FuncLocalPart.java,Java,,20,5,34,59
/jdk1.7.0_80/com/sun/org/apache/xpath/internal/functions/FuncNamespace.java,Java,,35,9,36,80
/jdk1.7.0_80/com/sun/org/apache/xpath/internal/functions/FuncNormalizeSpace.java,Java,,36,6,46,88
/jdk1.7.0_80/com/sun/org/apache/xpath/internal/functions/FuncNot.java,Java,,12,3,34,49
/jdk1.7.0_80/com/sun/org/apache/xpath/internal/functions/FuncNumber.java,Java,,12,3,34,49
/jdk1.7.0_80/com/sun/org/apache/xpath/internal/functions/FuncPosition.java,Java,,60,14,62,136
/jdk1.7.0_80/com/sun/org/apache/xpath/internal/functions/FuncQname.java,Java,,25,6,34,65
/jdk1.7.0_80/com/sun/org/apache/xpath/internal/functions/FuncRound.java,Java,,17,3,34,54
/jdk1.7.0_80/com/sun/org/apache/xpath/internal/functions/FuncStartsWith.java,Java,,13,3,34,50
/jdk1.7.0_80/com/sun/org/apache/xpath/internal/functions/FuncString.java,Java,,12,3,34,49
/jdk1.7.0_80/com/sun/org/apache/xpath/internal/functions/FuncStringLength.java,Java,,12,3,34,49
/jdk1.7.0_80/com/sun/org/apache/xpath/internal/functions/FuncSubstring.java,Java,,61,14,51,126
/jdk1.7.0_80/com/sun/org/apache/xpath/internal/functions/FuncSubstringAfter.java,Java,,18,5,34,57
/jdk1.7.0_80/com/sun/org/apache/xpath/internal/functions/FuncSubstringBefore.java,Java,,16,5,34,55
/jdk1.7.0_80/com/sun/org/apache/xpath/internal/functions/FuncSum.java,Java,,26,7,34,67
/jdk1.7.0_80/com/sun/org/apache/xpath/internal/functions/FuncSystemProperty.java,Java,,111,23,54,188
/jdk1.7.0_80/com/sun/org/apache/xpath/internal/functions/Function.java,Java,,49,14,83,146
/jdk1.7.0_80/com/sun/org/apache/xpath/internal/functions/Function2Args.java,Java,,79,21,86,186
/jdk1.7.0_80/com/sun/org/apache/xpath/internal/functions/Function3Args.java,Java,,79,21,85,185
/jdk1.7.0_80/com/sun/org/apache/xpath/internal/functions/FunctionDef1Arg.java,Java,,68,13,88,169
/jdk1.7.0_80/com/sun/org/apache/xpath/internal/functions/FunctionMultiArgs.java,Java,,121,29,88,238
/jdk1.7.0_80/com/sun/org/apache/xpath/internal/functions/FunctionOneArg.java,Java,,71,20,85,176
/jdk1.7.0_80/com/sun/org/apache/xpath/internal/functions/FuncTranslate.java,Java,,34,11,45,90
/jdk1.7.0_80/com/sun/org/apache/xpath/internal/functions/FuncTrue.java,Java,,15,5,38,58
/jdk1.7.0_80/com/sun/org/apache/xpath/internal/functions/FuncUnparsedEntityURI.java,Java,,18,6,33,57
/jdk1.7.0_80/com/sun/org/apache/xpath/internal/functions/WrongNumberArgsException.java,Java,,9,3,33,45
/jdk1.7.0_80/com/sun/org/apache/xpath/internal/jaxp/JAXPExtensionsProvider.java,Java,,129,30,55,214
/jdk1.7.0_80/com/sun/org/apache/xpath/internal/jaxp/JAXPPrefixResolver.java,Java,,55,24,49,128
/jdk1.7.0_80/com/sun/org/apache/xpath/internal/jaxp/JAXPVariableStack.java,Java,,36,10,28,74
/jdk1.7.0_80/com/sun/org/apache/xpath/internal/jaxp/XPathExpressionImpl.java,Java,,181,34,165,380
/jdk1.7.0_80/com/sun/org/apache/xpath/internal/jaxp/XPathFactoryImpl.java,Java,,138,38,152,328
/jdk1.7.0_80/com/sun/org/apache/xpath/internal/jaxp/XPathImpl.java,Java,,257,49,231,537
/jdk1.7.0_80/com/sun/org/apache/xpath/internal/NodeSet.java,Java,,598,234,540,1372
/jdk1.7.0_80/com/sun/org/apache/xpath/internal/NodeSetDTM.java,Java,,399,167,683,1249
/jdk1.7.0_80/com/sun/org/apache/xpath/internal/objects/DTMXRTreeFrag.java,Java,,27,7,26,60
/jdk1.7.0_80/com/sun/org/apache/xpath/internal/objects/XBoolean.java,Java,,58,21,91,170
/jdk1.7.0_80/com/sun/org/apache/xpath/internal/objects/XBooleanStatic.java,Java,,22,6,43,71
/jdk1.7.0_80/com/sun/org/apache/xpath/internal/objects/XMLStringFactoryImpl.java,Java,,29,8,66,103
/jdk1.7.0_80/com/sun/org/apache/xpath/internal/objects/XNodeSet.java,Java,,408,102,461,971
/jdk1.7.0_80/com/sun/org/apache/xpath/internal/objects/XNodeSetForDOM.java,Java,,56,15,59,130
/jdk1.7.0_80/com/sun/org/apache/xpath/internal/objects/XNull.java,Java,,39,12,81,132
/jdk1.7.0_80/com/sun/org/apache/xpath/internal/objects/XNumber.java,Java,,136,43,260,439
/jdk1.7.0_80/com/sun/org/apache/xpath/internal/objects/XObject.java,Java,,287,106,368,761
/jdk1.7.0_80/com/sun/org/apache/xpath/internal/objects/XObjectFactory.java,Java,,107,11,45,163
/jdk1.7.0_80/com/sun/org/apache/xpath/internal/objects/XRTreeFrag.java,Java,,143,33,127,303
/jdk1.7.0_80/com/sun/org/apache/xpath/internal/objects/XRTreeFragSelectWrapper.java,Java,,59,14,83,156
/jdk1.7.0_80/com/sun/org/apache/xpath/internal/objects/XString.java,Java,,356,95,673,1124
/jdk1.7.0_80/com/sun/org/apache/xpath/internal/objects/XStringForChars.java,Java,,70,23,125,218
/jdk1.7.0_80/com/sun/org/apache/xpath/internal/objects/XStringForFSB.java,Java,,402,122,464,988
/jdk1.7.0_80/com/sun/org/apache/xpath/internal/operations/And.java,Java,,24,8,45,77
/jdk1.7.0_80/com/sun/org/apache/xpath/internal/operations/Bool.java,Java,,20,6,44,70
/jdk1.7.0_80/com/sun/org/apache/xpath/internal/operations/Div.java,Java,,18,6,45,69
/jdk1.7.0_80/com/sun/org/apache/xpath/internal/operations/Equals.java,Java,,23,6,47,76
/jdk1.7.0_80/com/sun/org/apache/xpath/internal/operations/Gt.java,Java,,12,3,36,51
/jdk1.7.0_80/com/sun/org/apache/xpath/internal/operations/Gte.java,Java,,13,3,36,52
/jdk1.7.0_80/com/sun/org/apache/xpath/internal/operations/Lt.java,Java,,12,3,36,51
/jdk1.7.0_80/com/sun/org/apache/xpath/internal/operations/Lte.java,Java,,12,3,36,51
/jdk1.7.0_80/com/sun/org/apache/xpath/internal/operations/Minus.java,Java,,18,6,46,70
/jdk1.7.0_80/com/sun/org/apache/xpath/internal/operations/Mod.java,Java,,18,6,45,69
/jdk1.7.0_80/com/sun/org/apache/xpath/internal/operations/Mult.java,Java,,18,5,45,68
/jdk1.7.0_80/com/sun/org/apache/xpath/internal/operations/Neg.java,Java,,17,6,44,67
/jdk1.7.0_80/com/sun/org/apache/xpath/internal/operations/NotEquals.java,Java,,12,3,36,51
/jdk1.7.0_80/com/sun/org/apache/xpath/internal/operations/Number.java,Java,,20,7,44,71
/jdk1.7.0_80/com/sun/org/apache/xpath/internal/operations/Operation.java,Java,,92,26,96,214
/jdk1.7.0_80/com/sun/org/apache/xpath/internal/operations/Or.java,Java,,24,8,45,77
/jdk1.7.0_80/com/sun/org/apache/xpath/internal/operations/Plus.java,Java,,18,6,45,69
/jdk1.7.0_80/com/sun/org/apache/xpath/internal/operations/Quo.java,Java,,12,4,38,54
/jdk1.7.0_80/com/sun/org/apache/xpath/internal/operations/String.java,Java,,11,3,35,49
/jdk1.7.0_80/com/sun/org/apache/xpath/internal/operations/UnaryOperation.java,Java,,59,21,85,165
/jdk1.7.0_80/com/sun/org/apache/xpath/internal/operations/Variable.java,Java,,130,46,223,399
/jdk1.7.0_80/com/sun/org/apache/xpath/internal/operations/VariableSafeAbsRef.java,Java,,24,5,46,75
/jdk1.7.0_80/com/sun/org/apache/xpath/internal/patterns/ContextMatchStepPattern.java,Java,,95,24,62,181
/jdk1.7.0_80/com/sun/org/apache/xpath/internal/patterns/FunctionPattern.java,Java,,112,40,98,250
/jdk1.7.0_80/com/sun/org/apache/xpath/internal/patterns/NodeTest.java,Java,,297,102,295,694
/jdk1.7.0_80/com/sun/org/apache/xpath/internal/patterns/NodeTestFilter.java,Java,,5,2,34,41
/jdk1.7.0_80/com/sun/org/apache/xpath/internal/patterns/StepPattern.java,Java,,601,136,318,1055
/jdk1.7.0_80/com/sun/org/apache/xpath/internal/patterns/UnionPattern.java,Java,,116,29,75,220
/jdk1.7.0_80/com/sun/org/apache/xpath/internal/res/XPATHErrorResources.java,Java,,549,186,204,939
/jdk1.7.0_80/com/sun/org/apache/xpath/internal/res/XPATHErrorResources_de.java,Java,,549,186,204,939
/jdk1.7.0_80/com/sun/org/apache/xpath/internal/res/XPATHErrorResources_en.java,Java,,4,2,27,33
/jdk1.7.0_80/com/sun/org/apache/xpath/internal/res/XPATHErrorResources_es.java,Java,,549,186,204,939
/jdk1.7.0_80/com/sun/org/apache/xpath/internal/res/XPATHErrorResources_fr.java,Java,,549,186,204,939
/jdk1.7.0_80/com/sun/org/apache/xpath/internal/res/XPATHErrorResources_it.java,Java,,549,186,204,939
/jdk1.7.0_80/com/sun/org/apache/xpath/internal/res/XPATHErrorResources_ja.java,Java,,549,186,204,939
/jdk1.7.0_80/com/sun/org/apache/xpath/internal/res/XPATHErrorResources_ko.java,Java,,549,186,204,939
/jdk1.7.0_80/com/sun/org/apache/xpath/internal/res/XPATHErrorResources_pt_BR.java,Java,,549,186,204,939
/jdk1.7.0_80/com/sun/org/apache/xpath/internal/res/XPATHErrorResources_sv.java,Java,,549,186,204,939
/jdk1.7.0_80/com/sun/org/apache/xpath/internal/res/XPATHErrorResources_zh_CN.java,Java,,549,186,204,939
/jdk1.7.0_80/com/sun/org/apache/xpath/internal/res/XPATHErrorResources_zh_TW.java,Java,,549,186,204,939
/jdk1.7.0_80/com/sun/org/apache/xpath/internal/res/XPATHMessages.java,Java,,65,17,67,149
/jdk1.7.0_80/com/sun/org/apache/xpath/internal/SourceTree.java,Java,,11,5,38,54
/jdk1.7.0_80/com/sun/org/apache/xpath/internal/SourceTreeManager.java,Java,,191,54,147,392
/jdk1.7.0_80/com/sun/org/apache/xpath/internal/VariableStack.java,Java,,152,67,301,520
/jdk1.7.0_80/com/sun/org/apache/xpath/internal/WhitespaceStrippingElementMatcher.java,Java,,9,4,43,56
/jdk1.7.0_80/com/sun/org/apache/xpath/internal/XPath.java,Java,,292,80,273,645
/jdk1.7.0_80/com/sun/org/apache/xpath/internal/XPathAPI.java,Java,,73,27,185,285
/jdk1.7.0_80/com/sun/org/apache/xpath/internal/XPathContext.java,Java,,579,157,618,1354
/jdk1.7.0_80/com/sun/org/apache/xpath/internal/XPathException.java,Java,,161,57,112,330
/jdk1.7.0_80/com/sun/org/apache/xpath/internal/XPathFactory.java,Java,,8,4,40,52
/jdk1.7.0_80/com/sun/org/apache/xpath/internal/XPathProcessorException.java,Java,,13,4,39,56
/jdk1.7.0_80/com/sun/org/apache/xpath/internal/XPathVisitable.java,Java,,5,1,37,43
/jdk1.7.0_80/com/sun/org/apache/xpath/internal/XPathVisitor.java,Java,,63,16,125,204
/jdk1.7.0_80/com/sun/security/auth/callback/DialogCallbackHandler.java,Java,,196,43,77,316
/jdk1.7.0_80/com/sun/security/auth/callback/TextCallbackHandler.java,Java,,179,29,53,261
/jdk1.7.0_80/com/sun/security/auth/LdapPrincipal.java,Java,,42,14,82,138
/jdk1.7.0_80/com/sun/security/auth/login/ConfigFile.java,Java,,447,73,155,675
/jdk1.7.0_80/com/sun/security/auth/module/Crypt.java,Java,,263,53,82,398
/jdk1.7.0_80/com/sun/security/auth/module/JndiLoginModule.java,Java,,379,75,313,767
/jdk1.7.0_80/com/sun/security/auth/module/KeyStoreLoginModule.java,Java,,640,86,221,947
/jdk1.7.0_80/com/sun/security/auth/module/Krb5LoginModule.java,Java,,634,77,518,1229
/jdk1.7.0_80/com/sun/security/auth/module/LdapLoginModule.java,Java,,469,107,441,1017
/jdk1.7.0_80/com/sun/security/auth/module/NTLoginModule.java,Java,,230,32,136,398
/jdk1.7.0_80/com/sun/security/auth/module/NTSystem.java,Java,,46,15,86,147
/jdk1.7.0_80/com/sun/security/auth/module/SolarisLoginModule.java,Java,,150,25,139,314
/jdk1.7.0_80/com/sun/security/auth/module/SolarisSystem.java,Java,,24,9,61,94
/jdk1.7.0_80/com/sun/security/auth/module/UnixLoginModule.java,Java,,148,25,134,307
/jdk1.7.0_80/com/sun/security/auth/module/UnixSystem.java,Java,,24,9,61,94
/jdk1.7.0_80/com/sun/security/auth/NTDomainPrincipal.java,Java,,43,13,92,148
/jdk1.7.0_80/com/sun/security/auth/NTNumericCredential.java,Java,,33,12,74,119
/jdk1.7.0_80/com/sun/security/auth/NTSid.java,Java,,50,13,95,158
/jdk1.7.0_80/com/sun/security/auth/NTSidDomainPrincipal.java,Java,,24,9,75,108
/jdk1.7.0_80/com/sun/security/auth/NTSidGroupPrincipal.java,Java,,24,10,70,104
/jdk1.7.0_80/com/sun/security/auth/NTSidPrimaryGroupPrincipal.java,Java,,24,10,73,107
/jdk1.7.0_80/com/sun/security/auth/NTSidUserPrincipal.java,Java,,24,9,69,102
/jdk1.7.0_80/com/sun/security/auth/NTUserPrincipal.java,Java,,43,13,86,142
/jdk1.7.0_80/com/sun/security/auth/PolicyFile.java,Java,,755,137,571,1463
/jdk1.7.0_80/com/sun/security/auth/PolicyParser.java,Java,,612,106,246,964
/jdk1.7.0_80/com/sun/security/auth/PrincipalComparator.java,Java,,4,2,58,64
/jdk1.7.0_80/com/sun/security/auth/SolarisNumericGroupPrincipal.java,Java,,60,19,137,216
/jdk1.7.0_80/com/sun/security/auth/SolarisNumericUserPrincipal.java,Java,,49,18,115,182
/jdk1.7.0_80/com/sun/security/auth/SolarisPrincipal.java,Java,,41,16,89,146
/jdk1.7.0_80/com/sun/security/auth/SubjectCodeSource.java,Java,,193,45,167,405
/jdk1.7.0_80/com/sun/security/auth/UnixNumericGroupPrincipal.java,Java,,67,19,133,219
/jdk1.7.0_80/com/sun/security/auth/UnixNumericUserPrincipal.java,Java,,51,15,112,178
/jdk1.7.0_80/com/sun/security/auth/UnixPrincipal.java,Java,,43,14,86,143
/jdk1.7.0_80/com/sun/security/auth/UserPrincipal.java,Java,,30,10,72,112
/jdk1.7.0_80/com/sun/security/auth/X500Principal.java,Java,,61,20,103,184
/jdk1.7.0_80/com/sun/security/jgss/AuthorizationDataEntry.java,Java,,20,7,41,68
/jdk1.7.0_80/com/sun/security/jgss/ExtendedGSSContext.java,Java,,8,5,143,156
/jdk1.7.0_80/com/sun/security/jgss/GSSUtil.java,Java,,11,5,56,72
/jdk1.7.0_80/com/sun/security/jgss/InquireSecContextPermission.java,Java,,7,4,43,54
/jdk1.7.0_80/com/sun/security/jgss/InquireType.java,Java,,7,2,45,54
/jdk1.7.0_80/com/sun/source/tree/AnnotationTree.java,Java,,6,3,39,48
/jdk1.7.0_80/com/sun/source/tree/ArrayAccessTree.java,Java,,5,2,38,45
/jdk1.7.0_80/com/sun/source/tree/ArrayTypeTree.java,Java,,4,2,38,44
/jdk1.7.0_80/com/sun/source/tree/AssertTree.java,Java,,5,2,40,47
/jdk1.7.0_80/com/sun/source/tree/AssignmentTree.java,Java,,5,2,38,45
/jdk1.7.0_80/com/sun/source/tree/BinaryTree.java,Java,,5,2,39,46
/jdk1.7.0_80/com/sun/source/tree/BlockTree.java,Java,,6,3,42,51
/jdk1.7.0_80/com/sun/source/tree/BreakTree.java,Java,,5,3,40,48
/jdk1.7.0_80/com/sun/source/tree/CaseTree.java,Java,,6,3,45,54
/jdk1.7.0_80/com/sun/source/tree/CatchTree.java,Java,,5,2,39,46
/jdk1.7.0_80/com/sun/source/tree/ClassTree.java,Java,,11,3,44,58
/jdk1.7.0_80/com/sun/source/tree/CompilationUnitTree.java,Java,,12,4,38,54
/jdk1.7.0_80/com/sun/source/tree/CompoundAssignmentTree.java,Java,,5,2,39,46
/jdk1.7.0_80/com/sun/source/tree/ConditionalExpressionTree.java,Java,,6,2,38,46
/jdk1.7.0_80/com/sun/source/tree/ContinueTree.java,Java,,5,3,39,47
/jdk1.7.0_80/com/sun/source/tree/DoWhileLoopTree.java,Java,,5,2,40,47
/jdk1.7.0_80/com/sun/source/tree/EmptyStatementTree.java,Java,,2,2,38,42
/jdk1.7.0_80/com/sun/source/tree/EnhancedForLoopTree.java,Java,,6,2,39,47
/jdk1.7.0_80/com/sun/source/tree/ErroneousTree.java,Java,,5,3,31,39
/jdk1.7.0_80/com/sun/source/tree/ExpressionStatementTree.java,Java,,4,2,38,44
/jdk1.7.0_80/com/sun/source/tree/ExpressionTree.java,Java,,2,2,34,38
/jdk1.7.0_80/com/sun/source/tree/ForLoopTree.java,Java,,8,3,39,50
/jdk1.7.0_80/com/sun/source/tree/IdentifierTree.java,Java,,5,3,38,46
/jdk1.7.0_80/com/sun/source/tree/IfTree.java,Java,,6,2,47,55
/jdk1.7.0_80/com/sun/source/tree/ImportTree.java,Java,,5,2,44,51
/jdk1.7.0_80/com/sun/source/tree/InstanceOfTree.java,Java,,5,2,38,45
/jdk1.7.0_80/com/sun/source/tree/LabeledStatementTree.java,Java,,6,3,38,47
/jdk1.7.0_80/com/sun/source/tree/LineMap.java,Java,,7,6,65,78
/jdk1.7.0_80/com/sun/source/tree/LiteralTree.java,Java,,4,2,39,45
/jdk1.7.0_80/com/sun/source/tree/MemberSelectTree.java,Java,,6,3,38,47
/jdk1.7.0_80/com/sun/source/tree/MethodInvocationTree.java,Java,,7,3,40,50
/jdk1.7.0_80/com/sun/source/tree/MethodTree.java,Java,,13,3,42,58
/jdk1.7.0_80/com/sun/source/tree/ModifiersTree.java,Java,,8,3,40,51
/jdk1.7.0_80/com/sun/source/tree/NewArrayTree.java,Java,,7,3,40,50
/jdk1.7.0_80/com/sun/source/tree/NewClassTree.java,Java,,9,3,45,57
/jdk1.7.0_80/com/sun/source/tree/package-info.java,Java,,1,1,32,34
/jdk1.7.0_80/com/sun/source/tree/ParameterizedTypeTree.java,Java,,6,3,38,47
/jdk1.7.0_80/com/sun/source/tree/ParenthesizedTree.java,Java,,4,2,39,45
/jdk1.7.0_80/com/sun/source/tree/PrimitiveTypeTree.java,Java,,5,3,38,46
/jdk1.7.0_80/com/sun/source/tree/ReturnTree.java,Java,,4,2,39,45
/jdk1.7.0_80/com/sun/source/tree/Scope.java,Java,,12,6,55,73
/jdk1.7.0_80/com/sun/source/tree/StatementTree.java,Java,,2,2,34,38
/jdk1.7.0_80/com/sun/source/tree/SwitchTree.java,Java,,6,3,40,49
/jdk1.7.0_80/com/sun/source/tree/SynchronizedTree.java,Java,,5,2,39,46
/jdk1.7.0_80/com/sun/source/tree/ThrowTree.java,Java,,4,2,38,44
/jdk1.7.0_80/com/sun/source/tree/Tree.java,Java,,110,105,391,606
/jdk1.7.0_80/com/sun/source/tree/TreeVisitor.java,Java,,52,2,55,109
/jdk1.7.0_80/com/sun/source/tree/TryTree.java,Java,,8,3,42,53
/jdk1.7.0_80/com/sun/source/tree/TypeCastTree.java,Java,,5,2,38,45
/jdk1.7.0_80/com/sun/source/tree/TypeParameterTree.java,Java,,7,3,40,50
/jdk1.7.0_80/com/sun/source/tree/UnaryTree.java,Java,,4,2,41,47
/jdk1.7.0_80/com/sun/source/tree/UnionTypeTree.java,Java,,5,3,31,39
/jdk1.7.0_80/com/sun/source/tree/VariableTree.java,Java,,8,3,38,49
/jdk1.7.0_80/com/sun/source/tree/WhileLoopTree.java,Java,,5,2,40,47
/jdk1.7.0_80/com/sun/source/tree/WildcardTree.java,Java,,4,2,43,49
/jdk1.7.0_80/com/sun/source/util/JavacTask.java,Java,,20,9,62,91
/jdk1.7.0_80/com/sun/source/util/package-info.java,Java,,1,1,31,33
/jdk1.7.0_80/com/sun/source/util/SimpleTreeVisitor.java,Java,,171,57,30,258
/jdk1.7.0_80/com/sun/source/util/SourcePositions.java,Java,,6,6,74,86
/jdk1.7.0_80/com/sun/source/util/TaskEvent.java,Java,,55,14,53,122
/jdk1.7.0_80/com/sun/source/util/TaskListener.java,Java,,6,4,30,40
/jdk1.7.0_80/com/sun/source/util/TreePath.java,Java,,74,15,54,143
/jdk1.7.0_80/com/sun/source/util/TreePathScanner.java,Java,,28,8,46,82
/jdk1.7.0_80/com/sun/source/util/Trees.java,Java,,63,25,130,218
/jdk1.7.0_80/com/sun/source/util/TreeScanner.java,Java,,252,59,77,388
/jdk1.7.0_80/java/applet/Applet.java,Java,,147,38,408,593
/jdk1.7.0_80/java/applet/AppletContext.java,Java,,21,12,161,194
/jdk1.7.0_80/java/applet/AppletStub.java,Java,,10,8,93,111
/jdk1.7.0_80/java/applet/AudioClip.java,Java,,6,4,43,53
/jdk1.7.0_80/java/awt/ActiveEvent.java,Java,,4,3,52,59
/jdk1.7.0_80/java/awt/Adjustable.java,Java,,22,23,114,159
/jdk1.7.0_80/java/awt/AlphaComposite.java,Java,,120,46,639,805
/jdk1.7.0_80/java/awt/AttributeValue.java,Java,,25,5,26,56
/jdk1.7.0_80/java/awt/AWTError.java,Java,,7,4,38,49
/jdk1.7.0_80/java/awt/AWTEvent.java,Java,,316,69,235,620
/jdk1.7.0_80/java/awt/AWTEventMulticaster.java,Java,,366,88,578,1032
/jdk1.7.0_80/java/awt/AWTException.java,Java,,7,4,40,51
/jdk1.7.0_80/java/awt/AWTKeyStroke.java,Java,,457,67,368,892
/jdk1.7.0_80/java/awt/AWTPermission.java,Java,,13,9,215,237
/jdk1.7.0_80/java/awt/BasicStroke.java,Java,,140,35,270,445
/jdk1.7.0_80/java/awt/BorderLayout.java,Java,,335,57,495,887
/jdk1.7.0_80/java/awt/BufferCapabilities.java,Java,,60,21,136,217
/jdk1.7.0_80/java/awt/Button.java,Java,[PENDING:  WDW -- need to provide a localized string,205,54,416,675
/jdk1.7.0_80/java/awt/Canvas.java,Java,,70,20,164,254
/jdk1.7.0_80/java/awt/CardLayout.java,Java,,321,48,243,612
/jdk1.7.0_80/java/awt/Checkbox.java,Java,,281,70,515,866
/jdk1.7.0_80/java/awt/CheckboxGroup.java,Java,,34,9,107,150
/jdk1.7.0_80/java/awt/CheckboxMenuItem.java,Java,,191,51,399,641
/jdk1.7.0_80/java/awt/Choice.java,Java,,255,65,491,811
/jdk1.7.0_80/java/awt/color/CMMException.java,Java,,6,7,44,57
/jdk1.7.0_80/java/awt/color/ColorSpace.java,Java,,188,76,347,611
/jdk1.7.0_80/java/awt/color/ICC_ColorSpace.java,Java,,209,36,371,616
/jdk1.7.0_80/java/awt/color/ICC_Profile.java,Java,,868,352,853,2073
/jdk1.7.0_80/java/awt/color/ICC_ProfileGray.java,Java,,26,18,106,150
/jdk1.7.0_80/java/awt/color/ICC_ProfileRGB.java,Java,,74,34,174,282
/jdk1.7.0_80/java/awt/color/ProfileDataException.java,Java,,6,4,32,42
/jdk1.7.0_80/java/awt/Color.java,Java,,463,79,702,1244
/jdk1.7.0_80/java/awt/ColorPaintContext.java,Java,,34,12,37,83
/jdk1.7.0_80/java/awt/Component.java,Java,,4544,744,4824,10112
/jdk1.7.0_80/java/awt/ComponentOrientation.java,Java,,54,16,132,202
/jdk1.7.0_80/java/awt/Composite.java,Java,,7,5,74,86
/jdk1.7.0_80/java/awt/CompositeContext.java,Java,,9,7,52,68
/jdk1.7.0_80/java/awt/Conditional.java,Java,,4,2,31,37
/jdk1.7.0_80/java/awt/Container.java,Java,,2474,386,2044,4904
/jdk1.7.0_80/java/awt/ContainerOrderFocusTraversalPolicy.java,Java,,292,74,214,580
/jdk1.7.0_80/java/awt/Cursor.java,Java,,243,69,163,475
/jdk1.7.0_80/java/awt/datatransfer/Clipboard.java,Java,,116,29,209,354
/jdk1.7.0_80/java/awt/datatransfer/ClipboardOwner.java,Java,,4,5,47,56
/jdk1.7.0_80/java/awt/datatransfer/DataFlavor.java,Java,,505,124,760,1389
/jdk1.7.0_80/java/awt/datatransfer/FlavorEvent.java,Java,,7,3,41,51
/jdk1.7.0_80/java/awt/datatransfer/FlavorListener.java,Java,,5,3,47,55
/jdk1.7.0_80/java/awt/datatransfer/FlavorMap.java,Java,,6,6,63,75
/jdk1.7.0_80/java/awt/datatransfer/FlavorTable.java,Java,,6,6,70,82
/jdk1.7.0_80/java/awt/datatransfer/MimeType.java,Java,,171,40,182,393
/jdk1.7.0_80/java/awt/datatransfer/MimeTypeParameterList.java,Java,,241,56,107,404
/jdk1.7.0_80/java/awt/datatransfer/MimeTypeParseException.java,Java,,10,6,39,55
/jdk1.7.0_80/java/awt/datatransfer/StringSelection.java,Java,,38,11,91,140
/jdk1.7.0_80/java/awt/datatransfer/SystemFlavorMap.java,Java,,698,109,477,1284
/jdk1.7.0_80/java/awt/datatransfer/Transferable.java,Java,,7,8,58,73
/jdk1.7.0_80/java/awt/datatransfer/UnsupportedFlavorException.java,Java,,7,4,39,50
/jdk1.7.0_80/java/awt/DefaultFocusTraversalPolicy.java,Java,,33,7,88,128
/jdk1.7.0_80/java/awt/DefaultKeyboardFocusManager.java,Java,,868,128,372,1368
/jdk1.7.0_80/java/awt/Desktop.java,Java,,154,31,299,484
/jdk1.7.0_80/java/awt/Dialog.java,Java,,669,119,935,1723
/jdk1.7.0_80/java/awt/Dimension.java,Java,,60,20,159,239
/jdk1.7.0_80/java/awt/DisplayMode.java,Java,,45,14,97,156
/jdk1.7.0_80/java/awt/dnd/Autoscroll.java,Java,,7,9,64,80
/jdk1.7.0_80/java/awt/dnd/DnDConstants.java,Java,,10,12,61,83
/jdk1.7.0_80/java/awt/dnd/DnDEventMulticaster.java,Java,,79,19,133,231
/jdk1.7.0_80/java/awt/dnd/DragGestureEvent.java,Java,,87,55,242,384
/jdk1.7.0_80/java/awt/dnd/DragGestureListener.java,Java,,5,8,51,64
/jdk1.7.0_80/java/awt/dnd/DragGestureRecognizer.java,Java,,94,57,315,466
/jdk1.7.0_80/java/awt/dnd/DragSource.java,Java,,259,75,588,922
/jdk1.7.0_80/java/awt/dnd/DragSourceAdapter.java,Java,,10,8,124,142
/jdk1.7.0_80/java/awt/dnd/DragSourceContext.java,Java,,209,80,345,634
/jdk1.7.0_80/java/awt/dnd/DragSourceDragEvent.java,Java,,97,26,205,328
/jdk1.7.0_80/java/awt/dnd/DragSourceDropEvent.java,Java,,23,19,126,168
/jdk1.7.0_80/java/awt/dnd/DragSourceEvent.java,Java,,37,17,131,185
/jdk1.7.0_80/java/awt/dnd/DragSourceListener.java,Java,,9,9,108,126
/jdk1.7.0_80/java/awt/dnd/DragSourceMotionListener.java,Java,,5,5,51,61
/jdk1.7.0_80/java/awt/dnd/DropTarget.java,Java,,302,140,416,858
/jdk1.7.0_80/java/awt/dnd/DropTargetAdapter.java,Java,,7,6,96,109
/jdk1.7.0_80/java/awt/dnd/DropTargetContext.java,Java,,131,65,224,420
/jdk1.7.0_80/java/awt/dnd/DropTargetDragEvent.java,Java,,47,31,165,243
/jdk1.7.0_80/java/awt/dnd/DropTargetDropEvent.java,Java,,59,43,198,300
/jdk1.7.0_80/java/awt/dnd/DropTargetEvent.java,Java,,14,11,56,81
/jdk1.7.0_80/java/awt/dnd/DropTargetListener.java,Java,,11,15,126,152
/jdk1.7.0_80/java/awt/dnd/InvalidDnDOperationException.java,Java,,6,9,40,55
/jdk1.7.0_80/java/awt/dnd/MouseDragGestureRecognizer.java,Java,,35,33,140,208
/jdk1.7.0_80/java/awt/dnd/peer/DragSourceContextPeer.java,Java,,12,13,46,71
/jdk1.7.0_80/java/awt/dnd/peer/DropTargetContextPeer.java,Java,,18,27,66,111
/jdk1.7.0_80/java/awt/dnd/peer/DropTargetPeer.java,Java,,6,8,45,59
/jdk1.7.0_80/java/awt/dnd/SerializationTester.java,Java,,33,6,34,73
/jdk1.7.0_80/java/awt/event/ActionEvent.java,Java,,50,22,216,288
/jdk1.7.0_80/java/awt/event/ActionListener.java,Java,,5,5,42,52
/jdk1.7.0_80/java/awt/event/AdjustmentEvent.java,Java,,74,26,189,289
/jdk1.7.0_80/java/awt/event/AdjustmentListener.java,Java,,5,5,33,43
/jdk1.7.0_80/java/awt/event/AWTEventListener.java,Java,,6,5,51,62
/jdk1.7.0_80/java/awt/event/AWTEventListenerProxy.java,Java,,18,7,56,81
/jdk1.7.0_80/java/awt/event/ComponentAdapter.java,Java,,7,5,60,72
/jdk1.7.0_80/java/awt/event/ComponentEvent.java,Java,,44,14,107,165
/jdk1.7.0_80/java/awt/event/ComponentListener.java,Java,,8,6,60,74
/jdk1.7.0_80/java/awt/event/ContainerAdapter.java,Java,,5,3,54,62
/jdk1.7.0_80/java/awt/event/ContainerEvent.java,Java,,35,13,111,159
/jdk1.7.0_80/java/awt/event/ContainerListener.java,Java,,6,5,55,66
/jdk1.7.0_80/java/awt/event/FocusAdapter.java,Java,,5,3,54,62
/jdk1.7.0_80/java/awt/event/FocusEvent.java,Java,,52,18,179,249
/jdk1.7.0_80/java/awt/event/FocusListener.java,Java,,6,5,50,61
/jdk1.7.0_80/java/awt/event/HierarchyBoundsAdapter.java,Java,,6,3,52,61
/jdk1.7.0_80/java/awt/event/HierarchyBoundsListener.java,Java,,6,4,52,62
/jdk1.7.0_80/java/awt/event/HierarchyEvent.java,Java,,86,19,232,337
/jdk1.7.0_80/java/awt/event/HierarchyListener.java,Java,,5,3,49,57
/jdk1.7.0_80/java/awt/event/InputEvent.java,Java,,166,49,312,527
/jdk1.7.0_80/java/awt/event/InputMethodEvent.java,Java,,142,34,266,442
/jdk1.7.0_80/java/awt/event/InputMethodListener.java,Java,,6,7,43,56
/jdk1.7.0_80/java/awt/event/InvocationEvent.java,Java,,110,30,285,425
/jdk1.7.0_80/java/awt/event/ItemEvent.java,Java,,49,18,135,202
/jdk1.7.0_80/java/awt/event/ItemListener.java,Java,,5,5,46,56
/jdk1.7.0_80/java/awt/event/KeyAdapter.java,Java,,6,4,59,69
/jdk1.7.0_80/java/awt/event/KeyEvent.java,Java,,713,167,819,1699
/jdk1.7.0_80/java/awt/event/KeyListener.java,Java,,7,6,60,73
/jdk1.7.0_80/java/awt/event/MouseAdapter.java,Java,,11,9,93,113
/jdk1.7.0_80/java/awt/event/MouseEvent.java,Java,,343,62,765,1170
/jdk1.7.0_80/java/awt/event/MouseListener.java,Java,,9,8,67,84
/jdk1.7.0_80/java/awt/event/MouseMotionAdapter.java,Java,,5,3,63,71
/jdk1.7.0_80/java/awt/event/MouseMotionListener.java,Java,,6,6,63,75
/jdk1.7.0_80/java/awt/event/MouseWheelEvent.java,Java,,63,29,355,447
/jdk1.7.0_80/java/awt/event/MouseWheelListener.java,Java,,5,4,49,58
/jdk1.7.0_80/java/awt/event/NativeLibLoader.java,Java,,7,3,49,59
/jdk1.7.0_80/java/awt/event/PaintEvent.java,Java,,35,13,91,139
/jdk1.7.0_80/java/awt/event/TextEvent.java,Java,,22,11,80,113
/jdk1.7.0_80/java/awt/event/TextListener.java,Java,,5,5,45,55
/jdk1.7.0_80/java/awt/event/WindowAdapter.java,Java,,15,11,91,117
/jdk1.7.0_80/java/awt/event/WindowEvent.java,Java,,97,31,300,428
/jdk1.7.0_80/java/awt/event/WindowFocusListener.java,Java,,6,5,58,69
/jdk1.7.0_80/java/awt/event/WindowListener.java,Java,,11,9,83,103
/jdk1.7.0_80/java/awt/event/WindowStateListener.java,Java,,5,3,47,55
/jdk1.7.0_80/java/awt/Event.java,Java,,230,106,543,879
/jdk1.7.0_80/java/awt/EventDispatchThread.java,Java,,225,30,78,333
/jdk1.7.0_80/java/awt/EventFilter.java,Java,,9,3,49,61
/jdk1.7.0_80/java/awt/EventQueue.java,Java,,775,105,444,1324
/jdk1.7.0_80/java/awt/FileDialog.java,Java,,170,40,367,577
/jdk1.7.0_80/java/awt/FlowLayout.java,Java,,275,52,369,696
/jdk1.7.0_80/java/awt/FocusTraversalPolicy.java,Java,,20,7,148,175
/jdk1.7.0_80/java/awt/font/CharArrayIterator.java,Java,,84,27,82,193
/jdk1.7.0_80/java/awt/font/FontRenderContext.java,Java,,143,20,195,358
/jdk1.7.0_80/java/awt/font/GlyphJustificationInfo.java,Java,,60,23,129,212
/jdk1.7.0_80/java/awt/font/GlyphMetrics.java,Java,,69,29,226,324
/jdk1.7.0_80/java/awt/font/GlyphVector.java,Java,,82,41,488,611
/jdk1.7.0_80/java/awt/font/GraphicAttribute.java,Java,,52,23,146,221
/jdk1.7.0_80/java/awt/font/ImageGraphicAttribute.java,Java,,68,34,125,227
/jdk1.7.0_80/java/awt/font/LayoutPath.java,Java,,7,3,74,84
/jdk1.7.0_80/java/awt/font/LineBreakMeasurer.java,Java,,113,35,385,533
/jdk1.7.0_80/java/awt/font/LineMetrics.java,Java,,14,16,113,143
/jdk1.7.0_80/java/awt/font/MultipleMaster.java,Java,,15,10,81,106
/jdk1.7.0_80/java/awt/font/NumericShaper.java,Java,,851,111,545,1507
/jdk1.7.0_80/java/awt/font/OpenType.java,Java,,61,63,308,432
/jdk1.7.0_80/java/awt/font/ShapeGraphicAttribute.java,Java,,87,36,133,256
/jdk1.7.0_80/java/awt/font/StyledParagraph.java,Java,,275,62,155,492
/jdk1.7.0_80/java/awt/font/TextAttribute.java,Java,,145,73,899,1117
/jdk1.7.0_80/java/awt/font/TextHitInfo.java,Java,,54,18,175,247
/jdk1.7.0_80/java/awt/font/TextJustifier.java,Java,,146,26,68,240
/jdk1.7.0_80/java/awt/font/TextLayout.java,Java,,1278,326,1149,2753
/jdk1.7.0_80/java/awt/font/TextLine.java,Java,,992,276,169,1437
/jdk1.7.0_80/java/awt/font/TextMeasurer.java,Java,,401,118,240,759
/jdk1.7.0_80/java/awt/font/TransformAttribute.java,Java,,51,14,90,155
/jdk1.7.0_80/java/awt/Font.java,Java,,1036,190,1459,2685
/jdk1.7.0_80/java/awt/FontFormatException.java,Java,,8,3,40,51
/jdk1.7.0_80/java/awt/FontMetrics.java,Java,,150,39,453,642
/jdk1.7.0_80/java/awt/Frame.java,Java,,466,98,759,1323
/jdk1.7.0_80/java/awt/geom/AffineTransform.java,Java,,2119,150,1654,3923
/jdk1.7.0_80/java/awt/geom/Arc2D.java,Java,,552,102,820,1474
/jdk1.7.0_80/java/awt/geom/ArcIterator.java,Java,,143,10,159,312
/jdk1.7.0_80/java/awt/geom/Area.java,Java,,314,38,392,744
/jdk1.7.0_80/java/awt/geom/CubicCurve2D.java,Java,,624,134,817,1575
/jdk1.7.0_80/java/awt/geom/CubicIterator.java,Java,,66,9,81,156
/jdk1.7.0_80/java/awt/geom/Dimension2D.java,Java,,18,8,88,114
/jdk1.7.0_80/java/awt/geom/Ellipse2D.java,Java,,159,39,266,464
/jdk1.7.0_80/java/awt/geom/EllipseIterator.java,Java,,91,11,87,189
/jdk1.7.0_80/java/awt/geom/FlatteningPathIterator.java,Java,,184,36,175,395
/jdk1.7.0_80/java/awt/geom/GeneralPath.java,Java,,29,9,89,127
/jdk1.7.0_80/java/awt/geom/IllegalPathStateException.java,Java,,8,4,44,56
/jdk1.7.0_80/java/awt/geom/Line2D.java,Java,,306,74,748,1128
/jdk1.7.0_80/java/awt/geom/LineIterator.java,Java,,58,9,81,148
/jdk1.7.0_80/java/awt/geom/NoninvertibleTransformException.java,Java,,6,3,37,46
/jdk1.7.0_80/java/awt/geom/Path2D.java,Java,,1303,137,1155,2595
/jdk1.7.0_80/java/awt/geom/PathIterator.java,Java,,15,13,187,215
/jdk1.7.0_80/java/awt/geom/Point2D.java,Java,,117,36,275,428
/jdk1.7.0_80/java/awt/geom/QuadCurve2D.java,Java,,505,104,792,1401
/jdk1.7.0_80/java/awt/geom/QuadIterator.java,Java,,62,9,81,152
/jdk1.7.0_80/java/awt/geom/Rectangle2D.java,Java,,317,68,545,930
/jdk1.7.0_80/java/awt/geom/RectangularShape.java,Java,,103,29,265,397
/jdk1.7.0_80/java/awt/geom/RectIterator.java,Java,,66,9,81,156
/jdk1.7.0_80/java/awt/geom/RoundRectangle2D.java,Java,,250,55,376,681
/jdk1.7.0_80/java/awt/geom/RoundRectIterator.java,Java,,92,11,86,189
/jdk1.7.0_80/java/awt/GradientPaint.java,Java,,87,19,172,278
/jdk1.7.0_80/java/awt/GradientPaintContext.java,Java,,209,24,62,295
/jdk1.7.0_80/java/awt/Graphics.java,Java,,164,57,1035,1256
/jdk1.7.0_80/java/awt/Graphics2D.java,Java,,99,47,1088,1234
/jdk1.7.0_80/java/awt/GraphicsCallback.java,Java,,109,13,24,146
/jdk1.7.0_80/java/awt/GraphicsConfigTemplate.java,Java,,14,10,87,111
/jdk1.7.0_80/java/awt/GraphicsConfiguration.java,Java,,101,26,327,454
/jdk1.7.0_80/java/awt/GraphicsDevice.java,Java,,150,33,404,587
/jdk1.7.0_80/java/awt/GraphicsEnvironment.java,Java,,136,29,297,462
/jdk1.7.0_80/java/awt/GridBagConstraints.java,Java,,100,53,510,663
/jdk1.7.0_80/java/awt/GridBagLayout.java,Java,,1060,158,1010,2228
/jdk1.7.0_80/java/awt/GridBagLayoutInfo.java,Java,,23,6,58,87
/jdk1.7.0_80/java/awt/GridLayout.java,Java,,159,24,298,481
/jdk1.7.0_80/java/awt/HeadlessException.java,Java,,19,3,35,57
/jdk1.7.0_80/java/awt/IllegalComponentStateException.java,Java,,10,4,43,57
/jdk1.7.0_80/java/awt/im/InputContext.java,Java,,41,18,280,339
/jdk1.7.0_80/java/awt/im/InputMethodHighlight.java,Java,,48,21,126,195
/jdk1.7.0_80/java/awt/im/InputMethodRequests.java,Java,,15,11,182,208
/jdk1.7.0_80/java/awt/im/InputSubset.java,Java,,24,15,75,114
/jdk1.7.0_80/java/awt/im/spi/InputMethod.java,Java,,23,22,337,382
/jdk1.7.0_80/java/awt/im/spi/InputMethodContext.java,Java,,15,8,117,140
/jdk1.7.0_80/java/awt/im/spi/InputMethodDescriptor.java,Java,,11,10,103,124
/jdk1.7.0_80/java/awt/image/AffineTransformOp.java,Java,,273,39,248,560
/jdk1.7.0_80/java/awt/image/AreaAveragingScaleFilter.java,Java,,164,11,106,281
/jdk1.7.0_80/java/awt/image/BandCombineOp.java,Java,,132,15,142,289
/jdk1.7.0_80/java/awt/image/BandedSampleModel.java,Java,,395,94,360,849
/jdk1.7.0_80/java/awt/image/BufferedImage.java,Java,,738,131,770,1639
/jdk1.7.0_80/java/awt/image/BufferedImageFilter.java,Java,,263,15,139,417
/jdk1.7.0_80/java/awt/image/BufferedImageOp.java,Java,,12,7,117,136
/jdk1.7.0_80/java/awt/image/BufferStrategy.java,Java,,13,9,183,205
/jdk1.7.0_80/java/awt/image/ByteLookupTable.java,Java,,79,13,118,210
/jdk1.7.0_80/java/awt/image/ColorConvertOp.java,Java,,734,84,291,1109
/jdk1.7.0_80/java/awt/image/ColorModel.java,Java,,708,89,1162,1959
/jdk1.7.0_80/java/awt/image/ComponentColorModel.java,Java,,1824,79,1045,2948
/jdk1.7.0_80/java/awt/image/ComponentSampleModel.java,Java,,604,114,494,1212
/jdk1.7.0_80/java/awt/image/ConvolveOp.java,Java,,139,33,175,347
/jdk1.7.0_80/java/awt/image/CropImageFilter.java,Java,,86,11,96,193
/jdk1.7.0_80/java/awt/image/DataBuffer.java,Java,,176,51,314,541
/jdk1.7.0_80/java/awt/image/DataBufferByte.java,Java,,69,18,199,286
/jdk1.7.0_80/java/awt/image/DataBufferDouble.java,Java,,96,27,280,403
/jdk1.7.0_80/java/awt/image/DataBufferFloat.java,Java,,96,27,283,406
/jdk1.7.0_80/java/awt/image/DataBufferInt.java,Java,,69,18,197,284
/jdk1.7.0_80/java/awt/image/DataBufferShort.java,Java,,69,18,196,283
/jdk1.7.0_80/java/awt/image/DataBufferUShort.java,Java,,100,20,198,318
/jdk1.7.0_80/java/awt/image/DirectColorModel.java,Java,,715,55,646,1416
/jdk1.7.0_80/java/awt/image/FilteredImageSource.java,Java,,60,10,139,209
/jdk1.7.0_80/java/awt/image/ImageConsumer.java,Java,,22,18,186,226
/jdk1.7.0_80/java/awt/image/ImageFilter.java,Java,,52,13,193,258
/jdk1.7.0_80/java/awt/image/ImageObserver.java,Java,,14,11,145,170
/jdk1.7.0_80/java/awt/image/ImageProducer.java,Java,,8,6,98,112
/jdk1.7.0_80/java/awt/image/ImagingOpException.java,Java,,6,4,35,45
/jdk1.7.0_80/java/awt/image/IndexColorModel.java,Java,,684,79,771,1534
/jdk1.7.0_80/java/awt/image/Kernel.java,Java,,59,13,81,153
/jdk1.7.0_80/java/awt/image/LookupOp.java,Java,,331,50,186,567
/jdk1.7.0_80/java/awt/image/LookupTable.java,Java,,25,10,74,109
/jdk1.7.0_80/java/awt/image/MemoryImageSource.java,Java,,220,24,327,571
/jdk1.7.0_80/java/awt/image/MultiPixelPackedSampleModel.java,Java,,291,60,348,699
/jdk1.7.0_80/java/awt/image/PackedColorModel.java,Java,,209,36,241,486
/jdk1.7.0_80/java/awt/image/PixelGrabber.java,Java,,308,28,336,672
/jdk1.7.0_80/java/awt/image/PixelInterleavedSampleModel.java,Java,,67,6,98,171
/jdk1.7.0_80/java/awt/image/Raster.java,Java,,630,139,1005,1774
/jdk1.7.0_80/java/awt/image/RasterFormatException.java,Java,,6,4,34,44
/jdk1.7.0_80/java/awt/image/RasterOp.java,Java,,11,7,89,107
/jdk1.7.0_80/java/awt/image/renderable/ContextualRenderedImageFactory.java,Java,,15,9,119,143
/jdk1.7.0_80/java/awt/image/renderable/ParameterBlock.java,Java,,191,50,484,725
/jdk1.7.0_80/java/awt/image/renderable/RenderableImage.java,Java,,18,15,165,198
/jdk1.7.0_80/java/awt/image/renderable/RenderableImageOp.java,Java,,121,29,200,350
/jdk1.7.0_80/java/awt/image/renderable/RenderableImageProducer.java,Java,,93,19,107,219
/jdk1.7.0_80/java/awt/image/renderable/RenderContext.java,Java,,63,22,187,272
/jdk1.7.0_80/java/awt/image/renderable/RenderedImageFactory.java,Java,,7,4,67,78
/jdk1.7.0_80/java/awt/image/RenderedImage.java,Java,,27,25,165,217
/jdk1.7.0_80/java/awt/image/ReplicateScaleFilter.java,Java,,115,16,124,255
/jdk1.7.0_80/java/awt/image/RescaleOp.java,Java,,348,63,255,666
/jdk1.7.0_80/java/awt/image/RGBImageFilter.java,Java,,101,13,178,292
/jdk1.7.0_80/java/awt/image/SampleModel.java,Java,,562,168,777,1507
/jdk1.7.0_80/java/awt/image/ShortLookupTable.java,Java,,79,13,112,204
/jdk1.7.0_80/java/awt/image/SinglePixelPackedSampleModel.java,Java,,374,75,352,801
/jdk1.7.0_80/java/awt/image/TileObserver.java,Java,,6,4,45,55
/jdk1.7.0_80/java/awt/image/VolatileImage.java,Java,,33,22,287,342
/jdk1.7.0_80/java/awt/image/WritableRaster.java,Java,,223,37,481,741
/jdk1.7.0_80/java/awt/image/WritableRenderedImage.java,Java,,13,13,125,151
/jdk1.7.0_80/java/awt/Image.java,Java,,70,23,260,353
/jdk1.7.0_80/java/awt/ImageCapabilities.java,Java,,20,8,53,81
/jdk1.7.0_80/java/awt/Insets.java,Java,,53,15,120,188
/jdk1.7.0_80/java/awt/ItemSelectable.java,Java,,7,7,51,65
/jdk1.7.0_80/java/awt/JobAttributes.java,Java,,443,68,554,1065
/jdk1.7.0_80/java/awt/KeyboardFocusManager.java,Java,,1482,263,1333,3078
/jdk1.7.0_80/java/awt/KeyEventDispatcher.java,Java,,5,4,81,90
/jdk1.7.0_80/java/awt/KeyEventPostProcessor.java,Java,,5,4,84,93
/jdk1.7.0_80/java/awt/Label.java,Java,,123,33,204,360
/jdk1.7.0_80/java/awt/LayoutManager.java,Java,,8,5,70,83
/jdk1.7.0_80/java/awt/LayoutManager2.java,Java,,8,7,72,87
/jdk1.7.0_80/java/awt/LinearGradientPaint.java,Java,,98,16,270,384
/jdk1.7.0_80/java/awt/LinearGradientPaintContext.java,Java,,54,20,91,165
/jdk1.7.0_80/java/awt/List.java,Java,[FIXME,625,154,1170,1949
/jdk1.7.0_80/java/awt/MediaTracker.java,Java,,389,56,504,949
/jdk1.7.0_80/java/awt/Menu.java,Java,,251,60,319,630
/jdk1.7.0_80/java/awt/MenuBar.java,Java,,216,43,252,511
/jdk1.7.0_80/java/awt/MenuComponent.java,Java,,344,101,618,1063
/jdk1.7.0_80/java/awt/MenuContainer.java,Java,,7,3,33,43
/jdk1.7.0_80/java/awt/MenuItem.java,Java,[PENDING:  WDW -- need to provide a localized string,325,76,541,942
/jdk1.7.0_80/java/awt/MenuShortcut.java,Java,,52,13,143,208
/jdk1.7.0_80/java/awt/ModalEventFilter.java,Java,,156,23,37,216
/jdk1.7.0_80/java/awt/MouseInfo.java,Java,,53,12,70,135
/jdk1.7.0_80/java/awt/MultipleGradientPaint.java,Java,,124,38,149,311
/jdk1.7.0_80/java/awt/MultipleGradientPaintContext.java,Java,,357,94,273,724
/jdk1.7.0_80/java/awt/PageAttributes.java,Java,,521,52,805,1378
/jdk1.7.0_80/java/awt/Paint.java,Java,,11,5,92,108
/jdk1.7.0_80/java/awt/PaintContext.java,Java,,11,7,63,81
/jdk1.7.0_80/java/awt/Panel.java,Java,,37,14,82,133
/jdk1.7.0_80/java/awt/peer/ButtonPeer.java,Java,,5,4,41,50
/jdk1.7.0_80/java/awt/peer/CanvasPeer.java,Java,,7,2,40,49
/jdk1.7.0_80/java/awt/peer/CheckboxMenuItemPeer.java,Java,,5,3,41,49
/jdk1.7.0_80/java/awt/peer/CheckboxPeer.java,Java,,7,6,58,71
/jdk1.7.0_80/java/awt/peer/ChoicePeer.java,Java,,8,7,61,76
/jdk1.7.0_80/java/awt/peer/ComponentPeer.java,Java,,62,51,442,555
/jdk1.7.0_80/java/awt/peer/ContainerPeer.java,Java,,9,7,63,79
/jdk1.7.0_80/java/awt/peer/DesktopPeer.java,Java,,13,10,84,107
/jdk1.7.0_80/java/awt/peer/DialogPeer.java,Java,,7,6,57,70
/jdk1.7.0_80/java/awt/peer/FileDialogPeer.java,Java,,8,6,55,69
/jdk1.7.0_80/java/awt/peer/FontPeer.java,Java,,3,2,34,39
/jdk1.7.0_80/java/awt/peer/FramePeer.java,Java,,13,13,102,128
/jdk1.7.0_80/java/awt/peer/KeyboardFocusManagerPeer.java,Java,,10,9,61,80
/jdk1.7.0_80/java/awt/peer/LabelPeer.java,Java,,6,4,50,60
/jdk1.7.0_80/java/awt/peer/LightweightPeer.java,Java,,3,3,38,44
/jdk1.7.0_80/java/awt/peer/ListPeer.java,Java,,15,13,110,138
/jdk1.7.0_80/java/awt/peer/MenuBarPeer.java,Java,,8,5,54,67
/jdk1.7.0_80/java/awt/peer/MenuComponentPeer.java,Java,,7,4,46,57
/jdk1.7.0_80/java/awt/peer/MenuItemPeer.java,Java,,6,5,44,55
/jdk1.7.0_80/java/awt/peer/MenuPeer.java,Java,,8,5,52,65
/jdk1.7.0_80/java/awt/peer/MouseInfoPeer.java,Java,,7,6,56,69
/jdk1.7.0_80/java/awt/peer/PanelPeer.java,Java,,3,1,35,39
/jdk1.7.0_80/java/awt/peer/PopupMenuPeer.java,Java,,6,3,41,50
/jdk1.7.0_80/java/awt/peer/RobotPeer.java,Java,,14,11,99,124
/jdk1.7.0_80/java/awt/peer/ScrollbarPeer.java,Java,,7,5,57,69
/jdk1.7.0_80/java/awt/peer/ScrollPanePeer.java,Java,,12,8,77,97
/jdk1.7.0_80/java/awt/peer/SystemTrayPeer.java,Java,,6,4,35,45
/jdk1.7.0_80/java/awt/peer/TextAreaPeer.java,Java,,9,7,72,88
/jdk1.7.0_80/java/awt/peer/TextComponentPeer.java,Java,,14,11,96,121
/jdk1.7.0_80/java/awt/peer/TextFieldPeer.java,Java,,8,6,60,74
/jdk1.7.0_80/java/awt/peer/TrayIconPeer.java,Java,,10,8,62,80
/jdk1.7.0_80/java/awt/peer/WindowPeer.java,Java,,16,15,91,122
/jdk1.7.0_80/java/awt/Point.java,Java,,56,18,160,234
/jdk1.7.0_80/java/awt/PointerInfo.java,Java,,15,8,61,84
/jdk1.7.0_80/java/awt/Polygon.java,Java,,268,52,357,677
/jdk1.7.0_80/java/awt/PopupMenu.java,Java,,97,21,122,240
/jdk1.7.0_80/java/awt/print/Book.java,Java,,66,27,128,221
/jdk1.7.0_80/java/awt/print/Pageable.java,Java,,9,6,68,83
/jdk1.7.0_80/java/awt/print/PageFormat.java,Java,,141,58,164,363
/jdk1.7.0_80/java/awt/print/Paper.java,Java,,53,25,131,209
/jdk1.7.0_80/java/awt/print/Printable.java,Java,,8,7,128,143
/jdk1.7.0_80/java/awt/print/PrinterAbortException.java,Java,,9,6,40,55
/jdk1.7.0_80/java/awt/print/PrinterException.java,Java,,8,6,39,53
/jdk1.7.0_80/java/awt/print/PrinterGraphics.java,Java,,4,5,38,47
/jdk1.7.0_80/java/awt/print/PrinterIOException.java,Java,,16,6,66,88
/jdk1.7.0_80/java/awt/print/PrinterJob.java,Java,,165,47,407,619
/jdk1.7.0_80/java/awt/PrintGraphics.java,Java,,4,4,33,41
/jdk1.7.0_80/java/awt/PrintJob.java,Java,,11,9,60,80
/jdk1.7.0_80/java/awt/RadialGradientPaint.java,Java,,158,25,463,646
/jdk1.7.0_80/java/awt/RadialGradientPaintContext.java,Java,,176,65,208,449
/jdk1.7.0_80/java/awt/Rectangle.java,Java,,436,62,718,1216
/jdk1.7.0_80/java/awt/RenderingHints.java,Java,,222,76,1002,1300
/jdk1.7.0_80/java/awt/Robot.java,Java,,232,50,311,593
/jdk1.7.0_80/java/awt/Scrollbar.java,Java,,355,90,892,1337
/jdk1.7.0_80/java/awt/ScrollPane.java,Java,,359,79,411,849
/jdk1.7.0_80/java/awt/ScrollPaneAdjustable.java,Java,,148,45,261,454
/jdk1.7.0_80/java/awt/SecondaryLoop.java,Java,,5,5,137,147
/jdk1.7.0_80/java/awt/SentEvent.java,Java,,49,7,35,91
/jdk1.7.0_80/java/awt/SequencedEvent.java,Java,,122,19,84,225
/jdk1.7.0_80/java/awt/Shape.java,Java,,17,12,385,414
/jdk1.7.0_80/java/awt/SplashScreen.java,Java,,174,21,205,400
/jdk1.7.0_80/java/awt/Stroke.java,Java,,4,2,62,68
/jdk1.7.0_80/java/awt/SystemColor.java,Java,,142,66,335,543
/jdk1.7.0_80/java/awt/SystemTray.java,Java,,165,30,322,517
/jdk1.7.0_80/java/awt/TextArea.java,Java,,245,60,409,714
/jdk1.7.0_80/java/awt/TextComponent.java,Java,,485,93,647,1225
/jdk1.7.0_80/java/awt/TextField.java,Java,,230,56,475,761
/jdk1.7.0_80/java/awt/TexturePaint.java,Java,,46,12,93,151
/jdk1.7.0_80/java/awt/TexturePaintContext.java,Java,,704,48,75,827
/jdk1.7.0_80/java/awt/Toolkit.java,Java,,873,173,1576,2622
/jdk1.7.0_80/java/awt/Transparency.java,Java,,7,6,46,59
/jdk1.7.0_80/java/awt/TrayIcon.java,Java,,281,52,449,782
/jdk1.7.0_80/java/awt/WaitDispatchSupport.java,Java,,181,26,95,302
/jdk1.7.0_80/java/awt/Window.java,Java,,1634,282,2182,4098
/jdk1.7.0_80/java/beans/AppletInitializer.java,Java,,7,10,74,91
/jdk1.7.0_80/java/beans/beancontext/BeanContext.java,Java,,16,13,103,132
/jdk1.7.0_80/java/beans/beancontext/BeanContextChild.java,Java,,13,12,112,137
/jdk1.7.0_80/java/beans/beancontext/BeanContextChildComponentProxy.java,Java,,5,6,43,54
/jdk1.7.0_80/java/beans/beancontext/BeanContextChildSupport.java,Java,,100,57,216,373
/jdk1.7.0_80/java/beans/beancontext/BeanContextContainerProxy.java,Java,,5,5,42,52
/jdk1.7.0_80/java/beans/beancontext/BeanContextEvent.java,Java,,20,12,72,104
/jdk1.7.0_80/java/beans/beancontext/BeanContextMembershipEvent.java,Java,,29,19,83,131
/jdk1.7.0_80/java/beans/beancontext/BeanContextMembershipListener.java,Java,,7,7,47,61
/jdk1.7.0_80/java/beans/beancontext/BeanContextProxy.java,Java,,4,4,77,85
/jdk1.7.0_80/java/beans/beancontext/BeanContextServiceAvailableEvent.java,Java,,20,13,53,86
/jdk1.7.0_80/java/beans/beancontext/BeanContextServiceProvider.java,Java,,7,7,90,104
/jdk1.7.0_80/java/beans/beancontext/BeanContextServiceProviderBeanInfo.java,Java,,5,5,37,47
/jdk1.7.0_80/java/beans/beancontext/BeanContextServiceRevokedEvent.java,Java,,21,12,66,99
/jdk1.7.0_80/java/beans/beancontext/BeanContextServiceRevokedListener.java,Java,,6,4,36,46
/jdk1.7.0_80/java/beans/beancontext/BeanContextServices.java,Java,,17,17,125,159
/jdk1.7.0_80/java/beans/beancontext/BeanContextServicesListener.java,Java,,7,4,35,46
/jdk1.7.0_80/java/beans/beancontext/BeanContextServicesSupport.java,Java,,625,314,299,1238
/jdk1.7.0_80/java/beans/beancontext/BeanContextSupport.java,Java,,590,258,545,1393
/jdk1.7.0_80/java/beans/BeanDescriptor.java,Java,,37,12,60,109
/jdk1.7.0_80/java/beans/BeanInfo.java,Java,,15,15,146,176
/jdk1.7.0_80/java/beans/Beans.java,Java,,267,89,262,618
/jdk1.7.0_80/java/beans/ChangeListenerMap.java,Java,,117,15,109,241
/jdk1.7.0_80/java/beans/ConstructorProperties.java,Java,,8,3,65,76
/jdk1.7.0_80/java/beans/Customizer.java,Java,,6,7,52,65
/jdk1.7.0_80/java/beans/DefaultPersistenceDelegate.java,Java,,199,24,194,417
/jdk1.7.0_80/java/beans/DesignMode.java,Java,,6,9,74,89
/jdk1.7.0_80/java/beans/Encoder.java,Java,,115,20,216,351
/jdk1.7.0_80/java/beans/EventHandler.java,Java,,174,17,503,694
/jdk1.7.0_80/java/beans/EventSetDescriptor.java,Java,,273,45,218,536
/jdk1.7.0_80/java/beans/ExceptionListener.java,Java,,4,1,38,43
/jdk1.7.0_80/java/beans/Expression.java,Java,,32,11,139,182
/jdk1.7.0_80/java/beans/FeatureDescriptor.java,Java,,193,44,208,445
/jdk1.7.0_80/java/beans/IndexedPropertyChangeEvent.java,Java,,17,5,56,78
/jdk1.7.0_80/java/beans/IndexedPropertyDescriptor.java,Java,,288,52,180,520
/jdk1.7.0_80/java/beans/IntrospectionException.java,Java,,8,4,38,50
/jdk1.7.0_80/java/beans/Introspector.java,Java,,986,154,424,1564
/jdk1.7.0_80/java/beans/MetaData.java,Java,,1081,149,223,1453
/jdk1.7.0_80/java/beans/MethodDescriptor.java,Java,,124,26,70,220
/jdk1.7.0_80/java/beans/MethodRef.java,Java,,55,8,24,87
/jdk1.7.0_80/java/beans/NameGenerator.java,Java,,52,11,53,116
/jdk1.7.0_80/java/beans/ParameterDescriptor.java,Java,,8,6,39,53
/jdk1.7.0_80/java/beans/PersistenceDelegate.java,Java,,26,6,182,214
/jdk1.7.0_80/java/beans/PropertyChangeEvent.java,Java,,42,15,107,164
/jdk1.7.0_80/java/beans/PropertyChangeListener.java,Java,,4,6,34,44
/jdk1.7.0_80/java/beans/PropertyChangeListenerProxy.java,Java,,17,7,57,81
/jdk1.7.0_80/java/beans/PropertyChangeSupport.java,Java,,200,33,313,546
/jdk1.7.0_80/java/beans/PropertyDescriptor.java,Java,,433,67,249,749
/jdk1.7.0_80/java/beans/PropertyEditor.java,Java,,15,25,185,225
/jdk1.7.0_80/java/beans/PropertyEditorManager.java,Java,,23,7,95,125
/jdk1.7.0_80/java/beans/PropertyEditorSupport.java,Java,,86,32,184,302
/jdk1.7.0_80/java/beans/PropertyVetoException.java,Java,,13,7,44,64
/jdk1.7.0_80/java/beans/SimpleBeanInfo.java,Java,,44,13,78,135
/jdk1.7.0_80/java/beans/Statement.java,Java,,189,20,154,363
/jdk1.7.0_80/java/beans/ThreadGroupContext.java,Java,,71,22,37,130
/jdk1.7.0_80/java/beans/Transient.java,Java,,10,4,54,68
/jdk1.7.0_80/java/beans/VetoableChangeListener.java,Java,,5,2,37,44
/jdk1.7.0_80/java/beans/VetoableChangeListenerProxy.java,Java,,17,7,60,84
/jdk1.7.0_80/java/beans/VetoableChangeSupport.java,Java,,212,29,294,535
/jdk1.7.0_80/java/beans/Visibility.java,Java,,7,8,52,67
/jdk1.7.0_80/java/beans/WeakIdentityMap.java,Java,,129,17,44,190
/jdk1.7.0_80/java/beans/XMLDecoder.java,Java,,102,20,184,306
/jdk1.7.0_80/java/beans/XMLEncoder.java,Java,,420,54,338,812
/jdk1.7.0_80/java/io/Bits.java,Java,,69,18,36,123
/jdk1.7.0_80/java/io/BufferedInputStream.java,Java,,161,27,290,478
/jdk1.7.0_80/java/io/BufferedOutputStream.java,Java,,44,9,90,143
/jdk1.7.0_80/java/io/BufferedReader.java,Java,,263,36,223,522
/jdk1.7.0_80/java/io/BufferedWriter.java,Java,,109,23,140,272
/jdk1.7.0_80/java/io/ByteArrayInputStream.java,Java,,64,20,199,283
/jdk1.7.0_80/java/io/ByteArrayOutputStream.java,Java,,77,23,185,285
/jdk1.7.0_80/java/io/CharArrayReader.java,Java,,95,17,120,232
/jdk1.7.0_80/java/io/CharArrayWriter.java,Java,,90,20,170,280
/jdk1.7.0_80/java/io/CharConversionException.java,Java,,11,2,38,51
/jdk1.7.0_80/java/io/Closeable.java,Java,,5,5,38,48
/jdk1.7.0_80/java/io/Console.java,Java,,262,20,296,578
/jdk1.7.0_80/java/io/DataInput.java,Java,,19,16,600,635
/jdk1.7.0_80/java/io/DataInputStream.java,Java,,212,35,416,663
/jdk1.7.0_80/java/io/DataOutput.java,Java,,18,15,321,354
/jdk1.7.0_80/java/io/DataOutputStream.java,Java,,145,29,242,416
/jdk1.7.0_80/java/io/DeleteOnExitHook.java,Java,,36,10,37,83
/jdk1.7.0_80/java/io/EOFException.java,Java,,11,4,50,65
/jdk1.7.0_80/java/io/ExpiringCache.java,Java,,84,15,28,127
/jdk1.7.0_80/java/io/Externalizable.java,Java,,7,4,86,97
/jdk1.7.0_80/java/io/File.java,Java,,597,106,1497,2200
/jdk1.7.0_80/java/io/FileDescriptor.java,Java,,53,24,103,180
/jdk1.7.0_80/java/io/FileFilter.java,Java,,4,5,41,50
/jdk1.7.0_80/java/io/FileInputStream.java,Java,,132,32,278,442
/jdk1.7.0_80/java/io/FilenameFilter.java,Java,,5,2,46,53
/jdk1.7.0_80/java/io/FileNotFoundException.java,Java,,15,8,59,82
/jdk1.7.0_80/java/io/FileOutputStream.java,Java,,149,34,299,482
/jdk1.7.0_80/java/io/FilePermission.java,Java,,354,97,408,859
/jdk1.7.0_80/java/io/FileReader.java,Java,,12,7,66,85
/jdk1.7.0_80/java/io/FileSystem.java,Java,,58,47,147,252
/jdk1.7.0_80/java/io/FileWriter.java,Java,,18,10,91,119
/jdk1.7.0_80/java/io/FilterInputStream.java,Java,,35,12,198,245
/jdk1.7.0_80/java/io/FilterOutputStream.java,Java,,31,9,122,162
/jdk1.7.0_80/java/io/FilterReader.java,Java,,32,15,77,124
/jdk1.7.0_80/java/io/FilterWriter.java,Java,,23,12,72,107
/jdk1.7.0_80/java/io/Flushable.java,Java,,5,5,37,47
/jdk1.7.0_80/java/io/InputStream.java,Java,,62,19,285,366
/jdk1.7.0_80/java/io/InputStreamReader.java,Java,,50,15,136,201
/jdk1.7.0_80/java/io/InterruptedIOException.java,Java,,12,5,57,74
/jdk1.7.0_80/java/io/InvalidClassException.java,Java,,18,7,56,81
/jdk1.7.0_80/java/io/InvalidObjectException.java,Java,,7,4,40,51
/jdk1.7.0_80/java/io/IOError.java,Java,,7,3,40,50
/jdk1.7.0_80/java/io/IOException.java,Java,,17,6,78,101
/jdk1.7.0_80/java/io/LineNumberInputStream.java,Java,,97,19,176,292
/jdk1.7.0_80/java/io/LineNumberReader.java,Java,,100,23,158,281
/jdk1.7.0_80/java/io/NotActiveException.java,Java,,10,5,38,53
/jdk1.7.0_80/java/io/NotSerializableException.java,Java,,10,5,40,55
/jdk1.7.0_80/java/io/ObjectInput.java,Java,,11,8,88,107
/jdk1.7.0_80/java/io/ObjectInputStream.java,Java,,1936,295,1304,3535
/jdk1.7.0_80/java/io/ObjectInputValidation.java,Java,,4,2,39,45
/jdk1.7.0_80/java/io/ObjectOutput.java,Java,,10,7,73,90
/jdk1.7.0_80/java/io/ObjectOutputStream.java,Java,,1275,186,1012,2473
/jdk1.7.0_80/java/io/ObjectStreamClass.java,Java,,1520,197,620,2337
/jdk1.7.0_80/java/io/ObjectStreamConstants.java,Java,,34,36,165,235
/jdk1.7.0_80/java/io/ObjectStreamException.java,Java,,10,5,38,53
/jdk1.7.0_80/java/io/ObjectStreamField.java,Java,,140,22,162,324
/jdk1.7.0_80/java/io/OptionalDataException.java,Java,,14,6,63,83
/jdk1.7.0_80/java/io/OutputStream.java,Java,,24,7,123,154
/jdk1.7.0_80/java/io/OutputStreamWriter.java,Java,,56,17,162,235
/jdk1.7.0_80/java/io/PipedInputStream.java,Java,,191,31,228,450
/jdk1.7.0_80/java/io/PipedOutputStream.java,Java,,53,11,115,179
/jdk1.7.0_80/java/io/PipedReader.java,Java,,158,27,178,363
/jdk1.7.0_80/java/io/PipedWriter.java,Java,,53,14,117,184
/jdk1.7.0_80/java/io/PrintStream.java,Java,,355,63,711,1129
/jdk1.7.0_80/java/io/PrintWriter.java,Java,,324,59,683,1066
/jdk1.7.0_80/java/io/PushbackInputStream.java,Java,,115,19,249,383
/jdk1.7.0_80/java/io/PushbackReader.java,Java,,120,20,141,281
/jdk1.7.0_80/java/io/RandomAccessFile.java,Java,,329,71,776,1176
/jdk1.7.0_80/java/io/Reader.java,Java,,64,20,178,262
/jdk1.7.0_80/java/io/SequenceInputStream.java,Java,,78,14,143,235
/jdk1.7.0_80/java/io/SerialCallbackContext.java,Java,,28,7,39,74
/jdk1.7.0_80/java/io/Serializable.java,Java,,3,2,165,170
/jdk1.7.0_80/java/io/SerializablePermission.java,Java,,17,10,105,132
/jdk1.7.0_80/java/io/StreamCorruptedException.java,Java,,10,5,39,54
/jdk1.7.0_80/java/io/StreamTokenizer.java,Java,,365,52,417,834
/jdk1.7.0_80/java/io/StringBufferInputStream.java,Java,,54,11,107,172
/jdk1.7.0_80/java/io/StringReader.java,Java,,78,15,108,201
/jdk1.7.0_80/java/io/StringWriter.java,Java,,59,19,158,236
/jdk1.7.0_80/java/io/SyncFailedException.java,Java,,7,3,38,48
/jdk1.7.0_80/java/io/UnsupportedEncodingException.java,Java,,12,3,37,52
/jdk1.7.0_80/java/io/UTFDataFormatException.java,Java,,11,4,54,69
/jdk1.7.0_80/java/io/Win32FileSystem.java,Java,,421,64,123,608
/jdk1.7.0_80/java/io/WinNTFileSystem.java,Java,,33,12,34,79
/jdk1.7.0_80/java/io/WriteAbortedException.java,Java,,19,6,68,93
/jdk1.7.0_80/java/io/Writer.java,Java,,64,20,241,325
/jdk1.7.0_80/java/lang/AbstractMethodError.java,Java,,11,4,43,58
/jdk1.7.0_80/java/lang/AbstractStringBuilder.java,Java,,413,64,930,1407
/jdk1.7.0_80/java/lang/annotation/Annotation.java,Java,,7,5,119,131
/jdk1.7.0_80/java/lang/annotation/AnnotationFormatError.java,Java,,13,6,60,79
/jdk1.7.0_80/java/lang/annotation/AnnotationTypeMismatchException.java,Java,,19,7,65,91
/jdk1.7.0_80/java/lang/annotation/Documented.java,Java,,6,2,35,43
/jdk1.7.0_80/java/lang/annotation/ElementType.java,Java,,11,9,43,63
/jdk1.7.0_80/java/lang/annotation/IncompleteAnnotationException.java,Java,,19,8,56,83
/jdk1.7.0_80/java/lang/annotation/Inherited.java,Java,,6,2,44,52
/jdk1.7.0_80/java/lang/annotation/package-info.java,Java,,1,1,31,33
/jdk1.7.0_80/java/lang/annotation/Retention.java,Java,,7,2,38,47
/jdk1.7.0_80/java/lang/annotation/RetentionPolicy.java,Java,,6,4,47,57
/jdk1.7.0_80/java/lang/annotation/Target.java,Java,,7,2,59,68
/jdk1.7.0_80/java/lang/Appendable.java,Java,,7,6,108,121
/jdk1.7.0_80/java/lang/ApplicationShutdownHooks.java,Java,,52,14,44,110
/jdk1.7.0_80/java/lang/ArithmeticException.java,Java,,10,4,47,61
/jdk1.7.0_80/java/lang/ArrayIndexOutOfBoundsException.java,Java,,14,5,48,67
/jdk1.7.0_80/java/lang/ArrayStoreException.java,Java,,11,4,45,60
/jdk1.7.0_80/java/lang/AssertionError.java,Java,,35,12,120,167
/jdk1.7.0_80/java/lang/AssertionStatusDirectives.java,Java,,8,6,80,94
/jdk1.7.0_80/java/lang/AutoCloseable.java,Java,,4,2,66,72
/jdk1.7.0_80/java/lang/Boolean.java,Java,,61,20,201,282
/jdk1.7.0_80/java/lang/BootstrapMethodError.java,Java,,17,6,57,80
/jdk1.7.0_80/java/lang/Byte.java,Java,,91,31,330,452
/jdk1.7.0_80/java/lang/Character.java,Java,,2651,505,3876,7032
/jdk1.7.0_80/java/lang/CharacterData.java,Java,,57,10,30,97
/jdk1.7.0_80/java/lang/CharacterData00.java,Java,,1298,51,111,1460
/jdk1.7.0_80/java/lang/CharacterData01.java,Java,,530,41,83,654
/jdk1.7.0_80/java/lang/CharacterData02.java,Java,,270,39,82,391
/jdk1.7.0_80/java/lang/CharacterData0E.java,Java,,271,39,82,392
/jdk1.7.0_80/java/lang/CharacterDataLatin1.java,Java,,221,41,69,331
/jdk1.7.0_80/java/lang/CharacterDataPrivateUse.java,Java,,54,21,26,101
/jdk1.7.0_80/java/lang/CharacterDataUndefined.java,Java,,50,19,26,95
/jdk1.7.0_80/java/lang/CharacterName.java,Java,,73,8,25,106
/jdk1.7.0_80/java/lang/CharSequence.java,Java,,7,9,95,111
/jdk1.7.0_80/java/lang/Class.java,Java,,1241,254,1820,3315
/jdk1.7.0_80/java/lang/ClassCastException.java,Java,,11,4,45,60
/jdk1.7.0_80/java/lang/ClassCircularityError.java,Java,,10,4,41,55
/jdk1.7.0_80/java/lang/ClassFormatError.java,Java,,11,4,41,56
/jdk1.7.0_80/java/lang/ClassLoader.java,Java,,933,154,1154,2241
/jdk1.7.0_80/java/lang/ClassLoaderHelper.java,Java,,8,4,30,42
/jdk1.7.0_80/java/lang/ClassNotFoundException.java,Java,,21,8,96,125
/jdk1.7.0_80/java/lang/ClassValue.java,Java,,375,53,332,760
/jdk1.7.0_80/java/lang/Cloneable.java,Java,,3,2,49,54
/jdk1.7.0_80/java/lang/CloneNotSupportedException.java,Java,,11,5,49,65
/jdk1.7.0_80/java/lang/Comparable.java,Java,,5,3,130,138
/jdk1.7.0_80/java/lang/Compiler.java,Java,,40,10,86,136
/jdk1.7.0_80/java/lang/ConditionalSpecialCasing.java,Java,,280,61,131,472
/jdk1.7.0_80/java/lang/Deprecated.java,Java,,8,3,33,44
/jdk1.7.0_80/java/lang/Double.java,Java,,131,49,808,988
/jdk1.7.0_80/java/lang/Enum.java,Java,,64,17,175,256
/jdk1.7.0_80/java/lang/EnumConstantNotPresentException.java,Java,,14,7,58,79
/jdk1.7.0_80/java/lang/Error.java,Java,,21,7,100,128
/jdk1.7.0_80/java/lang/Exception.java,Java,,21,7,96,124
/jdk1.7.0_80/java/lang/ExceptionInInitializerError.java,Java,,22,8,96,126
/jdk1.7.0_80/java/lang/Float.java,Java,,115,42,735,892
/jdk1.7.0_80/java/lang/IllegalAccessError.java,Java,,10,4,44,58
/jdk1.7.0_80/java/lang/IllegalAccessException.java,Java,,10,4,64,78
/jdk1.7.0_80/java/lang/IllegalArgumentException.java,Java,,17,6,72,95
/jdk1.7.0_80/java/lang/IllegalMonitorStateException.java,Java,,11,4,47,62
/jdk1.7.0_80/java/lang/IllegalStateException.java,Java,,17,6,74,97
/jdk1.7.0_80/java/lang/IllegalThreadStateException.java,Java,,10,4,45,59
/jdk1.7.0_80/java/lang/IncompatibleClassChangeError.java,Java,,11,4,42,57
/jdk1.7.0_80/java/lang/IndexOutOfBoundsException.java,Java,,11,4,43,58
/jdk1.7.0_80/java/lang/InheritableThreadLocal.java,Java,,13,5,66,84
/jdk1.7.0_80/java/lang/InstantiationError.java,Java,,11,6,44,61
/jdk1.7.0_80/java/lang/InstantiationException.java,Java,,11,4,50,65
/jdk1.7.0_80/java/lang/instrument/ClassDefinition.java,Java,,22,7,59,88
/jdk1.7.0_80/java/lang/instrument/ClassFileTransformer.java,Java,,11,5,172,188
/jdk1.7.0_80/java/lang/instrument/IllegalClassFormatException.java,Java,,12,5,47,64
/jdk1.7.0_80/java/lang/instrument/Instrumentation.java,Java,,37,20,600,657
/jdk1.7.0_80/java/lang/instrument/UnmodifiableClassException.java,Java,,12,4,42,58
/jdk1.7.0_80/java/lang/Integer.java,Java,,377,82,785,1244
/jdk1.7.0_80/java/lang/InternalError.java,Java,,11,4,40,55
/jdk1.7.0_80/java/lang/InterruptedException.java,Java,,11,4,54,69
/jdk1.7.0_80/java/lang/invoke/BoundMethodHandle.java,Java,,501,82,275,858
/jdk1.7.0_80/java/lang/invoke/CallSite.java,Java,,125,20,172,317
/jdk1.7.0_80/java/lang/invoke/ConstantCallSite.java,Java,,23,7,90,120
/jdk1.7.0_80/java/lang/invoke/DirectMethodHandle.java,Java,,540,46,91,677
/jdk1.7.0_80/java/lang/invoke/DontInline.java,Java,,6,3,28,37
/jdk1.7.0_80/java/lang/invoke/ForceInline.java,Java,,6,3,28,37
/jdk1.7.0_80/java/lang/invoke/InvokeDynamic.java,Java,,4,2,27,33
/jdk1.7.0_80/java/lang/invoke/InvokeGeneric.java,Java,,92,14,42,148
/jdk1.7.0_80/java/lang/invoke/InvokerBytecodeGenerator.java,Java,,723,109,259,1091
/jdk1.7.0_80/java/lang/invoke/Invokers.java,Java,,345,35,84,464
/jdk1.7.0_80/java/lang/invoke/LambdaForm.java,Java,,1192,96,337,1625
/jdk1.7.0_80/java/lang/invoke/MemberName.java,Java,,668,48,246,962
/jdk1.7.0_80/java/lang/invoke/MethodHandle.java,Java,won,244,53,1114,1411
/jdk1.7.0_80/java/lang/invoke/MethodHandleImpl.java,Java,,749,75,113,937
/jdk1.7.0_80/java/lang/invoke/MethodHandleInfo.java,Java,,38,8,25,71
/jdk1.7.0_80/java/lang/invoke/MethodHandleNatives.java,Java,,399,34,103,536
/jdk1.7.0_80/java/lang/invoke/MethodHandleProxies.java,Java,,155,15,148,318
/jdk1.7.0_80/java/lang/invoke/MethodHandles.java,Java,,760,97,1570,2427
/jdk1.7.0_80/java/lang/invoke/MethodHandleStatics.java,Java,,93,11,31,135
/jdk1.7.0_80/java/lang/invoke/MethodType.java,Java,,554,93,632,1279
/jdk1.7.0_80/java/lang/invoke/MethodTypeForm.java,Java,,265,26,81,372
/jdk1.7.0_80/java/lang/invoke/MutableCallSite.java,Java,,29,8,246,283
/jdk1.7.0_80/java/lang/invoke/package-info.java,Java,,1,2,208,211
/jdk1.7.0_80/java/lang/invoke/SimpleMethodHandle.java,Java,,33,9,28,70
/jdk1.7.0_80/java/lang/invoke/SwitchPoint.java,Java,,31,7,190,228
/jdk1.7.0_80/java/lang/invoke/VolatileCallSite.java,Java,,20,6,83,109
/jdk1.7.0_80/java/lang/invoke/WrongMethodTypeException.java,Java,,16,6,63,85
/jdk1.7.0_80/java/lang/Iterable.java,Java,,5,4,37,46
/jdk1.7.0_80/java/lang/LinkageError.java,Java,,14,5,50,69
/jdk1.7.0_80/java/lang/Long.java,Java,,349,68,782,1199
/jdk1.7.0_80/java/lang/management/BufferPoolMXBean.java,Java,,7,6,80,93
/jdk1.7.0_80/java/lang/management/ClassLoadingMXBean.java,Java,,8,8,98,114
/jdk1.7.0_80/java/lang/management/CompilationMXBean.java,Java,,6,4,91,101
/jdk1.7.0_80/java/lang/management/GarbageCollectorMXBean.java,Java,,5,5,84,94
/jdk1.7.0_80/java/lang/management/LockInfo.java,Java,,29,10,83,122
/jdk1.7.0_80/java/lang/management/ManagementFactory.java,Java,,206,38,584,828
/jdk1.7.0_80/java/lang/management/ManagementPermission.java,Java,,20,5,98,123
/jdk1.7.0_80/java/lang/management/MemoryManagerMXBean.java,Java,,6,4,78,88
/jdk1.7.0_80/java/lang/management/MemoryMXBean.java,Java,,10,9,285,304
/jdk1.7.0_80/java/lang/management/MemoryNotificationInfo.java,Java,,50,13,193,256
/jdk1.7.0_80/java/lang/management/MemoryPoolMXBean.java,Java,,21,19,603,643
/jdk1.7.0_80/java/lang/management/MemoryType.java,Java,,13,8,52,73
/jdk1.7.0_80/java/lang/management/MemoryUsage.java,Java,,80,15,208,303
/jdk1.7.0_80/java/lang/management/MonitorInfo.java,Java,,47,10,102,159
/jdk1.7.0_80/java/lang/management/OperatingSystemMXBean.java,Java,,8,6,128,142
/jdk1.7.0_80/java/lang/management/PlatformComponent.java,Java,,319,45,103,467
/jdk1.7.0_80/java/lang/management/PlatformLoggingMXBean.java,Java,,7,6,125,138
/jdk1.7.0_80/java/lang/management/PlatformManagedObject.java,Java,,5,3,53,61
/jdk1.7.0_80/java/lang/management/RuntimeMXBean.java,Java,,19,18,302,339
/jdk1.7.0_80/java/lang/management/ThreadInfo.java,Java,,279,36,524,839
/jdk1.7.0_80/java/lang/management/ThreadMXBean.java,Java,,31,30,745,806
/jdk1.7.0_80/java/lang/Math.java,Java,,204,66,1256,1526
/jdk1.7.0_80/java/lang/NegativeArraySizeException.java,Java,,11,4,40,55
/jdk1.7.0_80/java/lang/NoClassDefFoundError.java,Java,,11,4,46,61
/jdk1.7.0_80/java/lang/NoSuchFieldError.java,Java,,11,4,44,59
/jdk1.7.0_80/java/lang/NoSuchFieldException.java,Java,,10,4,38,52
/jdk1.7.0_80/java/lang/NoSuchMethodError.java,Java,,11,4,45,60
/jdk1.7.0_80/java/lang/NoSuchMethodException.java,Java,,11,4,38,53
/jdk1.7.0_80/java/lang/NullPointerException.java,Java,,11,4,57,72
/jdk1.7.0_80/java/lang/Number.java,Java,,14,8,90,112
/jdk1.7.0_80/java/lang/NumberFormatException.java,Java,,14,5,48,67
/jdk1.7.0_80/java/lang/Object.java,Java,,36,17,501,554
/jdk1.7.0_80/java/lang/OutOfMemoryError.java,Java,,10,4,46,60
/jdk1.7.0_80/java/lang/Override.java,Java,,6,3,43,52
/jdk1.7.0_80/java/lang/package-info.java,Java,,1,1,69,71
/jdk1.7.0_80/java/lang/Package.java,Java,,309,40,266,615
/jdk1.7.0_80/java/lang/Process.java,Java,,10,8,159,177
/jdk1.7.0_80/java/lang/ProcessBuilder.java,Java,,262,57,735,1054
/jdk1.7.0_80/java/lang/ProcessEnvironment.java,Java,,214,40,92,346
/jdk1.7.0_80/java/lang/ProcessImpl.java,Java,,303,59,135,497
/jdk1.7.0_80/java/lang/Readable.java,Java,,5,6,44,55
/jdk1.7.0_80/java/lang/ref/Finalizer.java,Java,,157,21,51,229
/jdk1.7.0_80/java/lang/ref/FinalReference.java,Java,,6,6,25,37
/jdk1.7.0_80/java/lang/ref/PhantomReference.java,Java,,9,7,67,83
/jdk1.7.0_80/java/lang/ref/Reference.java,Java,,71,33,134,238
/jdk1.7.0_80/java/lang/ref/ReferenceQueue.java,Java,,72,13,69,154
/jdk1.7.0_80/java/lang/ref/SoftReference.java,Java,,19,10,89,118
/jdk1.7.0_80/java/lang/ref/WeakReference.java,Java,,9,7,56,72
/jdk1.7.0_80/java/lang/reflect/AccessibleObject.java,Java,,89,23,163,275
/jdk1.7.0_80/java/lang/reflect/AnnotatedElement.java,Java,,8,6,98,112
/jdk1.7.0_80/java/lang/reflect/Array.java,Java,,56,29,400,485
/jdk1.7.0_80/java/lang/reflect/Constructor.java,Java,,305,43,336,684
/jdk1.7.0_80/java/lang/reflect/Field.java,Java,,380,53,702,1135
/jdk1.7.0_80/java/lang/reflect/GenericArrayType.java,Java,,4,2,46,52
/jdk1.7.0_80/java/lang/reflect/GenericDeclaration.java,Java,,4,2,43,49
/jdk1.7.0_80/java/lang/reflect/GenericSignatureFormatError.java,Java,,4,3,31,38
/jdk1.7.0_80/java/lang/reflect/InvocationHandler.java,Java,,5,3,87,95
/jdk1.7.0_80/java/lang/reflect/InvocationTargetException.java,Java,,22,8,81,111
/jdk1.7.0_80/java/lang/reflect/MalformedParameterizedTypeException.java,Java,,4,3,32,39
/jdk1.7.0_80/java/lang/reflect/Member.java,Java,,10,8,75,93
/jdk1.7.0_80/java/lang/reflect/Method.java,Java,,321,44,417,782
/jdk1.7.0_80/java/lang/reflect/Modifier.java,Java,,120,46,286,452
/jdk1.7.0_80/java/lang/reflect/package-info.java,Java,,1,1,47,49
/jdk1.7.0_80/java/lang/reflect/ParameterizedType.java,Java,,6,5,84,95
/jdk1.7.0_80/java/lang/reflect/Proxy.java,Java,,326,54,451,831
/jdk1.7.0_80/java/lang/reflect/ReflectAccess.java,Java,,98,17,31,146
/jdk1.7.0_80/java/lang/reflect/ReflectPermission.java,Java,,11,6,84,101
/jdk1.7.0_80/java/lang/reflect/Type.java,Java,,3,3,31,37
/jdk1.7.0_80/java/lang/reflect/TypeVariable.java,Java,,6,4,79,89
/jdk1.7.0_80/java/lang/reflect/UndeclaredThrowableException.java,Java,,21,7,91,119
/jdk1.7.0_80/java/lang/reflect/WeakCache.java,Java,,195,45,153,393
/jdk1.7.0_80/java/lang/reflect/WildcardType.java,Java,,5,3,75,83
/jdk1.7.0_80/java/lang/ReflectiveOperationException.java,Java,,16,6,69,91
/jdk1.7.0_80/java/lang/Runnable.java,Java,,5,2,62,69
/jdk1.7.0_80/java/lang/Runtime.java,Java,,130,35,741,906
/jdk1.7.0_80/java/lang/RuntimeException.java,Java,,21,7,91,119
/jdk1.7.0_80/java/lang/RuntimePermission.java,Java,,16,9,363,388
/jdk1.7.0_80/java/lang/SafeVarargs.java,Java,,6,3,82,91
/jdk1.7.0_80/java/lang/SecurityException.java,Java,,16,6,62,84
/jdk1.7.0_80/java/lang/SecurityManager.java,Java,,370,66,1295,1731
/jdk1.7.0_80/java/lang/Short.java,Java,,98,32,338,468
/jdk1.7.0_80/java/lang/Shutdown.java,Java,,112,26,100,238
/jdk1.7.0_80/java/lang/StackOverflowError.java,Java,,11,4,40,55
/jdk1.7.0_80/java/lang/StackTraceElement.java,Java,,55,13,153,221
/jdk1.7.0_80/java/lang/StrictMath.java,Java,,197,71,1200,1468
/jdk1.7.0_80/java/lang/String.java,Java,,946,145,2007,3098
/jdk1.7.0_80/java/lang/StringBuffer.java,Java,,239,63,303,605
/jdk1.7.0_80/java/lang/StringBuilder.java,Java,,189,47,201,437
/jdk1.7.0_80/java/lang/StringCoding.java,Java,,302,31,71,404
/jdk1.7.0_80/java/lang/StringIndexOutOfBoundsException.java,Java,,14,5,52,71
/jdk1.7.0_80/java/lang/SuppressWarnings.java,Java,,8,3,53,64
/jdk1.7.0_80/java/lang/System.java,Java,,258,64,895,1217
/jdk1.7.0_80/java/lang/Terminator.java,Java,,25,11,40,76
/jdk1.7.0_80/java/lang/Thread.java,Java,,534,140,1384,2058
/jdk1.7.0_80/java/lang/ThreadDeath.java,Java,,4,3,44,51
/jdk1.7.0_80/java/lang/ThreadGroup.java,Java,,466,51,577,1094
/jdk1.7.0_80/java/lang/ThreadLocal.java,Java,,285,59,340,684
/jdk1.7.0_80/java/lang/Throwable.java,Java,,265,67,749,1081
/jdk1.7.0_80/java/lang/TypeNotPresentException.java,Java,,10,5,55,70
/jdk1.7.0_80/java/lang/UnknownError.java,Java,,11,4,40,55
/jdk1.7.0_80/java/lang/UnsatisfiedLinkError.java,Java,,11,4,41,56
/jdk1.7.0_80/java/lang/UnsupportedClassVersionError.java,Java,,11,4,41,56
/jdk1.7.0_80/java/lang/UnsupportedOperationException.java,Java,,15,6,73,94
/jdk1.7.0_80/java/lang/VerifyError.java,Java,,11,4,40,55
/jdk1.7.0_80/java/lang/VirtualMachineError.java,Java,,10,3,41,54
/jdk1.7.0_80/java/lang/Void.java,Java,,6,4,39,49
/jdk1.7.0_80/java/math/BigDecimal.java,Java,,1491,219,2145,3855
/jdk1.7.0_80/java/math/BigInteger.java,Java,,1614,382,1190,3186
/jdk1.7.0_80/java/math/BitSieve.java,Java,,84,20,108,212
/jdk1.7.0_80/java/math/MathContext.java,Java,,87,29,210,326
/jdk1.7.0_80/java/math/MutableBigInteger.java,Java,,901,179,397,1477
/jdk1.7.0_80/java/math/package-info.java,Java,,1,1,43,45
/jdk1.7.0_80/java/math/RoundingMode.java,Java,,37,22,290,349
/jdk1.7.0_80/java/math/SignedMutableBigInteger.java,Java,,42,18,75,135
/jdk1.7.0_80/java/net/AbstractPlainDatagramSocketImpl.java,Java,,203,42,124,369
/jdk1.7.0_80/java/net/AbstractPlainSocketImpl.java,Java,,475,59,184,718
/jdk1.7.0_80/java/net/Authenticator.java,Java,,152,28,245,425
/jdk1.7.0_80/java/net/BindException.java,Java,,8,5,41,54
/jdk1.7.0_80/java/net/CacheRequest.java,Java,,7,5,51,63
/jdk1.7.0_80/java/net/CacheResponse.java,Java,,9,5,50,64
/jdk1.7.0_80/java/net/ConnectException.java,Java,,8,4,42,54
/jdk1.7.0_80/java/net/ContentHandler.java,Java,,14,6,90,110
/jdk1.7.0_80/java/net/ContentHandlerFactory.java,Java,,4,2,48,54
/jdk1.7.0_80/java/net/CookieHandler.java,Java,,28,7,115,150
/jdk1.7.0_80/java/net/CookieManager.java,Java,,216,45,185,446
/jdk1.7.0_80/java/net/CookiePolicy.java,Java,,19,6,51,76
/jdk1.7.0_80/java/net/CookieStore.java,Java,,11,13,103,127
/jdk1.7.0_80/java/net/DatagramPacket.java,Java,,107,23,255,385
/jdk1.7.0_80/java/net/DatagramSocket.java,Java,,477,62,774,1313
/jdk1.7.0_80/java/net/DatagramSocketImpl.java,Java,,95,30,189,314
/jdk1.7.0_80/java/net/DatagramSocketImplFactory.java,Java,,5,2,39,46
/jdk1.7.0_80/java/net/DefaultDatagramSocketImplFactory.java,Java,,70,13,54,137
/jdk1.7.0_80/java/net/DefaultInterface.java,Java,,6,4,31,41
/jdk1.7.0_80/java/net/DualStackPlainDatagramSocketImpl.java,Java,,174,64,53,291
/jdk1.7.0_80/java/net/DualStackPlainSocketImpl.java,Java,,192,61,47,300
/jdk1.7.0_80/java/net/FileNameMap.java,Java,,4,3,37,44
/jdk1.7.0_80/java/net/HttpCookie.java,Java,,477,191,580,1248
/jdk1.7.0_80/java/net/HttpRetryException.java,Java,,26,9,64,99
/jdk1.7.0_80/java/net/HttpURLConnection.java,Java,,201,84,519,804
/jdk1.7.0_80/java/net/IDN.java,Java,,194,59,213,466
/jdk1.7.0_80/java/net/Inet4Address.java,Java,,117,29,235,381
/jdk1.7.0_80/java/net/Inet4AddressImpl.java,Java,,38,4,32,74
/jdk1.7.0_80/java/net/Inet6Address.java,Java,,433,94,397,924
/jdk1.7.0_80/java/net/Inet6AddressImpl.java,Java,,60,6,42,108
/jdk1.7.0_80/java/net/InetAddress.java,Java,,713,154,753,1620
/jdk1.7.0_80/java/net/InetAddressImpl.java,Java,,12,3,33,48
/jdk1.7.0_80/java/net/InetSocketAddress.java,Java,,192,35,192,419
/jdk1.7.0_80/java/net/InMemoryCookieStore.java,Java,,236,46,113,395
/jdk1.7.0_80/java/net/InterfaceAddress.java,Java,,36,10,88,134
/jdk1.7.0_80/java/net/JarURLConnection.java,Java,,57,19,237,313
/jdk1.7.0_80/java/net/MalformedURLException.java,Java,,10,5,41,56
/jdk1.7.0_80/java/net/MulticastSocket.java,Java,,226,51,428,705
/jdk1.7.0_80/java/net/NetPermission.java,Java,,16,8,181,205
/jdk1.7.0_80/java/net/NetUtil.java,Java,,30,10,34,74
/jdk1.7.0_80/java/net/NetworkInterface.java,Java,,256,60,255,571
/jdk1.7.0_80/java/net/NoRouteToHostException.java,Java,,8,4,42,54
/jdk1.7.0_80/java/net/PasswordAuthentication.java,Java,,15,8,58,81
/jdk1.7.0_80/java/net/PlainSocketImpl.java,Java,,221,66,58,345
/jdk1.7.0_80/java/net/PortUnreachableException.java,Java,,8,5,39,52
/jdk1.7.0_80/java/net/ProtocolException.java,Java,,11,5,40,56
/jdk1.7.0_80/java/net/ProtocolFamily.java,Java,,4,3,32,39
/jdk1.7.0_80/java/net/Proxy.java,Java,,49,12,110,171
/jdk1.7.0_80/java/net/ProxySelector.java,Java,,33,8,125,166
/jdk1.7.0_80/java/net/ResponseCache.java,Java,,26,8,129,163
/jdk1.7.0_80/java/net/SdpSocketImpl.java,Java,,17,5,27,49
/jdk1.7.0_80/java/net/SecureCacheResponse.java,Java,,14,7,87,108
/jdk1.7.0_80/java/net/ServerSocket.java,Java,,292,40,569,901
/jdk1.7.0_80/java/net/Socket.java,Java,,561,82,1032,1675
/jdk1.7.0_80/java/net/SocketAddress.java,Java,,3,2,37,42
/jdk1.7.0_80/java/net/SocketException.java,Java,,11,5,39,55
/jdk1.7.0_80/java/net/SocketImpl.java,Java,,110,35,252,397
/jdk1.7.0_80/java/net/SocketImplFactory.java,Java,,5,2,41,48
/jdk1.7.0_80/java/net/SocketInputStream.java,Java,,139,25,114,278
/jdk1.7.0_80/java/net/SocketOption.java,Java,,5,5,45,55
/jdk1.7.0_80/java/net/SocketOptions.java,Java,,20,28,281,329
/jdk1.7.0_80/java/net/SocketOutputStream.java,Java,,77,18,94,189
/jdk1.7.0_80/java/net/SocketPermission.java,Java,,753,188,539,1480
/jdk1.7.0_80/java/net/SocketSecrets.java,Java,,32,12,26,70
/jdk1.7.0_80/java/net/SocketTimeoutException.java,Java,,8,5,37,50
/jdk1.7.0_80/java/net/SocksConsts.java,Java,,25,6,27,58
/jdk1.7.0_80/java/net/SocksSocketImpl.java,Java,,836,44,210,1090
/jdk1.7.0_80/java/net/StandardProtocolFamily.java,Java,,5,5,35,45
/jdk1.7.0_80/java/net/StandardSocketOptions.java,Java,,37,22,308,367
/jdk1.7.0_80/java/net/TwoStacksPlainDatagramSocketImpl.java,Java,,110,41,58,209
/jdk1.7.0_80/java/net/TwoStacksPlainSocketImpl.java,Java,,128,31,84,243
/jdk1.7.0_80/java/net/UnknownHostException.java,Java,,11,5,40,56
/jdk1.7.0_80/java/net/UnknownServiceException.java,Java,,10,5,43,58
/jdk1.7.0_80/java/net/URI.java,Java,,1523,282,1721,3526
/jdk1.7.0_80/java/net/URISyntaxException.java,Java,,40,12,83,135
/jdk1.7.0_80/java/net/URL.java,Java,,461,107,772,1340
/jdk1.7.0_80/java/net/URLClassLoader.java,Java,,431,49,311,791
/jdk1.7.0_80/java/net/URLConnection.java,Java,,586,150,1061,1797
/jdk1.7.0_80/java/net/URLDecoder.java,Java,,67,20,120,207
/jdk1.7.0_80/java/net/URLEncoder.java,Java,,110,19,164,293
/jdk1.7.0_80/java/net/URLStreamHandler.java,Java,,303,42,245,590
/jdk1.7.0_80/java/net/URLStreamHandlerFactory.java,Java,,4,2,45,51
/jdk1.7.0_80/java/nio/Bits.java,Java,,583,141,87,811
/jdk1.7.0_80/java/nio/Buffer.java,Java,,134,37,391,562
/jdk1.7.0_80/java/nio/BufferOverflowException.java,Java,,7,8,36,51
/jdk1.7.0_80/java/nio/BufferUnderflowException.java,Java,,7,8,36,51
/jdk1.7.0_80/java/nio/ByteBuffer.java,Java,,192,502,1344,2038
/jdk1.7.0_80/java/nio/ByteBufferAsCharBufferB.java,Java,,124,68,27,219
/jdk1.7.0_80/java/nio/ByteBufferAsCharBufferL.java,Java,,124,68,27,219
/jdk1.7.0_80/java/nio/ByteBufferAsCharBufferRB.java,Java,,83,110,26,219
/jdk1.7.0_80/java/nio/ByteBufferAsCharBufferRL.java,Java,,83,110,26,219
/jdk1.7.0_80/java/nio/ByteBufferAsDoubleBufferB.java,Java,,93,100,26,219
/jdk1.7.0_80/java/nio/ByteBufferAsDoubleBufferL.java,Java,,93,100,26,219
/jdk1.7.0_80/java/nio/ByteBufferAsDoubleBufferRB.java,Java,,52,142,25,219
/jdk1.7.0_80/java/nio/ByteBufferAsDoubleBufferRL.java,Java,,52,142,25,219
/jdk1.7.0_80/java/nio/ByteBufferAsFloatBufferB.java,Java,,93,100,26,219
/jdk1.7.0_80/java/nio/ByteBufferAsFloatBufferL.java,Java,,93,100,26,219
/jdk1.7.0_80/java/nio/ByteBufferAsFloatBufferRB.java,Java,,52,142,25,219
/jdk1.7.0_80/java/nio/ByteBufferAsFloatBufferRL.java,Java,,52,142,25,219
/jdk1.7.0_80/java/nio/ByteBufferAsIntBufferB.java,Java,,93,100,26,219
/jdk1.7.0_80/java/nio/ByteBufferAsIntBufferL.java,Java,,93,100,26,219
/jdk1.7.0_80/java/nio/ByteBufferAsIntBufferRB.java,Java,,52,142,25,219
/jdk1.7.0_80/java/nio/ByteBufferAsIntBufferRL.java,Java,,52,142,25,219
/jdk1.7.0_80/java/nio/ByteBufferAsLongBufferB.java,Java,,93,100,26,219
/jdk1.7.0_80/java/nio/ByteBufferAsLongBufferL.java,Java,,93,100,26,219
/jdk1.7.0_80/java/nio/ByteBufferAsLongBufferRB.java,Java,,52,142,25,219
/jdk1.7.0_80/java/nio/ByteBufferAsLongBufferRL.java,Java,,52,142,25,219
/jdk1.7.0_80/java/nio/ByteBufferAsShortBufferB.java,Java,,93,100,26,219
/jdk1.7.0_80/java/nio/ByteBufferAsShortBufferL.java,Java,,93,100,26,219
/jdk1.7.0_80/java/nio/ByteBufferAsShortBufferRB.java,Java,,52,142,25,219
/jdk1.7.0_80/java/nio/ByteBufferAsShortBufferRL.java,Java,,52,142,25,219
/jdk1.7.0_80/java/nio/ByteOrder.java,Java,,17,11,61,89
/jdk1.7.0_80/java/nio/channels/AcceptPendingException.java,Java,,7,8,36,51
/jdk1.7.0_80/java/nio/channels/AlreadyBoundException.java,Java,,7,8,36,51
/jdk1.7.0_80/java/nio/channels/AlreadyConnectedException.java,Java,,7,8,36,51
/jdk1.7.0_80/java/nio/channels/AsynchronousByteChannel.java,Java,,15,7,187,209
/jdk1.7.0_80/java/nio/channels/AsynchronousChannel.java,Java,,9,4,104,117
/jdk1.7.0_80/java/nio/channels/AsynchronousChannelGroup.java,Java,,41,14,289,344
/jdk1.7.0_80/java/nio/channels/AsynchronousCloseException.java,Java,,7,8,37,52
/jdk1.7.0_80/java/nio/channels/AsynchronousFileChannel.java,Java,,66,20,684,770
/jdk1.7.0_80/java/nio/channels/AsynchronousServerSocketChannel.java,Java,,41,13,246,300
/jdk1.7.0_80/java/nio/channels/AsynchronousSocketChannel.java,Java,,86,28,534,648
/jdk1.7.0_80/java/nio/channels/ByteChannel.java,Java,,6,6,33,45
/jdk1.7.0_80/java/nio/channels/CancelledKeyException.java,Java,,7,8,36,51
/jdk1.7.0_80/java/nio/channels/Channel.java,Java,,7,8,69,84
/jdk1.7.0_80/java/nio/channels/Channels.java,Java,,318,55,242,615
/jdk1.7.0_80/java/nio/channels/ClosedByInterruptException.java,Java,,7,8,38,53
/jdk1.7.0_80/java/nio/channels/ClosedChannelException.java,Java,,7,8,39,54
/jdk1.7.0_80/java/nio/channels/ClosedSelectorException.java,Java,,7,8,36,51
/jdk1.7.0_80/java/nio/channels/CompletionHandler.java,Java,,5,5,56,66
/jdk1.7.0_80/java/nio/channels/ConnectionPendingException.java,Java,,7,8,37,52
/jdk1.7.0_80/java/nio/channels/DatagramChannel.java,Java,,52,28,488,568
/jdk1.7.0_80/java/nio/channels/FileChannel.java,Java,,86,43,1028,1157
/jdk1.7.0_80/java/nio/channels/FileLock.java,Java,,71,18,237,326
/jdk1.7.0_80/java/nio/channels/FileLockInterruptionException.java,Java,,7,8,37,52
/jdk1.7.0_80/java/nio/channels/GatheringByteChannel.java,Java,,10,9,147,166
/jdk1.7.0_80/java/nio/channels/IllegalBlockingModeException.java,Java,,7,8,36,51
/jdk1.7.0_80/java/nio/channels/IllegalChannelGroupException.java,Java,,7,8,36,51
/jdk1.7.0_80/java/nio/channels/IllegalSelectorException.java,Java,,7,8,37,52
/jdk1.7.0_80/java/nio/channels/InterruptedByTimeoutException.java,Java,,7,8,36,51
/jdk1.7.0_80/java/nio/channels/InterruptibleChannel.java,Java,,7,8,67,82
/jdk1.7.0_80/java/nio/channels/MembershipKey.java,Java,,16,12,149,177
/jdk1.7.0_80/java/nio/channels/MulticastChannel.java,Java,,16,6,208,230
/jdk1.7.0_80/java/nio/channels/NetworkChannel.java,Java,,14,8,138,160
/jdk1.7.0_80/java/nio/channels/NoConnectionPendingException.java,Java,,7,8,37,52
/jdk1.7.0_80/java/nio/channels/NonReadableChannelException.java,Java,,7,8,36,51
/jdk1.7.0_80/java/nio/channels/NonWritableChannelException.java,Java,,7,8,36,51
/jdk1.7.0_80/java/nio/channels/NotYetBoundException.java,Java,,7,8,36,51
/jdk1.7.0_80/java/nio/channels/NotYetConnectedException.java,Java,,7,8,36,51
/jdk1.7.0_80/java/nio/channels/OverlappingFileLockException.java,Java,,7,8,38,53
/jdk1.7.0_80/java/nio/channels/package-info.java,Java,,1,2,287,290
/jdk1.7.0_80/java/nio/channels/Pipe.java,Java,,33,16,104,153
/jdk1.7.0_80/java/nio/channels/ReadableByteChannel.java,Java,,6,7,95,108
/jdk1.7.0_80/java/nio/channels/ReadPendingException.java,Java,,7,8,36,51
/jdk1.7.0_80/java/nio/channels/ScatteringByteChannel.java,Java,,10,8,144,162
/jdk1.7.0_80/java/nio/channels/SeekableByteChannel.java,Java,,15,9,144,168
/jdk1.7.0_80/java/nio/channels/SelectableChannel.java,Java,,25,17,300,342
/jdk1.7.0_80/java/nio/channels/SelectionKey.java,Java,,40,34,327,401
/jdk1.7.0_80/java/nio/channels/Selector.java,Java,,21,17,358,396
/jdk1.7.0_80/java/nio/channels/ServerSocketChannel.java,Java,,32,15,221,268
/jdk1.7.0_80/java/nio/channels/ShutdownChannelGroupException.java,Java,,7,8,37,52
/jdk1.7.0_80/java/nio/channels/SocketChannel.java,Java,,67,28,401,496
/jdk1.7.0_80/java/nio/channels/spi/AbstractInterruptibleChannel.java,Java,,65,18,131,214
/jdk1.7.0_80/java/nio/channels/spi/AbstractSelectableChannel.java,Java,,142,34,132,308
/jdk1.7.0_80/java/nio/channels/spi/AbstractSelectionKey.java,Java,,22,10,45,77
/jdk1.7.0_80/java/nio/channels/spi/AbstractSelector.java,Java,,60,23,148,231
/jdk1.7.0_80/java/nio/channels/spi/AsynchronousChannelProvider.java,Java,,83,14,144,241
/jdk1.7.0_80/java/nio/channels/spi/SelectorProvider.java,Java,,89,19,194,302
/jdk1.7.0_80/java/nio/channels/UnresolvedAddressException.java,Java,,7,8,36,51
/jdk1.7.0_80/java/nio/channels/UnsupportedAddressTypeException.java,Java,,7,8,36,51
/jdk1.7.0_80/java/nio/channels/WritableByteChannel.java,Java,,8,7,90,105
/jdk1.7.0_80/java/nio/channels/WritePendingException.java,Java,,7,8,36,51
/jdk1.7.0_80/java/nio/CharBuffer.java,Java,,194,191,1066,1451
/jdk1.7.0_80/java/nio/charset/CharacterCodingException.java,Java,,7,8,36,51
/jdk1.7.0_80/java/nio/charset/Charset.java,Java,,302,60,557,919
/jdk1.7.0_80/java/nio/charset/CharsetDecoder.java,Java,,218,187,567,972
/jdk1.7.0_80/java/nio/charset/CharsetEncoder.java,Java,,263,141,568,972
/jdk1.7.0_80/java/nio/charset/CoderMalfunctionError.java,Java,,9,7,38,54
/jdk1.7.0_80/java/nio/charset/CoderResult.java,Java,,97,29,158,284
/jdk1.7.0_80/java/nio/charset/CodingErrorAction.java,Java,,16,11,57,84
/jdk1.7.0_80/java/nio/charset/IllegalCharsetNameException.java,Java,,14,10,44,68
/jdk1.7.0_80/java/nio/charset/MalformedInputException.java,Java,,16,10,31,57
/jdk1.7.0_80/java/nio/charset/spi/CharsetProvider.java,Java,,12,9,89,110
/jdk1.7.0_80/java/nio/charset/StandardCharsets.java,Java,,12,2,52,66
/jdk1.7.0_80/java/nio/charset/UnmappableCharacterException.java,Java,,16,10,31,57
/jdk1.7.0_80/java/nio/charset/UnsupportedCharsetException.java,Java,,14,10,44,68
/jdk1.7.0_80/java/nio/DirectByteBuffer.java,Java,,623,353,47,1023
/jdk1.7.0_80/java/nio/DirectByteBufferR.java,Java,,343,649,31,1023
/jdk1.7.0_80/java/nio/DirectCharBufferRS.java,Java,,93,363,28,484
/jdk1.7.0_80/java/nio/DirectCharBufferRU.java,Java,,93,363,28,484
/jdk1.7.0_80/java/nio/DirectCharBufferS.java,Java,,198,249,37,484
/jdk1.7.0_80/java/nio/DirectCharBufferU.java,Java,,198,249,37,484
/jdk1.7.0_80/java/nio/DirectDoubleBufferRS.java,Java,,62,395,27,484
/jdk1.7.0_80/java/nio/DirectDoubleBufferRU.java,Java,,62,395,27,484
/jdk1.7.0_80/java/nio/DirectDoubleBufferS.java,Java,,167,281,36,484
/jdk1.7.0_80/java/nio/DirectDoubleBufferU.java,Java,,167,281,36,484
/jdk1.7.0_80/java/nio/DirectFloatBufferRS.java,Java,,62,395,27,484
/jdk1.7.0_80/java/nio/DirectFloatBufferRU.java,Java,,62,395,27,484
/jdk1.7.0_80/java/nio/DirectFloatBufferS.java,Java,,167,281,36,484
/jdk1.7.0_80/java/nio/DirectFloatBufferU.java,Java,,167,281,36,484
/jdk1.7.0_80/java/nio/DirectIntBufferRS.java,Java,,62,395,27,484
/jdk1.7.0_80/java/nio/DirectIntBufferRU.java,Java,,62,395,27,484
/jdk1.7.0_80/java/nio/DirectIntBufferS.java,Java,,167,281,36,484
/jdk1.7.0_80/java/nio/DirectIntBufferU.java,Java,,167,281,36,484
/jdk1.7.0_80/java/nio/DirectLongBufferRS.java,Java,,62,395,27,484
/jdk1.7.0_80/java/nio/DirectLongBufferRU.java,Java,,62,395,27,484
/jdk1.7.0_80/java/nio/DirectLongBufferS.java,Java,,167,281,36,484
/jdk1.7.0_80/java/nio/DirectLongBufferU.java,Java,,167,281,36,484
/jdk1.7.0_80/java/nio/DirectShortBufferRS.java,Java,,62,395,27,484
/jdk1.7.0_80/java/nio/DirectShortBufferRU.java,Java,,62,395,27,484
/jdk1.7.0_80/java/nio/DirectShortBufferS.java,Java,,167,281,36,484
/jdk1.7.0_80/java/nio/DirectShortBufferU.java,Java,,167,281,36,484
/jdk1.7.0_80/java/nio/DoubleBuffer.java,Java,,148,513,790,1451
/jdk1.7.0_80/java/nio/file/AccessDeniedException.java,Java,,12,5,51,68
/jdk1.7.0_80/java/nio/file/AccessMode.java,Java,,6,3,38,47
/jdk1.7.0_80/java/nio/file/AtomicMoveNotSupportedException.java,Java,,12,4,40,56
/jdk1.7.0_80/java/nio/file/attribute/AclEntry.java,Java,,167,31,195,393
/jdk1.7.0_80/java/nio/file/attribute/AclEntryFlag.java,Java,,7,7,51,65
/jdk1.7.0_80/java/nio/file/attribute/AclEntryPermission.java,Java,,20,20,90,130
/jdk1.7.0_80/java/nio/file/attribute/AclEntryType.java,Java,,7,6,43,56
/jdk1.7.0_80/java/nio/file/attribute/AclFileAttributeView.java,Java,,12,6,191,209
/jdk1.7.0_80/java/nio/file/attribute/AttributeView.java,Java,,4,3,36,43
/jdk1.7.0_80/java/nio/file/attribute/BasicFileAttributes.java,Java,,12,12,120,144
/jdk1.7.0_80/java/nio/file/attribute/BasicFileAttributeView.java,Java,,12,6,159,177
/jdk1.7.0_80/java/nio/file/attribute/DosFileAttributes.java,Java,,9,6,69,84
/jdk1.7.0_80/java/nio/file/attribute/DosFileAttributeView.java,Java,,14,9,156,179
/jdk1.7.0_80/java/nio/file/attribute/FileAttribute.java,Java,,5,4,41,50
/jdk1.7.0_80/java/nio/file/attribute/FileAttributeView.java,Java,,5,3,34,42
/jdk1.7.0_80/java/nio/file/attribute/FileOwnerAttributeView.java,Java,,10,6,85,101
/jdk1.7.0_80/java/nio/file/attribute/FileStoreAttributeView.java,Java,,5,3,30,38
/jdk1.7.0_80/java/nio/file/attribute/FileTime.java,Java,,146,30,187,363
/jdk1.7.0_80/java/nio/file/attribute/GroupPrincipal.java,Java,,2,3,37,42
/jdk1.7.0_80/java/nio/file/attribute/package-info.java,Java,,1,2,107,110
/jdk1.7.0_80/java/nio/file/attribute/PosixFileAttributes.java,Java,,9,6,60,75
/jdk1.7.0_80/java/nio/file/attribute/PosixFileAttributeView.java,Java,,14,7,172,193
/jdk1.7.0_80/java/nio/file/attribute/PosixFilePermission.java,Java,,12,12,60,84
/jdk1.7.0_80/java/nio/file/attribute/PosixFilePermissions.java,Java,,78,9,93,180
/jdk1.7.0_80/java/nio/file/attribute/UserDefinedFileAttributeView.java,Java,,15,9,207,231
/jdk1.7.0_80/java/nio/file/attribute/UserPrincipal.java,Java,,3,4,47,54
/jdk1.7.0_80/java/nio/file/attribute/UserPrincipalLookupService.java,Java,,10,7,87,104
/jdk1.7.0_80/java/nio/file/attribute/UserPrincipalNotFoundException.java,Java,,15,7,42,64
/jdk1.7.0_80/java/nio/file/ClosedDirectoryStreamException.java,Java,,8,4,33,45
/jdk1.7.0_80/java/nio/file/ClosedFileSystemException.java,Java,,8,4,31,43
/jdk1.7.0_80/java/nio/file/ClosedWatchServiceException.java,Java,,8,4,31,43
/jdk1.7.0_80/java/nio/file/CopyMoveHelper.java,Java,,98,14,48,160
/jdk1.7.0_80/java/nio/file/CopyOption.java,Java,,3,3,39,45
/jdk1.7.0_80/java/nio/file/DirectoryIteratorException.java,Java,,26,7,54,87
/jdk1.7.0_80/java/nio/file/DirectoryNotEmptyException.java,Java,,9,4,36,49
/jdk1.7.0_80/java/nio/file/DirectoryStream.java,Java,,13,5,141,159
/jdk1.7.0_80/java/nio/file/FileAlreadyExistsException.java,Java,,12,5,46,63
/jdk1.7.0_80/java/nio/file/Files.java,Java,,606,96,2458,3160
/jdk1.7.0_80/java/nio/file/FileStore.java,Java,,18,15,186,219
/jdk1.7.0_80/java/nio/file/FileSystem.java,Java,,25,16,428,469
/jdk1.7.0_80/java/nio/file/FileSystemAlreadyExistsException.java,Java,,11,5,37,53
/jdk1.7.0_80/java/nio/file/FileSystemException.java,Java,,45,11,69,125
/jdk1.7.0_80/java/nio/file/FileSystemLoopException.java,Java,,9,4,37,50
/jdk1.7.0_80/java/nio/file/FileSystemNotFoundException.java,Java,,11,5,36,52
/jdk1.7.0_80/java/nio/file/FileSystems.java,Java,,107,22,276,405
/jdk1.7.0_80/java/nio/file/FileTreeWalker.java,Java,,159,23,66,248
/jdk1.7.0_80/java/nio/file/FileVisitOption.java,Java,,4,3,34,41
/jdk1.7.0_80/java/nio/file/FileVisitor.java,Java,,13,8,156,177
/jdk1.7.0_80/java/nio/file/FileVisitResult.java,Java,,7,3,52,62
/jdk1.7.0_80/java/nio/file/InvalidPathException.java,Java,,40,10,80,130
/jdk1.7.0_80/java/nio/file/LinkOption.java,Java,,4,3,36,43
/jdk1.7.0_80/java/nio/file/LinkPermission.java,Java,,21,6,80,107
/jdk1.7.0_80/java/nio/file/NoSuchFileException.java,Java,,12,5,46,63
/jdk1.7.0_80/java/nio/file/NotDirectoryException.java,Java,,9,4,36,49
/jdk1.7.0_80/java/nio/file/NotLinkException.java,Java,,12,5,46,63
/jdk1.7.0_80/java/nio/file/OpenOption.java,Java,,3,3,39,45
/jdk1.7.0_80/java/nio/file/package-info.java,Java,,1,1,115,117
/jdk1.7.0_80/java/nio/file/Path.java,Java,,47,36,718,801
/jdk1.7.0_80/java/nio/file/PathMatcher.java,Java,,4,3,42,49
/jdk1.7.0_80/java/nio/file/Paths.java,Java,,22,9,118,149
/jdk1.7.0_80/java/nio/file/ProviderMismatchException.java,Java,,11,4,38,53
/jdk1.7.0_80/java/nio/file/ProviderNotFoundException.java,Java,,11,5,36,52
/jdk1.7.0_80/java/nio/file/ReadOnlyFileSystemException.java,Java,,8,4,31,43
/jdk1.7.0_80/java/nio/file/SecureDirectoryStream.java,Java,,23,9,274,306
/jdk1.7.0_80/java/nio/file/SimpleFileVisitor.java,Java,,40,8,64,112
/jdk1.7.0_80/java/nio/file/spi/FileSystemProvider.java,Java,,170,44,879,1093
/jdk1.7.0_80/java/nio/file/spi/FileTypeDetector.java,Java,,17,7,82,106
/jdk1.7.0_80/java/nio/file/spi/package-info.java,Java,,1,2,36,39
/jdk1.7.0_80/java/nio/file/StandardCopyOption.java,Java,,6,3,38,47
/jdk1.7.0_80/java/nio/file/StandardOpenOption.java,Java,,13,12,100,125
/jdk1.7.0_80/java/nio/file/StandardWatchEventKinds.java,Java,,23,8,63,94
/jdk1.7.0_80/java/nio/file/TempFileHelper.java,Java,,109,14,52,175
/jdk1.7.0_80/java/nio/file/Watchable.java,Java,,10,7,110,127
/jdk1.7.0_80/java/nio/file/WatchEvent.java,Java,,13,9,89,111
/jdk1.7.0_80/java/nio/file/WatchKey.java,Java,,9,9,132,150
/jdk1.7.0_80/java/nio/file/WatchService.java,Java,,14,8,152,174
/jdk1.7.0_80/java/nio/FloatBuffer.java,Java,,148,513,790,1451
/jdk1.7.0_80/java/nio/HeapByteBuffer.java,Java,,302,232,61,595
/jdk1.7.0_80/java/nio/HeapByteBufferR.java,Java,,201,345,49,595
/jdk1.7.0_80/java/nio/HeapCharBuffer.java,Java,,133,406,56,595
/jdk1.7.0_80/java/nio/HeapCharBufferR.java,Java,,80,471,44,595
/jdk1.7.0_80/java/nio/HeapDoubleBuffer.java,Java,,113,427,55,595
/jdk1.7.0_80/java/nio/HeapDoubleBufferR.java,Java,,60,492,43,595
/jdk1.7.0_80/java/nio/HeapFloatBuffer.java,Java,,113,427,55,595
/jdk1.7.0_80/java/nio/HeapFloatBufferR.java,Java,,60,492,43,595
/jdk1.7.0_80/java/nio/HeapIntBuffer.java,Java,,113,427,55,595
/jdk1.7.0_80/java/nio/HeapIntBufferR.java,Java,,60,492,43,595
/jdk1.7.0_80/java/nio/HeapLongBuffer.java,Java,,113,427,55,595
/jdk1.7.0_80/java/nio/HeapLongBufferR.java,Java,,60,492,43,595
/jdk1.7.0_80/java/nio/HeapShortBuffer.java,Java,,113,427,55,595
/jdk1.7.0_80/java/nio/HeapShortBufferR.java,Java,,60,492,43,595
/jdk1.7.0_80/java/nio/IntBuffer.java,Java,,145,516,790,1451
/jdk1.7.0_80/java/nio/InvalidMarkException.java,Java,,7,8,36,51
/jdk1.7.0_80/java/nio/LongBuffer.java,Java,,145,516,790,1451
/jdk1.7.0_80/java/nio/MappedByteBuffer.java,Java,,73,20,118,211
/jdk1.7.0_80/java/nio/ReadOnlyBufferException.java,Java,,7,8,36,51
/jdk1.7.0_80/java/nio/ShortBuffer.java,Java,,145,516,790,1451
/jdk1.7.0_80/java/nio/StringCharBuffer.java,Java,,77,21,26,124
/jdk1.7.0_80/java/rmi/AccessException.java,Java,,10,5,55,70
/jdk1.7.0_80/java/rmi/activation/Activatable.java,Java,,134,22,399,555
/jdk1.7.0_80/java/rmi/activation/ActivateFailedException.java,Java,,10,5,47,62
/jdk1.7.0_80/java/rmi/activation/ActivationDesc.java,Java,,98,22,219,339
/jdk1.7.0_80/java/rmi/activation/ActivationException.java,Java,,28,9,81,118
/jdk1.7.0_80/java/rmi/activation/ActivationGroup.java,Java,,175,31,322,528
/jdk1.7.0_80/java/rmi/activation/ActivationGroupDesc.java,Java,,122,31,217,370
/jdk1.7.0_80/java/rmi/activation/ActivationGroupID.java,Java,,26,9,80,115
/jdk1.7.0_80/java/rmi/activation/ActivationID.java,Java,,94,16,180,290
/jdk1.7.0_80/java/rmi/activation/ActivationInstantiator.java,Java,,9,4,63,76
/jdk1.7.0_80/java/rmi/activation/ActivationMonitor.java,Java,,16,7,85,108
/jdk1.7.0_80/java/rmi/activation/ActivationSystem.java,Java,,32,14,183,229
/jdk1.7.0_80/java/rmi/activation/Activator.java,Java,,10,4,100,114
/jdk1.7.0_80/java/rmi/activation/UnknownGroupException.java,Java,,7,4,49,60
/jdk1.7.0_80/java/rmi/activation/UnknownObjectException.java,Java,,7,4,51,62
/jdk1.7.0_80/java/rmi/AlreadyBoundException.java,Java,,10,4,48,62
/jdk1.7.0_80/java/rmi/ConnectException.java,Java,,10,5,47,62
/jdk1.7.0_80/java/rmi/ConnectIOException.java,Java,,10,6,48,64
/jdk1.7.0_80/java/rmi/dgc/DGC.java,Java,,9,4,102,115
/jdk1.7.0_80/java/rmi/dgc/Lease.java,Java,,19,6,52,77
/jdk1.7.0_80/java/rmi/dgc/VMID.java,Java,,57,12,65,134
/jdk1.7.0_80/java/rmi/MarshalException.java,Java,,10,5,56,71
/jdk1.7.0_80/java/rmi/MarshalledObject.java,Java,,111,28,177,316
/jdk1.7.0_80/java/rmi/Naming.java,Java,,171,22,163,356
/jdk1.7.0_80/java/rmi/NoSuchObjectException.java,Java,,7,4,51,62
/jdk1.7.0_80/java/rmi/NotBoundException.java,Java,,10,4,50,64
/jdk1.7.0_80/java/rmi/registry/LocateRegistry.java,Java,,68,15,158,241
/jdk1.7.0_80/java/rmi/registry/Registry.java,Java,,18,8,166,192
/jdk1.7.0_80/java/rmi/registry/RegistryHandler.java,Java,,11,5,57,73
/jdk1.7.0_80/java/rmi/Remote.java,Java,,2,2,46,50
/jdk1.7.0_80/java/rmi/RemoteException.java,Java,,28,9,85,122
/jdk1.7.0_80/java/rmi/RMISecurityException.java,Java,,13,4,50,67
/jdk1.7.0_80/java/rmi/RMISecurityManager.java,Java,,6,4,54,64
/jdk1.7.0_80/java/rmi/server/ExportException.java,Java,,10,6,52,68
/jdk1.7.0_80/java/rmi/server/LoaderHandler.java,Java,,15,7,73,95
/jdk1.7.0_80/java/rmi/server/LogStream.java,Java,,123,27,122,272
/jdk1.7.0_80/java/rmi/server/ObjID.java,Java,,68,18,162,248
/jdk1.7.0_80/java/rmi/server/Operation.java,Java,,17,5,51,73
/jdk1.7.0_80/java/rmi/server/RemoteCall.java,Java,,24,10,98,132
/jdk1.7.0_80/java/rmi/server/RemoteObject.java,Java,,89,15,354,458
/jdk1.7.0_80/java/rmi/server/RemoteObjectInvocationHandler.java,Java,,129,16,138,283
/jdk1.7.0_80/java/rmi/server/RemoteRef.java,Java,,22,14,159,195
/jdk1.7.0_80/java/rmi/server/RemoteServer.java,Java,,27,8,80,115
/jdk1.7.0_80/java/rmi/server/RemoteStub.java,Java,,14,5,55,74
/jdk1.7.0_80/java/rmi/server/RMIClassLoader.java,Java,,134,25,563,722
/jdk1.7.0_80/java/rmi/server/RMIClassLoaderSpi.java,Java,,15,7,170,192
/jdk1.7.0_80/java/rmi/server/RMIClientSocketFactory.java,Java,,7,4,63,74
/jdk1.7.0_80/java/rmi/server/RMIFailureHandler.java,Java,,4,4,52,60
/jdk1.7.0_80/java/rmi/server/RMIServerSocketFactory.java,Java,,7,4,63,74
/jdk1.7.0_80/java/rmi/server/RMISocketFactory.java,Java,,52,12,124,188
/jdk1.7.0_80/java/rmi/server/ServerCloneException.java,Java,,25,8,79,112
/jdk1.7.0_80/java/rmi/server/ServerNotActiveException.java,Java,,9,5,47,61
/jdk1.7.0_80/java/rmi/server/ServerRef.java,Java,,8,6,52,66
/jdk1.7.0_80/java/rmi/server/Skeleton.java,Java,,10,3,57,70
/jdk1.7.0_80/java/rmi/server/SkeletonMismatchException.java,Java,,10,6,46,62
/jdk1.7.0_80/java/rmi/server/SkeletonNotFoundException.java,Java,,12,6,50,68
/jdk1.7.0_80/java/rmi/server/SocketSecurityException.java,Java,,10,6,46,62
/jdk1.7.0_80/java/rmi/server/UID.java,Java,,88,17,164,269
/jdk1.7.0_80/java/rmi/server/UnicastRemoteObject.java,Java,,83,18,211,312
/jdk1.7.0_80/java/rmi/server/Unreferenced.java,Java,,4,2,39,45
/jdk1.7.0_80/java/rmi/ServerError.java,Java,,7,4,45,56
/jdk1.7.0_80/java/rmi/ServerException.java,Java,,10,5,52,67
/jdk1.7.0_80/java/rmi/ServerRuntimeException.java,Java,,9,4,52,65
/jdk1.7.0_80/java/rmi/StubNotFoundException.java,Java,,10,5,52,67
/jdk1.7.0_80/java/rmi/UnexpectedException.java,Java,,10,5,49,64
/jdk1.7.0_80/java/rmi/UnknownHostException.java,Java,,10,5,47,62
/jdk1.7.0_80/java/rmi/UnmarshalException.java,Java,,10,5,61,76
/jdk1.7.0_80/java/security/AccessControlContext.java,Java,,293,78,234,605
/jdk1.7.0_80/java/security/AccessControlException.java,Java,,15,8,59,82
/jdk1.7.0_80/java/security/AccessController.java,Java,,96,32,433,561
/jdk1.7.0_80/java/security/acl/Acl.java,Java,,16,12,213,241
/jdk1.7.0_80/java/security/acl/AclEntry.java,Java,,15,13,126,154
/jdk1.7.0_80/java/security/acl/AclNotFoundException.java,Java,,6,5,33,44
/jdk1.7.0_80/java/security/acl/Group.java,Java,,9,9,69,87
/jdk1.7.0_80/java/security/acl/LastOwnerException.java,Java,,6,4,35,45
/jdk1.7.0_80/java/security/acl/NotOwnerException.java,Java,,6,4,34,44
/jdk1.7.0_80/java/security/acl/Owner.java,Java,,9,7,79,95
/jdk1.7.0_80/java/security/acl/Permission.java,Java,,5,6,43,54
/jdk1.7.0_80/java/security/AlgorithmConstraints.java,Java,,9,8,91,108
/jdk1.7.0_80/java/security/AlgorithmParameterGenerator.java,Java,,78,18,247,343
/jdk1.7.0_80/java/security/AlgorithmParameterGeneratorSpi.java,Java,,9,7,70,86
/jdk1.7.0_80/java/security/AlgorithmParameters.java,Java,,108,21,269,398
/jdk1.7.0_80/java/security/AlgorithmParametersSpi.java,Java,,20,11,120,151
/jdk1.7.0_80/java/security/AllPermission.java,Java,,69,31,137,237
/jdk1.7.0_80/java/security/AuthProvider.java,Java,,13,7,106,126
/jdk1.7.0_80/java/security/BasicPermission.java,Java,,210,74,281,565
/jdk1.7.0_80/java/security/cert/Certificate.java,Java,,90,24,160,274
/jdk1.7.0_80/java/security/cert/CertificateEncodingException.java,Java,,16,7,65,88
/jdk1.7.0_80/java/security/cert/CertificateException.java,Java,,17,8,63,88
/jdk1.7.0_80/java/security/cert/CertificateExpiredException.java,Java,,10,5,44,59
/jdk1.7.0_80/java/security/cert/CertificateFactory.java,Java,,102,22,413,537
/jdk1.7.0_80/java/security/cert/CertificateFactorySpi.java,Java,,38,12,265,315
/jdk1.7.0_80/java/security/cert/CertificateNotYetValidException.java,Java,,10,5,44,59
/jdk1.7.0_80/java/security/cert/CertificateParsingException.java,Java,,16,7,66,89
/jdk1.7.0_80/java/security/cert/CertificateRevokedException.java,Java,,98,21,130,249
/jdk1.7.0_80/java/security/cert/CertPath.java,Java,,92,25,226,343
/jdk1.7.0_80/java/security/cert/CertPathBuilder.java,Java,,69,13,222,304
/jdk1.7.0_80/java/security/cert/CertPathBuilderException.java,Java,,17,9,78,104
/jdk1.7.0_80/java/security/cert/CertPathBuilderResult.java,Java,,5,4,59,68
/jdk1.7.0_80/java/security/cert/CertPathBuilderSpi.java,Java,,7,5,63,75
/jdk1.7.0_80/java/security/cert/CertPathHelperImpl.java,Java,,20,9,37,66
/jdk1.7.0_80/java/security/cert/CertPathParameters.java,Java,,4,3,42,49
/jdk1.7.0_80/java/security/cert/CertPathValidator.java,Java,,71,13,231,315
/jdk1.7.0_80/java/security/cert/CertPathValidatorException.java,Java,,77,26,193,296
/jdk1.7.0_80/java/security/cert/CertPathValidatorResult.java,Java,,4,3,43,50
/jdk1.7.0_80/java/security/cert/CertPathValidatorSpi.java,Java,,8,5,72,85
/jdk1.7.0_80/java/security/cert/CertSelector.java,Java,,5,4,58,67
/jdk1.7.0_80/java/security/cert/CertStore.java,Java,,100,15,309,424
/jdk1.7.0_80/java/security/cert/CertStoreException.java,Java,,17,9,77,103
/jdk1.7.0_80/java/security/cert/CertStoreParameters.java,Java,,4,3,73,80
/jdk1.7.0_80/java/security/cert/CertStoreSpi.java,Java,,11,6,108,125
/jdk1.7.0_80/java/security/cert/CollectionCertStoreParameters.java,Java,,33,9,99,141
/jdk1.7.0_80/java/security/cert/CRL.java,Java,,12,8,68,88
/jdk1.7.0_80/java/security/cert/CRLException.java,Java,,17,8,63,88
/jdk1.7.0_80/java/security/cert/CRLReason.java,Java,,14,12,78,104
/jdk1.7.0_80/java/security/cert/CRLSelector.java,Java,,5,4,57,66
/jdk1.7.0_80/java/security/cert/Extension.java,Java,,10,7,84,101
/jdk1.7.0_80/java/security/cert/LDAPCertStoreParameters.java,Java,,39,13,97,149
/jdk1.7.0_80/java/security/cert/PKIXBuilderParameters.java,Java,,40,9,150,199
/jdk1.7.0_80/java/security/cert/PKIXCertPathBuilderResult.java,Java,,28,7,84,119
/jdk1.7.0_80/java/security/cert/PKIXCertPathChecker.java,Java,,20,9,152,181
/jdk1.7.0_80/java/security/cert/PKIXCertPathValidatorResult.java,Java,,43,10,106,159
/jdk1.7.0_80/java/security/cert/PKIXParameters.java,Java,,251,42,443,736
/jdk1.7.0_80/java/security/cert/PKIXReason.java,Java,,11,9,57,77
/jdk1.7.0_80/java/security/cert/PolicyNode.java,Java,,12,10,111,133
/jdk1.7.0_80/java/security/cert/PolicyQualifierInfo.java,Java,,46,12,115,173
/jdk1.7.0_80/java/security/cert/TrustAnchor.java,Java,,98,16,220,334
/jdk1.7.0_80/java/security/cert/X509Certificate.java,Java,,60,30,559,649
/jdk1.7.0_80/java/security/cert/X509CertSelector.java,Java,,1260,107,1271,2638
/jdk1.7.0_80/java/security/cert/X509CRL.java,Java,,82,27,334,443
/jdk1.7.0_80/java/security/cert/X509CRLEntry.java,Java,,50,16,125,191
/jdk1.7.0_80/java/security/cert/X509CRLSelector.java,Java,,271,38,405,714
/jdk1.7.0_80/java/security/cert/X509Extension.java,Java,,8,8,183,199
/jdk1.7.0_80/java/security/Certificate.java,Java,,15,11,130,156
/jdk1.7.0_80/java/security/CodeSigner.java,Java,,68,16,89,173
/jdk1.7.0_80/java/security/CodeSource.java,Java,,266,60,313,639
/jdk1.7.0_80/java/security/CryptoPrimitive.java,Java,,13,11,59,83
/jdk1.7.0_80/java/security/DigestException.java,Java,,16,7,63,86
/jdk1.7.0_80/java/security/DigestInputStream.java,Java,,41,14,133,188
/jdk1.7.0_80/java/security/DigestOutputStream.java,Java,,39,12,120,171
/jdk1.7.0_80/java/security/DomainCombiner.java,Java,,5,3,104,112
/jdk1.7.0_80/java/security/GeneralSecurityException.java,Java,,16,8,64,88
/jdk1.7.0_80/java/security/Guard.java,Java,,4,4,48,56
/jdk1.7.0_80/java/security/GuardedObject.java,Java,,25,11,66,102
/jdk1.7.0_80/java/security/Identity.java,Java,,177,42,276,495
/jdk1.7.0_80/java/security/IdentityScope.java,Java,,67,26,164,257
/jdk1.7.0_80/java/security/interfaces/DSAKey.java,Java,,4,3,43,50
/jdk1.7.0_80/java/security/interfaces/DSAKeyPairGenerator.java,Java,,8,5,102,115
/jdk1.7.0_80/java/security/interfaces/DSAParams.java,Java,,7,6,51,64
/jdk1.7.0_80/java/security/interfaces/DSAPrivateKey.java,Java,,6,6,46,58
/jdk1.7.0_80/java/security/interfaces/DSAPublicKey.java,Java,,6,6,46,58
/jdk1.7.0_80/java/security/interfaces/ECKey.java,Java,,5,2,38,45
/jdk1.7.0_80/java/security/interfaces/ECPrivateKey.java,Java,,7,3,43,53
/jdk1.7.0_80/java/security/interfaces/ECPublicKey.java,Java,,7,4,44,55
/jdk1.7.0_80/java/security/interfaces/RSAKey.java,Java,,5,5,39,49
/jdk1.7.0_80/java/security/interfaces/RSAMultiPrimePrivateCrtKey.java,Java,,13,12,75,100
/jdk1.7.0_80/java/security/interfaces/RSAPrivateCrtKey.java,Java,,11,11,63,85
/jdk1.7.0_80/java/security/interfaces/RSAPrivateKey.java,Java,,7,6,37,50
/jdk1.7.0_80/java/security/interfaces/RSAPublicKey.java,Java,,7,5,35,47
/jdk1.7.0_80/java/security/InvalidAlgorithmParameterException.java,Java,,17,8,72,97
/jdk1.7.0_80/java/security/InvalidKeyException.java,Java,,16,9,64,89
/jdk1.7.0_80/java/security/InvalidParameterException.java,Java,,10,6,43,59
/jdk1.7.0_80/java/security/Key.java,Java,,7,8,138,153
/jdk1.7.0_80/java/security/KeyException.java,Java,,16,8,66,90
/jdk1.7.0_80/java/security/KeyFactory.java,Java,,188,25,261,474
/jdk1.7.0_80/java/security/KeyFactorySpi.java,Java,,14,9,117,140
/jdk1.7.0_80/java/security/KeyManagementException.java,Java,,16,8,75,99
/jdk1.7.0_80/java/security/KeyPair.java,Java,,17,9,55,81
/jdk1.7.0_80/java/security/KeyPairGenerator.java,Java,,248,44,424,716
/jdk1.7.0_80/java/security/KeyPairGeneratorSpi.java,Java,,11,7,88,106
/jdk1.7.0_80/java/security/KeyRep.java,Java,,60,21,114,195
/jdk1.7.0_80/java/security/KeyStore.java,Java,,644,106,1031,1781
/jdk1.7.0_80/java/security/KeyStoreException.java,Java,,16,8,66,90
/jdk1.7.0_80/java/security/KeyStoreSpi.java,Java,,181,39,373,593
/jdk1.7.0_80/java/security/MessageDigest.java,Java,,224,47,329,600
/jdk1.7.0_80/java/security/MessageDigestSpi.java,Java,,56,15,135,206
/jdk1.7.0_80/java/security/NoSuchAlgorithmException.java,Java,,16,8,65,89
/jdk1.7.0_80/java/security/NoSuchProviderException.java,Java,,10,6,42,58
/jdk1.7.0_80/java/security/Permission.java,Java,,31,21,179,231
/jdk1.7.0_80/java/security/PermissionCollection.java,Java,,30,12,154,196
/jdk1.7.0_80/java/security/Permissions.java,Java,,240,80,278,598
/jdk1.7.0_80/java/security/Policy.java,Java,,343,70,450,863
/jdk1.7.0_80/java/security/PolicySpi.java,Java,,14,8,96,118
/jdk1.7.0_80/java/security/Principal.java,Java,,7,6,59,72
/jdk1.7.0_80/java/security/PrivateKey.java,Java,,4,3,49,56
/jdk1.7.0_80/java/security/PrivilegedAction.java,Java,,4,4,48,56
/jdk1.7.0_80/java/security/PrivilegedActionException.java,Java,,19,7,79,105
/jdk1.7.0_80/java/security/PrivilegedExceptionAction.java,Java,,4,5,53,62
/jdk1.7.0_80/java/security/ProtectionDomain.java,Java,,242,45,185,472
/jdk1.7.0_80/java/security/Provider.java,Java,,828,101,562,1491
/jdk1.7.0_80/java/security/ProviderException.java,Java,,16,7,66,89
/jdk1.7.0_80/java/security/PublicKey.java,Java,,4,3,46,53
/jdk1.7.0_80/java/security/SecureClassLoader.java,Java,,69,16,142,227
/jdk1.7.0_80/java/security/SecureRandom.java,Java,,146,38,408,592
/jdk1.7.0_80/java/security/SecureRandomSpi.java,Java,,7,7,60,74
/jdk1.7.0_80/java/security/Security.java,Java,,515,95,497,1107
/jdk1.7.0_80/java/security/SecurityPermission.java,Java,,16,9,306,331
/jdk1.7.0_80/java/security/Signature.java,Java,,667,100,571,1338
/jdk1.7.0_80/java/security/SignatureException.java,Java,,16,8,63,87
/jdk1.7.0_80/java/security/SignatureSpi.java,Java,,92,22,276,390
/jdk1.7.0_80/java/security/SignedObject.java,Java,,57,16,185,258
/jdk1.7.0_80/java/security/Signer.java,Java,,61,17,105,183
/jdk1.7.0_80/java/security/spec/AlgorithmParameterSpec.java,Java,,2,3,39,44
/jdk1.7.0_80/java/security/spec/DSAParameterSpec.java,Java,,22,9,58,89
/jdk1.7.0_80/java/security/spec/DSAPrivateKeySpec.java,Java,,27,10,69,106
/jdk1.7.0_80/java/security/spec/DSAPublicKeySpec.java,Java,,27,10,69,106
/jdk1.7.0_80/java/security/spec/ECField.java,Java,,6,2,41,49
/jdk1.7.0_80/java/security/spec/ECFieldF2m.java,Java,,91,12,138,241
/jdk1.7.0_80/java/security/spec/ECFieldFp.java,Java,,28,8,62,98
/jdk1.7.0_80/java/security/spec/ECGenParameterSpec.java,Java,,13,4,51,68
/jdk1.7.0_80/java/security/spec/ECParameterSpec.java,Java,,42,8,63,113
/jdk1.7.0_80/java/security/spec/ECPoint.java,Java,,37,10,67,114
/jdk1.7.0_80/java/security/spec/ECPrivateKeySpec.java,Java,,22,6,53,81
/jdk1.7.0_80/java/security/spec/ECPublicKeySpec.java,Java,,24,5,56,85
/jdk1.7.0_80/java/security/spec/EllipticCurve.java,Java,,81,13,102,196
/jdk1.7.0_80/java/security/spec/EncodedKeySpec.java,Java,,11,7,67,85
/jdk1.7.0_80/java/security/spec/InvalidKeySpecException.java,Java,,17,9,68,94
/jdk1.7.0_80/java/security/spec/InvalidParameterSpecException.java,Java,,11,7,48,66
/jdk1.7.0_80/java/security/spec/KeySpec.java,Java,,2,3,57,62
/jdk1.7.0_80/java/security/spec/MGF1ParameterSpec.java,Java,,22,7,78,107
/jdk1.7.0_80/java/security/spec/PKCS8EncodedKeySpec.java,Java,,12,6,78,96
/jdk1.7.0_80/java/security/spec/PSSParameterSpec.java,Java,,59,14,138,211
/jdk1.7.0_80/java/security/spec/RSAKeyGenParameterSpec.java,Java,,19,10,57,86
/jdk1.7.0_80/java/security/spec/RSAMultiPrimePrivateCrtKeySpec.java,Java,,90,13,109,212
/jdk1.7.0_80/java/security/spec/RSAOtherPrimeInfo.java,Java,,35,10,75,120
/jdk1.7.0_80/java/security/spec/RSAPrivateCrtKeySpec.java,Java,,44,14,85,143
/jdk1.7.0_80/java/security/spec/RSAPrivateKeySpec.java,Java,,16,8,53,77
/jdk1.7.0_80/java/security/spec/RSAPublicKeySpec.java,Java,,16,8,53,77
/jdk1.7.0_80/java/security/spec/X509EncodedKeySpec.java,Java,,12,6,68,86
/jdk1.7.0_80/java/security/Timestamp.java,Java,,62,16,86,164
/jdk1.7.0_80/java/security/UnrecoverableEntryException.java,Java,,10,6,40,56
/jdk1.7.0_80/java/security/UnrecoverableKeyException.java,Java,,10,6,40,56
/jdk1.7.0_80/java/security/UnresolvedPermission.java,Java,,294,47,263,604
/jdk1.7.0_80/java/security/UnresolvedPermissionCollection.java,Java,,90,27,99,216
/jdk1.7.0_80/java/security/URIParameter.java,Java,,14,6,43,63
/jdk1.7.0_80/java/sql/Array.java,Java,,17,14,335,366
/jdk1.7.0_80/java/sql/BatchUpdateException.java,Java,,45,17,278,340
/jdk1.7.0_80/java/sql/Blob.java,Java,,15,16,273,304
/jdk1.7.0_80/java/sql/CallableStatement.java,Java,,164,123,2212,2499
/jdk1.7.0_80/java/sql/ClientInfoStatus.java,Java,,8,8,46,62
/jdk1.7.0_80/java/sql/Clob.java,Java,,17,19,312,348
/jdk1.7.0_80/java/sql/Connection.java,Java,,81,68,1337,1486
/jdk1.7.0_80/java/sql/DatabaseMetaData.java,Java,,276,247,3132,3655
/jdk1.7.0_80/java/sql/DataTruncation.java,Java,,44,18,126,188
/jdk1.7.0_80/java/sql/Date.java,Java,,80,25,145,250
/jdk1.7.0_80/java/sql/Driver.java,Java,,13,14,143,170
/jdk1.7.0_80/java/sql/DriverManager.java,Java,,256,74,294,624
/jdk1.7.0_80/java/sql/DriverPropertyInfo.java,Java,,12,9,63,84
/jdk1.7.0_80/java/sql/NClob.java,Java,,3,4,48,55
/jdk1.7.0_80/java/sql/ParameterMetaData.java,Java,,19,20,157,196
/jdk1.7.0_80/java/sql/PreparedStatement.java,Java,,89,57,1077,1223
/jdk1.7.0_80/java/sql/PseudoColumnUsage.java,Java,,7,8,42,57
/jdk1.7.0_80/java/sql/Ref.java,Java,,7,8,112,127
/jdk1.7.0_80/java/sql/ResultSet.java,Java,,252,215,3672,4139
/jdk1.7.0_80/java/sql/ResultSetMetaData.java,Java,,27,28,222,277
/jdk1.7.0_80/java/sql/RowId.java,Java,,7,7,106,120
/jdk1.7.0_80/java/sql/RowIdLifetime.java,Java,,9,9,49,67
/jdk1.7.0_80/java/sql/Savepoint.java,Java,,5,5,50,60
/jdk1.7.0_80/java/sql/SQLClientInfoException.java,Java,,63,27,231,321
/jdk1.7.0_80/java/sql/SQLData.java,Java,,6,5,126,137
/jdk1.7.0_80/java/sql/SQLDataException.java,Java,,28,11,134,173
/jdk1.7.0_80/java/sql/SQLException.java,Java,,152,35,188,375
/jdk1.7.0_80/java/sql/SQLFeatureNotSupportedException.java,Java,,28,11,140,179
/jdk1.7.0_80/java/sql/SQLInput.java,Java,,30,36,358,424
/jdk1.7.0_80/java/sql/SQLIntegrityConstraintViolationException.java,Java,,28,11,135,174
/jdk1.7.0_80/java/sql/SQLInvalidAuthorizationSpecException.java,Java,,28,11,135,174
/jdk1.7.0_80/java/sql/SQLNonTransientConnectionException.java,Java,,28,12,136,176
/jdk1.7.0_80/java/sql/SQLNonTransientException.java,Java,,28,12,135,175
/jdk1.7.0_80/java/sql/SQLOutput.java,Java,,30,38,369,437
/jdk1.7.0_80/java/sql/SQLPermission.java,Java,,11,11,136,158
/jdk1.7.0_80/java/sql/SQLRecoverableException.java,Java,,28,11,136,175
/jdk1.7.0_80/java/sql/SQLSyntaxErrorException.java,Java,,28,11,134,173
/jdk1.7.0_80/java/sql/SQLTimeoutException.java,Java,,28,11,132,171
/jdk1.7.0_80/java/sql/SQLTransactionRollbackException.java,Java,,28,10,135,173
/jdk1.7.0_80/java/sql/SQLTransientConnectionException.java,Java,,28,11,135,174
/jdk1.7.0_80/java/sql/SQLTransientException.java,Java,,28,11,133,172
/jdk1.7.0_80/java/sql/SQLWarning.java,Java,,52,14,151,217
/jdk1.7.0_80/java/sql/SQLXML.java,Java,,19,13,393,425
/jdk1.7.0_80/java/sql/Statement.java,Java,,54,59,950,1063
/jdk1.7.0_80/java/sql/Struct.java,Java,,7,6,93,106
/jdk1.7.0_80/java/sql/Time.java,Java,,86,20,142,248
/jdk1.7.0_80/java/sql/Timestamp.java,Java,,258,38,236,532
/jdk1.7.0_80/java/sql/Types.java,Java,,40,45,229,314
/jdk1.7.0_80/java/sql/Wrapper.java,Java,,5,6,69,80
/jdk1.7.0_80/java/text/Annotation.java,Java,,13,8,63,84
/jdk1.7.0_80/java/text/AttributedCharacterIterator.java,Java,,54,29,171,254
/jdk1.7.0_80/java/text/AttributedString.java,Java,,716,132,272,1120
/jdk1.7.0_80/java/text/Bidi.java,Java,,88,32,208,328
/jdk1.7.0_80/java/text/BreakDictionary.java,Java,,142,36,163,341
/jdk1.7.0_80/java/text/BreakIterator.java,Java,,235,49,431,715
/jdk1.7.0_80/java/text/CalendarBuilder.java,Java,,116,18,45,179
/jdk1.7.0_80/java/text/CharacterIterator.java,Java,,15,17,161,193
/jdk1.7.0_80/java/text/CharacterIteratorFieldDelegate.java,Java,,60,11,53,124
/jdk1.7.0_80/java/text/ChoiceFormat.java,Java,,263,39,317,619
/jdk1.7.0_80/java/text/CollationElementIterator.java,Java,,410,57,310,777
/jdk1.7.0_80/java/text/CollationKey.java,Java,,15,10,120,145
/jdk1.7.0_80/java/text/CollationRules.java,Java,,204,11,59,274
/jdk1.7.0_80/java/text/Collator.java,Java,,147,33,373,553
/jdk1.7.0_80/java/text/DateFormat.java,Java,,303,73,654,1030
/jdk1.7.0_80/java/text/DateFormatSymbols.java,Java,,305,68,435,808
/jdk1.7.0_80/java/text/DecimalFormat.java,Java,,1527,236,1515,3278
/jdk1.7.0_80/java/text/DecimalFormatSymbols.java,Java,,309,82,446,837
/jdk1.7.0_80/java/text/DictionaryBasedBreakIterator.java,Java,,216,49,249,514
/jdk1.7.0_80/java/text/DigitList.java,Java,,385,63,267,715
/jdk1.7.0_80/java/text/DontCareFieldPosition.java,Java,,18,5,30,53
/jdk1.7.0_80/java/text/EntryPair.java,Java,,15,4,41,60
/jdk1.7.0_80/java/text/FieldPosition.java,Java,,96,27,180,303
/jdk1.7.0_80/java/text/Format.java,Java,,68,28,310,406
/jdk1.7.0_80/java/text/MergeCollation.java,Java,,187,31,124,342
/jdk1.7.0_80/java/text/MessageFormat.java,Java,,671,85,838,1594
/jdk1.7.0_80/java/text/Normalizer.java,Java,,18,12,153,183
/jdk1.7.0_80/java/text/NumberFormat.java,Java,,333,94,735,1162
/jdk1.7.0_80/java/text/ParseException.java,Java,,12,6,60,78
/jdk1.7.0_80/java/text/ParsePosition.java,Java,,38,12,89,139
/jdk1.7.0_80/java/text/PatternEntry.java,Java,,206,29,71,306
/jdk1.7.0_80/java/text/RBCollationTables.java,Java,,129,31,143,303
/jdk1.7.0_80/java/text/RBTableBuilder.java,Java,,338,55,225,618
/jdk1.7.0_80/java/text/RuleBasedBreakIterator.java,Java,,494,119,535,1148
/jdk1.7.0_80/java/text/RuleBasedCollationKey.java,Java,,38,10,75,123
/jdk1.7.0_80/java/text/RuleBasedCollator.java,Java,,276,44,443,763
/jdk1.7.0_80/java/text/SimpleDateFormat.java,Java,,1242,166,941,2349
/jdk1.7.0_80/java/text/spi/BreakIteratorProvider.java,Java,,12,8,87,107
/jdk1.7.0_80/java/text/spi/CollatorProvider.java,Java,,9,5,47,61
/jdk1.7.0_80/java/text/spi/DateFormatProvider.java,Java,,12,7,95,114
/jdk1.7.0_80/java/text/spi/DateFormatSymbolsProvider.java,Java,,9,5,48,62
/jdk1.7.0_80/java/text/spi/DecimalFormatSymbolsProvider.java,Java,,9,5,48,62
/jdk1.7.0_80/java/text/spi/NumberFormatProvider.java,Java,,12,8,93,113
/jdk1.7.0_80/java/text/StringCharacterIterator.java,Java,,129,26,124,279
/jdk1.7.0_80/java/util/AbstractCollection.java,Java,,158,29,278,465
/jdk1.7.0_80/java/util/AbstractList.java,Java,,336,78,367,781
/jdk1.7.0_80/java/util/AbstractMap.java,Java,,304,74,444,822
/jdk1.7.0_80/java/util/AbstractQueue.java,Java,,42,10,140,192
/jdk1.7.0_80/java/util/AbstractSequentialList.java,Java,,57,14,182,253
/jdk1.7.0_80/java/util/AbstractSet.java,Java,,46,10,129,185
/jdk1.7.0_80/java/util/ArrayDeque.java,Java,,361,73,432,866
/jdk1.7.0_80/java/util/ArrayList.java,Java,,575,120,477,1172
/jdk1.7.0_80/java/util/Arrays.java,Java,...,1177,241,2255,3673
/jdk1.7.0_80/java/util/BitSet.java,Java,,486,142,563,1191
/jdk1.7.0_80/java/util/Calendar.java,Java,,898,206,1720,2824
/jdk1.7.0_80/java/util/Collection.java,Java,,18,23,415,456
/jdk1.7.0_80/java/util/Collections.java,Java,,1931,388,1655,3974
/jdk1.7.0_80/java/util/ComparableTimSort.java,Java,,468,71,356,895
/jdk1.7.0_80/java/util/Comparator.java,Java,,5,4,159,168
/jdk1.7.0_80/java/util/concurrent/AbstractExecutorService.java,Java,,174,23,112,309
/jdk1.7.0_80/java/util/concurrent/ArrayBlockingQueue.java,Java,,432,50,323,805
/jdk1.7.0_80/java/util/concurrent/atomic/AtomicBoolean.java,Java,,49,15,100,164
/jdk1.7.0_80/java/util/concurrent/atomic/AtomicInteger.java,Java,,104,27,134,265
/jdk1.7.0_80/java/util/concurrent/atomic/AtomicIntegerArray.java,Java,,104,28,152,284
/jdk1.7.0_80/java/util/concurrent/atomic/AtomicIntegerFieldUpdater.java,Java,,141,29,177,347
/jdk1.7.0_80/java/util/concurrent/atomic/AtomicLong.java,Java,,106,29,144,279
/jdk1.7.0_80/java/util/concurrent/atomic/AtomicLongArray.java,Java,,104,29,151,284
/jdk1.7.0_80/java/util/concurrent/atomic/AtomicLongFieldUpdater.java,Java,,221,41,174,436
/jdk1.7.0_80/java/util/concurrent/atomic/AtomicMarkableReference.java,Java,,76,17,119,212
/jdk1.7.0_80/java/util/concurrent/atomic/AtomicReference.java,Java,,44,16,95,155
/jdk1.7.0_80/java/util/concurrent/atomic/AtomicReferenceArray.java,Java,,95,25,120,240
/jdk1.7.0_80/java/util/concurrent/atomic/AtomicReferenceFieldUpdater.java,Java,,128,25,156,309
/jdk1.7.0_80/java/util/concurrent/atomic/AtomicStampedReference.java,Java,,76,18,119,213
/jdk1.7.0_80/java/util/concurrent/atomic/package-info.java,Java,,1,2,196,199
/jdk1.7.0_80/java/util/concurrent/BlockingDeque.java,Java,,39,34,577,650
/jdk1.7.0_80/java/util/concurrent/BlockingQueue.java,Java,,18,14,345,377
/jdk1.7.0_80/java/util/concurrent/BrokenBarrierException.java,Java,,8,5,54,67
/jdk1.7.0_80/java/util/concurrent/Callable.java,Java,,4,3,58,65
/jdk1.7.0_80/java/util/concurrent/CancellationException.java,Java,,8,5,50,63
/jdk1.7.0_80/java/util/concurrent/CompletionService.java,Java,,8,8,110,126
/jdk1.7.0_80/java/util/concurrent/ConcurrentHashMap.java,Java,,899,110,610,1619
/jdk1.7.0_80/java/util/concurrent/ConcurrentLinkedDeque.java,Java,,673,116,680,1469
/jdk1.7.0_80/java/util/concurrent/ConcurrentLinkedQueue.java,Java,,357,60,418,835
/jdk1.7.0_80/java/util/concurrent/ConcurrentMap.java,Java,,8,6,151,165
/jdk1.7.0_80/java/util/concurrent/ConcurrentNavigableMap.java,Java,,17,13,147,177
/jdk1.7.0_80/java/util/concurrent/ConcurrentSkipListMap.java,Java,,1725,248,1146,3119
/jdk1.7.0_80/java/util/concurrent/ConcurrentSkipListSet.java,Java,,151,47,293,491
/jdk1.7.0_80/java/util/concurrent/CopyOnWriteArrayList.java,Java,,723,101,516,1340
/jdk1.7.0_80/java/util/concurrent/CopyOnWriteArraySet.java,Java,,81,23,288,392
/jdk1.7.0_80/java/util/concurrent/CountDownLatch.java,Java,,48,14,258,320
/jdk1.7.0_80/java/util/concurrent/CyclicBarrier.java,Java,,131,23,329,483
/jdk1.7.0_80/java/util/concurrent/Delayed.java,Java,,5,5,52,62
/jdk1.7.0_80/java/util/concurrent/DelayQueue.java,Java,,261,33,252,546
/jdk1.7.0_80/java/util/concurrent/Exchanger.java,Java,,194,30,463,687
/jdk1.7.0_80/java/util/concurrent/ExecutionException.java,Java,,14,7,73,94
/jdk1.7.0_80/java/util/concurrent/Executor.java,Java,,4,4,133,141
/jdk1.7.0_80/java/util/concurrent/ExecutorCompletionService.java,Java,,65,14,126,205
/jdk1.7.0_80/java/util/concurrent/Executors.java,Java,,302,45,358,705
/jdk1.7.0_80/java/util/concurrent/ExecutorService.java,Java,,26,17,327,370
/jdk1.7.0_80/java/util/concurrent/ForkJoinPool.java,Java,,956,122,1099,2177
/jdk1.7.0_80/java/util/concurrent/ForkJoinTask.java,Java,,593,69,724,1386
/jdk1.7.0_80/java/util/concurrent/ForkJoinWorkerThread.java,Java,,438,61,499,998
/jdk1.7.0_80/java/util/concurrent/Future.java,Java,,9,8,152,169
/jdk1.7.0_80/java/util/concurrent/FutureTask.java,Java,,247,30,205,482
/jdk1.7.0_80/java/util/concurrent/LinkedBlockingDeque.java,Java,,632,97,469,1198
/jdk1.7.0_80/java/util/concurrent/LinkedBlockingQueue.java,Java,,475,63,372,910
/jdk1.7.0_80/java/util/concurrent/LinkedTransferQueue.java,Java,,554,84,713,1351
/jdk1.7.0_80/java/util/concurrent/locks/AbstractOwnableSynchronizer.java,Java,,13,8,65,86
/jdk1.7.0_80/java/util/concurrent/locks/AbstractQueuedLongSynchronizer.java,Java,,843,128,1138,2109
/jdk1.7.0_80/java/util/concurrent/locks/AbstractQueuedSynchronizer.java,Java,,843,127,1360,2330
/jdk1.7.0_80/java/util/concurrent/locks/Condition.java,Java,,12,10,466,488
/jdk1.7.0_80/java/util/concurrent/locks/Lock.java,Java,,10,9,337,356
/jdk1.7.0_80/java/util/concurrent/locks/LockSupport.java,Java,,56,16,313,385
/jdk1.7.0_80/java/util/concurrent/locks/package-info.java,Java,,1,2,76,79
/jdk1.7.0_80/java/util/concurrent/locks/ReadWriteLock.java,Java,,5,4,124,133
/jdk1.7.0_80/java/util/concurrent/locks/ReentrantLock.java,Java,,178,43,549,770
/jdk1.7.0_80/java/util/concurrent/locks/ReentrantReadWriteLock.java,Java,,416,83,987,1486
/jdk1.7.0_80/java/util/concurrent/package-info.java,Java,,1,2,297,300
/jdk1.7.0_80/java/util/concurrent/Phaser.java,Java,,459,57,636,1152
/jdk1.7.0_80/java/util/concurrent/PriorityBlockingQueue.java,Java,,489,56,406,951
/jdk1.7.0_80/java/util/concurrent/RecursiveAction.java,Java,,11,8,162,181
/jdk1.7.0_80/java/util/concurrent/RecursiveTask.java,Java,,16,9,72,97
/jdk1.7.0_80/java/util/concurrent/RejectedExecutionException.java,Java,,14,7,70,91
/jdk1.7.0_80/java/util/concurrent/RejectedExecutionHandler.java,Java,,4,4,54,62
/jdk1.7.0_80/java/util/concurrent/RunnableFuture.java,Java,,4,3,47,54
/jdk1.7.0_80/java/util/concurrent/RunnableScheduledFuture.java,Java,,4,4,50,58
/jdk1.7.0_80/java/util/concurrent/ScheduledExecutorService.java,Java,,17,8,162,187
/jdk1.7.0_80/java/util/concurrent/ScheduledFuture.java,Java,,3,3,42,48
/jdk1.7.0_80/java/util/concurrent/ScheduledThreadPoolExecutor.java,Java,,650,92,535,1277
/jdk1.7.0_80/java/util/concurrent/Semaphore.java,Java,,147,37,529,713
/jdk1.7.0_80/java/util/concurrent/SynchronousQueue.java,Java,,556,91,549,1196
/jdk1.7.0_80/java/util/concurrent/ThreadFactory.java,Java,,4,4,62,70
/jdk1.7.0_80/java/util/concurrent/ThreadLocalRandom.java,Java,,67,19,140,226
/jdk1.7.0_80/java/util/concurrent/ThreadPoolExecutor.java,Java,,727,125,1250,2102
/jdk1.7.0_80/java/util/concurrent/TimeoutException.java,Java,,8,5,54,67
/jdk1.7.0_80/java/util/concurrent/TimeUnit.java,Java,,141,20,203,364
/jdk1.7.0_80/java/util/concurrent/TransferQueue.java,Java,,9,7,145,161
/jdk1.7.0_80/java/util/ConcurrentModificationException.java,Java,,15,6,102,123
/jdk1.7.0_80/java/util/Currency.java,Java,,395,66,283,744
/jdk1.7.0_80/java/util/Date.java,Java,,533,59,739,1331
/jdk1.7.0_80/java/util/Deque.java,Java,,30,36,518,584
/jdk1.7.0_80/java/util/Dictionary.java,Java,,13,9,133,155
/jdk1.7.0_80/java/util/DualPivotQuicksort.java,Java,,1527,236,1255,3018
/jdk1.7.0_80/java/util/DuplicateFormatFlagsException.java,Java,,16,7,45,68
/jdk1.7.0_80/java/util/EmptyStackException.java,Java,,7,3,36,46
/jdk1.7.0_80/java/util/Enumeration.java,Java,,5,3,71,79
/jdk1.7.0_80/java/util/EnumMap.java,Java,,442,89,277,808
/jdk1.7.0_80/java/util/EnumSet.java,Java,,144,32,267,443
/jdk1.7.0_80/java/util/EventListener.java,Java,,3,2,28,33
/jdk1.7.0_80/java/util/EventListenerProxy.java,Java,,11,5,59,75
/jdk1.7.0_80/java/util/EventObject.java,Java,,16,9,53,78
/jdk1.7.0_80/java/util/FormatFlagsConversionMismatchException.java,Java,,23,8,53,84
/jdk1.7.0_80/java/util/Formattable.java,Java,,5,4,155,164
/jdk1.7.0_80/java/util/FormattableFlags.java,Java,,7,6,62,75
/jdk1.7.0_80/java/util/Formatter.java,Java,,1739,253,2449,4441
/jdk1.7.0_80/java/util/FormatterClosedException.java,Java,,5,4,36,45
/jdk1.7.0_80/java/util/GregorianCalendar.java,Java,,1666,201,1312,3179
/jdk1.7.0_80/java/util/HashMap.java,Java,,583,120,485,1188
/jdk1.7.0_80/java/util/HashSet.java,Java,,78,26,208,312
/jdk1.7.0_80/java/util/Hashtable.java,Java,,584,116,501,1201
/jdk1.7.0_80/java/util/IdentityHashMap.java,Java,,603,102,538,1243
/jdk1.7.0_80/java/util/IllegalFormatCodePointException.java,Java,,14,7,48,69
/jdk1.7.0_80/java/util/IllegalFormatConversionException.java,Java,,21,8,55,84
/jdk1.7.0_80/java/util/IllegalFormatException.java,Java,,5,4,33,42
/jdk1.7.0_80/java/util/IllegalFormatFlagsException.java,Java,,16,7,44,67
/jdk1.7.0_80/java/util/IllegalFormatPrecisionException.java,Java,,14,7,42,63
/jdk1.7.0_80/java/util/IllegalFormatWidthException.java,Java,,14,7,41,62
/jdk1.7.0_80/java/util/IllformedLocaleException.java,Java,,18,9,63,90
/jdk1.7.0_80/java/util/InputMismatchException.java,Java,,11,4,44,59
/jdk1.7.0_80/java/util/InvalidPropertiesFormatException.java,Java,,22,8,60,90
/jdk1.7.0_80/java/util/Iterator.java,Java,,6,4,77,87
/jdk1.7.0_80/java/util/JapaneseImperialCalendar.java,Java,,1574,163,646,2383
/jdk1.7.0_80/java/util/jar/Attributes.java,Java,,264,62,337,663
/jdk1.7.0_80/java/util/jar/JarEntry.java,Java,,32,9,87,128
/jdk1.7.0_80/java/util/jar/JarException.java,Java,,10,4,38,52
/jdk1.7.0_80/java/util/jar/JarFile.java,Java,,467,61,212,740
/jdk1.7.0_80/java/util/jar/JarInputStream.java,Java,,101,13,119,233
/jdk1.7.0_80/java/util/jar/JarOutputStream.java,Java,,60,10,79,149
/jdk1.7.0_80/java/util/jar/JarVerifier.java,Java,,588,119,173,880
/jdk1.7.0_80/java/util/jar/JavaUtilJarAccessImpl.java,Java,,30,9,24,63
/jdk1.7.0_80/java/util/jar/Manifest.java,Java,,263,34,150,447
/jdk1.7.0_80/java/util/jar/Pack200.java,Java,,87,54,623,764
/jdk1.7.0_80/java/util/JumboEnumSet.java,Java,,186,48,141,375
/jdk1.7.0_80/java/util/LinkedHashMap.java,Java,,153,38,301,492
/jdk1.7.0_80/java/util/LinkedHashSet.java,Java,,19,8,144,171
/jdk1.7.0_80/java/util/LinkedList.java,Java,,511,103,524,1138
/jdk1.7.0_80/java/util/List.java,Java,,28,41,531,600
/jdk1.7.0_80/java/util/ListIterator.java,Java,,12,13,170,195
/jdk1.7.0_80/java/util/ListResourceBundle.java,Java,,46,13,145,204
/jdk1.7.0_80/java/util/Locale.java,Java,,857,170,1533,2560
/jdk1.7.0_80/java/util/LocaleISOData.java,Java,,447,4,31,482
/jdk1.7.0_80/java/util/logging/ConsoleHandler.java,Java,,33,9,75,117
/jdk1.7.0_80/java/util/logging/ErrorManager.java,Java,,24,7,68,99
/jdk1.7.0_80/java/util/logging/FileHandler.java,Java,,325,37,266,628
/jdk1.7.0_80/java/util/logging/Filter.java,Java,,4,6,40,50
/jdk1.7.0_80/java/util/logging/Formatter.java,Java,,36,12,99,147
/jdk1.7.0_80/java/util/logging/Handler.java,Java,,94,22,188,304
/jdk1.7.0_80/java/util/logging/Level.java,Java,,246,61,312,619
/jdk1.7.0_80/java/util/logging/Logger.java,Java,,641,124,943,1708
/jdk1.7.0_80/java/util/logging/Logging.java,Java,,60,15,44,119
/jdk1.7.0_80/java/util/logging/LoggingMXBean.java,Java,,7,7,125,139
/jdk1.7.0_80/java/util/logging/LoggingPermission.java,Java,,14,7,57,78
/jdk1.7.0_80/java/util/logging/LoggingProxyImpl.java,Java,,70,19,28,117
/jdk1.7.0_80/java/util/logging/LogManager.java,Java,,789,125,649,1563
/jdk1.7.0_80/java/util/logging/LogRecord.java,Java,,212,53,307,572
/jdk1.7.0_80/java/util/logging/MemoryHandler.java,Java,,102,16,152,270
/jdk1.7.0_80/java/util/logging/SimpleFormatter.java,Java,,38,7,124,169
/jdk1.7.0_80/java/util/logging/SocketHandler.java,Java,,74,15,102,191
/jdk1.7.0_80/java/util/logging/StreamHandler.java,Java,,123,18,145,286
/jdk1.7.0_80/java/util/logging/XMLFormatter.java,Java,,166,27,75,268
/jdk1.7.0_80/java/util/Map.java,Java,,24,28,426,478
/jdk1.7.0_80/java/util/MissingFormatArgumentException.java,Java,,16,7,47,70
/jdk1.7.0_80/java/util/MissingFormatWidthException.java,Java,,16,7,45,68
/jdk1.7.0_80/java/util/MissingResourceException.java,Java,,23,11,90,124
/jdk1.7.0_80/java/util/NavigableMap.java,Java,,25,23,376,424
/jdk1.7.0_80/java/util/NavigableSet.java,Java,,19,17,283,319
/jdk1.7.0_80/java/util/NoSuchElementException.java,Java,,11,4,45,60
/jdk1.7.0_80/java/util/Objects.java,Java,,42,11,176,229
/jdk1.7.0_80/java/util/Observable.java,Java,,47,15,151,213
/jdk1.7.0_80/java/util/Observer.java,Java,,4,1,42,47
/jdk1.7.0_80/java/util/prefs/AbstractPreferences.java,Java,,534,105,974,1613
/jdk1.7.0_80/java/util/prefs/BackingStoreException.java,Java,,11,5,42,58
/jdk1.7.0_80/java/util/prefs/Base64.java,Java,,145,20,96,261
/jdk1.7.0_80/java/util/prefs/InvalidPreferencesFormatException.java,Java,,14,6,57,77
/jdk1.7.0_80/java/util/prefs/NodeChangeEvent.java,Java,,24,10,70,104
/jdk1.7.0_80/java/util/prefs/NodeChangeListener.java,Java,,5,4,45,54
/jdk1.7.0_80/java/util/prefs/PreferenceChangeEvent.java,Java,,30,12,83,125
/jdk1.7.0_80/java/util/prefs/PreferenceChangeListener.java,Java,,4,2,40,46
/jdk1.7.0_80/java/util/prefs/Preferences.java,Java,,168,57,1036,1261
/jdk1.7.0_80/java/util/prefs/PreferencesFactory.java,Java,,6,3,48,57
/jdk1.7.0_80/java/util/prefs/WindowsPreferences.java,Java,,700,67,344,1111
/jdk1.7.0_80/java/util/prefs/WindowsPreferencesFactory.java,Java,,9,3,39,51
/jdk1.7.0_80/java/util/prefs/XmlSupport.java,Java,,245,33,143,421
/jdk1.7.0_80/java/util/PriorityQueue.java,Java,,331,58,386,775
/jdk1.7.0_80/java/util/Properties.java,Java,,473,42,599,1114
/jdk1.7.0_80/java/util/PropertyPermission.java,Java,,268,94,305,667
/jdk1.7.0_80/java/util/PropertyResourceBundle.java,Java,,32,10,148,190
/jdk1.7.0_80/java/util/Queue.java,Java,,9,8,201,218
/jdk1.7.0_80/java/util/Random.java,Java,,138,32,411,581
/jdk1.7.0_80/java/util/RandomAccess.java,Java,,3,2,63,68
/jdk1.7.0_80/java/util/regex/ASCII.java,Java,,205,40,29,274
/jdk1.7.0_80/java/util/regex/Matcher.java,Java,,360,67,830,1257
/jdk1.7.0_80/java/util/regex/MatchResult.java,Java,,10,10,168,188
/jdk1.7.0_80/java/util/regex/Pattern.java,Java,,3493,292,1863,5648
/jdk1.7.0_80/java/util/regex/PatternSyntaxException.java,Java,,43,13,68,124
/jdk1.7.0_80/java/util/regex/UnicodeProp.java,Java,,160,27,49,236
/jdk1.7.0_80/java/util/RegularEnumSet.java,Java,,134,38,131,303
/jdk1.7.0_80/java/util/ResourceBundle.java,Java,,943,145,1839,2927
/jdk1.7.0_80/java/util/Scanner.java,Java,,1089,170,1401,2660
/jdk1.7.0_80/java/util/ServiceConfigurationError.java,Java,,12,8,67,87
/jdk1.7.0_80/java/util/ServiceLoader.java,Java,,204,35,306,545
/jdk1.7.0_80/java/util/Set.java,Java,,18,25,342,385
/jdk1.7.0_80/java/util/SimpleTimeZone.java,Java,,630,110,966,1706
/jdk1.7.0_80/java/util/SortedMap.java,Java,,12,11,261,284
/jdk1.7.0_80/java/util/SortedSet.java,Java,,9,8,205,222
/jdk1.7.0_80/java/util/spi/CurrencyNameProvider.java,Java,,29,9,81,119
/jdk1.7.0_80/java/util/spi/LocaleNameProvider.java,Java,,12,8,124,144
/jdk1.7.0_80/java/util/spi/LocaleServiceProvider.java,Java,,7,5,126,138
/jdk1.7.0_80/java/util/spi/TimeZoneNameProvider.java,Java,,7,5,68,80
/jdk1.7.0_80/java/util/Stack.java,Java,,34,13,94,141
/jdk1.7.0_80/java/util/StringTokenizer.java,Java,,153,27,251,431
/jdk1.7.0_80/java/util/Timer.java,Java,,231,49,440,720
/jdk1.7.0_80/java/util/TimerTask.java,Java,,27,14,117,158
/jdk1.7.0_80/java/util/TimeZone.java,Java,,361,62,509,932
/jdk1.7.0_80/java/util/TimSort.java,Java,,472,72,384,928
/jdk1.7.0_80/java/util/TooManyListenersException.java,Java,,10,7,54,71
/jdk1.7.0_80/java/util/TreeMap.java,Java,,1458,257,727,2442
/jdk1.7.0_80/java/util/TreeSet.java,Java,,147,47,345,539
/jdk1.7.0_80/java/util/UnknownFormatConversionException.java,Java,,16,7,45,68
/jdk1.7.0_80/java/util/UnknownFormatFlagsException.java,Java,,16,7,45,68
/jdk1.7.0_80/java/util/UUID.java,Java,,127,35,281,443
/jdk1.7.0_80/java/util/Vector.java,Java,,431,90,691,1212
/jdk1.7.0_80/java/util/WeakHashMap.java,Java,,522,110,437,1069
/jdk1.7.0_80/java/util/XMLUtils.java,Java,,152,17,37,206
/jdk1.7.0_80/java/util/zip/Adler32.java,Java,,60,12,68,140
/jdk1.7.0_80/java/util/zip/CheckedInputStream.java,Java,,42,8,66,116
/jdk1.7.0_80/java/util/zip/CheckedOutputStream.java,Java,,23,7,54,84
/jdk1.7.0_80/java/util/zip/Checksum.java,Java,,8,5,47,60
/jdk1.7.0_80/java/util/zip/CRC32.java,Java,,30,10,53,93
/jdk1.7.0_80/java/util/zip/DataFormatException.java,Java,,11,4,37,52
/jdk1.7.0_80/java/util/zip/Deflater.java,Java,,194,40,322,556
/jdk1.7.0_80/java/util/zip/DeflaterInputStream.java,Java,,117,30,147,294
/jdk1.7.0_80/java/util/zip/DeflaterOutputStream.java,Java,,102,23,159,284
/jdk1.7.0_80/java/util/zip/GZIPInputStream.java,Java,,144,20,125,289
/jdk1.7.0_80/java/util/zip/GZIPOutputStream.java,Java,,81,16,126,223
/jdk1.7.0_80/java/util/zip/Inflater.java,Java,,161,28,218,407
/jdk1.7.0_80/java/util/zip/InflaterInputStream.java,Java,,121,23,144,288
/jdk1.7.0_80/java/util/zip/InflaterOutputStream.java,Java,,120,29,127,276
/jdk1.7.0_80/java/util/zip/ZipCoder.java,Java,,110,16,33,159
/jdk1.7.0_80/java/util/zip/ZipConstants.java,Java,,43,7,48,98
/jdk1.7.0_80/java/util/zip/ZipConstants64.java,Java,,29,10,45,84
/jdk1.7.0_80/java/util/zip/ZipEntry.java,Java,,131,29,167,327
/jdk1.7.0_80/java/util/zip/ZipError.java,Java,,7,3,34,44
/jdk1.7.0_80/java/util/zip/ZipException.java,Java,,12,7,41,60
/jdk1.7.0_80/java/util/zip/ZipFile.java,Java,,452,66,264,782
/jdk1.7.0_80/java/util/zip/ZipInputStream.java,Java,,278,24,154,456
/jdk1.7.0_80/java/util/zip/ZipOutputStream.java,Java,,432,35,153,620
/jdk1.7.0_80/java/util/zip/ZStreamRef.java,Java,,13,6,27,46
/jdk1.7.0_80/javax/accessibility/Accessible.java,Java,,4,3,43,50
/jdk1.7.0_80/javax/accessibility/AccessibleAction.java,Java,,14,11,88,113
/jdk1.7.0_80/javax/accessibility/AccessibleAttributeSequence.java,Java,,12,8,58,78
/jdk1.7.0_80/javax/accessibility/AccessibleBundle.java,Java,,56,19,80,155
/jdk1.7.0_80/javax/accessibility/AccessibleComponent.java,Java,,32,30,253,315
/jdk1.7.0_80/javax/accessibility/AccessibleContext.java,Java,,146,60,568,774
/jdk1.7.0_80/javax/accessibility/AccessibleEditableText.java,Java,,15,14,104,133
/jdk1.7.0_80/javax/accessibility/AccessibleExtendedComponent.java,Java,,6,5,63,74
/jdk1.7.0_80/javax/accessibility/AccessibleExtendedTable.java,Java,,6,4,63,73
/jdk1.7.0_80/javax/accessibility/AccessibleExtendedText.java,Java,,13,12,117,142
/jdk1.7.0_80/javax/accessibility/AccessibleHyperlink.java,Java,,14,13,113,140
/jdk1.7.0_80/javax/accessibility/AccessibleHypertext.java,Java,,9,8,63,80
/jdk1.7.0_80/javax/accessibility/AccessibleIcon.java,Java,,7,7,68,82
/jdk1.7.0_80/javax/accessibility/AccessibleKeyBinding.java,Java,,5,4,54,63
/jdk1.7.0_80/javax/accessibility/AccessibleRelation.java,Java,,65,35,269,369
/jdk1.7.0_80/javax/accessibility/AccessibleRelationSet.java,Java,,115,16,112,243
/jdk1.7.0_80/javax/accessibility/AccessibleResourceBundle.java,Java,,89,5,58,152
/jdk1.7.0_80/javax/accessibility/AccessibleRole.java,Java,,135,84,442,661
/jdk1.7.0_80/javax/accessibility/AccessibleSelection.java,Java,,10,9,95,114
/jdk1.7.0_80/javax/accessibility/AccessibleState.java,Java,,68,35,272,375
/jdk1.7.0_80/javax/accessibility/AccessibleStateSet.java,Java,,86,14,99,199
/jdk1.7.0_80/javax/accessibility/AccessibleStreamable.java,Java,,7,4,54,65
/jdk1.7.0_80/javax/accessibility/AccessibleTable.java,Java,,25,24,169,218
/jdk1.7.0_80/javax/accessibility/AccessibleTableModelChange.java,Java,,11,10,80,101
/jdk1.7.0_80/javax/accessibility/AccessibleText.java,Java,,20,19,149,188
/jdk1.7.0_80/javax/accessibility/AccessibleTextSequence.java,Java,,11,7,58,76
/jdk1.7.0_80/javax/accessibility/AccessibleValue.java,Java,,7,7,78,92
/jdk1.7.0_80/javax/annotation/Generated.java,Java,,13,5,53,71
/jdk1.7.0_80/javax/annotation/PostConstruct.java,Java,,9,3,50,62
/jdk1.7.0_80/javax/annotation/PreDestroy.java,Java,,9,4,49,62
/jdk1.7.0_80/javax/annotation/processing/AbstractProcessor.java,Java,,72,14,109,195
/jdk1.7.0_80/javax/annotation/processing/Completion.java,Java,,5,4,42,51
/jdk1.7.0_80/javax/annotation/processing/Completions.java,Java,,31,11,47,89
/jdk1.7.0_80/javax/annotation/processing/Filer.java,Java,,18,6,239,263
/jdk1.7.0_80/javax/annotation/processing/FilerException.java,Java,,9,3,41,53
/jdk1.7.0_80/javax/annotation/processing/Messager.java,Java,,14,6,81,101
/jdk1.7.0_80/javax/annotation/processing/package-info.java,Java,,1,1,41,43
/jdk1.7.0_80/javax/annotation/processing/ProcessingEnvironment.java,Java,,17,9,110,136
/jdk1.7.0_80/javax/annotation/processing/Processor.java,Java,,16,8,386,410
/jdk1.7.0_80/javax/annotation/processing/RoundEnvironment.java,Java,,12,7,94,113
/jdk1.7.0_80/javax/annotation/processing/SupportedAnnotationTypes.java,Java,,10,3,38,51
/jdk1.7.0_80/javax/annotation/processing/SupportedOptions.java,Java,,10,3,37,50
/jdk1.7.0_80/javax/annotation/processing/SupportedSourceVersion.java,Java,,11,4,36,51
/jdk1.7.0_80/javax/annotation/Resource.java,Java,,19,11,102,132
/jdk1.7.0_80/javax/annotation/Resources.java,Java,,10,3,33,46
/jdk1.7.0_80/javax/imageio/event/IIOReadProgressListener.java,Java,,15,12,143,170
/jdk1.7.0_80/javax/imageio/event/IIOReadUpdateListener.java,Java,,34,9,206,249
/jdk1.7.0_80/javax/imageio/event/IIOReadWarningListener.java,Java,,6,4,48,58
/jdk1.7.0_80/javax/imageio/event/IIOWriteProgressListener.java,Java,,14,10,116,140
/jdk1.7.0_80/javax/imageio/event/IIOWriteWarningListener.java,Java,,8,4,50,62
/jdk1.7.0_80/javax/imageio/IIOException.java,Java,,11,5,57,73
/jdk1.7.0_80/javax/imageio/IIOImage.java,Java,,88,20,214,322
/jdk1.7.0_80/javax/imageio/IIOParam.java,Java,,152,38,486,676
/jdk1.7.0_80/javax/imageio/IIOParamController.java,Java,,4,3,111,118
/jdk1.7.0_80/javax/imageio/ImageIO.java,Java,,817,138,664,1619
/jdk1.7.0_80/javax/imageio/ImageReader.java,Java,,850,147,1901,2898
/jdk1.7.0_80/javax/imageio/ImageReadParam.java,Java,,98,24,386,508
/jdk1.7.0_80/javax/imageio/ImageTranscoder.java,Java,,9,5,138,152
/jdk1.7.0_80/javax/imageio/ImageTypeSpecifier.java,Java,,722,100,419,1241
/jdk1.7.0_80/javax/imageio/ImageWriteParam.java,Java,,395,59,1017,1471
/jdk1.7.0_80/javax/imageio/ImageWriter.java,Java,,441,92,1504,2037
/jdk1.7.0_80/javax/imageio/metadata/IIOInvalidTreeException.java,Java,,18,7,72,97
/jdk1.7.0_80/javax/imageio/metadata/IIOMetadata.java,Java,,222,44,634,900
/jdk1.7.0_80/javax/imageio/metadata/IIOMetadataController.java,Java,,4,3,79,86
/jdk1.7.0_80/javax/imageio/metadata/IIOMetadataFormat.java,Java,,59,57,723,839
/jdk1.7.0_80/javax/imageio/metadata/IIOMetadataFormatImpl.java,Java,,621,118,531,1270
/jdk1.7.0_80/javax/imageio/metadata/IIOMetadataNode.java,Java,,526,155,451,1132
/jdk1.7.0_80/javax/imageio/plugins/bmp/BMPImageWriteParam.java,Java,,23,11,82,116
/jdk1.7.0_80/javax/imageio/plugins/jpeg/JPEGHuffmanTable.java,Java,,146,23,87,256
/jdk1.7.0_80/javax/imageio/plugins/jpeg/JPEGImageReadParam.java,Java,,48,11,140,199
/jdk1.7.0_80/javax/imageio/plugins/jpeg/JPEGImageWriteParam.java,Java,,105,17,198,320
/jdk1.7.0_80/javax/imageio/plugins/jpeg/JPEGQTable.java,Java,,96,18,96,210
/jdk1.7.0_80/javax/imageio/spi/DigraphNode.java,Java,,62,20,79,161
/jdk1.7.0_80/javax/imageio/spi/IIORegistry.java,Java,,109,14,128,251
/jdk1.7.0_80/javax/imageio/spi/IIOServiceProvider.java,Java,,32,12,128,172
/jdk1.7.0_80/javax/imageio/spi/ImageInputStreamSpi.java,Java,,32,11,158,201
/jdk1.7.0_80/javax/imageio/spi/ImageOutputStreamSpi.java,Java,,33,11,156,200
/jdk1.7.0_80/javax/imageio/spi/ImageReaderSpi.java,Java,,79,18,316,413
/jdk1.7.0_80/javax/imageio/spi/ImageReaderWriterSpi.java,Java,,181,35,385,601
/jdk1.7.0_80/javax/imageio/spi/ImageTranscoderSpi.java,Java,,13,8,74,95
/jdk1.7.0_80/javax/imageio/spi/ImageWriterSpi.java,Java,,87,20,333,440
/jdk1.7.0_80/javax/imageio/spi/PartiallyOrderedSet.java,Java,,97,31,86,214
/jdk1.7.0_80/javax/imageio/spi/RegisterableService.java,Java,,5,4,55,64
/jdk1.7.0_80/javax/imageio/spi/ServiceRegistry.java,Java,,324,59,452,835
/jdk1.7.0_80/javax/imageio/stream/FileCacheImageInputStream.java,Java,,146,35,113,294
/jdk1.7.0_80/javax/imageio/stream/FileCacheImageOutputStream.java,Java,,129,29,103,261
/jdk1.7.0_80/javax/imageio/stream/FileImageInputStream.java,Java,,72,15,77,164
/jdk1.7.0_80/javax/imageio/stream/FileImageOutputStream.java,Java,,82,17,73,172
/jdk1.7.0_80/javax/imageio/stream/IIOByteBuffer.java,Java,,29,12,102,143
/jdk1.7.0_80/javax/imageio/stream/ImageInputStream.java,Java,,52,48,900,1000
/jdk1.7.0_80/javax/imageio/stream/ImageInputStreamImpl.java,Java,,544,109,227,880
/jdk1.7.0_80/javax/imageio/stream/ImageOutputStream.java,Java,,28,26,609,663
/jdk1.7.0_80/javax/imageio/stream/ImageOutputStreamImpl.java,Java,,385,53,72,510
/jdk1.7.0_80/javax/imageio/stream/MemoryCache.java,Java,,185,37,142,364
/jdk1.7.0_80/javax/imageio/stream/MemoryCacheImageInputStream.java,Java,,91,26,85,202
/jdk1.7.0_80/javax/imageio/stream/MemoryCacheImageOutputStream.java,Java,,88,24,84,196
/jdk1.7.0_80/javax/lang/model/element/AnnotationMirror.java,Java,,7,5,62,74
/jdk1.7.0_80/javax/lang/model/element/AnnotationValue.java,Java,,8,7,62,77
/jdk1.7.0_80/javax/lang/model/element/AnnotationValueVisitor.java,Java,,21,21,160,202
/jdk1.7.0_80/javax/lang/model/element/Element.java,Java,,22,17,237,276
/jdk1.7.0_80/javax/lang/model/element/ElementKind.java,Java,,29,13,87,129
/jdk1.7.0_80/javax/lang/model/element/ElementVisitor.java,Java,,12,10,114,136
/jdk1.7.0_80/javax/lang/model/element/ExecutableElement.java,Java,,14,9,90,113
/jdk1.7.0_80/javax/lang/model/element/Modifier.java,Java,,21,9,46,76
/jdk1.7.0_80/javax/lang/model/element/Name.java,Java,,6,4,79,89
/jdk1.7.0_80/javax/lang/model/element/NestingKind.java,Java,,10,3,86,99
/jdk1.7.0_80/javax/lang/model/element/package-info.java,Java,,1,1,96,98
/jdk1.7.0_80/javax/lang/model/element/PackageElement.java,Java,,9,6,63,78
/jdk1.7.0_80/javax/lang/model/element/Parameterizable.java,Java,,5,3,37,45
/jdk1.7.0_80/javax/lang/model/element/QualifiedNameable.java,Java,,4,2,35,41
/jdk1.7.0_80/javax/lang/model/element/TypeElement.java,Java,,16,12,132,160
/jdk1.7.0_80/javax/lang/model/element/TypeParameterElement.java,Java,,10,6,57,73
/jdk1.7.0_80/javax/lang/model/element/UnknownAnnotationValueException.java,Java,,18,8,61,87
/jdk1.7.0_80/javax/lang/model/element/UnknownElementException.java,Java,,18,8,59,85
/jdk1.7.0_80/javax/lang/model/element/VariableElement.java,Java,,6,4,56,66
/jdk1.7.0_80/javax/lang/model/package-info.java,Java,,1,2,57,60
/jdk1.7.0_80/javax/lang/model/SourceVersion.java,Java,,82,23,153,258
/jdk1.7.0_80/javax/lang/model/type/ArrayType.java,Java,,4,4,39,47
/jdk1.7.0_80/javax/lang/model/type/DeclaredType.java,Java,,10,9,78,97
/jdk1.7.0_80/javax/lang/model/type/ErrorType.java,Java,,3,2,37,42
/jdk1.7.0_80/javax/lang/model/type/ExecutableType.java,Java,,9,10,70,89
/jdk1.7.0_80/javax/lang/model/type/MirroredTypeException.java,Java,,22,9,50,81
/jdk1.7.0_80/javax/lang/model/type/MirroredTypesException.java,Java,,32,10,53,95
/jdk1.7.0_80/javax/lang/model/type/NoType.java,Java,,4,5,41,50
/jdk1.7.0_80/javax/lang/model/type/NullType.java,Java,,3,4,33,40
/jdk1.7.0_80/javax/lang/model/type/package-info.java,Java,,1,1,39,41
/jdk1.7.0_80/javax/lang/model/type/PrimitiveType.java,Java,,3,3,34,40
/jdk1.7.0_80/javax/lang/model/type/ReferenceType.java,Java,,3,3,34,40
/jdk1.7.0_80/javax/lang/model/type/TypeKind.java,Java,,38,24,108,170
/jdk1.7.0_80/javax/lang/model/type/TypeMirror.java,Java,,10,8,90,108
/jdk1.7.0_80/javax/lang/model/type/TypeVariable.java,Java,,9,8,67,84
/jdk1.7.0_80/javax/lang/model/type/TypeVisitor.java,Java,,17,15,143,175
/jdk1.7.0_80/javax/lang/model/type/UnionType.java,Java,,5,4,38,47
/jdk1.7.0_80/javax/lang/model/type/UnknownTypeException.java,Java,,18,8,59,85
/jdk1.7.0_80/javax/lang/model/type/WildcardType.java,Java,,5,5,55,65
/jdk1.7.0_80/javax/lang/model/UnknownEntityException.java,Java,,7,4,46,57
/jdk1.7.0_80/javax/lang/model/util/AbstractAnnotationValueVisitor6.java,Java,,21,9,85,115
/jdk1.7.0_80/javax/lang/model/util/AbstractAnnotationValueVisitor7.java,Java,,13,5,55,73
/jdk1.7.0_80/javax/lang/model/util/AbstractElementVisitor6.java,Java,,20,8,96,124
/jdk1.7.0_80/javax/lang/model/util/AbstractElementVisitor7.java,Java,,13,4,58,75
/jdk1.7.0_80/javax/lang/model/util/AbstractTypeVisitor6.java,Java,,17,7,104,128
/jdk1.7.0_80/javax/lang/model/util/AbstractTypeVisitor7.java,Java,,8,4,65,77
/jdk1.7.0_80/javax/lang/model/util/ElementFilter.java,Java,,89,20,105,214
/jdk1.7.0_80/javax/lang/model/util/ElementKindVisitor6.java,Java,,120,39,244,403
/jdk1.7.0_80/javax/lang/model/util/ElementKindVisitor7.java,Java,,19,5,86,110
/jdk1.7.0_80/javax/lang/model/util/Elements.java,Java,,23,21,208,252
/jdk1.7.0_80/javax/lang/model/util/ElementScanner6.java,Java,,46,14,153,213
/jdk1.7.0_80/javax/lang/model/util/ElementScanner7.java,Java,,19,6,95,120
/jdk1.7.0_80/javax/lang/model/util/package-info.java,Java,,1,1,41,43
/jdk1.7.0_80/javax/lang/model/util/SimpleAnnotationValueVisitor6.java,Java,,62,22,178,262
/jdk1.7.0_80/javax/lang/model/util/SimpleAnnotationValueVisitor7.java,Java,,16,5,69,90
/jdk1.7.0_80/javax/lang/model/util/SimpleElementVisitor6.java,Java,,37,11,133,181
/jdk1.7.0_80/javax/lang/model/util/SimpleElementVisitor7.java,Java,,19,5,81,105
/jdk1.7.0_80/javax/lang/model/util/SimpleTypeVisitor6.java,Java,,45,16,153,214
/jdk1.7.0_80/javax/lang/model/util/SimpleTypeVisitor7.java,Java,,18,5,82,105
/jdk1.7.0_80/javax/lang/model/util/TypeKindVisitor6.java,Java,,86,30,186,302
/jdk1.7.0_80/javax/lang/model/util/TypeKindVisitor7.java,Java,,19,5,84,108
/jdk1.7.0_80/javax/lang/model/util/Types.java,Java,,27,22,252,301
/jdk1.7.0_80/javax/management/AndQueryExp.java,Java,,26,14,67,107
/jdk1.7.0_80/javax/management/Attribute.java,Java,,41,22,72,135
/jdk1.7.0_80/javax/management/AttributeChangeNotification.java,Java,,29,20,97,146
/jdk1.7.0_80/javax/management/AttributeChangeNotificationFilter.java,Java,,34,18,74,126
/jdk1.7.0_80/javax/management/AttributeList.java,Java,,102,25,210,337
/jdk1.7.0_80/javax/management/AttributeNotFoundException.java,Java,,10,7,38,55
/jdk1.7.0_80/javax/management/AttributeValueExp.java,Java,,47,19,102,168
/jdk1.7.0_80/javax/management/BadAttributeValueExpException.java,Java,,33,12,44,89
/jdk1.7.0_80/javax/management/BadBinaryOpValueExpException.java,Java,,14,12,49,75
/jdk1.7.0_80/javax/management/BadStringOperationException.java,Java,,11,9,43,63
/jdk1.7.0_80/javax/management/BetweenQueryExp.java,Java,,52,18,72,142
/jdk1.7.0_80/javax/management/BinaryOpValueExp.java,Java,,122,28,107,257
/jdk1.7.0_80/javax/management/BinaryRelQueryExp.java,Java,,113,27,72,212
/jdk1.7.0_80/javax/management/BooleanValueExp.java,Java,,25,15,53,93
/jdk1.7.0_80/javax/management/ClassAttributeValueExp.java,Java,,48,14,80,142
/jdk1.7.0_80/javax/management/DefaultLoaderRepository.java,Java,,13,6,71,90
/jdk1.7.0_80/javax/management/Descriptor.java,Java,,28,19,587,634
/jdk1.7.0_80/javax/management/DescriptorAccess.java,Java,,5,2,50,57
/jdk1.7.0_80/javax/management/DescriptorKey.java,Java,,8,3,161,172
/jdk1.7.0_80/javax/management/DescriptorRead.java,Java,,4,2,35,41
/jdk1.7.0_80/javax/management/DynamicMBean.java,Java,,12,12,98,122
/jdk1.7.0_80/javax/management/ImmutableDescriptor.java,Java,,306,35,215,556
/jdk1.7.0_80/javax/management/InQueryExp.java,Java,,56,21,66,143
/jdk1.7.0_80/javax/management/InstanceAlreadyExistsException.java,Java,,10,7,38,55
/jdk1.7.0_80/javax/management/InstanceNotFoundException.java,Java,,10,6,38,54
/jdk1.7.0_80/javax/management/InstanceOfQueryExp.java,Java,,37,12,71,120
/jdk1.7.0_80/javax/management/IntrospectionException.java,Java,,10,6,38,54
/jdk1.7.0_80/javax/management/InvalidApplicationException.java,Java,,8,8,42,58
/jdk1.7.0_80/javax/management/InvalidAttributeValueException.java,Java,,10,6,38,54
/jdk1.7.0_80/javax/management/JMException.java,Java,,10,7,39,56
/jdk1.7.0_80/javax/management/JMRuntimeException.java,Java,,13,7,43,63
/jdk1.7.0_80/javax/management/JMX.java,Java,,86,23,326,435
/jdk1.7.0_80/javax/management/ListenerNotFoundException.java,Java,,10,7,38,55
/jdk1.7.0_80/javax/management/loading/ClassLoaderRepository.java,Java,,12,7,132,151
/jdk1.7.0_80/javax/management/loading/DefaultLoaderRepository.java,Java,,37,8,75,120
/jdk1.7.0_80/javax/management/loading/MLet.java,Java,,635,94,609,1338
/jdk1.7.0_80/javax/management/loading/MLetContent.java,Java,,75,28,136,239
/jdk1.7.0_80/javax/management/loading/MLetMBean.java,Java,,21,18,147,186
/jdk1.7.0_80/javax/management/loading/MLetObjectInputStream.java,Java,,61,21,40,122
/jdk1.7.0_80/javax/management/loading/MLetParser.java,Java,,187,23,77,287
/jdk1.7.0_80/javax/management/loading/PrivateClassLoader.java,Java,,2,2,33,37
/jdk1.7.0_80/javax/management/loading/PrivateMLet.java,Java,,18,6,75,99
/jdk1.7.0_80/javax/management/MalformedObjectNameException.java,Java,,10,7,38,55
/jdk1.7.0_80/javax/management/MatchQueryExp.java,Java,,91,18,73,182
/jdk1.7.0_80/javax/management/MBeanAttributeInfo.java,Java,,165,32,157,354
/jdk1.7.0_80/javax/management/MBeanConstructorInfo.java,Java,,84,19,112,215
/jdk1.7.0_80/javax/management/MBeanException.java,Java,,19,12,58,89
/jdk1.7.0_80/javax/management/MBeanFeatureInfo.java,Java,,84,30,153,267
/jdk1.7.0_80/javax/management/MBeanInfo.java,Java,,286,70,367,723
/jdk1.7.0_80/javax/management/MBeanNotificationInfo.java,Java,,80,22,114,216
/jdk1.7.0_80/javax/management/MBeanOperationInfo.java,Java,,136,31,170,337
/jdk1.7.0_80/javax/management/MBeanParameterInfo.java,Java,,52,17,81,150
/jdk1.7.0_80/javax/management/MBeanPermission.java,Java,,666,95,398,1159
/jdk1.7.0_80/javax/management/MBeanRegistration.java,Java,,8,9,100,117
/jdk1.7.0_80/javax/management/MBeanRegistrationException.java,Java,,10,6,45,61
/jdk1.7.0_80/javax/management/MBeanServer.java,Java,,115,46,635,796
/jdk1.7.0_80/javax/management/MBeanServerBuilder.java,Java,,15,5,93,113
/jdk1.7.0_80/javax/management/MBeanServerConnection.java,Java,,97,42,898,1037
/jdk1.7.0_80/javax/management/MBeanServerDelegate.java,Java,,108,24,102,234
/jdk1.7.0_80/javax/management/MBeanServerDelegateMBean.java,Java,,10,11,67,88
/jdk1.7.0_80/javax/management/MBeanServerFactory.java,Java,,167,38,338,543
/jdk1.7.0_80/javax/management/MBeanServerInvocationHandler.java,Java,,229,46,209,484
/jdk1.7.0_80/javax/management/MBeanServerNotification.java,Java,,21,10,127,158
/jdk1.7.0_80/javax/management/MBeanServerPermission.java,Java,,165,43,163,371
/jdk1.7.0_80/javax/management/MBeanTrustPermission.java,Java,,34,10,64,108
/jdk1.7.0_80/javax/management/modelmbean/DescriptorSupport.java,Java,,850,131,421,1402
/jdk1.7.0_80/javax/management/modelmbean/InvalidTargetObjectTypeException.java,Java,,88,17,94,199
/jdk1.7.0_80/javax/management/modelmbean/ModelMBean.java,Java,,17,7,99,123
/jdk1.7.0_80/javax/management/modelmbean/ModelMBeanAttributeInfo.java,Java,,225,41,264,530
/jdk1.7.0_80/javax/management/modelmbean/ModelMBeanConstructorInfo.java,Java,,233,34,224,491
/jdk1.7.0_80/javax/management/modelmbean/ModelMBeanInfo.java,Java,,36,31,303,370
/jdk1.7.0_80/javax/management/modelmbean/ModelMBeanInfoSupport.java,Java,,697,102,268,1067
/jdk1.7.0_80/javax/management/modelmbean/ModelMBeanNotificationBroadcaster.java,Java,,27,16,150,193
/jdk1.7.0_80/javax/management/modelmbean/ModelMBeanNotificationInfo.java,Java,,182,33,205,420
/jdk1.7.0_80/javax/management/modelmbean/ModelMBeanOperationInfo.java,Java,,253,35,254,542
/jdk1.7.0_80/javax/management/modelmbean/RequiredModelMBean.java,Java,,1862,314,828,3004
/jdk1.7.0_80/javax/management/modelmbean/XMLParseException.java,Java,,66,10,82,158
/jdk1.7.0_80/javax/management/monitor/CounterMonitor.java,Java,,470,85,426,981
/jdk1.7.0_80/javax/management/monitor/CounterMonitorMBean.java,Java,,25,21,170,216
/jdk1.7.0_80/javax/management/monitor/GaugeMonitor.java,Java,,431,73,380,884
/jdk1.7.0_80/javax/management/monitor/GaugeMonitorMBean.java,Java,,19,17,126,162
/jdk1.7.0_80/javax/management/monitor/Monitor.java,Java,,891,162,598,1651
/jdk1.7.0_80/javax/management/monitor/MonitorMBean.java,Java,,19,17,121,157
/jdk1.7.0_80/javax/management/monitor/MonitorNotification.java,Java,,39,34,186,259
/jdk1.7.0_80/javax/management/monitor/MonitorSettingException.java,Java,,10,6,42,58
/jdk1.7.0_80/javax/management/monitor/StringMonitor.java,Java,,202,44,217,463
/jdk1.7.0_80/javax/management/monitor/StringMonitorMBean.java,Java,,16,14,108,138
/jdk1.7.0_80/javax/management/MXBean.java,Java,,30,5,1143,1178
/jdk1.7.0_80/javax/management/NotCompliantMBeanException.java,Java,,10,8,38,56
/jdk1.7.0_80/javax/management/Notification.java,Java,,138,31,228,397
/jdk1.7.0_80/javax/management/NotificationBroadcaster.java,Java,,11,7,109,127
/jdk1.7.0_80/javax/management/NotificationBroadcasterSupport.java,Java,,142,37,175,354
/jdk1.7.0_80/javax/management/NotificationEmitter.java,Java,,8,3,87,98
/jdk1.7.0_80/javax/management/NotificationFilter.java,Java,,4,4,36,44
/jdk1.7.0_80/javax/management/NotificationFilterSupport.java,Java,,41,17,105,163
/jdk1.7.0_80/javax/management/NotificationListener.java,Java,,4,4,40,48
/jdk1.7.0_80/javax/management/NotQueryExp.java,Java,,21,13,59,93
/jdk1.7.0_80/javax/management/NumericValueExp.java,Java,,139,22,99,260
/jdk1.7.0_80/javax/management/ObjectInstance.java,Java,,45,17,92,154
/jdk1.7.0_80/javax/management/ObjectName.java,Java,,882,178,1051,2111
/jdk1.7.0_80/javax/management/openmbean/ArrayType.java,Java,,349,71,607,1027
/jdk1.7.0_80/javax/management/openmbean/CompositeData.java,Java,,13,18,143,174
/jdk1.7.0_80/javax/management/openmbean/CompositeDataInvocationHandler.java,Java,,80,11,159,250
/jdk1.7.0_80/javax/management/openmbean/CompositeDataSupport.java,Java,,212,51,223,486
/jdk1.7.0_80/javax/management/openmbean/CompositeDataView.java,Java,,4,2,122,128
/jdk1.7.0_80/javax/management/openmbean/CompositeType.java,Java,,161,52,265,478
/jdk1.7.0_80/javax/management/openmbean/InvalidKeyException.java,Java,,10,6,39,55
/jdk1.7.0_80/javax/management/openmbean/InvalidOpenTypeException.java,Java,,10,6,37,53
/jdk1.7.0_80/javax/management/openmbean/KeyAlreadyExistsException.java,Java,,10,6,39,55
/jdk1.7.0_80/javax/management/openmbean/OpenDataException.java,Java,,11,7,41,59
/jdk1.7.0_80/javax/management/openmbean/OpenMBeanAttributeInfo.java,Java,,9,21,108,138
/jdk1.7.0_80/javax/management/openmbean/OpenMBeanAttributeInfoSupport.java,Java,,557,97,473,1127
/jdk1.7.0_80/javax/management/openmbean/OpenMBeanConstructorInfo.java,Java,,10,18,109,137
/jdk1.7.0_80/javax/management/openmbean/OpenMBeanConstructorInfoSupport.java,Java,,84,33,188,305
/jdk1.7.0_80/javax/management/openmbean/OpenMBeanInfo.java,Java,,16,22,150,188
/jdk1.7.0_80/javax/management/openmbean/OpenMBeanInfoSupport.java,Java,,131,41,244,416
/jdk1.7.0_80/javax/management/openmbean/OpenMBeanOperationInfo.java,Java,,13,22,145,180
/jdk1.7.0_80/javax/management/openmbean/OpenMBeanOperationInfoSupport.java,Java,,136,48,243,427
/jdk1.7.0_80/javax/management/openmbean/OpenMBeanParameterInfo.java,Java,,20,29,163,212
/jdk1.7.0_80/javax/management/openmbean/OpenMBeanParameterInfoSupport.java,Java,,151,68,408,627
/jdk1.7.0_80/javax/management/openmbean/OpenType.java,Java,,175,41,202,418
/jdk1.7.0_80/javax/management/openmbean/SimpleType.java,Java,,89,49,182,320
/jdk1.7.0_80/javax/management/openmbean/TabularData.java,Java,,21,52,231,304
/jdk1.7.0_80/javax/management/openmbean/TabularDataSupport.java,Java,,242,140,534,916
/jdk1.7.0_80/javax/management/openmbean/TabularType.java,Java,,126,51,203,380
/jdk1.7.0_80/javax/management/OperationsException.java,Java,,10,8,39,57
/jdk1.7.0_80/javax/management/OrQueryExp.java,Java,,27,15,65,107
/jdk1.7.0_80/javax/management/PersistentMBean.java,Java,,10,7,75,92
/jdk1.7.0_80/javax/management/QualifiedAttributeValueExp.java,Java,,38,16,68,122
/jdk1.7.0_80/javax/management/Query.java,Java,,113,47,495,655
/jdk1.7.0_80/javax/management/QueryEval.java,Java,,13,7,58,78
/jdk1.7.0_80/javax/management/QueryExp.java,Java,,7,8,56,71
/jdk1.7.0_80/javax/management/ReflectionException.java,Java,,19,11,57,87
/jdk1.7.0_80/javax/management/relation/InvalidRelationIdException.java,Java,,10,5,39,54
/jdk1.7.0_80/javax/management/relation/InvalidRelationServiceException.java,Java,,10,5,38,53
/jdk1.7.0_80/javax/management/relation/InvalidRelationTypeException.java,Java,,10,5,42,57
/jdk1.7.0_80/javax/management/relation/InvalidRoleInfoException.java,Java,,10,5,39,54
/jdk1.7.0_80/javax/management/relation/InvalidRoleValueException.java,Java,,10,5,44,59
/jdk1.7.0_80/javax/management/relation/MBeanServerNotificationFilter.java,Java,,233,56,189,478
/jdk1.7.0_80/javax/management/relation/Relation.java,Java,,43,16,205,264
/jdk1.7.0_80/javax/management/relation/RelationException.java,Java,,11,6,39,56
/jdk1.7.0_80/javax/management/relation/RelationNotFoundException.java,Java,,10,5,39,54
/jdk1.7.0_80/javax/management/relation/RelationNotification.java,Java,,271,65,279,615
/jdk1.7.0_80/javax/management/relation/RelationService.java,Java,,1893,490,1407,3790
/jdk1.7.0_80/javax/management/relation/RelationServiceMBean.java,Java,,143,41,614,798
/jdk1.7.0_80/javax/management/relation/RelationServiceNotRegisteredException.java,Java,,10,5,39,54
/jdk1.7.0_80/javax/management/relation/RelationSupport.java,Java,,750,208,773,1731
/jdk1.7.0_80/javax/management/relation/RelationSupportMBean.java,Java,,7,4,65,76
/jdk1.7.0_80/javax/management/relation/RelationType.java,Java,,11,8,56,75
/jdk1.7.0_80/javax/management/relation/RelationTypeNotFoundException.java,Java,,10,5,39,54
/jdk1.7.0_80/javax/management/relation/RelationTypeSupport.java,Java,,232,61,193,486
/jdk1.7.0_80/javax/management/relation/Role.java,Java,,152,35,151,338
/jdk1.7.0_80/javax/management/relation/RoleInfo.java,Java,,293,53,263,609
/jdk1.7.0_80/javax/management/relation/RoleInfoNotFoundException.java,Java,,10,5,39,54
/jdk1.7.0_80/javax/management/relation/RoleList.java,Java,,148,37,188,373
/jdk1.7.0_80/javax/management/relation/RoleNotFoundException.java,Java,,10,5,39,54
/jdk1.7.0_80/javax/management/relation/RoleResult.java,Java,,118,25,118,261
/jdk1.7.0_80/javax/management/relation/RoleStatus.java,Java,,22,5,66,93
/jdk1.7.0_80/javax/management/relation/RoleUnresolved.java,Java,,164,32,162,358
/jdk1.7.0_80/javax/management/relation/RoleUnresolvedList.java,Java,,149,37,184,370
/jdk1.7.0_80/javax/management/remote/JMXAddressable.java,Java,,4,3,45,52
/jdk1.7.0_80/javax/management/remote/JMXAuthenticator.java,Java,,6,4,60,70
/jdk1.7.0_80/javax/management/remote/JMXConnectionNotification.java,Java,,39,13,145,197
/jdk1.7.0_80/javax/management/remote/JMXConnector.java,Java,,33,12,254,299
/jdk1.7.0_80/javax/management/remote/JMXConnectorFactory.java,Java,,266,54,252,572
/jdk1.7.0_80/javax/management/remote/JMXConnectorProvider.java,Java,,8,4,61,73
/jdk1.7.0_80/javax/management/remote/JMXConnectorServer.java,Java,,141,37,236,414
/jdk1.7.0_80/javax/management/remote/JMXConnectorServerFactory.java,Java,,127,22,208,357
/jdk1.7.0_80/javax/management/remote/JMXConnectorServerMBean.java,Java,,14,11,187,212
/jdk1.7.0_80/javax/management/remote/JMXConnectorServerProvider.java,Java,,10,4,68,82
/jdk1.7.0_80/javax/management/remote/JMXPrincipal.java,Java,,47,16,87,150
/jdk1.7.0_80/javax/management/remote/JMXProviderException.java,Java,,18,10,55,83
/jdk1.7.0_80/javax/management/remote/JMXServerErrorException.java,Java,,14,9,48,71
/jdk1.7.0_80/javax/management/remote/JMXServiceURL.java,Java,...,359,64,310,733
/jdk1.7.0_80/javax/management/remote/MBeanServerForwarder.java,Java,,6,5,54,65
/jdk1.7.0_80/javax/management/remote/NotificationResult.java,Java,,59,14,97,170
/jdk1.7.0_80/javax/management/remote/rmi/NoCallStackClassLoader.java,Java,,64,13,219,296
/jdk1.7.0_80/javax/management/remote/rmi/RMIConnection.java,Java,,194,32,866,1092
/jdk1.7.0_80/javax/management/remote/rmi/RMIConnectionImpl.java,Java,,1461,250,121,1832
/jdk1.7.0_80/javax/management/remote/rmi/RMIConnectionImpl_Stub.java,Java,,540,33,31,604
/jdk1.7.0_80/javax/management/remote/rmi/RMIConnector.java,Java,,1747,289,575,2611
/jdk1.7.0_80/javax/management/remote/rmi/RMIConnectorServer.java,Java,,420,94,338,852
/jdk1.7.0_80/javax/management/remote/rmi/RMIIIOPServerImpl.java,Java,,66,17,81,164
/jdk1.7.0_80/javax/management/remote/rmi/RMIJRMPServerImpl.java,Java,,90,20,89,199
/jdk1.7.0_80/javax/management/remote/rmi/RMIServer.java,Java,,8,4,79,91
/jdk1.7.0_80/javax/management/remote/rmi/RMIServerImpl.java,Java,,242,59,250,551
/jdk1.7.0_80/javax/management/remote/rmi/RMIServerImpl_Stub.java,Java,,49,8,6,63
/jdk1.7.0_80/javax/management/remote/SubjectDelegationPermission.java,Java,,13,7,76,96
/jdk1.7.0_80/javax/management/remote/TargetedNotification.java,Java,,42,14,95,151
/jdk1.7.0_80/javax/management/RuntimeErrorException.java,Java,,19,10,55,84
/jdk1.7.0_80/javax/management/RuntimeMBeanException.java,Java,,19,10,58,87
/jdk1.7.0_80/javax/management/RuntimeOperationsException.java,Java,,19,11,56,86
/jdk1.7.0_80/javax/management/ServiceNotFoundException.java,Java,,11,8,39,58
/jdk1.7.0_80/javax/management/StandardEmitterMBean.java,Java,,83,14,216,313
/jdk1.7.0_80/javax/management/StandardMBean.java,Java,,509,72,656,1237
/jdk1.7.0_80/javax/management/StringValueExp.java,Java,,22,13,72,107
/jdk1.7.0_80/javax/management/timer/Timer.java,Java,,510,157,625,1292
/jdk1.7.0_80/javax/management/timer/TimerAlarmClockNotification.java,Java,,8,5,39,52
/jdk1.7.0_80/javax/management/timer/TimerMBean.java,Java,,36,33,307,376
/jdk1.7.0_80/javax/management/timer/TimerNotification.java,Java,,18,16,80,114
/jdk1.7.0_80/javax/management/ValueExp.java,Java,,8,5,90,103
/jdk1.7.0_80/javax/naming/AuthenticationException.java,Java,,10,5,60,75
/jdk1.7.0_80/javax/naming/AuthenticationNotSupportedException.java,Java,,10,5,65,80
/jdk1.7.0_80/javax/naming/BinaryRefAddr.java,Java,,50,13,120,183
/jdk1.7.0_80/javax/naming/Binding.java,Java,,40,14,145,199
/jdk1.7.0_80/javax/naming/CannotProceedException.java,Java,,42,21,223,286
/jdk1.7.0_80/javax/naming/CommunicationException.java,Java,,10,4,52,66
/jdk1.7.0_80/javax/naming/CompositeName.java,Java,,125,32,473,630
/jdk1.7.0_80/javax/naming/CompoundName.java,Java,,127,29,468,624
/jdk1.7.0_80/javax/naming/ConfigurationException.java,Java,,10,4,58,72
/jdk1.7.0_80/javax/naming/Context.java,Java,,56,49,994,1099
/jdk1.7.0_80/javax/naming/ContextNotEmptyException.java,Java,,10,4,58,72
/jdk1.7.0_80/javax/naming/directory/Attribute.java,Java,,26,22,292,340
/jdk1.7.0_80/javax/naming/directory/AttributeInUseException.java,Java,,11,5,51,67
/jdk1.7.0_80/javax/naming/directory/AttributeModificationException.java,Java,,26,12,102,140
/jdk1.7.0_80/javax/naming/directory/Attributes.java,Java,,16,15,152,183
/jdk1.7.0_80/javax/naming/directory/BasicAttribute.java,Java,,269,51,236,556
/jdk1.7.0_80/javax/naming/directory/BasicAttributes.java,Java,,169,45,162,376
/jdk1.7.0_80/javax/naming/directory/DirContext.java,Java,,77,35,927,1039
/jdk1.7.0_80/javax/naming/directory/InitialDirContext.java,Java,,181,38,81,300
/jdk1.7.0_80/javax/naming/directory/InvalidAttributeIdentifierException.java,Java,,11,6,49,66
/jdk1.7.0_80/javax/naming/directory/InvalidAttributesException.java,Java,,11,6,55,72
/jdk1.7.0_80/javax/naming/directory/InvalidAttributeValueException.java,Java,,11,6,53,70
/jdk1.7.0_80/javax/naming/directory/InvalidSearchControlsException.java,Java,,11,6,50,67
/jdk1.7.0_80/javax/naming/directory/InvalidSearchFilterException.java,Java,,11,6,50,67
/jdk1.7.0_80/javax/naming/directory/ModificationItem.java,Java,,37,13,83,133
/jdk1.7.0_80/javax/naming/directory/NoSuchAttributeException.java,Java,,11,7,48,66
/jdk1.7.0_80/javax/naming/directory/SchemaViolationException.java,Java,,11,6,60,77
/jdk1.7.0_80/javax/naming/directory/SearchControls.java,Java,,70,26,240,336
/jdk1.7.0_80/javax/naming/directory/SearchResult.java,Java,,34,14,141,189
/jdk1.7.0_80/javax/naming/event/EventContext.java,Java,,15,12,222,249
/jdk1.7.0_80/javax/naming/event/EventDirContext.java,Java,,15,6,138,159
/jdk1.7.0_80/javax/naming/event/NamespaceChangeListener.java,Java,,6,5,80,91
/jdk1.7.0_80/javax/naming/event/NamingEvent.java,Java,,52,20,228,300
/jdk1.7.0_80/javax/naming/event/NamingExceptionEvent.java,Java,,19,9,66,94
/jdk1.7.0_80/javax/naming/event/NamingListener.java,Java,,4,2,59,65
/jdk1.7.0_80/javax/naming/event/ObjectChangeListener.java,Java,,4,3,66,73
/jdk1.7.0_80/javax/naming/InitialContext.java,Java,,195,50,314,559
/jdk1.7.0_80/javax/naming/InsufficientResourcesException.java,Java,,10,5,57,72
/jdk1.7.0_80/javax/naming/InterruptedNamingException.java,Java,,10,5,61,76
/jdk1.7.0_80/javax/naming/InvalidNameException.java,Java,,10,5,57,72
/jdk1.7.0_80/javax/naming/ldap/BasicControl.java,Java,,24,11,82,117
/jdk1.7.0_80/javax/naming/ldap/Control.java,Java,,8,7,81,96
/jdk1.7.0_80/javax/naming/ldap/ControlFactory.java,Java,,27,13,117,157
/jdk1.7.0_80/javax/naming/ldap/ExtendedRequest.java,Java,,8,7,133,148
/jdk1.7.0_80/javax/naming/ldap/ExtendedResponse.java,Java,,5,6,88,99
/jdk1.7.0_80/javax/naming/ldap/HasControls.java,Java,,5,5,60,70
/jdk1.7.0_80/javax/naming/ldap/InitialLdapContext.java,Java,,62,20,129,211
/jdk1.7.0_80/javax/naming/ldap/LdapContext.java,Java,,17,11,323,351
/jdk1.7.0_80/javax/naming/ldap/LdapName.java,Java,,295,55,441,791
/jdk1.7.0_80/javax/naming/ldap/LdapReferralException.java,Java,,22,9,131,162
/jdk1.7.0_80/javax/naming/ldap/ManageReferralControl.java,Java,,11,6,50,67
/jdk1.7.0_80/javax/naming/ldap/PagedResultsControl.java,Java,,31,14,153,198
/jdk1.7.0_80/javax/naming/ldap/PagedResultsResponseControl.java,Java,,28,13,92,133
/jdk1.7.0_80/javax/naming/ldap/Rdn.java,Java,,369,71,328,768
/jdk1.7.0_80/javax/naming/ldap/Rfc2253Parser.java,Java,,153,34,66,253
/jdk1.7.0_80/javax/naming/ldap/SortControl.java,Java,,44,17,161,222
/jdk1.7.0_80/javax/naming/ldap/SortKey.java,Java,,24,11,83,118
/jdk1.7.0_80/javax/naming/ldap/SortResponseControl.java,Java,,35,16,118,169
/jdk1.7.0_80/javax/naming/ldap/StartTlsRequest.java,Java,,76,27,146,249
/jdk1.7.0_80/javax/naming/ldap/StartTlsResponse.java,Java,,23,19,164,206
/jdk1.7.0_80/javax/naming/ldap/UnsolicitedNotification.java,Java,,6,5,53,64
/jdk1.7.0_80/javax/naming/ldap/UnsolicitedNotificationEvent.java,Java,,16,8,60,84
/jdk1.7.0_80/javax/naming/ldap/UnsolicitedNotificationListener.java,Java,,5,4,59,68
/jdk1.7.0_80/javax/naming/LimitExceededException.java,Java,,11,7,56,74
/jdk1.7.0_80/javax/naming/LinkException.java,Java,,63,23,218,304
/jdk1.7.0_80/javax/naming/LinkLoopException.java,Java,,10,5,52,67
/jdk1.7.0_80/javax/naming/LinkRef.java,Java,,21,7,88,116
/jdk1.7.0_80/javax/naming/MalformedLinkException.java,Java,,10,6,51,67
/jdk1.7.0_80/javax/naming/Name.java,Java,,22,20,235,277
/jdk1.7.0_80/javax/naming/NameAlreadyBoundException.java,Java,,10,5,58,73
/jdk1.7.0_80/javax/naming/NameClassPair.java,Java,,48,21,229,298
/jdk1.7.0_80/javax/naming/NameImpl.java,Java,,530,80,120,730
/jdk1.7.0_80/javax/naming/NameNotFoundException.java,Java,,10,5,50,65
/jdk1.7.0_80/javax/naming/NameParser.java,Java,,4,3,50,57
/jdk1.7.0_80/javax/naming/NamingEnumeration.java,Java,,7,5,135,147
/jdk1.7.0_80/javax/naming/NamingException.java,Java,,104,24,307,435
/jdk1.7.0_80/javax/naming/NamingSecurityException.java,Java,,10,5,56,71
/jdk1.7.0_80/javax/naming/NoInitialContextException.java,Java,,10,4,61,75
/jdk1.7.0_80/javax/naming/NoPermissionException.java,Java,,10,4,50,64
/jdk1.7.0_80/javax/naming/NotContextException.java,Java,,10,5,58,73
/jdk1.7.0_80/javax/naming/OperationNotSupportedException.java,Java,,10,5,52,67
/jdk1.7.0_80/javax/naming/PartialResultException.java,Java,,10,5,51,66
/jdk1.7.0_80/javax/naming/RefAddr.java,Java,,36,12,103,151
/jdk1.7.0_80/javax/naming/Reference.java,Java,,109,29,257,395
/jdk1.7.0_80/javax/naming/Referenceable.java,Java,,4,2,52,58
/jdk1.7.0_80/javax/naming/ReferralException.java,Java,,18,11,175,204
/jdk1.7.0_80/javax/naming/ServiceUnavailableException.java,Java,,10,5,53,68
/jdk1.7.0_80/javax/naming/SizeLimitExceededException.java,Java,,11,6,52,69
/jdk1.7.0_80/javax/naming/spi/ContinuationContext.java,Java,,181,34,31,246
/jdk1.7.0_80/javax/naming/spi/ContinuationDirContext.java,Java,,244,52,37,333
/jdk1.7.0_80/javax/naming/spi/DirectoryManager.java,Java,,121,30,186,337
/jdk1.7.0_80/javax/naming/spi/DirObjectFactory.java,Java,,10,4,118,132
/jdk1.7.0_80/javax/naming/spi/DirStateFactory.java,Java,,20,10,158,188
/jdk1.7.0_80/javax/naming/spi/InitialContextFactory.java,Java,,7,4,61,72
/jdk1.7.0_80/javax/naming/spi/InitialContextFactoryBuilder.java,Java,,8,3,60,71
/jdk1.7.0_80/javax/naming/spi/NamingManager.java,Java,,302,83,489,874
/jdk1.7.0_80/javax/naming/spi/ObjectFactory.java,Java,,8,5,161,174
/jdk1.7.0_80/javax/naming/spi/ObjectFactoryBuilder.java,Java,,8,3,64,75
/jdk1.7.0_80/javax/naming/spi/Resolver.java,Java,,12,7,77,96
/jdk1.7.0_80/javax/naming/spi/ResolveResult.java,Java,,63,13,125,201
/jdk1.7.0_80/javax/naming/spi/StateFactory.java,Java,,8,2,128,138
/jdk1.7.0_80/javax/naming/StringRefAddr.java,Java,,12,5,69,86
/jdk1.7.0_80/javax/naming/TimeLimitExceededException.java,Java,,11,6,52,69
/jdk1.7.0_80/javax/print/attribute/Attribute.java,Java,,6,6,51,63
/jdk1.7.0_80/javax/print/attribute/AttributeSet.java,Java,,16,19,275,310
/jdk1.7.0_80/javax/print/attribute/AttributeSetUtilities.java,Java,,259,73,246,578
/jdk1.7.0_80/javax/print/attribute/DateTimeSyntax.java,Java,,27,17,102,146
/jdk1.7.0_80/javax/print/attribute/DocAttribute.java,Java,,3,4,41,48
/jdk1.7.0_80/javax/print/attribute/DocAttributeSet.java,Java,,5,6,100,111
/jdk1.7.0_80/javax/print/attribute/EnumSyntax.java,Java,,60,23,198,281
/jdk1.7.0_80/javax/print/attribute/HashAttributeSet.java,Java,,163,37,328,528
/jdk1.7.0_80/javax/print/attribute/HashDocAttributeSet.java,Java,,18,10,74,102
/jdk1.7.0_80/javax/print/attribute/HashPrintJobAttributeSet.java,Java,,18,9,73,100
/jdk1.7.0_80/javax/print/attribute/HashPrintRequestAttributeSet.java,Java,,19,12,73,104
/jdk1.7.0_80/javax/print/attribute/HashPrintServiceAttributeSet.java,Java,,19,10,73,102
/jdk1.7.0_80/javax/print/attribute/IntegerSyntax.java,Java,,30,12,92,134
/jdk1.7.0_80/javax/print/attribute/PrintJobAttribute.java,Java,,3,2,40,45
/jdk1.7.0_80/javax/print/attribute/PrintJobAttributeSet.java,Java,,5,5,99,109
/jdk1.7.0_80/javax/print/attribute/PrintRequestAttribute.java,Java,,3,4,44,51
/jdk1.7.0_80/javax/print/attribute/PrintRequestAttributeSet.java,Java,,5,6,100,111
/jdk1.7.0_80/javax/print/attribute/PrintServiceAttribute.java,Java,,3,2,36,41
/jdk1.7.0_80/javax/print/attribute/PrintServiceAttributeSet.java,Java,,5,7,102,114
/jdk1.7.0_80/javax/print/attribute/ResolutionSyntax.java,Java,,82,29,247,358
/jdk1.7.0_80/javax/print/attribute/SetOfIntegerSyntax.java,Java,,265,41,252,558
/jdk1.7.0_80/javax/print/attribute/Size2DSyntax.java,Java,,85,23,238,346
/jdk1.7.0_80/javax/print/attribute/standard/Chromaticity.java,Java,,31,15,113,159
/jdk1.7.0_80/javax/print/attribute/standard/ColorSupported.java,Java,,29,13,88,130
/jdk1.7.0_80/javax/print/attribute/standard/Compression.java,Java,,34,16,84,134
/jdk1.7.0_80/javax/print/attribute/standard/Copies.java,Java,,21,8,107,136
/jdk1.7.0_80/javax/print/attribute/standard/CopiesSupported.java,Java,,31,10,100,141
/jdk1.7.0_80/javax/print/attribute/standard/DateTimeAtCompleted.java,Java,,22,9,94,125
/jdk1.7.0_80/javax/print/attribute/standard/DateTimeAtCreation.java,Java,,22,8,93,123
/jdk1.7.0_80/javax/print/attribute/standard/DateTimeAtProcessing.java,Java,,22,8,94,124
/jdk1.7.0_80/javax/print/attribute/standard/Destination.java,Java,,23,9,91,123
/jdk1.7.0_80/javax/print/attribute/standard/DialogTypeSelection.java,Java,,32,17,82,131
/jdk1.7.0_80/javax/print/attribute/standard/DocumentName.java,Java,,20,9,92,121
/jdk1.7.0_80/javax/print/attribute/standard/Fidelity.java,Java,,35,13,81,129
/jdk1.7.0_80/javax/print/attribute/standard/Finishings.java,Java,,122,30,325,477
/jdk1.7.0_80/javax/print/attribute/standard/JobHoldUntil.java,Java,,22,10,121,153
/jdk1.7.0_80/javax/print/attribute/standard/JobImpressions.java,Java,,21,9,114,144
/jdk1.7.0_80/javax/print/attribute/standard/JobImpressionsCompleted.java,Java,,21,8,99,128
/jdk1.7.0_80/javax/print/attribute/standard/JobImpressionsSupported.java,Java,,27,10,93,130
/jdk1.7.0_80/javax/print/attribute/standard/JobKOctets.java,Java,,21,8,165,194
/jdk1.7.0_80/javax/print/attribute/standard/JobKOctetsProcessed.java,Java,,21,8,111,140
/jdk1.7.0_80/javax/print/attribute/standard/JobKOctetsSupported.java,Java,,27,8,93,128
/jdk1.7.0_80/javax/print/attribute/standard/JobMediaSheets.java,Java,,21,9,108,138
/jdk1.7.0_80/javax/print/attribute/standard/JobMediaSheetsCompleted.java,Java,,21,8,99,128
/jdk1.7.0_80/javax/print/attribute/standard/JobMediaSheetsSupported.java,Java,,27,8,93,128
/jdk1.7.0_80/javax/print/attribute/standard/JobMessageFromOperator.java,Java,,22,9,98,129
/jdk1.7.0_80/javax/print/attribute/standard/JobName.java,Java,,22,9,94,125
/jdk1.7.0_80/javax/print/attribute/standard/JobOriginatingUserName.java,Java,,22,9,98,129
/jdk1.7.0_80/javax/print/attribute/standard/JobPriority.java,Java,,21,8,98,127
/jdk1.7.0_80/javax/print/attribute/standard/JobPrioritySupported.java,Java,,21,11,92,124
/jdk1.7.0_80/javax/print/attribute/standard/JobSheets.java,Java,,35,14,85,134
/jdk1.7.0_80/javax/print/attribute/standard/JobState.java,Java,,52,22,163,237
/jdk1.7.0_80/javax/print/attribute/standard/JobStateReason.java,Java,,138,41,282,461
/jdk1.7.0_80/javax/print/attribute/standard/JobStateReasons.java,Java,,33,12,136,181
/jdk1.7.0_80/javax/print/attribute/standard/Media.java,Java,,24,8,91,123
/jdk1.7.0_80/javax/print/attribute/standard/MediaName.java,Java,,33,15,65,113
/jdk1.7.0_80/javax/print/attribute/standard/MediaPrintableArea.java,Java,,85,24,226,335
/jdk1.7.0_80/javax/print/attribute/standard/MediaSize.java,Java,,319,35,501,855
/jdk1.7.0_80/javax/print/attribute/standard/MediaSizeName.java,Java,,260,35,270,565
/jdk1.7.0_80/javax/print/attribute/standard/MediaTray.java,Java,,45,20,75,140
/jdk1.7.0_80/javax/print/attribute/standard/MultipleDocumentHandling.java,Java,,44,17,207,268
/jdk1.7.0_80/javax/print/attribute/standard/NumberOfDocuments.java,Java,,21,9,84,114
/jdk1.7.0_80/javax/print/attribute/standard/NumberOfInterveningJobs.java,Java,,21,8,84,113
/jdk1.7.0_80/javax/print/attribute/standard/NumberUp.java,Java,,22,9,161,192
/jdk1.7.0_80/javax/print/attribute/standard/NumberUpSupported.java,Java,,51,11,117,179
/jdk1.7.0_80/javax/print/attribute/standard/OrientationRequested.java,Java,,48,16,124,188
/jdk1.7.0_80/javax/print/attribute/standard/OutputDeviceAssigned.java,Java,,22,11,95,128
/jdk1.7.0_80/javax/print/attribute/standard/PageRanges.java,Java,,60,13,192,265
/jdk1.7.0_80/javax/print/attribute/standard/PagesPerMinute.java,Java,,21,8,85,114
/jdk1.7.0_80/javax/print/attribute/standard/PagesPerMinuteColor.java,Java,,21,8,97,126
/jdk1.7.0_80/javax/print/attribute/standard/PDLOverrideSupported.java,Java,,35,14,79,128
/jdk1.7.0_80/javax/print/attribute/standard/PresentationDirection.java,Java,,60,19,107,186
/jdk1.7.0_80/javax/print/attribute/standard/PrinterInfo.java,Java,,21,9,91,121
/jdk1.7.0_80/javax/print/attribute/standard/PrinterIsAcceptingJobs.java,Java,,35,13,80,128
/jdk1.7.0_80/javax/print/attribute/standard/PrinterLocation.java,Java,,21,9,89,119
/jdk1.7.0_80/javax/print/attribute/standard/PrinterMakeAndModel.java,Java,,22,8,88,118
/jdk1.7.0_80/javax/print/attribute/standard/PrinterMessageFromOperator.java,Java,,22,9,103,134
/jdk1.7.0_80/javax/print/attribute/standard/PrinterMoreInfo.java,Java,,22,9,92,123
/jdk1.7.0_80/javax/print/attribute/standard/PrinterMoreInfoManufacturer.java,Java,,22,9,96,127
/jdk1.7.0_80/javax/print/attribute/standard/PrinterName.java,Java,,21,9,91,121
/jdk1.7.0_80/javax/print/attribute/standard/PrinterResolution.java,Java,,24,8,119,151
/jdk1.7.0_80/javax/print/attribute/standard/PrinterState.java,Java,,43,15,84,142
/jdk1.7.0_80/javax/print/attribute/standard/PrinterStateReason.java,Java,,156,45,243,444
/jdk1.7.0_80/javax/print/attribute/standard/PrinterStateReasons.java,Java,,108,23,178,309
/jdk1.7.0_80/javax/print/attribute/standard/PrinterURI.java,Java,,22,10,84,116
/jdk1.7.0_80/javax/print/attribute/standard/PrintQuality.java,Java,,41,14,80,135
/jdk1.7.0_80/javax/print/attribute/standard/QueuedJobCount.java,Java,,21,8,82,111
/jdk1.7.0_80/javax/print/attribute/standard/ReferenceUriSchemesSupported.java,Java,,51,19,113,183
/jdk1.7.0_80/javax/print/attribute/standard/RequestingUserName.java,Java,,22,9,99,130
/jdk1.7.0_80/javax/print/attribute/standard/Severity.java,Java,,34,15,109,158
/jdk1.7.0_80/javax/print/attribute/standard/SheetCollate.java,Java,,35,13,186,234
/jdk1.7.0_80/javax/print/attribute/standard/Sides.java,Java,,40,17,165,222
/jdk1.7.0_80/javax/print/attribute/SupportedValuesAttribute.java,Java,,3,3,38,44
/jdk1.7.0_80/javax/print/attribute/TextSyntax.java,Java,,42,16,94,152
/jdk1.7.0_80/javax/print/attribute/UnmodifiableSetException.java,Java,,8,3,40,51
/jdk1.7.0_80/javax/print/attribute/URISyntax.java,Java,,30,13,78,121
/jdk1.7.0_80/javax/print/AttributeException.java,Java,,6,8,52,66
/jdk1.7.0_80/javax/print/CancelablePrintJob.java,Java,,4,5,68,77
/jdk1.7.0_80/javax/print/Doc.java,Java,,12,11,183,206
/jdk1.7.0_80/javax/print/DocFlavor.java,Java,,225,123,1085,1433
/jdk1.7.0_80/javax/print/DocPrintJob.java,Java,,19,12,145,176
/jdk1.7.0_80/javax/print/event/PrintEvent.java,Java,,10,7,37,54
/jdk1.7.0_80/javax/print/event/PrintJobAdapter.java,Java,,15,13,77,105
/jdk1.7.0_80/javax/print/event/PrintJobAttributeEvent.java,Java,,19,16,47,82
/jdk1.7.0_80/javax/print/event/PrintJobAttributeListener.java,Java,,4,4,38,46
/jdk1.7.0_80/javax/print/event/PrintJobEvent.java,Java,,22,20,83,125
/jdk1.7.0_80/javax/print/event/PrintJobListener.java,Java,,9,15,71,95
/jdk1.7.0_80/javax/print/event/PrintServiceAttributeEvent.java,Java,,19,15,50,84
/jdk1.7.0_80/javax/print/event/PrintServiceAttributeListener.java,Java,,4,5,39,48
/jdk1.7.0_80/javax/print/FlavorException.java,Java,,5,5,37,47
/jdk1.7.0_80/javax/print/MimeType.java,Java,,389,43,215,647
/jdk1.7.0_80/javax/print/MultiDoc.java,Java,,6,8,122,136
/jdk1.7.0_80/javax/print/MultiDocPrintJob.java,Java,,6,6,55,67
/jdk1.7.0_80/javax/print/MultiDocPrintService.java,Java,,4,5,33,42
/jdk1.7.0_80/javax/print/PrintException.java,Java,,15,8,50,73
/jdk1.7.0_80/javax/print/PrintService.java,Java,,37,25,426,488
/jdk1.7.0_80/javax/print/PrintServiceLookup.java,Java,,254,41,193,488
/jdk1.7.0_80/javax/print/ServiceUI.java,Java,,132,27,177,336
/jdk1.7.0_80/javax/print/ServiceUIFactory.java,Java,,13,15,114,142
/jdk1.7.0_80/javax/print/SimpleDoc.java,Java,,79,22,153,254
/jdk1.7.0_80/javax/print/StreamPrintService.java,Java,,21,12,81,114
/jdk1.7.0_80/javax/print/StreamPrintServiceFactory.java,Java,,101,26,108,235
/jdk1.7.0_80/javax/print/URIException.java,Java,,9,10,54,73
/jdk1.7.0_80/javax/rmi/CORBA/ClassDesc.java,Java,,5,4,39,48
/jdk1.7.0_80/javax/rmi/CORBA/GetORBPropertiesFileAction.java,Java,,54,18,36,108
/jdk1.7.0_80/javax/rmi/CORBA/PortableRemoteObjectDelegate.java,Java,,17,9,58,84
/jdk1.7.0_80/javax/rmi/CORBA/Stub.java,Java,,134,43,84,261
/jdk1.7.0_80/javax/rmi/CORBA/StubDelegate.java,Java,,17,10,66,93
/jdk1.7.0_80/javax/rmi/CORBA/Tie.java,Java,,18,9,58,85
/jdk1.7.0_80/javax/rmi/CORBA/Util.java,Java,,166,51,174,391
/jdk1.7.0_80/javax/rmi/CORBA/UtilDelegate.java,Java,,28,19,88,135
/jdk1.7.0_80/javax/rmi/CORBA/ValueHandler.java,Java,,14,9,73,96
/jdk1.7.0_80/javax/rmi/CORBA/ValueHandlerMultiFormat.java,Java,,7,4,59,70
/jdk1.7.0_80/javax/rmi/PortableRemoteObject.java,Java,,150,42,101,293
/jdk1.7.0_80/javax/rmi/ssl/SslRMIClientSocketFactory.java,Java,,67,10,135,212
/jdk1.7.0_80/javax/rmi/ssl/SslRMIServerSocketFactory.java,Java,,144,22,212,378
/jdk1.7.0_80/javax/script/AbstractScriptEngine.java,Java,,88,42,181,311
/jdk1.7.0_80/javax/script/Bindings.java,Java,,9,6,110,125
/jdk1.7.0_80/javax/script/Compilable.java,Java,,9,5,58,72
/jdk1.7.0_80/javax/script/CompiledScript.java,Java,,23,13,81,117
/jdk1.7.0_80/javax/script/Invocable.java,Java,,9,7,95,111
/jdk1.7.0_80/javax/script/ScriptContext.java,Java,,22,24,160,206
/jdk1.7.0_80/javax/script/ScriptEngine.java,Java,,27,33,263,323
/jdk1.7.0_80/javax/script/ScriptEngineFactory.java,Java,,16,18,196,230
/jdk1.7.0_80/javax/script/ScriptEngineManager.java,Java,,218,28,171,417
/jdk1.7.0_80/javax/script/ScriptException.java,Java,,55,13,84,152
/jdk1.7.0_80/javax/script/SimpleBindings.java,Java,,75,19,129,223
/jdk1.7.0_80/javax/script/SimpleScriptContext.java,Java,,129,42,151,322
/jdk1.7.0_80/javax/security/auth/AuthPermission.java,Java,,13,5,154,172
/jdk1.7.0_80/javax/security/auth/callback/Callback.java,Java,,2,3,47,52
/jdk1.7.0_80/javax/security/auth/callback/CallbackHandler.java,Java,,5,3,145,153
/jdk1.7.0_80/javax/security/auth/callback/ChoiceCallback.java,Java,,48,15,148,211
/jdk1.7.0_80/javax/security/auth/callback/ConfirmationCallback.java,Java,,122,37,342,501
/jdk1.7.0_80/javax/security/auth/callback/LanguageCallback.java,Java,,13,8,58,79
/jdk1.7.0_80/javax/security/auth/callback/NameCallback.java,Java,,31,11,102,144
/jdk1.7.0_80/javax/security/auth/callback/PasswordCallback.java,Java,,31,11,100,142
/jdk1.7.0_80/javax/security/auth/callback/TextInputCallback.java,Java,,31,11,103,145
/jdk1.7.0_80/javax/security/auth/callback/TextOutputCallback.java,Java,,23,9,75,107
/jdk1.7.0_80/javax/security/auth/callback/UnsupportedCallbackException.java,Java,,16,7,58,81
/jdk1.7.0_80/javax/security/auth/Destroyable.java,Java,,5,4,53,62
/jdk1.7.0_80/javax/security/auth/DestroyFailedException.java,Java,,10,5,45,60
/jdk1.7.0_80/javax/security/auth/kerberos/DelegationPermission.java,Java,,131,49,211,391
/jdk1.7.0_80/javax/security/auth/kerberos/JavaxSecurityAuthKerberosAccessImpl.java,Java,,11,3,24,38
/jdk1.7.0_80/javax/security/auth/kerberos/KerberosKey.java,Java,,112,30,162,304
/jdk1.7.0_80/javax/security/auth/kerberos/KerberosPrincipal.java,Java,,103,43,156,302
/jdk1.7.0_80/javax/security/auth/kerberos/KerberosTicket.java,Java,,371,85,328,784
/jdk1.7.0_80/javax/security/auth/kerberos/KeyImpl.java,Java,,142,37,65,244
/jdk1.7.0_80/javax/security/auth/kerberos/KeyTab.java,Java,,81,18,144,243
/jdk1.7.0_80/javax/security/auth/kerberos/ServicePermission.java,Java,,219,92,288,599
/jdk1.7.0_80/javax/security/auth/login/AccountException.java,Java,,10,5,42,57
/jdk1.7.0_80/javax/security/auth/login/AccountExpiredException.java,Java,,10,5,48,63
/jdk1.7.0_80/javax/security/auth/login/AccountLockedException.java,Java,,10,5,46,61
/jdk1.7.0_80/javax/security/auth/login/AccountNotFoundException.java,Java,,10,5,45,60
/jdk1.7.0_80/javax/security/auth/login/AppConfigurationEntry.java,Java,,50,17,106,173
/jdk1.7.0_80/javax/security/auth/login/Configuration.java,Java,,197,37,389,623
/jdk1.7.0_80/javax/security/auth/login/ConfigurationSpi.java,Java,,6,5,64,75
/jdk1.7.0_80/javax/security/auth/login/CredentialException.java,Java,,10,5,42,57
/jdk1.7.0_80/javax/security/auth/login/CredentialExpiredException.java,Java,,10,5,50,65
/jdk1.7.0_80/javax/security/auth/login/CredentialNotFoundException.java,Java,,10,5,45,60
/jdk1.7.0_80/javax/security/auth/login/FailedLoginException.java,Java,,10,5,45,60
/jdk1.7.0_80/javax/security/auth/login/LoginContext.java,Java,,397,86,491,974
/jdk1.7.0_80/javax/security/auth/login/LoginException.java,Java,,10,6,42,58
/jdk1.7.0_80/javax/security/auth/Policy.java,Java,,105,17,245,367
/jdk1.7.0_80/javax/security/auth/PrivateCredentialPermission.java,Java,,227,81,253,561
/jdk1.7.0_80/javax/security/auth/Refreshable.java,Java,,5,4,53,62
/jdk1.7.0_80/javax/security/auth/RefreshFailedException.java,Java,,10,5,45,60
/jdk1.7.0_80/javax/security/auth/spi/LoginModule.java,Java,,15,8,217,240
/jdk1.7.0_80/javax/security/auth/Subject.java,Java,,684,145,618,1447
/jdk1.7.0_80/javax/security/auth/SubjectDomainCombiner.java,Java,,334,66,165,565
/jdk1.7.0_80/javax/security/auth/x500/X500Principal.java,Java,,140,23,336,499
/jdk1.7.0_80/javax/security/auth/x500/X500PrivateCredential.java,Java,,41,14,79,134
/jdk1.7.0_80/javax/security/cert/Certificate.java,Java,,49,12,116,177
/jdk1.7.0_80/javax/security/cert/CertificateEncodingException.java,Java,,9,5,49,63
/jdk1.7.0_80/javax/security/cert/CertificateException.java,Java,,9,5,48,62
/jdk1.7.0_80/javax/security/cert/CertificateExpiredException.java,Java,,9,5,51,65
/jdk1.7.0_80/javax/security/cert/CertificateNotYetValidException.java,Java,,9,5,51,65
/jdk1.7.0_80/javax/security/cert/CertificateParsingException.java,Java,,9,5,50,64
/jdk1.7.0_80/javax/security/cert/X509Certificate.java,Java,,79,24,349,452
/jdk1.7.0_80/javax/security/sasl/AuthenticationException.java,Java,,13,5,65,83
/jdk1.7.0_80/javax/security/sasl/AuthorizeCallback.java,Java,,34,14,97,145
/jdk1.7.0_80/javax/security/sasl/RealmCallback.java,Java,,11,6,50,67
/jdk1.7.0_80/javax/security/sasl/RealmChoiceCallback.java,Java,,9,5,48,62
/jdk1.7.0_80/javax/security/sasl/Sasl.java,Java,,179,37,390,606
/jdk1.7.0_80/javax/security/sasl/SaslClient.java,Java,,14,11,200,225
/jdk1.7.0_80/javax/security/sasl/SaslClientFactory.java,Java,,13,4,95,112
/jdk1.7.0_80/javax/security/sasl/SaslException.java,Java,,33,11,85,129
/jdk1.7.0_80/javax/security/sasl/SaslServer.java,Java,,14,11,191,216
/jdk1.7.0_80/javax/security/sasl/SaslServerFactory.java,Java,,12,4,93,109
/jdk1.7.0_80/javax/sound/midi/ControllerEventListener.java,Java,,5,5,54,64
/jdk1.7.0_80/javax/sound/midi/Instrument.java,Java,,12,13,63,88
/jdk1.7.0_80/javax/sound/midi/InvalidMidiDataException.java,Java,,9,8,46,63
/jdk1.7.0_80/javax/sound/midi/MetaEventListener.java,Java,,5,5,40,50
/jdk1.7.0_80/javax/sound/midi/MetaMessage.java,Java,,75,31,138,244
/jdk1.7.0_80/javax/sound/midi/MidiChannel.java,Java,,29,30,478,537
/jdk1.7.0_80/javax/sound/midi/MidiDevice.java,Java,,48,52,293,393
/jdk1.7.0_80/javax/sound/midi/MidiDeviceReceiver.java,Java,,4,2,33,39
/jdk1.7.0_80/javax/sound/midi/MidiDeviceTransmitter.java,Java,,4,4,33,41
/jdk1.7.0_80/javax/sound/midi/MidiEvent.java,Java,,18,15,63,96
/jdk1.7.0_80/javax/sound/midi/MidiFileFormat.java,Java,,59,34,210,303
/jdk1.7.0_80/javax/sound/midi/MidiMessage.java,Java,,36,20,132,188
/jdk1.7.0_80/javax/sound/midi/MidiSystem.java,Java,,593,158,729,1480
/jdk1.7.0_80/javax/sound/midi/MidiUnavailableException.java,Java,,9,8,46,63
/jdk1.7.0_80/javax/sound/midi/Patch.java,Java,,15,17,80,112
/jdk1.7.0_80/javax/sound/midi/Receiver.java,Java,,5,6,63,74
/jdk1.7.0_80/javax/sound/midi/Sequence.java,Java,,81,51,208,340
/jdk1.7.0_80/javax/sound/midi/Sequencer.java,Java,,68,114,686,868
/jdk1.7.0_80/javax/sound/midi/ShortMessage.java,Java,,143,60,292,495
/jdk1.7.0_80/javax/sound/midi/Soundbank.java,Java,,11,17,105,133
/jdk1.7.0_80/javax/sound/midi/SoundbankResource.java,Java,,21,26,130,177
/jdk1.7.0_80/javax/sound/midi/spi/MidiDeviceProvider.java,Java,,16,11,52,79
/jdk1.7.0_80/javax/sound/midi/spi/MidiFileReader.java,Java,,16,15,111,142
/jdk1.7.0_80/javax/sound/midi/spi/MidiFileWriter.java,Java,,30,18,87,135
/jdk1.7.0_80/javax/sound/midi/spi/SoundbankReader.java,Java,,12,15,57,84
/jdk1.7.0_80/javax/sound/midi/Synthesizer.java,Java,,19,48,327,394
/jdk1.7.0_80/javax/sound/midi/SysexMessage.java,Java,,57,28,166,251
/jdk1.7.0_80/javax/sound/midi/Track.java,Java,,110,30,134,274
/jdk1.7.0_80/javax/sound/midi/Transmitter.java,Java,,6,9,61,76
/jdk1.7.0_80/javax/sound/midi/VoiceStatus.java,Java,,9,16,135,160
/jdk1.7.0_80/javax/sound/sampled/AudioFileFormat.java,Java,,106,61,250,417
/jdk1.7.0_80/javax/sound/sampled/AudioFormat.java,Java,,191,73,405,669
/jdk1.7.0_80/javax/sound/sampled/AudioInputStream.java,Java,,199,81,235,515
/jdk1.7.0_80/javax/sound/sampled/AudioPermission.java,Java,,10,10,216,236
/jdk1.7.0_80/javax/sound/sampled/AudioSystem.java,Java,,627,203,801,1631
/jdk1.7.0_80/javax/sound/sampled/BooleanControl.java,Java,,34,41,117,192
/jdk1.7.0_80/javax/sound/sampled/Clip.java,Java,,14,13,196,223
/jdk1.7.0_80/javax/sound/sampled/CompoundControl.java,Java,,33,38,69,140
/jdk1.7.0_80/javax/sound/sampled/Control.java,Java,,28,29,89,146
/jdk1.7.0_80/javax/sound/sampled/DataLine.java,Java,,107,56,333,496
/jdk1.7.0_80/javax/sound/sampled/EnumControl.java,Java,,43,51,120,214
/jdk1.7.0_80/javax/sound/sampled/FloatControl.java,Java,,108,93,328,529
/jdk1.7.0_80/javax/sound/sampled/Line.java,Java,,46,47,266,359
/jdk1.7.0_80/javax/sound/sampled/LineEvent.java,Java,,49,44,188,281
/jdk1.7.0_80/javax/sound/sampled/LineListener.java,Java,,4,6,58,68
/jdk1.7.0_80/javax/sound/sampled/LineUnavailableException.java,Java,,9,8,51,68
/jdk1.7.0_80/javax/sound/sampled/Mixer.java,Java,,49,38,265,352
/jdk1.7.0_80/javax/sound/sampled/Port.java,Java,,45,45,118,208
/jdk1.7.0_80/javax/sound/sampled/ReverbType.java,Java,,48,32,219,299
/jdk1.7.0_80/javax/sound/sampled/SourceDataLine.java,Java,,6,10,187,203
/jdk1.7.0_80/javax/sound/sampled/spi/AudioFileReader.java,Java,,16,10,111,137
/jdk1.7.0_80/javax/sound/sampled/spi/AudioFileWriter.java,Java,,31,22,94,147
/jdk1.7.0_80/javax/sound/sampled/spi/FormatConversionProvider.java,Java,,48,34,115,197
/jdk1.7.0_80/javax/sound/sampled/spi/MixerProvider.java,Java,,15,11,75,101
/jdk1.7.0_80/javax/sound/sampled/TargetDataLine.java,Java,,6,9,177,192
/jdk1.7.0_80/javax/sound/sampled/UnsupportedAudioFileException.java,Java,,9,8,49,66
/jdk1.7.0_80/javax/sql/CommonDataSource.java,Java,,12,9,108,129
/jdk1.7.0_80/javax/sql/ConnectionEvent.java,Java,,14,10,71,95
/jdk1.7.0_80/javax/sql/ConnectionEventListener.java,Java,,5,6,65,76
/jdk1.7.0_80/javax/sql/ConnectionPoolDataSource.java,Java,,7,7,59,73
/jdk1.7.0_80/javax/sql/DataSource.java,Java,,9,7,83,99
/jdk1.7.0_80/javax/sql/PooledConnection.java,Java,,11,11,156,178
/jdk1.7.0_80/javax/sql/rowset/BaseRowSet.java,Java,,756,284,3472,4512
/jdk1.7.0_80/javax/sql/rowset/CachedRowSet.java,Java,,53,51,1521,1625
/jdk1.7.0_80/javax/sql/rowset/FilteredRowSet.java,Java,,10,6,144,160
/jdk1.7.0_80/javax/sql/rowset/JdbcRowSet.java,Java,,17,16,254,287
/jdk1.7.0_80/javax/sql/rowset/Joinable.java,Java,,14,13,264,291
/jdk1.7.0_80/javax/sql/rowset/JoinRowSet.java,Java,,34,28,475,537
/jdk1.7.0_80/javax/sql/rowset/Predicate.java,Java,,8,8,148,164
/jdk1.7.0_80/javax/sql/rowset/RowSetFactory.java,Java,,9,9,81,99
/jdk1.7.0_80/javax/sql/rowset/RowSetMetaDataImpl.java,Java,,322,94,679,1095
/jdk1.7.0_80/javax/sql/rowset/RowSetProvider.java,Java,,139,25,155,319
/jdk1.7.0_80/javax/sql/rowset/RowSetWarning.java,Java,,24,11,111,146
/jdk1.7.0_80/javax/sql/rowset/serial/SerialArray.java,Java,,145,42,348,535
/jdk1.7.0_80/javax/sql/rowset/serial/SerialBlob.java,Java,,131,41,285,457
/jdk1.7.0_80/javax/sql/rowset/serial/SerialClob.java,Java,,172,49,301,522
/jdk1.7.0_80/javax/sql/rowset/serial/SerialDatalink.java,Java,,25,13,71,109
/jdk1.7.0_80/javax/sql/rowset/serial/SerialException.java,Java,,10,6,40,56
/jdk1.7.0_80/javax/sql/rowset/serial/SerialJavaObject.java,Java,,58,22,93,173
/jdk1.7.0_80/javax/sql/rowset/serial/SerialRef.java,Java,,58,19,95,172
/jdk1.7.0_80/javax/sql/rowset/serial/SerialStruct.java,Java,,70,28,156,254
/jdk1.7.0_80/javax/sql/rowset/serial/SQLInputImpl.java,Java,,276,68,483,827
/jdk1.7.0_80/javax/sql/rowset/serial/SQLOutputImpl.java,Java,,166,51,401,618
/jdk1.7.0_80/javax/sql/rowset/spi/SyncFactory.java,Java,,405,109,468,982
/jdk1.7.0_80/javax/sql/rowset/spi/SyncFactoryException.java,Java,,10,6,42,58
/jdk1.7.0_80/javax/sql/rowset/spi/SyncProvider.java,Java,,28,26,376,430
/jdk1.7.0_80/javax/sql/rowset/spi/SyncProviderException.java,Java,,40,11,113,164
/jdk1.7.0_80/javax/sql/rowset/spi/SyncResolver.java,Java,,16,15,341,372
/jdk1.7.0_80/javax/sql/rowset/spi/TransactionalWriter.java,Java,,11,7,65,83
/jdk1.7.0_80/javax/sql/rowset/spi/XmlReader.java,Java,,9,6,59,74
/jdk1.7.0_80/javax/sql/rowset/spi/XmlWriter.java,Java,,9,8,57,74
/jdk1.7.0_80/javax/sql/rowset/WebRowSet.java,Java,,18,12,469,499
/jdk1.7.0_80/javax/sql/RowSet.java,Java,,166,132,1888,2186
/jdk1.7.0_80/javax/sql/RowSetEvent.java,Java,,6,5,51,62
/jdk1.7.0_80/javax/sql/RowSetInternal.java,Java,,9,10,84,103
/jdk1.7.0_80/javax/sql/RowSetListener.java,Java,,6,6,65,77
/jdk1.7.0_80/javax/sql/RowSetMetaData.java,Java,,21,22,192,235
/jdk1.7.0_80/javax/sql/RowSetReader.java,Java,,5,6,62,73
/jdk1.7.0_80/javax/sql/RowSetWriter.java,Java,,5,6,53,64
/jdk1.7.0_80/javax/sql/StatementEvent.java,Java,,27,14,76,117
/jdk1.7.0_80/javax/sql/StatementEventListener.java,Java,,5,4,77,86
/jdk1.7.0_80/javax/sql/XAConnection.java,Java,,5,8,48,61
/jdk1.7.0_80/javax/sql/XADataSource.java,Java,,7,6,60,73
/jdk1.7.0_80/javax/swing/AbstractAction.java,Java,,150,36,181,367
/jdk1.7.0_80/javax/swing/AbstractButton.java,Java,,1429,232,1440,3101
/jdk1.7.0_80/javax/swing/AbstractCellEditor.java,Java,,50,15,102,167
/jdk1.7.0_80/javax/swing/AbstractListModel.java,Java,,59,19,144,222
/jdk1.7.0_80/javax/swing/AbstractSpinnerModel.java,Java,,33,17,90,140
/jdk1.7.0_80/javax/swing/Action.java,Java,,24,12,355,391
/jdk1.7.0_80/javax/swing/ActionMap.java,Java,,107,22,96,225
/jdk1.7.0_80/javax/swing/ActionPropertyChangeListener.java,Java,,81,16,60,157
/jdk1.7.0_80/javax/swing/AncestorNotifier.java,Java,,148,31,60,239
/jdk1.7.0_80/javax/swing/ArrayTable.java,Java,,222,23,97,342
/jdk1.7.0_80/javax/swing/Autoscroller.java,Java,,84,20,75,179
/jdk1.7.0_80/javax/swing/border/AbstractBorder.java,Java,,50,11,137,198
/jdk1.7.0_80/javax/swing/border/BevelBorder.java,Java,,121,36,140,297
/jdk1.7.0_80/javax/swing/border/Border.java,Java,,11,4,75,90
/jdk1.7.0_80/javax/swing/border/CompoundBorder.java,Java,,66,14,88,168
/jdk1.7.0_80/javax/swing/border/EmptyBorder.java,Java,,37,9,66,112
/jdk1.7.0_80/javax/swing/border/EtchedBorder.java,Java,,64,21,120,205
/jdk1.7.0_80/javax/swing/border/LineBorder.java,Java,,84,18,89,191
/jdk1.7.0_80/javax/swing/border/MatteBorder.java,Java,,96,21,104,221
/jdk1.7.0_80/javax/swing/border/SoftBevelBorder.java,Java,,67,18,80,165
/jdk1.7.0_80/javax/swing/border/StrokeBorder.java,Java,,53,8,103,164
/jdk1.7.0_80/javax/swing/border/TitledBorder.java,Java,,461,50,222,733
/jdk1.7.0_80/javax/swing/BorderFactory.java,Java,,196,47,516,759
/jdk1.7.0_80/javax/swing/BoundedRangeModel.java,Java,,18,30,220,268
/jdk1.7.0_80/javax/swing/Box.java,Java,,97,27,313,437
/jdk1.7.0_80/javax/swing/BoxLayout.java,Java,,194,42,302,538
/jdk1.7.0_80/javax/swing/BufferStrategyPaintManager.java,Java,,616,60,280,956
/jdk1.7.0_80/javax/swing/ButtonGroup.java,Java,,67,16,107,190
/jdk1.7.0_80/javax/swing/ButtonModel.java,Java,,27,25,190,242
/jdk1.7.0_80/javax/swing/CellEditor.java,Java,,12,10,112,134
/jdk1.7.0_80/javax/swing/CellRendererPane.java,Java,,83,30,114,227
/jdk1.7.0_80/javax/swing/ClientPropertyKey.java,Java,,26,13,85,124
/jdk1.7.0_80/javax/swing/colorchooser/AbstractColorChooserPanel.java,Java,,73,20,138,231
/jdk1.7.0_80/javax/swing/colorchooser/CenterLayout.java,Java,,41,9,29,79
/jdk1.7.0_80/javax/swing/colorchooser/ColorChooserComponentFactory.java,Java,,17,6,40,63
/jdk1.7.0_80/javax/swing/colorchooser/ColorChooserPanel.java,Java,,151,24,30,205
/jdk1.7.0_80/javax/swing/colorchooser/ColorModel.java,Java,,61,17,24,102
/jdk1.7.0_80/javax/swing/colorchooser/ColorModelCMYK.java,Java,,45,7,42,94
/jdk1.7.0_80/javax/swing/colorchooser/ColorModelHSL.java,Java,,105,15,68,188
/jdk1.7.0_80/javax/swing/colorchooser/ColorModelHSV.java,Java,,84,12,42,138
/jdk1.7.0_80/javax/swing/colorchooser/ColorPanel.java,Java,,173,23,24,220
/jdk1.7.0_80/javax/swing/colorchooser/ColorSelectionModel.java,Java,,10,6,57,73
/jdk1.7.0_80/javax/swing/colorchooser/DefaultColorSelectionModel.java,Java,,46,16,92,154
/jdk1.7.0_80/javax/swing/colorchooser/DefaultPreviewPanel.java,Java,,167,45,39,251
/jdk1.7.0_80/javax/swing/colorchooser/DefaultSwatchChooserPanel.java,Java,,608,77,85,770
/jdk1.7.0_80/javax/swing/colorchooser/DiagramComponent.java,Java,,116,20,24,160
/jdk1.7.0_80/javax/swing/colorchooser/SlidingSpinner.java,Java,,81,13,24,118
/jdk1.7.0_80/javax/swing/colorchooser/SmartGridLayout.java,Java,,108,49,33,190
/jdk1.7.0_80/javax/swing/colorchooser/ValueFormatter.java,Java,,109,18,24,151
/jdk1.7.0_80/javax/swing/ComboBoxEditor.java,Java,,11,8,37,56
/jdk1.7.0_80/javax/swing/ComboBoxModel.java,Java,,5,3,49,57
/jdk1.7.0_80/javax/swing/ComponentInputMap.java,Java,,43,7,68,118
/jdk1.7.0_80/javax/swing/DebugGraphics.java,Java,,1035,180,253,1468
/jdk1.7.0_80/javax/swing/DebugGraphicsFilter.java,Java,,13,5,28,46
/jdk1.7.0_80/javax/swing/DebugGraphicsInfo.java,Java,,35,7,29,71
/jdk1.7.0_80/javax/swing/DebugGraphicsObserver.java,Java,,19,6,28,53
/jdk1.7.0_80/javax/swing/DefaultBoundedRangeModel.java,Java,,141,49,233,423
/jdk1.7.0_80/javax/swing/DefaultButtonModel.java,Java,,207,62,264,533
/jdk1.7.0_80/javax/swing/DefaultCellEditor.java,Java,,164,42,192,398
/jdk1.7.0_80/javax/swing/DefaultComboBoxModel.java,Java,,87,22,70,179
/jdk1.7.0_80/javax/swing/DefaultDesktopManager.java,Java,,494,109,204,807
/jdk1.7.0_80/javax/swing/DefaultFocusManager.java,Java,,98,26,48,172
/jdk1.7.0_80/javax/swing/DefaultListCellRenderer.java,Java,,139,36,173,348
/jdk1.7.0_80/javax/swing/DefaultListModel.java,Java,,144,42,360,546
/jdk1.7.0_80/javax/swing/DefaultListSelectionModel.java,Java,,374,97,378,849
/jdk1.7.0_80/javax/swing/DefaultRowSorter.java,Java,,678,119,582,1379
/jdk1.7.0_80/javax/swing/DefaultSingleSelectionModel.java,Java,,51,13,111,175
/jdk1.7.0_80/javax/swing/DelegatingDefaultFocusManager.java,Java,,109,9,44,162
/jdk1.7.0_80/javax/swing/DesktopManager.java,Java,,19,10,89,118
/jdk1.7.0_80/javax/swing/DropMode.java,Java,,11,9,83,103
/jdk1.7.0_80/javax/swing/event/AncestorEvent.java,Java,,25,7,71,103
/jdk1.7.0_80/javax/swing/event/AncestorListener.java,Java,,10,6,53,69
/jdk1.7.0_80/javax/swing/event/CaretEvent.java,Java,,9,6,56,71
/jdk1.7.0_80/javax/swing/event/CaretListener.java,Java,,5,4,35,44
/jdk1.7.0_80/javax/swing/event/CellEditorListener.java,Java,,7,6,32,45
/jdk1.7.0_80/javax/swing/event/ChangeEvent.java,Java,,7,3,45,55
/jdk1.7.0_80/javax/swing/event/ChangeListener.java,Java,,5,4,34,43
/jdk1.7.0_80/javax/swing/event/DocumentEvent.java,Java,,28,20,135,183
/jdk1.7.0_80/javax/swing/event/DocumentListener.java,Java,,7,5,66,78
/jdk1.7.0_80/javax/swing/event/EventListenerList.java,Java,,118,18,157,293
/jdk1.7.0_80/javax/swing/event/HyperlinkEvent.java,Java,,62,21,145,228
/jdk1.7.0_80/javax/swing/event/HyperlinkListener.java,Java,,5,4,34,43
/jdk1.7.0_80/javax/swing/event/InternalFrameAdapter.java,Java,,10,8,61,79
/jdk1.7.0_80/javax/swing/event/InternalFrameEvent.java,Java,,49,18,125,192
/jdk1.7.0_80/javax/swing/event/InternalFrameListener.java,Java,,11,9,65,85
/jdk1.7.0_80/javax/swing/event/ListDataEvent.java,Java,,26,9,85,120
/jdk1.7.0_80/javax/swing/event/ListDataListener.java,Java,,7,8,54,69
/jdk1.7.0_80/javax/swing/event/ListSelectionEvent.java,Java,,29,9,85,123
/jdk1.7.0_80/javax/swing/event/ListSelectionListener.java,Java,,6,6,36,48
/jdk1.7.0_80/javax/swing/event/MenuDragMouseEvent.java,Java,,34,7,103,144
/jdk1.7.0_80/javax/swing/event/MenuDragMouseListener.java,Java,,8,4,53,65
/jdk1.7.0_80/javax/swing/event/MenuEvent.java,Java,,7,3,47,57
/jdk1.7.0_80/javax/swing/event/MenuKeyEvent.java,Java,,23,6,67,96
/jdk1.7.0_80/javax/swing/event/MenuKeyListener.java,Java,,7,6,39,52
/jdk1.7.0_80/javax/swing/event/MenuListener.java,Java,,7,4,44,55
/jdk1.7.0_80/javax/swing/event/MouseInputAdapter.java,Java,,5,3,34,42
/jdk1.7.0_80/javax/swing/event/MouseInputListener.java,Java,,5,4,31,40
/jdk1.7.0_80/javax/swing/event/PopupMenuEvent.java,Java,,7,2,45,54
/jdk1.7.0_80/javax/swing/event/PopupMenuListener.java,Java,,7,5,39,51
/jdk1.7.0_80/javax/swing/event/RowSorterEvent.java,Java,,38,10,96,144
/jdk1.7.0_80/javax/swing/event/RowSorterListener.java,Java,,4,1,37,42
/jdk1.7.0_80/javax/swing/event/SwingPropertyChangeSupport.java,Java,,34,11,79,124
/jdk1.7.0_80/javax/swing/event/TableColumnModelEvent.java,Java,,15,10,65,90
/jdk1.7.0_80/javax/swing/event/TableColumnModelListener.java,Java,,12,8,39,59
/jdk1.7.0_80/javax/swing/event/TableModelEvent.java,Java,,38,18,122,178
/jdk1.7.0_80/javax/swing/event/TableModelListener.java,Java,,6,4,35,45
/jdk1.7.0_80/javax/swing/event/TreeExpansionEvent.java,Java,,12,5,58,75
/jdk1.7.0_80/javax/swing/event/TreeExpansionListener.java,Java,,7,5,40,52
/jdk1.7.0_80/javax/swing/event/TreeModelEvent.java,Java,,75,16,223,314
/jdk1.7.0_80/javax/swing/event/TreeModelListener.java,Java,,8,8,82,98
/jdk1.7.0_80/javax/swing/event/TreeSelectionEvent.java,Java,,71,14,125,210
/jdk1.7.0_80/javax/swing/event/TreeSelectionListener.java,Java,,6,3,41,50
/jdk1.7.0_80/javax/swing/event/TreeWillExpandListener.java,Java,,7,5,39,51
/jdk1.7.0_80/javax/swing/event/UndoableEditEvent.java,Java,,12,5,50,67
/jdk1.7.0_80/javax/swing/event/UndoableEditListener.java,Java,,5,5,33,43
/jdk1.7.0_80/javax/swing/filechooser/FileFilter.java,Java,,6,4,52,62
/jdk1.7.0_80/javax/swing/filechooser/FileNameExtensionFilter.java,Java,,56,8,94,158
/jdk1.7.0_80/javax/swing/filechooser/FileSystemView.java,Java,,429,112,277,818
/jdk1.7.0_80/javax/swing/filechooser/FileView.java,Java,,20,8,83,111
/jdk1.7.0_80/javax/swing/FocusManager.java,Java,,38,9,104,151
/jdk1.7.0_80/javax/swing/GraphicsWrapper.java,Java,,10,8,29,47
/jdk1.7.0_80/javax/swing/GrayFilter.java,Java,,31,8,54,93
/jdk1.7.0_80/javax/swing/GroupLayout.java,Java,,2122,303,1320,3745
/jdk1.7.0_80/javax/swing/Icon.java,Java,,9,6,44,59
/jdk1.7.0_80/javax/swing/ImageIcon.java,Java,,285,67,351,703
/jdk1.7.0_80/javax/swing/InputMap.java,Java,,116,25,90,231
/jdk1.7.0_80/javax/swing/InputVerifier.java,Java,,8,11,116,135
/jdk1.7.0_80/javax/swing/InternalFrameFocusTraversalPolicy.java,Java,,10,4,54,68
/jdk1.7.0_80/javax/swing/JApplet.java,Java,,154,46,367,567
/jdk1.7.0_80/javax/swing/JButton.java,Java,,86,30,207,323
/jdk1.7.0_80/javax/swing/JCheckBox.java,Java,,93,35,222,350
/jdk1.7.0_80/javax/swing/JCheckBoxMenuItem.java,Java,,83,25,199,307
/jdk1.7.0_80/javax/swing/JColorChooser.java,Java,,308,93,362,763
/jdk1.7.0_80/javax/swing/JComboBox.java,Java,,878,198,1358,2434
/jdk1.7.0_80/javax/swing/JComponent.java,Java,,2414,432,2750,5596
/jdk1.7.0_80/javax/swing/JDesktopPane.java,Java,,298,50,285,633
/jdk1.7.0_80/javax/swing/JDialog.java,Java,,298,70,925,1293
/jdk1.7.0_80/javax/swing/JEditorPane.java,Java,,1199,165,1046,2410
/jdk1.7.0_80/javax/swing/JFileChooser.java,Java,,737,185,1059,1981
/jdk1.7.0_80/javax/swing/JFormattedTextField.java,Java,,414,88,685,1187
/jdk1.7.0_80/javax/swing/JFrame.java,Java,,266,62,612,940
/jdk1.7.0_80/javax/swing/JInternalFrame.java,Java,,895,186,1341,2422
/jdk1.7.0_80/javax/swing/JLabel.java,Java,,704,130,801,1635
/jdk1.7.0_80/javax/swing/JLayer.java,Java,,374,51,440,865
/jdk1.7.0_80/javax/swing/JLayeredPane.java,Java,,311,67,406,784
/jdk1.7.0_80/javax/swing/JList.java,Java,,1606,341,1788,3735
/jdk1.7.0_80/javax/swing/JMenu.java,Java,,717,146,761,1624
/jdk1.7.0_80/javax/swing/JMenuBar.java,Java,,323,75,367,765
/jdk1.7.0_80/javax/swing/JMenuItem.java,Java,,418,83,446,947
/jdk1.7.0_80/javax/swing/JOptionPane.java,Java,,916,168,1517,2601
/jdk1.7.0_80/javax/swing/JPanel.java,Java,,63,22,163,248
/jdk1.7.0_80/javax/swing/JPasswordField.java,Java,,208,44,413,665
/jdk1.7.0_80/javax/swing/JPopupMenu.java,Java,,725,154,674,1553
/jdk1.7.0_80/javax/swing/JProgressBar.java,Java,,304,91,731,1126
/jdk1.7.0_80/javax/swing/JRadioButton.java,Java,,71,31,198,300
/jdk1.7.0_80/javax/swing/JRadioButtonMenuItem.java,Java,,72,21,187,280
/jdk1.7.0_80/javax/swing/JRootPane.java,Java,,354,85,663,1102
/jdk1.7.0_80/javax/swing/JScrollBar.java,Java,,305,111,503,919
/jdk1.7.0_80/javax/swing/JScrollPane.java,Java,,535,147,873,1555
/jdk1.7.0_80/javax/swing/JSeparator.java,Java,,86,25,183,294
/jdk1.7.0_80/javax/swing/JSlider.java,Java,,508,174,838,1520
/jdk1.7.0_80/javax/swing/JSpinner.java,Java,,778,201,1054,2033
/jdk1.7.0_80/javax/swing/JSplitPane.java,Java,,409,166,678,1253
/jdk1.7.0_80/javax/swing/JTabbedPane.java,Java,,1001,248,1169,2418
/jdk1.7.0_80/javax/swing/JTable.java,Java,,4455,835,4323,9613
/jdk1.7.0_80/javax/swing/JTextArea.java,Java,,301,54,460,815
/jdk1.7.0_80/javax/swing/JTextField.java,Java,,326,70,565,961
/jdk1.7.0_80/javax/swing/JTextPane.java,Java,,178,34,281,493
/jdk1.7.0_80/javax/swing/JToggleButton.java,Java,,147,48,229,424
/jdk1.7.0_80/javax/swing/JToolBar.java,Java,[WDW - need to add orientation from BoxLayout,375,83,413,871
/jdk1.7.0_80/javax/swing/JToolTip.java,Java,,85,31,174,290
/jdk1.7.0_80/javax/swing/JTree.java,Java,,2579,487,2456,5522
/jdk1.7.0_80/javax/swing/JViewport.java,Java,,770,184,812,1766
/jdk1.7.0_80/javax/swing/JWindow.java,Java,,170,44,456,670
/jdk1.7.0_80/javax/swing/KeyboardManager.java,Java,,234,49,109,392
/jdk1.7.0_80/javax/swing/KeyStroke.java,Java,,61,11,244,316
/jdk1.7.0_80/javax/swing/LayoutComparator.java,Java,,91,24,44,159
/jdk1.7.0_80/javax/swing/LayoutFocusTraversalPolicy.java,Java,,107,12,155,274
/jdk1.7.0_80/javax/swing/LayoutStyle.java,Java,,40,11,166,217
/jdk1.7.0_80/javax/swing/LegacyGlueFocusTraversalPolicy.java,Java,,147,15,38,200
/jdk1.7.0_80/javax/swing/ListCellRenderer.java,Java,,11,4,101,116
/jdk1.7.0_80/javax/swing/ListModel.java,Java,,9,6,56,71
/jdk1.7.0_80/javax/swing/ListSelectionModel.java,Java,,28,35,249,312
/jdk1.7.0_80/javax/swing/LookAndFeel.java,Java,,154,46,529,729
/jdk1.7.0_80/javax/swing/MenuElement.java,Java,,10,9,64,83
/jdk1.7.0_80/javax/swing/MenuSelectionManager.java,Java,,326,53,128,507
/jdk1.7.0_80/javax/swing/MultiUIDefaults.java,Java,,151,27,28,206
/jdk1.7.0_80/javax/swing/MutableComboBoxModel.java,Java,,7,6,60,73
/jdk1.7.0_80/javax/swing/OverlayLayout.java,Java,,121,26,141,288
/jdk1.7.0_80/javax/swing/Painter.java,Java,,5,2,100,107
/jdk1.7.0_80/javax/swing/plaf/ActionMapUIResource.java,Java,,6,4,31,41
/jdk1.7.0_80/javax/swing/plaf/basic/BasicArrowButton.java,Java,,159,31,118,308
/jdk1.7.0_80/javax/swing/plaf/basic/BasicBorders.java,Java,,440,77,83,600
/jdk1.7.0_80/javax/swing/plaf/basic/BasicButtonListener.java,Java,,224,36,57,317
/jdk1.7.0_80/javax/swing/plaf/basic/BasicButtonUI.java,Java,,298,68,105,471
/jdk1.7.0_80/javax/swing/plaf/basic/BasicCheckBoxMenuItemUI.java,Java,,32,7,31,70
/jdk1.7.0_80/javax/swing/plaf/basic/BasicCheckBoxUI.java,Java,,24,11,41,76
/jdk1.7.0_80/javax/swing/plaf/basic/BasicColorChooserUI.java,Java,,256,46,52,354
/jdk1.7.0_80/javax/swing/plaf/basic/BasicComboBoxEditor.java,Java,,81,19,67,167
/jdk1.7.0_80/javax/swing/plaf/basic/BasicComboBoxRenderer.java,Java,,61,18,65,144
/jdk1.7.0_80/javax/swing/plaf/basic/BasicComboBoxUI.java,Java,,1192,227,580,1999
/jdk1.7.0_80/javax/swing/plaf/basic/BasicComboPopup.java,Java,,647,141,507,1295
/jdk1.7.0_80/javax/swing/plaf/basic/BasicDesktopIconUI.java,Java,,195,45,56,296
/jdk1.7.0_80/javax/swing/plaf/basic/BasicDesktopPaneUI.java,Java,,529,60,124,713
/jdk1.7.0_80/javax/swing/plaf/basic/BasicDirectoryModel.java,Java,,318,60,119,497
/jdk1.7.0_80/javax/swing/plaf/basic/BasicEditorPaneUI.java,Java,,282,28,103,413
/jdk1.7.0_80/javax/swing/plaf/basic/BasicFileChooserUI.java,Java,,981,200,193,1374
/jdk1.7.0_80/javax/swing/plaf/basic/BasicFormattedTextFieldUI.java,Java,,11,3,43,57
/jdk1.7.0_80/javax/swing/plaf/basic/BasicGraphicsUtils.java,Java,,190,54,70,314
/jdk1.7.0_80/javax/swing/plaf/basic/BasicHTML.java,Java,,275,55,314,644
/jdk1.7.0_80/javax/swing/plaf/basic/BasicIconFactory.java,Java,,151,32,39,222
/jdk1.7.0_80/javax/swing/plaf/basic/BasicInternalFrameTitlePane.java,Java,,575,103,117,795
/jdk1.7.0_80/javax/swing/plaf/basic/BasicInternalFrameUI.java,Java,,1071,197,189,1457
/jdk1.7.0_80/javax/swing/plaf/basic/BasicLabelUI.java,Java,,338,48,99,485
/jdk1.7.0_80/javax/swing/plaf/basic/BasicListUI.java,Java,,1861,317,702,2880
/jdk1.7.0_80/javax/swing/plaf/basic/BasicLookAndFeel.java,Java,,1710,174,442,2326
/jdk1.7.0_80/javax/swing/plaf/basic/BasicMenuBarUI.java,Java,,162,37,39,238
/jdk1.7.0_80/javax/swing/plaf/basic/BasicMenuItemUI.java,Java,,684,96,192,972
/jdk1.7.0_80/javax/swing/plaf/basic/BasicMenuUI.java,Java,,415,75,141,631
/jdk1.7.0_80/javax/swing/plaf/basic/BasicOptionPaneUI.java,Java,,1016,172,268,1456
/jdk1.7.0_80/javax/swing/plaf/basic/BasicPanelUI.java,Java,,54,13,46,113
/jdk1.7.0_80/javax/swing/plaf/basic/BasicPasswordFieldUI.java,Java,,36,11,61,108
/jdk1.7.0_80/javax/swing/plaf/basic/BasicPopupMenuSeparatorUI.java,Java,,27,9,30,66
/jdk1.7.0_80/javax/swing/plaf/basic/BasicPopupMenuUI.java,Java,,950,134,139,1223
/jdk1.7.0_80/javax/swing/plaf/basic/BasicProgressBarUI.java,Java,,686,135,454,1275
/jdk1.7.0_80/javax/swing/plaf/basic/BasicRadioButtonMenuItemUI.java,Java,,33,5,30,68
/jdk1.7.0_80/javax/swing/plaf/basic/BasicRadioButtonUI.java,Java,,358,92,158,608
/jdk1.7.0_80/javax/swing/plaf/basic/BasicRootPaneUI.java,Java,,173,33,42,248
/jdk1.7.0_80/javax/swing/plaf/basic/BasicScrollBarUI.java,Java,,1090,214,314,1618
/jdk1.7.0_80/javax/swing/plaf/basic/BasicScrollPaneUI.java,Java,,823,132,223,1178
/jdk1.7.0_80/javax/swing/plaf/basic/BasicSeparatorUI.java,Java,,69,18,31,118
/jdk1.7.0_80/javax/swing/plaf/basic/BasicSliderUI.java,Java,,1480,290,255,2025
/jdk1.7.0_80/javax/swing/plaf/basic/BasicSpinnerUI.java,Java,,630,120,312,1062
/jdk1.7.0_80/javax/swing/plaf/basic/BasicSplitPaneDivider.java,Java,,636,146,308,1090
/jdk1.7.0_80/javax/swing/plaf/basic/BasicSplitPaneUI.java,Java,,1297,281,668,2246
/jdk1.7.0_80/javax/swing/plaf/basic/BasicTabbedPaneUI.java,Java,,2931,401,602,3934
/jdk1.7.0_80/javax/swing/plaf/basic/BasicTableHeaderUI.java,Java,,673,122,166,961
/jdk1.7.0_80/javax/swing/plaf/basic/BasicTableUI.java,Java,,1528,312,377,2217
/jdk1.7.0_80/javax/swing/plaf/basic/BasicTextAreaUI.java,Java,,202,37,155,394
/jdk1.7.0_80/javax/swing/plaf/basic/BasicTextFieldUI.java,Java,,198,29,193,420
/jdk1.7.0_80/javax/swing/plaf/basic/BasicTextPaneUI.java,Java,,25,8,65,98
/jdk1.7.0_80/javax/swing/plaf/basic/BasicTextUI.java,Java,,1350,245,1050,2645
/jdk1.7.0_80/javax/swing/plaf/basic/BasicToggleButtonUI.java,Java,,99,31,45,175
/jdk1.7.0_80/javax/swing/plaf/basic/BasicToolBarSeparatorUI.java,Java,,47,10,31,88
/jdk1.7.0_80/javax/swing/plaf/basic/BasicToolBarUI.java,Java,,987,184,272,1443
/jdk1.7.0_80/javax/swing/plaf/basic/BasicToolTipUI.java,Java,,167,32,54,253
/jdk1.7.0_80/javax/swing/plaf/basic/BasicTransferable.java,Java,,154,31,97,282
/jdk1.7.0_80/javax/swing/plaf/basic/BasicTreeUI.java,Java,,3078,605,908,4591
/jdk1.7.0_80/javax/swing/plaf/basic/BasicViewportUI.java,Java,,33,10,30,73
/jdk1.7.0_80/javax/swing/plaf/basic/CenterLayout.java,Java,,40,11,29,80
/jdk1.7.0_80/javax/swing/plaf/basic/ComboPopup.java,Java,,15,11,75,101
/jdk1.7.0_80/javax/swing/plaf/basic/DefaultMenuLayout.java,Java,,21,8,33,62
/jdk1.7.0_80/javax/swing/plaf/basic/DragRecognitionSupport.java,Java,,92,25,64,181
/jdk1.7.0_80/javax/swing/plaf/basic/LazyActionMap.java,Java,,87,17,61,165
/jdk1.7.0_80/javax/swing/plaf/BorderUIResource.java,Java,,158,43,50,251
/jdk1.7.0_80/javax/swing/plaf/ButtonUI.java,Java,,8,2,29,39
/jdk1.7.0_80/javax/swing/plaf/ColorChooserUI.java,Java,,6,5,30,41
/jdk1.7.0_80/javax/swing/plaf/ColorUIResource.java,Java,,19,6,41,66
/jdk1.7.0_80/javax/swing/plaf/ComboBoxUI.java,Java,,7,6,39,52
/jdk1.7.0_80/javax/swing/plaf/ComponentInputMapUIResource.java,Java,,8,4,31,43
/jdk1.7.0_80/javax/swing/plaf/ComponentUI.java,Java,,64,18,278,360
/jdk1.7.0_80/javax/swing/plaf/DesktopIconUI.java,Java,,3,3,29,35
/jdk1.7.0_80/javax/swing/plaf/DesktopPaneUI.java,Java,,3,3,29,35
/jdk1.7.0_80/javax/swing/plaf/DimensionUIResource.java,Java,,9,4,43,56
/jdk1.7.0_80/javax/swing/plaf/FileChooserUI.java,Java,,17,7,36,60
/jdk1.7.0_80/javax/swing/plaf/FontUIResource.java,Java,,12,5,42,59
/jdk1.7.0_80/javax/swing/plaf/IconUIResource.java,Java,,25,8,50,83
/jdk1.7.0_80/javax/swing/plaf/InputMapUIResource.java,Java,,6,4,31,41
/jdk1.7.0_80/javax/swing/plaf/InsetsUIResource.java,Java,,9,4,42,55
/jdk1.7.0_80/javax/swing/plaf/InternalFrameUI.java,Java,,3,2,29,34
/jdk1.7.0_80/javax/swing/plaf/LabelUI.java,Java,,3,2,29,34
/jdk1.7.0_80/javax/swing/plaf/LayerUI.java,Java,,157,34,528,719
/jdk1.7.0_80/javax/swing/plaf/ListUI.java,Java,,10,9,65,84
/jdk1.7.0_80/javax/swing/plaf/MenuBarUI.java,Java,,5,4,30,39
/jdk1.7.0_80/javax/swing/plaf/MenuItemUI.java,Java,,5,2,31,38
/jdk1.7.0_80/javax/swing/plaf/metal/DefaultMetalTheme.java,Java,,178,40,215,433
/jdk1.7.0_80/javax/swing/plaf/metal/MetalBorders.java,Java,,713,155,110,978
/jdk1.7.0_80/javax/swing/plaf/metal/MetalBumps.java,Java,,158,31,46,235
/jdk1.7.0_80/javax/swing/plaf/metal/MetalButtonUI.java,Java,,112,23,72,207
/jdk1.7.0_80/javax/swing/plaf/metal/MetalCheckBoxIcon.java,Java,,55,14,38,107
/jdk1.7.0_80/javax/swing/plaf/metal/MetalCheckBoxUI.java,Java,,37,15,48,100
/jdk1.7.0_80/javax/swing/plaf/metal/MetalComboBoxButton.java,Java,,147,31,46,224
/jdk1.7.0_80/javax/swing/plaf/metal/MetalComboBoxEditor.java,Java,,63,13,63,139
/jdk1.7.0_80/javax/swing/plaf/metal/MetalComboBoxIcon.java,Java,,24,11,39,74
/jdk1.7.0_80/javax/swing/plaf/metal/MetalComboBoxUI.java,Java,,229,37,116,382
/jdk1.7.0_80/javax/swing/plaf/metal/MetalDesktopIconUI.java,Java,,87,21,36,144
/jdk1.7.0_80/javax/swing/plaf/metal/MetalFileChooserUI.java,Java,,916,199,163,1278
/jdk1.7.0_80/javax/swing/plaf/metal/MetalFontDesktopProperty.java,Java,,33,8,58,99
/jdk1.7.0_80/javax/swing/plaf/metal/MetalHighContrastTheme.java,Java,,121,33,35,189
/jdk1.7.0_80/javax/swing/plaf/metal/MetalIconFactory.java,Java,,1966,370,321,2657
/jdk1.7.0_80/javax/swing/plaf/metal/MetalInternalFrameTitlePane.java,Java,,404,69,78,551
/jdk1.7.0_80/javax/swing/plaf/metal/MetalInternalFrameUI.java,Java,,176,36,43,255
/jdk1.7.0_80/javax/swing/plaf/metal/MetalLabelUI.java,Java,,32,11,44,87
/jdk1.7.0_80/javax/swing/plaf/metal/MetalLookAndFeel.java,Java,,1472,195,835,2502
/jdk1.7.0_80/javax/swing/plaf/metal/MetalMenuBarUI.java,Java,,48,6,65,119
/jdk1.7.0_80/javax/swing/plaf/metal/MetalPopupMenuSeparatorUI.java,Java,,29,9,30,68
/jdk1.7.0_80/javax/swing/plaf/metal/MetalProgressBarUI.java,Java,,96,25,69,190
/jdk1.7.0_80/javax/swing/plaf/metal/MetalRadioButtonUI.java,Java,,135,34,57,226
/jdk1.7.0_80/javax/swing/plaf/metal/MetalRootPaneUI.java,Java,,594,93,302,989
/jdk1.7.0_80/javax/swing/plaf/metal/MetalScrollBarUI.java,Java,,355,81,52,488
/jdk1.7.0_80/javax/swing/plaf/metal/MetalScrollButton.java,Java,,228,56,62,346
/jdk1.7.0_80/javax/swing/plaf/metal/MetalScrollPaneUI.java,Java,,93,19,50,162
/jdk1.7.0_80/javax/swing/plaf/metal/MetalSeparatorUI.java,Java,,45,11,39,95
/jdk1.7.0_80/javax/swing/plaf/metal/MetalSliderUI.java,Java,,399,83,74,556
/jdk1.7.0_80/javax/swing/plaf/metal/MetalSplitPaneDivider.java,Java,,269,41,106,416
/jdk1.7.0_80/javax/swing/plaf/metal/MetalSplitPaneUI.java,Java,,13,6,44,63
/jdk1.7.0_80/javax/swing/plaf/metal/MetalTabbedPaneUI.java,Java,,862,166,201,1229
/jdk1.7.0_80/javax/swing/plaf/metal/MetalTextFieldUI.java,Java,,15,7,46,68
/jdk1.7.0_80/javax/swing/plaf/metal/MetalTheme.java,Java,,68,56,361,485
/jdk1.7.0_80/javax/swing/plaf/metal/MetalTitlePane.java,Java,,674,135,231,1040
/jdk1.7.0_80/javax/swing/plaf/metal/MetalToggleButtonUI.java,Java,,122,26,77,225
/jdk1.7.0_80/javax/swing/plaf/metal/MetalToolBarUI.java,Java,,244,42,110,396
/jdk1.7.0_80/javax/swing/plaf/metal/MetalToolTipUI.java,Java,,124,27,46,197
/jdk1.7.0_80/javax/swing/plaf/metal/MetalTreeUI.java,Java,,127,40,71,238
/jdk1.7.0_80/javax/swing/plaf/metal/MetalUtils.java,Java,,297,51,104,452
/jdk1.7.0_80/javax/swing/plaf/metal/OceanTheme.java,Java,,248,54,158,460
/jdk1.7.0_80/javax/swing/plaf/multi/MultiButtonUI.java,Java,,88,18,104,210
/jdk1.7.0_80/javax/swing/plaf/multi/MultiColorChooserUI.java,Java,,88,18,104,210
/jdk1.7.0_80/javax/swing/plaf/multi/MultiComboBoxUI.java,Java,,110,21,119,250
/jdk1.7.0_80/javax/swing/plaf/multi/MultiDesktopIconUI.java,Java,,88,18,104,210
/jdk1.7.0_80/javax/swing/plaf/multi/MultiDesktopPaneUI.java,Java,,88,18,104,210
/jdk1.7.0_80/javax/swing/plaf/multi/MultiFileChooserUI.java,Java,,135,24,134,293
/jdk1.7.0_80/javax/swing/plaf/multi/MultiInternalFrameUI.java,Java,,88,18,104,210
/jdk1.7.0_80/javax/swing/plaf/multi/MultiLabelUI.java,Java,,88,18,104,210
/jdk1.7.0_80/javax/swing/plaf/multi/MultiListUI.java,Java,,115,21,122,258
/jdk1.7.0_80/javax/swing/plaf/multi/MultiLookAndFeel.java,Java,,123,16,164,303
/jdk1.7.0_80/javax/swing/plaf/multi/MultiMenuBarUI.java,Java,,88,18,104,210
/jdk1.7.0_80/javax/swing/plaf/multi/MultiMenuItemUI.java,Java,,89,19,107,215
/jdk1.7.0_80/javax/swing/plaf/multi/MultiOptionPaneUI.java,Java,,102,20,113,235
/jdk1.7.0_80/javax/swing/plaf/multi/MultiPanelUI.java,Java,,88,18,104,210
/jdk1.7.0_80/javax/swing/plaf/multi/MultiPopupMenuUI.java,Java,,107,20,118,245
/jdk1.7.0_80/javax/swing/plaf/multi/MultiProgressBarUI.java,Java,,88,18,104,210
/jdk1.7.0_80/javax/swing/plaf/multi/MultiRootPaneUI.java,Java,,88,18,105,211
/jdk1.7.0_80/javax/swing/plaf/multi/MultiScrollBarUI.java,Java,,88,18,104,210
/jdk1.7.0_80/javax/swing/plaf/multi/MultiScrollPaneUI.java,Java,,88,18,104,210
/jdk1.7.0_80/javax/swing/plaf/multi/MultiSeparatorUI.java,Java,,88,18,104,210
/jdk1.7.0_80/javax/swing/plaf/multi/MultiSliderUI.java,Java,,88,18,104,210
/jdk1.7.0_80/javax/swing/plaf/multi/MultiSpinnerUI.java,Java,,88,18,105,211
/jdk1.7.0_80/javax/swing/plaf/multi/MultiSplitPaneUI.java,Java,,128,24,131,283
/jdk1.7.0_80/javax/swing/plaf/multi/MultiTabbedPaneUI.java,Java,,114,21,122,257
/jdk1.7.0_80/javax/swing/plaf/multi/MultiTableHeaderUI.java,Java,,88,18,104,210
/jdk1.7.0_80/javax/swing/plaf/multi/MultiTableUI.java,Java,,88,18,104,210
/jdk1.7.0_80/javax/swing/plaf/multi/MultiTextUI.java,Java,,173,28,159,360
/jdk1.7.0_80/javax/swing/plaf/multi/MultiToolBarUI.java,Java,,88,18,104,210
/jdk1.7.0_80/javax/swing/plaf/multi/MultiToolTipUI.java,Java,,88,18,104,210
/jdk1.7.0_80/javax/swing/plaf/multi/MultiTreeUI.java,Java,,165,28,158,351
/jdk1.7.0_80/javax/swing/plaf/multi/MultiViewportUI.java,Java,,88,18,104,210
/jdk1.7.0_80/javax/swing/plaf/nimbus/AbstractRegionPainter.java,Java,,346,40,366,752
/jdk1.7.0_80/javax/swing/plaf/nimbus/ArrowButtonPainter.java,Java,,56,26,36,118
/jdk1.7.0_80/javax/swing/plaf/nimbus/ButtonPainter.java,Java,,554,62,36,652
/jdk1.7.0_80/javax/swing/plaf/nimbus/CheckBoxMenuItemPainter.java,Java,,93,33,36,162
/jdk1.7.0_80/javax/swing/plaf/nimbus/CheckBoxPainter.java,Java,,529,70,36,635
/jdk1.7.0_80/javax/swing/plaf/nimbus/ComboBoxArrowButtonEditableState.java,Java,,12,6,24,42
/jdk1.7.0_80/javax/swing/plaf/nimbus/ComboBoxArrowButtonPainter.java,Java,,382,58,36,476
/jdk1.7.0_80/javax/swing/plaf/nimbus/ComboBoxEditableState.java,Java,,11,7,24,42
/jdk1.7.0_80/javax/swing/plaf/nimbus/ComboBoxPainter.java,Java,,628,69,36,733
/jdk1.7.0_80/javax/swing/plaf/nimbus/ComboBoxTextFieldPainter.java,Java,,182,36,36,254
/jdk1.7.0_80/javax/swing/plaf/nimbus/DerivedColor.java,Java,,118,18,56,192
/jdk1.7.0_80/javax/swing/plaf/nimbus/DesktopIconPainter.java,Java,,95,28,36,159
/jdk1.7.0_80/javax/swing/plaf/nimbus/DesktopPanePainter.java,Java,,274,40,36,350
/jdk1.7.0_80/javax/swing/plaf/nimbus/DropShadowEffect.java,Java,,65,5,58,128
/jdk1.7.0_80/javax/swing/plaf/nimbus/EditorPanePainter.java,Java,,60,28,36,124
/jdk1.7.0_80/javax/swing/plaf/nimbus/Effect.java,Java,,58,14,61,133
/jdk1.7.0_80/javax/swing/plaf/nimbus/EffectUtils.java,Java,,220,37,169,426
/jdk1.7.0_80/javax/swing/plaf/nimbus/FileChooserPainter.java,Java,,2035,177,36,2248
/jdk1.7.0_80/javax/swing/plaf/nimbus/FormattedTextFieldPainter.java,Java,,296,49,36,381
/jdk1.7.0_80/javax/swing/plaf/nimbus/ImageCache.java,Java,,125,15,77,217
/jdk1.7.0_80/javax/swing/plaf/nimbus/ImageScalingHelper.java,Java,,164,22,94,280
/jdk1.7.0_80/javax/swing/plaf/nimbus/InnerGlowEffect.java,Java,,8,2,29,39
/jdk1.7.0_80/javax/swing/plaf/nimbus/InnerShadowEffect.java,Java,,68,5,58,131
/jdk1.7.0_80/javax/swing/plaf/nimbus/InternalFramePainter.java,Java,,323,43,36,402
/jdk1.7.0_80/javax/swing/plaf/nimbus/InternalFrameTitlePaneCloseButtonPainter.java,Java,,377,50,36,463
/jdk1.7.0_80/javax/swing/plaf/nimbus/InternalFrameTitlePaneCloseButtonWindowNotFocusedState.java,Java,,21,6,24,51
/jdk1.7.0_80/javax/swing/plaf/nimbus/InternalFrameTitlePaneIconifyButtonPainter.java,Java,,518,52,36,606
/jdk1.7.0_80/javax/swing/plaf/nimbus/InternalFrameTitlePaneIconifyButtonWindowNotFocusedState.java,Java,,21,6,24,51
/jdk1.7.0_80/javax/swing/plaf/nimbus/InternalFrameTitlePaneMaximizeButtonPainter.java,Java,,927,82,36,1045
/jdk1.7.0_80/javax/swing/plaf/nimbus/InternalFrameTitlePaneMaximizeButtonWindowMaximizedState.java,Java,,21,6,24,51
/jdk1.7.0_80/javax/swing/plaf/nimbus/InternalFrameTitlePaneMaximizeButtonWindowNotFocusedState.java,Java,,21,6,24,51
/jdk1.7.0_80/javax/swing/plaf/nimbus/InternalFrameTitlePaneMenuButtonPainter.java,Java,,427,54,36,517
/jdk1.7.0_80/javax/swing/plaf/nimbus/InternalFrameTitlePaneMenuButtonWindowNotFocusedState.java,Java,,21,6,24,51
/jdk1.7.0_80/javax/swing/plaf/nimbus/InternalFrameTitlePanePainter.java,Java,,31,21,36,88
/jdk1.7.0_80/javax/swing/plaf/nimbus/InternalFrameTitlePaneWindowFocusedState.java,Java,,11,6,24,41
/jdk1.7.0_80/javax/swing/plaf/nimbus/InternalFrameWindowFocusedState.java,Java,,11,6,24,41
/jdk1.7.0_80/javax/swing/plaf/nimbus/LoweredBorder.java,Java,,95,12,95,202
/jdk1.7.0_80/javax/swing/plaf/nimbus/MenuBarMenuPainter.java,Java,,47,24,36,107
/jdk1.7.0_80/javax/swing/plaf/nimbus/MenuBarPainter.java,Java,,87,29,36,152
/jdk1.7.0_80/javax/swing/plaf/nimbus/MenuItemPainter.java,Java,,47,24,36,107
/jdk1.7.0_80/javax/swing/plaf/nimbus/MenuPainter.java,Java,,89,32,36,157
/jdk1.7.0_80/javax/swing/plaf/nimbus/NimbusDefaults.java,Java,,1299,130,345,1774
/jdk1.7.0_80/javax/swing/plaf/nimbus/NimbusIcon.java,Java,,158,10,57,225
/jdk1.7.0_80/javax/swing/plaf/nimbus/NimbusLookAndFeel.java,Java,,340,49,232,621
/jdk1.7.0_80/javax/swing/plaf/nimbus/NimbusStyle.java,Java,,521,72,525,1118
/jdk1.7.0_80/javax/swing/plaf/nimbus/OptionPaneMessageAreaOptionPaneLabelPainter.java,Java,,45,24,36,105
/jdk1.7.0_80/javax/swing/plaf/nimbus/OptionPaneMessageAreaPainter.java,Java,,31,21,36,88
/jdk1.7.0_80/javax/swing/plaf/nimbus/OptionPanePainter.java,Java,,491,56,36,583
/jdk1.7.0_80/javax/swing/plaf/nimbus/OuterGlowEffect.java,Java,,8,2,29,39
/jdk1.7.0_80/javax/swing/plaf/nimbus/PasswordFieldPainter.java,Java,,296,49,36,381
/jdk1.7.0_80/javax/swing/plaf/nimbus/PopupMenuPainter.java,Java,,97,30,36,163
/jdk1.7.0_80/javax/swing/plaf/nimbus/PopupMenuSeparatorPainter.java,Java,,45,24,36,105
/jdk1.7.0_80/javax/swing/plaf/nimbus/ProgressBarFinishedState.java,Java,,12,7,24,43
/jdk1.7.0_80/javax/swing/plaf/nimbus/ProgressBarIndeterminateState.java,Java,,12,7,24,43
/jdk1.7.0_80/javax/swing/plaf/nimbus/ProgressBarPainter.java,Java,,515,61,36,612
/jdk1.7.0_80/javax/swing/plaf/nimbus/RadioButtonMenuItemPainter.java,Java,,101,34,36,171
/jdk1.7.0_80/javax/swing/plaf/nimbus/RadioButtonPainter.java,Java,,595,73,36,704
/jdk1.7.0_80/javax/swing/plaf/nimbus/ScrollBarButtonPainter.java,Java,,302,42,36,380
/jdk1.7.0_80/javax/swing/plaf/nimbus/ScrollBarPainter.java,Java,,30,21,36,87
/jdk1.7.0_80/javax/swing/plaf/nimbus/ScrollBarThumbPainter.java,Java,,301,42,36,379
/jdk1.7.0_80/javax/swing/plaf/nimbus/ScrollBarTrackPainter.java,Java,,203,36,36,275
/jdk1.7.0_80/javax/swing/plaf/nimbus/ScrollPanePainter.java,Java,,112,30,36,178
/jdk1.7.0_80/javax/swing/plaf/nimbus/SeparatorPainter.java,Java,,45,24,36,105
/jdk1.7.0_80/javax/swing/plaf/nimbus/ShadowEffect.java,Java,,52,15,36,103
/jdk1.7.0_80/javax/swing/plaf/nimbus/SliderArrowShapeState.java,Java,,11,5,24,40
/jdk1.7.0_80/javax/swing/plaf/nimbus/SliderPainter.java,Java,,30,21,36,87
/jdk1.7.0_80/javax/swing/plaf/nimbus/SliderThumbArrowShapeState.java,Java,,11,5,24,40
/jdk1.7.0_80/javax/swing/plaf/nimbus/SliderThumbPainter.java,Java,,544,74,36,654
/jdk1.7.0_80/javax/swing/plaf/nimbus/SliderTrackArrowShapeState.java,Java,,11,5,24,40
/jdk1.7.0_80/javax/swing/plaf/nimbus/SliderTrackPainter.java,Java,,159,34,36,229
/jdk1.7.0_80/javax/swing/plaf/nimbus/SpinnerNextButtonPainter.java,Java,,474,72,36,582
/jdk1.7.0_80/javax/swing/plaf/nimbus/SpinnerPainter.java,Java,,31,21,36,88
/jdk1.7.0_80/javax/swing/plaf/nimbus/SpinnerPanelSpinnerFormattedTextFieldPainter.java,Java,,242,42,36,320
/jdk1.7.0_80/javax/swing/plaf/nimbus/SpinnerPreviousButtonPainter.java,Java,,402,66,36,504
/jdk1.7.0_80/javax/swing/plaf/nimbus/SplitPaneDividerPainter.java,Java,,213,40,36,289
/jdk1.7.0_80/javax/swing/plaf/nimbus/SplitPaneDividerVerticalState.java,Java,,11,6,24,41
/jdk1.7.0_80/javax/swing/plaf/nimbus/SplitPanePainter.java,Java,,31,21,36,88
/jdk1.7.0_80/javax/swing/plaf/nimbus/SplitPaneVerticalState.java,Java,,11,6,24,41
/jdk1.7.0_80/javax/swing/plaf/nimbus/State.java,Java,,81,16,116,213
/jdk1.7.0_80/javax/swing/plaf/nimbus/SynthPainterImpl.java,Java,,961,149,1692,2802
/jdk1.7.0_80/javax/swing/plaf/nimbus/TabbedPanePainter.java,Java,,35,21,36,92
/jdk1.7.0_80/javax/swing/plaf/nimbus/TabbedPaneTabAreaPainter.java,Java,,149,35,36,220
/jdk1.7.0_80/javax/swing/plaf/nimbus/TabbedPaneTabPainter.java,Java,,570,71,36,677
/jdk1.7.0_80/javax/swing/plaf/nimbus/TableEditorPainter.java,Java,,71,27,36,134
/jdk1.7.0_80/javax/swing/plaf/nimbus/TableHeaderPainter.java,Java,,76,28,36,140
/jdk1.7.0_80/javax/swing/plaf/nimbus/TableHeaderRendererPainter.java,Java,,297,47,36,380
/jdk1.7.0_80/javax/swing/plaf/nimbus/TableHeaderRendererSortedState.java,Java,,12,6,24,42
/jdk1.7.0_80/javax/swing/plaf/nimbus/TableScrollPaneCorner.java,Java,,28,4,36,68
/jdk1.7.0_80/javax/swing/plaf/nimbus/TextAreaNotInScrollPaneState.java,Java,,11,6,24,41
/jdk1.7.0_80/javax/swing/plaf/nimbus/TextAreaPainter.java,Java,,321,54,36,411
/jdk1.7.0_80/javax/swing/plaf/nimbus/TextFieldPainter.java,Java,,296,49,36,381
/jdk1.7.0_80/javax/swing/plaf/nimbus/TextPanePainter.java,Java,,60,28,36,124
/jdk1.7.0_80/javax/swing/plaf/nimbus/ToggleButtonPainter.java,Java,,601,68,36,705
/jdk1.7.0_80/javax/swing/plaf/nimbus/ToolBarButtonPainter.java,Java,,213,39,36,288
/jdk1.7.0_80/javax/swing/plaf/nimbus/ToolBarEastState.java,Java,,12,7,24,43
/jdk1.7.0_80/javax/swing/plaf/nimbus/ToolBarNorthState.java,Java,,12,7,24,43
/jdk1.7.0_80/javax/swing/plaf/nimbus/ToolBarPainter.java,Java,,137,38,36,211
/jdk1.7.0_80/javax/swing/plaf/nimbus/ToolBarSeparatorPainter.java,Java,,25,5,41,71
/jdk1.7.0_80/javax/swing/plaf/nimbus/ToolBarSouthState.java,Java,,12,7,24,43
/jdk1.7.0_80/javax/swing/plaf/nimbus/ToolBarToggleButtonPainter.java,Java,,435,64,36,535
/jdk1.7.0_80/javax/swing/plaf/nimbus/ToolBarWestState.java,Java,,12,7,24,43
/jdk1.7.0_80/javax/swing/plaf/nimbus/ToolTipPainter.java,Java,,86,28,36,150
/jdk1.7.0_80/javax/swing/plaf/nimbus/TreeCellEditorPainter.java,Java,,80,27,36,143
/jdk1.7.0_80/javax/swing/plaf/nimbus/TreeCellPainter.java,Java,,80,29,36,145
/jdk1.7.0_80/javax/swing/plaf/nimbus/TreePainter.java,Java,,553,63,36,652
/jdk1.7.0_80/javax/swing/plaf/OptionPaneUI.java,Java,,7,5,37,49
/jdk1.7.0_80/javax/swing/plaf/PanelUI.java,Java,,3,3,29,35
/jdk1.7.0_80/javax/swing/plaf/PopupMenuUI.java,Java,,14,6,43,63
/jdk1.7.0_80/javax/swing/plaf/ProgressBarUI.java,Java,,3,3,29,35
/jdk1.7.0_80/javax/swing/plaf/RootPaneUI.java,Java,,3,2,30,35
/jdk1.7.0_80/javax/swing/plaf/ScrollBarUI.java,Java,,3,2,29,34
/jdk1.7.0_80/javax/swing/plaf/ScrollPaneUI.java,Java,,3,4,29,36
/jdk1.7.0_80/javax/swing/plaf/SeparatorUI.java,Java,,3,3,30,36
/jdk1.7.0_80/javax/swing/plaf/SliderUI.java,Java,,3,2,29,34
/jdk1.7.0_80/javax/swing/plaf/SpinnerUI.java,Java,,3,3,30,36
/jdk1.7.0_80/javax/swing/plaf/SplitPaneUI.java,Java,,12,8,49,69
/jdk1.7.0_80/javax/swing/plaf/synth/ColorType.java,Java,,34,12,95,141
/jdk1.7.0_80/javax/swing/plaf/synth/DefaultSynthStyleFactory.java,Java,,106,24,79,209
/jdk1.7.0_80/javax/swing/plaf/synth/ImagePainter.java,Java,,779,149,92,1020
/jdk1.7.0_80/javax/swing/plaf/synth/ParsedSynthStyle.java,Java,,1831,312,32,2175
/jdk1.7.0_80/javax/swing/plaf/synth/Region.java,Java,,173,71,333,577
/jdk1.7.0_80/javax/swing/plaf/synth/SynthArrowButton.java,Java,,90,17,38,145
/jdk1.7.0_80/javax/swing/plaf/synth/SynthBorder.java,Java,,89,7,40,136
/jdk1.7.0_80/javax/swing/plaf/synth/SynthButtonUI.java,Java,,341,54,141,536
/jdk1.7.0_80/javax/swing/plaf/synth/SynthCheckBoxMenuItemUI.java,Java,,23,9,46,78
/jdk1.7.0_80/javax/swing/plaf/synth/SynthCheckBoxUI.java,Java,,23,8,46,77
/jdk1.7.0_80/javax/swing/plaf/synth/SynthColorChooserUI.java,Java,,93,24,91,208
/jdk1.7.0_80/javax/swing/plaf/synth/SynthComboBoxUI.java,Java,,392,87,290,769
/jdk1.7.0_80/javax/swing/plaf/synth/SynthComboPopup.java,Java,,42,6,42,90
/jdk1.7.0_80/javax/swing/plaf/synth/SynthConstants.java,Java,,11,3,57,71
/jdk1.7.0_80/javax/swing/plaf/synth/SynthContext.java,Java,,96,27,81,204
/jdk1.7.0_80/javax/swing/plaf/synth/SynthDefaultLookup.java,Java,,16,2,29,47
/jdk1.7.0_80/javax/swing/plaf/synth/SynthDesktopIconUI.java,Java,,145,24,86,255
/jdk1.7.0_80/javax/swing/plaf/synth/SynthDesktopPaneUI.java,Java,,355,50,107,512
/jdk1.7.0_80/javax/swing/plaf/synth/SynthEditorPaneUI.java,Java,,95,22,87,204
/jdk1.7.0_80/javax/swing/plaf/synth/SynthFormattedTextFieldUI.java,Java,,24,5,49,78
/jdk1.7.0_80/javax/swing/plaf/synth/SynthGraphicsUtils.java,Java,,372,67,218,657
/jdk1.7.0_80/javax/swing/plaf/synth/SynthInternalFrameTitlePane.java,Java,,401,46,42,489
/jdk1.7.0_80/javax/swing/plaf/synth/SynthInternalFrameUI.java,Java,,149,29,100,278
/jdk1.7.0_80/javax/swing/plaf/synth/SynthLabelUI.java,Java,,182,27,93,302
/jdk1.7.0_80/javax/swing/plaf/synth/SynthListUI.java,Java,,133,29,70,232
/jdk1.7.0_80/javax/swing/plaf/synth/SynthLookAndFeel.java,Java,,583,93,308,984
/jdk1.7.0_80/javax/swing/plaf/synth/SynthMenuBarUI.java,Java,,90,19,86,195
/jdk1.7.0_80/javax/swing/plaf/synth/SynthMenuItemLayoutHelper.java,Java,,218,28,62,308
/jdk1.7.0_80/javax/swing/plaf/synth/SynthMenuItemUI.java,Java,,174,38,98,310
/jdk1.7.0_80/javax/swing/plaf/synth/SynthMenuLayout.java,Java,,18,6,29,53
/jdk1.7.0_80/javax/swing/plaf/synth/SynthMenuUI.java,Java,,177,32,98,307
/jdk1.7.0_80/javax/swing/plaf/synth/SynthOptionPaneUI.java,Java,,147,35,103,285
/jdk1.7.0_80/javax/swing/plaf/synth/SynthPainter.java,Java,,572,139,1706,2417
/jdk1.7.0_80/javax/swing/plaf/synth/SynthPanelUI.java,Java,,86,24,97,207
/jdk1.7.0_80/javax/swing/plaf/synth/SynthParser.java,Java,,1078,104,151,1333
/jdk1.7.0_80/javax/swing/plaf/synth/SynthPasswordFieldUI.java,Java,,39,9,59,107
/jdk1.7.0_80/javax/swing/plaf/synth/SynthPopupMenuUI.java,Java,,93,21,88,202
/jdk1.7.0_80/javax/swing/plaf/synth/SynthProgressBarUI.java,Java,,306,40,129,475
/jdk1.7.0_80/javax/swing/plaf/synth/SynthRadioButtonMenuItemUI.java,Java,,24,7,44,75
/jdk1.7.0_80/javax/swing/plaf/synth/SynthRadioButtonUI.java,Java,,27,8,50,85
/jdk1.7.0_80/javax/swing/plaf/synth/SynthRootPaneUI.java,Java,,75,18,82,175
/jdk1.7.0_80/javax/swing/plaf/synth/SynthScrollBarUI.java,Java,,292,46,139,477
/jdk1.7.0_80/javax/swing/plaf/synth/SynthScrollPaneUI.java,Java,,188,35,86,309
/jdk1.7.0_80/javax/swing/plaf/synth/SynthSeparatorUI.java,Java,,128,29,103,260
/jdk1.7.0_80/javax/swing/plaf/synth/SynthSliderUI.java,Java,,695,117,196,1008
/jdk1.7.0_80/javax/swing/plaf/synth/SynthSpinnerUI.java,Java,,247,50,173,470
/jdk1.7.0_80/javax/swing/plaf/synth/SynthSplitPaneDivider.java,Java,,96,17,38,151
/jdk1.7.0_80/javax/swing/plaf/synth/SynthSplitPaneUI.java,Java,,199,45,117,361
/jdk1.7.0_80/javax/swing/plaf/synth/SynthStyle.java,Java,,792,62,199,1053
/jdk1.7.0_80/javax/swing/plaf/synth/SynthStyleFactory.java,Java,,7,3,65,75
/jdk1.7.0_80/javax/swing/plaf/synth/SynthTabbedPaneUI.java,Java,,624,95,213,932
/jdk1.7.0_80/javax/swing/plaf/synth/SynthTableHeaderUI.java,Java,,149,30,98,277
/jdk1.7.0_80/javax/swing/plaf/synth/SynthTableUI.java,Java,,585,105,141,831
/jdk1.7.0_80/javax/swing/plaf/synth/SynthTextAreaUI.java,Java,,88,22,95,205
/jdk1.7.0_80/javax/swing/plaf/synth/SynthTextFieldUI.java,Java,,144,36,99,279
/jdk1.7.0_80/javax/swing/plaf/synth/SynthTextPaneUI.java,Java,,75,17,103,195
/jdk1.7.0_80/javax/swing/plaf/synth/SynthToggleButtonUI.java,Java,,27,7,46,80
/jdk1.7.0_80/javax/swing/plaf/synth/SynthToolBarUI.java,Java,,350,62,151,563
/jdk1.7.0_80/javax/swing/plaf/synth/SynthToolTipUI.java,Java,,128,25,92,245
/jdk1.7.0_80/javax/swing/plaf/synth/SynthTreeUI.java,Java,,585,101,137,823
/jdk1.7.0_80/javax/swing/plaf/synth/SynthUI.java,Java,,8,4,46,58
/jdk1.7.0_80/javax/swing/plaf/synth/SynthViewportUI.java,Java,,92,24,112,228
/jdk1.7.0_80/javax/swing/plaf/TabbedPaneUI.java,Java,,8,3,30,41
/jdk1.7.0_80/javax/swing/plaf/TableHeaderUI.java,Java,,3,2,29,34
/jdk1.7.0_80/javax/swing/plaf/TableUI.java,Java,,3,2,29,34
/jdk1.7.0_80/javax/swing/plaf/TextUI.java,Java,,28,11,126,165
/jdk1.7.0_80/javax/swing/plaf/ToolBarUI.java,Java,,5,4,29,38
/jdk1.7.0_80/javax/swing/plaf/ToolTipUI.java,Java,,3,2,29,34
/jdk1.7.0_80/javax/swing/plaf/TreeUI.java,Java,,18,12,75,105
/jdk1.7.0_80/javax/swing/plaf/UIResource.java,Java,,3,4,60,67
/jdk1.7.0_80/javax/swing/plaf/ViewportUI.java,Java,,3,3,29,35
/jdk1.7.0_80/javax/swing/Popup.java,Java,,108,30,130,268
/jdk1.7.0_80/javax/swing/PopupFactory.java,Java,,585,121,268,974
/jdk1.7.0_80/javax/swing/ProgressMonitor.java,Java,,457,100,489,1046
/jdk1.7.0_80/javax/swing/ProgressMonitorInputStream.java,Java,,73,25,90,188
/jdk1.7.0_80/javax/swing/Renderer.java,Java,,6,3,42,51
/jdk1.7.0_80/javax/swing/RepaintManager.java,Java,,991,161,535,1687
/jdk1.7.0_80/javax/swing/RootPaneContainer.java,Java,,13,17,149,179
/jdk1.7.0_80/javax/swing/RowFilter.java,Java,,238,54,317,609
/jdk1.7.0_80/javax/swing/RowSorter.java,Java,,79,28,318,425
/jdk1.7.0_80/javax/swing/Scrollable.java,Java,,11,11,107,129
/jdk1.7.0_80/javax/swing/ScrollPaneConstants.java,Java,,25,7,85,117
/jdk1.7.0_80/javax/swing/ScrollPaneLayout.java,Java,,544,138,439,1121
/jdk1.7.0_80/javax/swing/SingleSelectionModel.java,Java,,10,8,59,77
/jdk1.7.0_80/javax/swing/SizeRequirements.java,Java,,175,27,286,488
/jdk1.7.0_80/javax/swing/SizeSequence.java,Java,,140,24,243,407
/jdk1.7.0_80/javax/swing/SortingFocusTraversalPolicy.java,Java,,346,73,232,651
/jdk1.7.0_80/javax/swing/SortOrder.java,Java,,6,3,45,54
/jdk1.7.0_80/javax/swing/SpinnerDateModel.java,Java,,110,33,321,464
/jdk1.7.0_80/javax/swing/SpinnerListModel.java,Java,,73,27,147,247
/jdk1.7.0_80/javax/swing/SpinnerModel.java,Java,,12,14,113,139
/jdk1.7.0_80/javax/swing/SpinnerNumberModel.java,Java,,118,38,294,450
/jdk1.7.0_80/javax/swing/Spring.java,Java,,293,93,305,691
/jdk1.7.0_80/javax/swing/SpringLayout.java,Java,,505,95,633,1233
/jdk1.7.0_80/javax/swing/SwingConstants.java,Java,,22,8,108,138
/jdk1.7.0_80/javax/swing/SwingHeavyWeight.java,Java,,3,1,30,34
/jdk1.7.0_80/javax/swing/SwingPaintEventDispatcher.java,Java,,56,6,32,94
/jdk1.7.0_80/javax/swing/SwingUtilities.java,Java,,1168,180,740,2088
/jdk1.7.0_80/javax/swing/SwingWorker.java,Java,,270,45,551,866
/jdk1.7.0_80/javax/swing/table/AbstractTableModel.java,Java,,73,24,243,340
/jdk1.7.0_80/javax/swing/table/DefaultTableCellRenderer.java,Java,,148,41,210,399
/jdk1.7.0_80/javax/swing/table/DefaultTableColumnModel.java,Java,,267,72,400,739
/jdk1.7.0_80/javax/swing/table/DefaultTableModel.java,Java,,214,55,439,708
/jdk1.7.0_80/javax/swing/table/JTableHeader.java,Java,,782,155,535,1472
/jdk1.7.0_80/javax/swing/table/TableCellEditor.java,Java,,9,6,57,72
/jdk1.7.0_80/javax/swing/table/TableCellRenderer.java,Java,,8,5,81,94
/jdk1.7.0_80/javax/swing/table/TableColumn.java,Java,,226,71,528,825
/jdk1.7.0_80/javax/swing/table/TableColumnModel.java,Java,,27,26,188,241
/jdk1.7.0_80/javax/swing/table/TableModel.java,Java,,15,12,116,143
/jdk1.7.0_80/javax/swing/table/TableRowSorter.java,Java,,99,21,188,308
/jdk1.7.0_80/javax/swing/table/TableStringConverter.java,Java,,4,1,43,48
/jdk1.7.0_80/javax/swing/TablePrintable.java,Java,,208,95,218,521
/jdk1.7.0_80/javax/swing/text/AbstractDocument.java,Java,,1285,293,1540,3118
/jdk1.7.0_80/javax/swing/text/AbstractWriter.java,Java,,329,54,330,713
/jdk1.7.0_80/javax/swing/text/AsyncBoxView.java,Java,,649,109,662,1420
/jdk1.7.0_80/javax/swing/text/AttributeSet.java,Java,,23,18,152,193
/jdk1.7.0_80/javax/swing/text/BadLocationException.java,Java,,12,3,50,65
/jdk1.7.0_80/javax/swing/text/BoxView.java,Java,,565,84,539,1188
/jdk1.7.0_80/javax/swing/text/Caret.java,Java,,24,20,160,204
/jdk1.7.0_80/javax/swing/text/ChangedCharSetException.java,Java,,16,7,30,53
/jdk1.7.0_80/javax/swing/text/ComponentView.java,Java,,245,37,222,504
/jdk1.7.0_80/javax/swing/text/CompositeView.java,Java,,321,47,426,794
/jdk1.7.0_80/javax/swing/text/DateFormatter.java,Java,,64,17,79,160
/jdk1.7.0_80/javax/swing/text/DefaultCaret.java,Java,,984,147,792,1923
/jdk1.7.0_80/javax/swing/text/DefaultEditorKit.java,Java,,1141,221,950,2312
/jdk1.7.0_80/javax/swing/text/DefaultFormatter.java,Java,,378,78,310,766
/jdk1.7.0_80/javax/swing/text/DefaultFormatterFactory.java,Java,,84,22,207,313
/jdk1.7.0_80/javax/swing/text/DefaultHighlighter.java,Java,,381,61,212,654
/jdk1.7.0_80/javax/swing/text/DefaultStyledDocument.java,Java,,1635,220,889,2744
/jdk1.7.0_80/javax/swing/text/DefaultTextUI.java,Java,,5,4,33,42
/jdk1.7.0_80/javax/swing/text/Document.java,Java,,23,23,430,476
/jdk1.7.0_80/javax/swing/text/DocumentFilter.java,Java,,26,8,152,186
/jdk1.7.0_80/javax/swing/text/EditorKit.java,Java,,34,16,158,208
/jdk1.7.0_80/javax/swing/text/Element.java,Java,,13,13,113,139
/jdk1.7.0_80/javax/swing/text/ElementIterator.java,Java,,167,42,172,381
/jdk1.7.0_80/javax/swing/text/FieldView.java,Java,,149,19,143,311
/jdk1.7.0_80/javax/swing/text/FlowView.java,Java,,426,68,401,895
/jdk1.7.0_80/javax/swing/text/GapContent.java,Java,,545,94,315,954
/jdk1.7.0_80/javax/swing/text/GapVector.java,Java,,120,31,148,299
/jdk1.7.0_80/javax/swing/text/GlyphPainter1.java,Java,,120,23,107,250
/jdk1.7.0_80/javax/swing/text/GlyphPainter2.java,Java,,214,28,144,386
/jdk1.7.0_80/javax/swing/text/GlyphView.java,Java,,671,96,576,1343
/jdk1.7.0_80/javax/swing/text/Highlighter.java,Java,,22,19,111,152
/jdk1.7.0_80/javax/swing/text/html/AccessibleHTML.java,Java,,1551,296,1211,3058
/jdk1.7.0_80/javax/swing/text/html/BlockView.java,Java,,206,32,205,443
/jdk1.7.0_80/javax/swing/text/html/BRView.java,Java,,14,4,39,57
/jdk1.7.0_80/javax/swing/text/html/CommentView.java,Java,,92,13,36,141
/jdk1.7.0_80/javax/swing/text/html/CSS.java,Java,,2245,340,819,3404
/jdk1.7.0_80/javax/swing/text/html/CSSBorder.java,Java,,267,48,121,436
/jdk1.7.0_80/javax/swing/text/html/CSSParser.java,Java,,583,77,194,854
/jdk1.7.0_80/javax/swing/text/html/EditableView.java,Java,,70,11,47,128
/jdk1.7.0_80/javax/swing/text/html/FormSubmitEvent.java,Java,,21,9,62,92
/jdk1.7.0_80/javax/swing/text/html/FormView.java,Java,,592,75,303,970
/jdk1.7.0_80/javax/swing/text/html/FrameSetView.java,Java,,178,31,113,322
/jdk1.7.0_80/javax/swing/text/html/FrameView.java,Java,,289,51,139,479
/jdk1.7.0_80/javax/swing/text/html/HiddenTagView.java,Java,,254,39,68,361
/jdk1.7.0_80/javax/swing/text/html/HRuleView.java,Java,,182,26,113,321
/jdk1.7.0_80/javax/swing/text/html/HTML.java,Java,,411,47,239,697
/jdk1.7.0_80/javax/swing/text/html/HTMLDocument.java,Java,,2083,298,1815,4196
/jdk1.7.0_80/javax/swing/text/html/HTMLEditorKit.java,Java,,1321,172,795,2288
/jdk1.7.0_80/javax/swing/text/html/HTMLFrameHyperlinkEvent.java,Java,,37,12,85,134
/jdk1.7.0_80/javax/swing/text/html/HTMLWriter.java,Java,,816,105,352,1273
/jdk1.7.0_80/javax/swing/text/html/ImageView.java,Java,,623,95,290,1008
/jdk1.7.0_80/javax/swing/text/html/InlineView.java,Java,,69,16,140,225
/jdk1.7.0_80/javax/swing/text/html/IsindexView.java,Java,,51,15,48,114
/jdk1.7.0_80/javax/swing/text/html/LineView.java,Java,,63,11,112,186
/jdk1.7.0_80/javax/swing/text/html/ListView.java,Java,,53,8,61,122
/jdk1.7.0_80/javax/swing/text/html/Map.java,Java,,346,48,109,503
/jdk1.7.0_80/javax/swing/text/html/MinimalHTMLWriter.java,Java,,348,82,296,726
/jdk1.7.0_80/javax/swing/text/html/MuxingAttributeSet.java,Java,,148,28,135,311
/jdk1.7.0_80/javax/swing/text/html/NoFramesView.java,Java,,57,15,101,173
/jdk1.7.0_80/javax/swing/text/html/ObjectView.java,Java,,67,9,88,164
/jdk1.7.0_80/javax/swing/text/html/Option.java,Java,,37,11,72,120
/jdk1.7.0_80/javax/swing/text/html/OptionComboBoxModel.java,Java,,13,7,43,63
/jdk1.7.0_80/javax/swing/text/html/OptionListModel.java,Java,,304,72,194,570
/jdk1.7.0_80/javax/swing/text/html/ParagraphView.java,Java,,136,20,138,294
/jdk1.7.0_80/javax/swing/text/html/parser/AttributeList.java,Java,,83,19,70,172
/jdk1.7.0_80/javax/swing/text/html/parser/ContentModel.java,Java,,144,26,85,255
/jdk1.7.0_80/javax/swing/text/html/parser/ContentModelState.java,Java,,173,27,95,295
/jdk1.7.0_80/javax/swing/text/html/parser/DocumentParser.java,Java,,152,19,110,281
/jdk1.7.0_80/javax/swing/text/html/parser/DTD.java,Java,,261,40,165,466
/jdk1.7.0_80/javax/swing/text/html/parser/DTDConstants.java,Java,,39,6,37,82
/jdk1.7.0_80/javax/swing/text/html/parser/Element.java,Java,,79,22,74,175
/jdk1.7.0_80/javax/swing/text/html/parser/Entity.java,Java,,53,14,72,139
/jdk1.7.0_80/javax/swing/text/html/parser/Parser.java,Java,,1573,246,511,2330
/jdk1.7.0_80/javax/swing/text/html/parser/ParserDelegator.java,Java,,65,19,45,129
/jdk1.7.0_80/javax/swing/text/html/parser/ResourceLoader.java,Java,,16,7,37,60
/jdk1.7.0_80/javax/swing/text/html/parser/TagElement.java,Java,,33,11,30,74
/jdk1.7.0_80/javax/swing/text/html/parser/TagStack.java,Java,,114,25,65,204
/jdk1.7.0_80/javax/swing/text/html/ResourceLoader.java,Java,,16,7,37,60
/jdk1.7.0_80/javax/swing/text/html/StyleSheet.java,Java,,2083,224,1031,3338
/jdk1.7.0_80/javax/swing/text/html/TableView.java,Java,,1030,166,605,1801
/jdk1.7.0_80/javax/swing/text/html/TextAreaDocument.java,Java,,20,8,40,68
/jdk1.7.0_80/javax/swing/text/IconView.java,Java,,56,11,101,168
/jdk1.7.0_80/javax/swing/text/InternationalFormatter.java,Java,,535,96,427,1058
/jdk1.7.0_80/javax/swing/text/JTextComponent.java,Java,,2444,401,2228,5073
/jdk1.7.0_80/javax/swing/text/Keymap.java,Java,,18,16,113,147
/jdk1.7.0_80/javax/swing/text/LabelView.java,Java,,96,24,196,316
/jdk1.7.0_80/javax/swing/text/LayeredHighlighter.java,Java,,14,4,45,63
/jdk1.7.0_80/javax/swing/text/LayoutQueue.java,Java,,62,15,52,129
/jdk1.7.0_80/javax/swing/text/MaskFormatter.java,Java,,468,86,460,1014
/jdk1.7.0_80/javax/swing/text/MutableAttributeSet.java,Java,,10,9,68,87
/jdk1.7.0_80/javax/swing/text/NavigationFilter.java,Java,,22,8,117,147
/jdk1.7.0_80/javax/swing/text/NumberFormatter.java,Java,,264,37,169,470
/jdk1.7.0_80/javax/swing/text/ParagraphView.java,Java,,657,76,468,1201
/jdk1.7.0_80/javax/swing/text/PasswordView.java,Java,,113,12,111,236
/jdk1.7.0_80/javax/swing/text/PlainDocument.java,Java,,169,16,136,321
/jdk1.7.0_80/javax/swing/text/PlainView.java,Java,,384,46,285,715
/jdk1.7.0_80/javax/swing/text/Position.java,Java,,15,8,70,93
/jdk1.7.0_80/javax/swing/text/rtf/AbstractFilter.java,Java,,108,25,96,229
/jdk1.7.0_80/javax/swing/text/rtf/Constants.java,Java,,28,10,40,78
/jdk1.7.0_80/javax/swing/text/rtf/MockAttributeSet.java,Java,,78,20,26,124
/jdk1.7.0_80/javax/swing/text/rtf/RTFAttribute.java,Java,,26,7,34,67
/jdk1.7.0_80/javax/swing/text/rtf/RTFAttributes.java,Java,,323,64,34,421
/jdk1.7.0_80/javax/swing/text/rtf/RTFEditorKit.java,Java,,43,13,99,155
/jdk1.7.0_80/javax/swing/text/rtf/RTFGenerator.java,Java,,757,130,114,1001
/jdk1.7.0_80/javax/swing/text/rtf/RTFParser.java,Java,,228,34,71,333
/jdk1.7.0_80/javax/swing/text/rtf/RTFReader.java,Java,,1116,225,300,1641
/jdk1.7.0_80/javax/swing/text/Segment.java,Java,,122,29,165,316
/jdk1.7.0_80/javax/swing/text/SegmentCache.java,Java,,39,15,73,127
/jdk1.7.0_80/javax/swing/text/SimpleAttributeSet.java,Java,,188,34,170,392
/jdk1.7.0_80/javax/swing/text/StateInvariantError.java,Java,,7,2,36,45
/jdk1.7.0_80/javax/swing/text/StringContent.java,Java,,264,40,194,498
/jdk1.7.0_80/javax/swing/text/Style.java,Java,,11,10,54,75
/jdk1.7.0_80/javax/swing/text/StyleConstants.java,Java,,282,100,470,852
/jdk1.7.0_80/javax/swing/text/StyleContext.java,Java,,711,147,763,1621
/jdk1.7.0_80/javax/swing/text/StyledDocument.java,Java,,17,16,144,177
/jdk1.7.0_80/javax/swing/text/StyledEditorKit.java,Java,,397,76,422,895
/jdk1.7.0_80/javax/swing/text/TabableView.java,Java,,5,4,61,70
/jdk1.7.0_80/javax/swing/text/TabExpander.java,Java,,4,4,39,47
/jdk1.7.0_80/javax/swing/text/TableView.java,Java,,426,75,406,907
/jdk1.7.0_80/javax/swing/text/TabSet.java,Java,,103,17,92,212
/jdk1.7.0_80/javax/swing/text/TabStop.java,Java,,76,14,87,177
/jdk1.7.0_80/javax/swing/text/TextAction.java,Java,,43,6,86,135
/jdk1.7.0_80/javax/swing/text/TextLayoutStrategy.java,Java,,302,53,200,555
/jdk1.7.0_80/javax/swing/text/Utilities.java,Java,,689,59,330,1078
/jdk1.7.0_80/javax/swing/text/View.java,Java,,387,70,916,1373
/jdk1.7.0_80/javax/swing/text/ViewFactory.java,Java,,5,4,39,48
/jdk1.7.0_80/javax/swing/text/WhitespaceBasedBreakIterator.java,Java,,71,16,32,119
/jdk1.7.0_80/javax/swing/text/WrappedPlainView.java,Java,,450,65,338,853
/jdk1.7.0_80/javax/swing/text/ZoneView.java,Java,,247,49,355,651
/jdk1.7.0_80/javax/swing/Timer.java,Java,,191,73,381,645
/jdk1.7.0_80/javax/swing/TimerQueue.java,Java,,200,40,61,301
/jdk1.7.0_80/javax/swing/ToolTipManager.java,Java,,549,78,235,862
/jdk1.7.0_80/javax/swing/TransferHandler.java,Java,,802,206,780,1788
/jdk1.7.0_80/javax/swing/tree/AbstractLayoutCache.java,Java,,140,56,335,531
/jdk1.7.0_80/javax/swing/tree/DefaultMutableTreeNode.java,Java,,639,227,634,1500
/jdk1.7.0_80/javax/swing/tree/DefaultTreeCellEditor.java,Java,,381,88,311,780
/jdk1.7.0_80/javax/swing/tree/DefaultTreeCellRenderer.java,Java,,306,81,305,692
/jdk1.7.0_80/javax/swing/tree/DefaultTreeModel.java,Java,,263,55,363,681
/jdk1.7.0_80/javax/swing/tree/DefaultTreeSelectionModel.java,Java,,688,116,423,1227
/jdk1.7.0_80/javax/swing/tree/ExpandVetoException.java,Java,,12,6,45,63
/jdk1.7.0_80/javax/swing/tree/FixedHeightLayoutCache.java,Java,,964,185,452,1601
/jdk1.7.0_80/javax/swing/tree/MutableTreeNode.java,Java,,10,8,55,73
/jdk1.7.0_80/javax/swing/tree/RowMapper.java,Java,,6,3,37,46
/jdk1.7.0_80/javax/swing/tree/TreeCellEditor.java,Java,,10,4,51,65
/jdk1.7.0_80/javax/swing/tree/TreeCellRenderer.java,Java,,8,4,64,76
/jdk1.7.0_80/javax/swing/tree/TreeModel.java,Java,,13,15,132,160
/jdk1.7.0_80/javax/swing/tree/TreeNode.java,Java,,12,10,65,87
/jdk1.7.0_80/javax/swing/tree/TreePath.java,Java,,126,27,207,360
/jdk1.7.0_80/javax/swing/tree/TreeSelectionModel.java,Java,,36,33,242,311
/jdk1.7.0_80/javax/swing/tree/VariableHeightLayoutCache.java,Java,,1046,191,530,1767
/jdk1.7.0_80/javax/swing/UIDefaults.java,Java,,539,122,669,1330
/jdk1.7.0_80/javax/swing/UIManager.java,Java,,597,133,759,1489
/jdk1.7.0_80/javax/swing/undo/AbstractUndoableEdit.java,Java,,73,23,182,278
/jdk1.7.0_80/javax/swing/undo/CannotRedoException.java,Java,,3,1,38,42
/jdk1.7.0_80/javax/swing/undo/CannotUndoException.java,Java,,3,2,38,43
/jdk1.7.0_80/javax/swing/undo/CompoundEdit.java,Java,,110,21,131,262
/jdk1.7.0_80/javax/swing/undo/StateEdit.java,Java,,59,27,107,193
/jdk1.7.0_80/javax/swing/undo/StateEditable.java,Java,,7,8,39,54
/jdk1.7.0_80/javax/swing/undo/UndoableEdit.java,Java,,15,13,173,201
/jdk1.7.0_80/javax/swing/undo/UndoableEditSupport.java,Java,,69,15,92,176
/jdk1.7.0_80/javax/swing/undo/UndoManager.java,Java,,208,44,372,624
/jdk1.7.0_80/javax/swing/UnsupportedLookAndFeelException.java,Java,,7,1,43,51
/jdk1.7.0_80/javax/swing/ViewportLayout.java,Java,,82,19,101,202
/jdk1.7.0_80/javax/swing/WindowConstants.java,Java,,8,7,69,84
/jdk1.7.0_80/javax/tools/Diagnostic.java,Java,,21,14,135,170
/jdk1.7.0_80/javax/tools/DiagnosticCollector.java,Java,,15,5,38,58
/jdk1.7.0_80/javax/tools/DiagnosticListener.java,Java,,4,2,43,49
/jdk1.7.0_80/javax/tools/FileObject.java,Java,,18,13,128,159
/jdk1.7.0_80/javax/tools/ForwardingFileObject.java,Java,,41,14,65,120
/jdk1.7.0_80/javax/tools/ForwardingJavaFileManager.java,Java,,75,18,74,167
/jdk1.7.0_80/javax/tools/ForwardingJavaFileObject.java,Java,,19,9,37,65
/jdk1.7.0_80/javax/tools/JavaCompiler.java,Java,,24,9,302,335
/jdk1.7.0_80/javax/tools/JavaFileManager.java,Java,,43,17,342,402
/jdk1.7.0_80/javax/tools/JavaFileObject.java,Java,,26,12,98,136
/jdk1.7.0_80/javax/tools/OptionChecker.java,Java,,4,4,38,46
/jdk1.7.0_80/javax/tools/package-info.java,Java,,1,1,76,78
/jdk1.7.0_80/javax/tools/SimpleJavaFileObject.java,Java,,69,19,128,216
/jdk1.7.0_80/javax/tools/StandardJavaFileManager.java,Java,,16,11,212,239
/jdk1.7.0_80/javax/tools/StandardLocation.java,Java,,28,13,61,102
/jdk1.7.0_80/javax/tools/Tool.java,Java,,9,6,57,72
/jdk1.7.0_80/javax/tools/ToolProvider.java,Java,,117,24,62,203
/jdk1.7.0_80/javax/xml/bind/annotation/adapters/CollapsedStringAdapter.java,Java,,44,17,58,119
/jdk1.7.0_80/javax/xml/bind/annotation/adapters/HexBinaryAdapter.java,Java,,12,4,33,49
/jdk1.7.0_80/javax/xml/bind/annotation/adapters/NormalizedStringAdapter.java,Java,,24,14,54,92
/jdk1.7.0_80/javax/xml/bind/annotation/adapters/XmlAdapter.java,Java,,6,5,182,193
/jdk1.7.0_80/javax/xml/bind/annotation/adapters/XmlJavaTypeAdapter.java,Java,,24,11,81,116
/jdk1.7.0_80/javax/xml/bind/annotation/adapters/XmlJavaTypeAdapters.java,Java,,9,3,50,62
/jdk1.7.0_80/javax/xml/bind/annotation/DomHandler.java,Java,,9,5,105,119
/jdk1.7.0_80/javax/xml/bind/annotation/W3CDomHandler.java,Java,,47,13,49,109
/jdk1.7.0_80/javax/xml/bind/annotation/XmlAccessOrder.java,Java,,5,3,40,48
/jdk1.7.0_80/javax/xml/bind/annotation/XmlAccessorOrder.java,Java,,11,5,64,80
/jdk1.7.0_80/javax/xml/bind/annotation/XmlAccessorType.java,Java,,11,6,83,100
/jdk1.7.0_80/javax/xml/bind/annotation/XmlAccessType.java,Java,,7,5,58,70
/jdk1.7.0_80/javax/xml/bind/annotation/XmlAnyAttribute.java,Java,,12,4,58,74
/jdk1.7.0_80/javax/xml/bind/annotation/XmlAnyElement.java,Java,,17,7,264,288
/jdk1.7.0_80/javax/xml/bind/annotation/XmlAttachmentRef.java,Java,,10,3,61,74
/jdk1.7.0_80/javax/xml/bind/annotation/XmlAttribute.java,Java,,11,7,134,152
/jdk1.7.0_80/javax/xml/bind/annotation/XmlElement.java,Java,,17,12,181,210
/jdk1.7.0_80/javax/xml/bind/annotation/XmlElementDecl.java,Java,,16,10,190,216
/jdk1.7.0_80/javax/xml/bind/annotation/XmlElementRef.java,Java,,16,7,267,290
/jdk1.7.0_80/javax/xml/bind/annotation/XmlElementRefs.java,Java,,12,3,44,59
/jdk1.7.0_80/javax/xml/bind/annotation/XmlElements.java,Java,,11,3,163,177
/jdk1.7.0_80/javax/xml/bind/annotation/XmlElementWrapper.java,Java,,14,7,124,145
/jdk1.7.0_80/javax/xml/bind/annotation/XmlEnum.java,Java,,9,4,62,75
/jdk1.7.0_80/javax/xml/bind/annotation/XmlEnumValue.java,Java,,10,3,110,123
/jdk1.7.0_80/javax/xml/bind/annotation/XmlID.java,Java,,7,4,83,94
/jdk1.7.0_80/javax/xml/bind/annotation/XmlIDREF.java,Java,,7,4,239,250
/jdk1.7.0_80/javax/xml/bind/annotation/XmlInlineBinaryData.java,Java,,15,4,41,60
/jdk1.7.0_80/javax/xml/bind/annotation/XmlList.java,Java,,10,3,98,111
/jdk1.7.0_80/javax/xml/bind/annotation/XmlMimeType.java,Java,,14,4,43,61
/jdk1.7.0_80/javax/xml/bind/annotation/XmlMixed.java,Java,,12,5,115,132
/jdk1.7.0_80/javax/xml/bind/annotation/XmlNs.java,Java,,9,5,45,59
/jdk1.7.0_80/javax/xml/bind/annotation/XmlNsForm.java,Java,,2,2,62,66
/jdk1.7.0_80/javax/xml/bind/annotation/XmlRegistry.java,Java,,9,3,31,43
/jdk1.7.0_80/javax/xml/bind/annotation/XmlRootElement.java,Java,,11,6,165,182
/jdk1.7.0_80/javax/xml/bind/annotation/XmlSchema.java,Java,,14,11,181,206
/jdk1.7.0_80/javax/xml/bind/annotation/XmlSchemaType.java,Java,,14,9,85,108
/jdk1.7.0_80/javax/xml/bind/annotation/XmlSchemaTypes.java,Java,,9,3,49,61
/jdk1.7.0_80/javax/xml/bind/annotation/XmlSeeAlso.java,Java,,11,3,65,79
/jdk1.7.0_80/javax/xml/bind/annotation/XmlTransient.java,Java,,7,4,84,95
/jdk1.7.0_80/javax/xml/bind/annotation/XmlType.java,Java,,14,9,429,452
/jdk1.7.0_80/javax/xml/bind/annotation/XmlValue.java,Java,,7,4,120,131
/jdk1.7.0_80/javax/xml/bind/attachment/AttachmentMarshaller.java,Java,,9,7,184,200
/jdk1.7.0_80/javax/xml/bind/attachment/AttachmentUnmarshaller.java,Java,,7,5,127,139
/jdk1.7.0_80/javax/xml/bind/Binder.java,Java,,21,20,380,421
/jdk1.7.0_80/javax/xml/bind/ContextFinder.java,Java,,352,65,157,574
/jdk1.7.0_80/javax/xml/bind/DataBindingException.java,Java,,9,3,35,47
/jdk1.7.0_80/javax/xml/bind/DatatypeConverter.java,Java,,177,46,472,695
/jdk1.7.0_80/javax/xml/bind/DatatypeConverterImpl.java,Java,,724,170,168,1062
/jdk1.7.0_80/javax/xml/bind/DatatypeConverterInterface.java,Java,,43,41,439,523
/jdk1.7.0_80/javax/xml/bind/Element.java,Java,,3,3,36,42
/jdk1.7.0_80/javax/xml/bind/GetPropertyAction.java,Java,,11,5,28,44
/jdk1.7.0_80/javax/xml/bind/helpers/AbstractMarshallerImpl.java,Java,,259,73,163,495
/jdk1.7.0_80/javax/xml/bind/helpers/AbstractUnmarshallerImpl.java,Java,,219,64,152,435
/jdk1.7.0_80/javax/xml/bind/helpers/DefaultValidationEventHandler.java,Java,,62,16,53,131
/jdk1.7.0_80/javax/xml/bind/helpers/Messages.java,Java,,44,19,34,97
/jdk1.7.0_80/javax/xml/bind/helpers/NotIdentifiableEventImpl.java,Java,,15,8,62,85
/jdk1.7.0_80/javax/xml/bind/helpers/ParseConversionEventImpl.java,Java,,16,8,62,86
/jdk1.7.0_80/javax/xml/bind/helpers/PrintConversionEventImpl.java,Java,,16,8,62,86
/jdk1.7.0_80/javax/xml/bind/helpers/ValidationEventImpl.java,Java,,68,18,89,175
/jdk1.7.0_80/javax/xml/bind/helpers/ValidationEventLocatorImpl.java,Java,,103,28,142,273
/jdk1.7.0_80/javax/xml/bind/JAXB.java,Java,,231,34,364,629
/jdk1.7.0_80/javax/xml/bind/JAXBContext.java,Java,,55,32,663,750
/jdk1.7.0_80/javax/xml/bind/JAXBElement.java,Java,,55,23,140,218
/jdk1.7.0_80/javax/xml/bind/JAXBException.java,Java,,52,19,113,184
/jdk1.7.0_80/javax/xml/bind/JAXBIntrospector.java,Java,,13,5,74,92
/jdk1.7.0_80/javax/xml/bind/JAXBPermission.java,Java,,9,5,80,94
/jdk1.7.0_80/javax/xml/bind/MarshalException.java,Java,,18,8,73,99
/jdk1.7.0_80/javax/xml/bind/Marshaller.java,Java,,58,35,730,823
/jdk1.7.0_80/javax/xml/bind/Messages.java,Java,,41,18,34,93
/jdk1.7.0_80/javax/xml/bind/NotIdentifiableEvent.java,Java,,3,3,33,39
/jdk1.7.0_80/javax/xml/bind/ParseConversionEvent.java,Java,,3,3,34,40
/jdk1.7.0_80/javax/xml/bind/PrintConversionEvent.java,Java,,3,3,34,40
/jdk1.7.0_80/javax/xml/bind/PropertyException.java,Java,,26,12,75,113
/jdk1.7.0_80/javax/xml/bind/SchemaOutputResolver.java,Java,,6,3,73,82
/jdk1.7.0_80/javax/xml/bind/TypeConstraintException.java,Java,,47,19,117,183
/jdk1.7.0_80/javax/xml/bind/UnmarshalException.java,Java,,18,8,75,101
/jdk1.7.0_80/javax/xml/bind/Unmarshaller.java,Java,,51,35,1056,1142
/jdk1.7.0_80/javax/xml/bind/UnmarshallerHandler.java,Java,,6,3,74,83
/jdk1.7.0_80/javax/xml/bind/util/JAXBResult.java,Java,,25,10,115,150
/jdk1.7.0_80/javax/xml/bind/util/JAXBSource.java,Java,,123,30,118,271
/jdk1.7.0_80/javax/xml/bind/util/Messages.java,Java,,34,15,34,83
/jdk1.7.0_80/javax/xml/bind/util/ValidationEventCollector.java,Java,,44,10,59,113
/jdk1.7.0_80/javax/xml/bind/ValidationEvent.java,Java,,10,10,72,92
/jdk1.7.0_80/javax/xml/bind/ValidationEventHandler.java,Java,,4,3,87,94
/jdk1.7.0_80/javax/xml/bind/ValidationEventLocator.java,Java,,9,9,72,90
/jdk1.7.0_80/javax/xml/bind/ValidationException.java,Java,,18,8,73,99
/jdk1.7.0_80/javax/xml/bind/Validator.java,Java,,12,9,264,285
/jdk1.7.0_80/javax/xml/bind/WhiteSpaceProcessor.java,Java,,82,30,86,198
/jdk1.7.0_80/javax/xml/crypto/AlgorithmMethod.java,Java,,6,4,48,58
/jdk1.7.0_80/javax/xml/crypto/Data.java,Java,,3,2,37,42
/jdk1.7.0_80/javax/xml/crypto/dom/DOMCryptoContext.java,Java,,102,21,120,243
/jdk1.7.0_80/javax/xml/crypto/dom/DOMStructure.java,Java,,23,6,59,88
/jdk1.7.0_80/javax/xml/crypto/dom/DOMURIReference.java,Java,,6,3,42,51
/jdk1.7.0_80/javax/xml/crypto/dsig/CanonicalizationMethod.java,Java,,14,7,83,104
/jdk1.7.0_80/javax/xml/crypto/dsig/DigestMethod.java,Java,,12,7,79,98
/jdk1.7.0_80/javax/xml/crypto/dsig/dom/DOMSignContext.java,Java,,74,11,124,209
/jdk1.7.0_80/javax/xml/crypto/dsig/dom/DOMValidateContext.java,Java,,44,9,82,135
/jdk1.7.0_80/javax/xml/crypto/dsig/keyinfo/KeyInfo.java,Java,,11,5,107,123
/jdk1.7.0_80/javax/xml/crypto/dsig/keyinfo/KeyInfoFactory.java,Java,,106,27,389,522
/jdk1.7.0_80/javax/xml/crypto/dsig/keyinfo/KeyName.java,Java,,5,3,59,67
/jdk1.7.0_80/javax/xml/crypto/dsig/keyinfo/KeyValue.java,Java,,14,5,115,134
/jdk1.7.0_80/javax/xml/crypto/dsig/keyinfo/PGPData.java,Java,,10,6,100,116
/jdk1.7.0_80/javax/xml/crypto/dsig/keyinfo/RetrievalMethod.java,Java,,13,5,94,112
/jdk1.7.0_80/javax/xml/crypto/dsig/keyinfo/X509Data.java,Java,,10,5,98,113
/jdk1.7.0_80/javax/xml/crypto/dsig/keyinfo/X509IssuerSerial.java,Java,,8,4,77,89
/jdk1.7.0_80/javax/xml/crypto/dsig/Manifest.java,Java,,8,5,77,90
/jdk1.7.0_80/javax/xml/crypto/dsig/Reference.java,Java,,17,10,141,168
/jdk1.7.0_80/javax/xml/crypto/dsig/SignatureMethod.java,Java,,14,6,77,97
/jdk1.7.0_80/javax/xml/crypto/dsig/SignatureProperties.java,Java,,9,5,77,91
/jdk1.7.0_80/javax/xml/crypto/dsig/SignatureProperty.java,Java,,8,5,82,95
/jdk1.7.0_80/javax/xml/crypto/dsig/SignedInfo.java,Java,,11,7,84,102
/jdk1.7.0_80/javax/xml/crypto/dsig/spec/C14NMethodParameterSpec.java,Java,,3,2,38,43
/jdk1.7.0_80/javax/xml/crypto/dsig/spec/DigestMethodParameterSpec.java,Java,,4,2,38,44
/jdk1.7.0_80/javax/xml/crypto/dsig/spec/ExcC14NParameterSpec.java,Java,,27,7,81,115
/jdk1.7.0_80/javax/xml/crypto/dsig/spec/HMACParameterSpec.java,Java,,11,5,59,75
/jdk1.7.0_80/javax/xml/crypto/dsig/spec/SignatureMethodParameterSpec.java,Java,,4,2,38,44
/jdk1.7.0_80/javax/xml/crypto/dsig/spec/TransformParameterSpec.java,Java,,4,2,38,44
/jdk1.7.0_80/javax/xml/crypto/dsig/spec/XPathFilter2ParameterSpec.java,Java,,28,5,59,92
/jdk1.7.0_80/javax/xml/crypto/dsig/spec/XPathFilterParameterSpec.java,Java,,40,7,79,126
/jdk1.7.0_80/javax/xml/crypto/dsig/spec/XPathType.java,Java,,58,14,127,199
/jdk1.7.0_80/javax/xml/crypto/dsig/spec/XSLTTransformParameterSpec.java,Java,,15,4,59,78
/jdk1.7.0_80/javax/xml/crypto/dsig/Transform.java,Java,,23,10,115,148
/jdk1.7.0_80/javax/xml/crypto/dsig/TransformException.java,Java,,42,12,102,156
/jdk1.7.0_80/javax/xml/crypto/dsig/TransformService.java,Java,,151,16,226,393
/jdk1.7.0_80/javax/xml/crypto/dsig/XMLObject.java,Java,,10,8,110,128
/jdk1.7.0_80/javax/xml/crypto/dsig/XMLSignature.java,Java,,27,15,203,245
/jdk1.7.0_80/javax/xml/crypto/dsig/XMLSignatureException.java,Java,,42,12,99,153
/jdk1.7.0_80/javax/xml/crypto/dsig/XMLSignatureFactory.java,Java,,140,38,615,793
/jdk1.7.0_80/javax/xml/crypto/dsig/XMLSignContext.java,Java,,4,2,57,63
/jdk1.7.0_80/javax/xml/crypto/dsig/XMLValidateContext.java,Java,,3,2,58,63
/jdk1.7.0_80/javax/xml/crypto/KeySelector.java,Java,,40,14,98,152
/jdk1.7.0_80/javax/xml/crypto/KeySelectorException.java,Java,,33,12,103,148
/jdk1.7.0_80/javax/xml/crypto/KeySelectorResult.java,Java,,5,3,46,54
/jdk1.7.0_80/javax/xml/crypto/MarshalException.java,Java,,38,12,105,155
/jdk1.7.0_80/javax/xml/crypto/NodeSetData.java,Java,,5,3,48,56
/jdk1.7.0_80/javax/xml/crypto/NoSuchMechanismException.java,Java,,38,12,106,156
/jdk1.7.0_80/javax/xml/crypto/OctetStreamData.java,Java,,31,8,67,106
/jdk1.7.0_80/javax/xml/crypto/URIDereferencer.java,Java,,5,3,67,75
/jdk1.7.0_80/javax/xml/crypto/URIReference.java,Java,,5,3,52,60
/jdk1.7.0_80/javax/xml/crypto/URIReferenceException.java,Java,,46,15,127,188
/jdk1.7.0_80/javax/xml/crypto/XMLCryptoContext.java,Java,,17,15,194,226
/jdk1.7.0_80/javax/xml/crypto/XMLStructure.java,Java,,4,2,44,50
/jdk1.7.0_80/javax/xml/datatype/DatatypeConfigurationException.java,Java,,15,11,53,79
/jdk1.7.0_80/javax/xml/datatype/DatatypeConstants.java,Java,,55,46,173,274
/jdk1.7.0_80/javax/xml/datatype/DatatypeFactory.java,Java,,282,61,721,1064
/jdk1.7.0_80/javax/xml/datatype/Duration.java,Java,,186,53,749,988
/jdk1.7.0_80/javax/xml/datatype/FactoryFinder.java,Java,,202,34,131,367
/jdk1.7.0_80/javax/xml/datatype/SecuritySupport.java,Java,,65,10,31,106
/jdk1.7.0_80/javax/xml/datatype/XMLGregorianCalendar.java,Java,,102,57,903,1062
/jdk1.7.0_80/javax/xml/namespace/NamespaceContext.java,Java,,7,7,274,288
/jdk1.7.0_80/javax/xml/namespace/QName.java,Java,,128,31,357,516
/jdk1.7.0_80/javax/xml/parsers/DocumentBuilder.java,Java,,80,42,226,348
/jdk1.7.0_80/javax/xml/parsers/DocumentBuilderFactory.java,Java,,112,53,474,639
/jdk1.7.0_80/javax/xml/parsers/FactoryConfigurationError.java,Java,,35,21,79,135
/jdk1.7.0_80/javax/xml/parsers/FactoryFinder.java,Java,,200,32,132,364
/jdk1.7.0_80/javax/xml/parsers/ParserConfigurationException.java,Java,,9,8,39,56
/jdk1.7.0_80/javax/xml/parsers/SAXParser.java,Java,,150,42,363,555
/jdk1.7.0_80/javax/xml/parsers/SAXParserFactory.java,Java,,84,32,356,472
/jdk1.7.0_80/javax/xml/parsers/SecuritySupport.java,Java,,65,12,33,110
/jdk1.7.0_80/javax/xml/soap/AttachmentPart.java,Java,,61,37,428,526
/jdk1.7.0_80/javax/xml/soap/Detail.java,Java,,8,7,84,99
/jdk1.7.0_80/javax/xml/soap/DetailEntry.java,Java,,3,3,30,36
/jdk1.7.0_80/javax/xml/soap/FactoryFinder.java,Java,,112,21,103,236
/jdk1.7.0_80/javax/xml/soap/MessageFactory.java,Java,,33,16,151,200
/jdk1.7.0_80/javax/xml/soap/MimeHeader.java,Java,,15,7,48,70
/jdk1.7.0_80/javax/xml/soap/MimeHeaders.java,Java,,123,31,115,269
/jdk1.7.0_80/javax/xml/soap/Name.java,Java,,7,5,98,110
/jdk1.7.0_80/javax/xml/soap/Node.java,Java,,9,8,95,112
/jdk1.7.0_80/javax/xml/soap/SAAJMetaFactory.java,Java,,24,7,82,113
/jdk1.7.0_80/javax/xml/soap/SAAJResult.java,Java,,19,9,105,133
/jdk1.7.0_80/javax/xml/soap/SOAPBody.java,Java,,22,18,257,297
/jdk1.7.0_80/javax/xml/soap/SOAPBodyElement.java,Java,,3,2,38,43
/jdk1.7.0_80/javax/xml/soap/SOAPConnection.java,Java,,11,6,78,95
/jdk1.7.0_80/javax/xml/soap/SOAPConnectionFactory.java,Java,,21,5,60,86
/jdk1.7.0_80/javax/xml/soap/SOAPConstants.java,Java,,42,23,136,201
/jdk1.7.0_80/javax/xml/soap/SOAPElement.java,Java,,44,33,447,524
/jdk1.7.0_80/javax/xml/soap/SOAPElementFactory.java,Java,,25,8,104,137
/jdk1.7.0_80/javax/xml/soap/SOAPEnvelope.java,Java,,12,7,181,200
/jdk1.7.0_80/javax/xml/soap/SOAPException.java,Java,,41,11,111,163
/jdk1.7.0_80/javax/xml/soap/SOAPFactory.java,Java,,50,20,229,299
/jdk1.7.0_80/javax/xml/soap/SOAPFault.java,Java,,34,32,445,511
/jdk1.7.0_80/javax/xml/soap/SOAPFaultElement.java,Java,,3,2,32,37
/jdk1.7.0_80/javax/xml/soap/SOAPHeader.java,Java,,22,15,225,262
/jdk1.7.0_80/javax/xml/soap/SOAPHeaderElement.java,Java,,11,10,145,166
/jdk1.7.0_80/javax/xml/soap/SOAPMessage.java,Java,,52,28,376,456
/jdk1.7.0_80/javax/xml/soap/SOAPPart.java,Java,,36,17,212,265
/jdk1.7.0_80/javax/xml/soap/Text.java,Java,,4,3,35,42
/jdk1.7.0_80/javax/xml/stream/EventFilter.java,Java,,5,4,41,50
/jdk1.7.0_80/javax/xml/stream/events/Attribute.java,Java,,8,9,52,69
/jdk1.7.0_80/javax/xml/stream/events/Characters.java,Java,,7,7,62,76
/jdk1.7.0_80/javax/xml/stream/events/Comment.java,Java,,4,4,37,45
/jdk1.7.0_80/javax/xml/stream/events/DTD.java,Java,,8,8,58,74
/jdk1.7.0_80/javax/xml/stream/events/EndDocument.java,Java,,3,3,36,42
/jdk1.7.0_80/javax/xml/stream/events/EndElement.java,Java,,7,6,46,59
/jdk1.7.0_80/javax/xml/stream/events/EntityDeclaration.java,Java,,9,9,62,80
/jdk1.7.0_80/javax/xml/stream/events/EntityReference.java,Java,,5,4,53,62
/jdk1.7.0_80/javax/xml/stream/events/Namespace.java,Java,,7,7,45,59
/jdk1.7.0_80/javax/xml/stream/events/NotationDeclaration.java,Java,,6,4,48,58
/jdk1.7.0_80/javax/xml/stream/events/ProcessingInstruction.java,Java,,5,4,43,52
/jdk1.7.0_80/javax/xml/stream/events/StartDocument.java,Java,,9,8,57,74
/jdk1.7.0_80/javax/xml/stream/events/StartElement.java,Java,,13,11,93,117
/jdk1.7.0_80/javax/xml/stream/events/XMLEvent.java,Java,,22,21,135,178
/jdk1.7.0_80/javax/xml/stream/FactoryConfigurationError.java,Java,,38,14,73,125
/jdk1.7.0_80/javax/xml/stream/FactoryFinder.java,Java,,222,35,154,411
/jdk1.7.0_80/javax/xml/stream/Location.java,Java,,8,7,62,77
/jdk1.7.0_80/javax/xml/stream/SecuritySupport.java,Java,,65,12,33,110
/jdk1.7.0_80/javax/xml/stream/StreamFilter.java,Java,,4,4,43,51
/jdk1.7.0_80/javax/xml/stream/util/EventReaderDelegate.java,Java,,60,18,56,134
/jdk1.7.0_80/javax/xml/stream/util/StreamReaderDelegate.java,Java,,177,55,55,287
/jdk1.7.0_80/javax/xml/stream/util/XMLEventAllocator.java,Java,,11,8,63,82
/jdk1.7.0_80/javax/xml/stream/util/XMLEventConsumer.java,Java,,7,5,46,58
/jdk1.7.0_80/javax/xml/stream/XMLEventFactory.java,Java,,94,29,291,414
/jdk1.7.0_80/javax/xml/stream/XMLEventReader.java,Java,,12,11,83,106
/jdk1.7.0_80/javax/xml/stream/XMLEventWriter.java,Java,,16,16,224,256
/jdk1.7.0_80/javax/xml/stream/XMLInputFactory.java,Java,,99,45,316,460
/jdk1.7.0_80/javax/xml/stream/XMLOutputFactory.java,Java,,57,24,233,314
/jdk1.7.0_80/javax/xml/stream/XMLReporter.java,Java,,5,4,56,65
/jdk1.7.0_80/javax/xml/stream/XMLResolver.java,Java,,8,4,48,60
/jdk1.7.0_80/javax/xml/stream/XMLStreamConstants.java,Java,,18,15,94,127
/jdk1.7.0_80/javax/xml/stream/XMLStreamException.java,Java,,39,15,76,130
/jdk1.7.0_80/javax/xml/stream/XMLStreamReader.java,Java,,53,52,599,704
/jdk1.7.0_80/javax/xml/stream/XMLStreamWriter.java,Java,,75,40,413,528
/jdk1.7.0_80/javax/xml/transform/dom/DOMLocator.java,Java,,6,6,37,49
/jdk1.7.0_80/javax/xml/transform/dom/DOMResult.java,Java,,84,30,248,362
/jdk1.7.0_80/javax/xml/transform/dom/DOMSource.java,Java,,29,14,94,137
/jdk1.7.0_80/javax/xml/transform/ErrorListener.java,Java,,9,5,103,117
/jdk1.7.0_80/javax/xml/transform/FactoryFinder.java,Java,,225,31,139,395
/jdk1.7.0_80/javax/xml/transform/OutputKeys.java,Java,,15,13,172,200
/jdk1.7.0_80/javax/xml/transform/Result.java,Java,,9,6,71,86
/jdk1.7.0_80/javax/xml/transform/sax/SAXResult.java,Java,,34,17,93,144
/jdk1.7.0_80/javax/xml/transform/sax/SAXSource.java,Java,,59,22,128,209
/jdk1.7.0_80/javax/xml/transform/sax/SAXTransformerFactory.java,Java,,22,13,115,150
/jdk1.7.0_80/javax/xml/transform/sax/TemplatesHandler.java,Java,,8,7,53,68
/jdk1.7.0_80/javax/xml/transform/sax/TransformerHandler.java,Java,,13,8,55,76
/jdk1.7.0_80/javax/xml/transform/SecuritySupport.java,Java,,65,10,33,108
/jdk1.7.0_80/javax/xml/transform/Source.java,Java,,5,4,44,53
/jdk1.7.0_80/javax/xml/transform/SourceLocator.java,Java,,7,6,83,96
/jdk1.7.0_80/javax/xml/transform/stax/StAXResult.java,Java,,39,20,124,183
/jdk1.7.0_80/javax/xml/transform/stax/StAXSource.java,Java,,62,23,151,236
/jdk1.7.0_80/javax/xml/transform/stream/StreamResult.java,Java,,48,21,134,203
/jdk1.7.0_80/javax/xml/transform/stream/StreamSource.java,Java,,61,26,197,284
/jdk1.7.0_80/javax/xml/transform/Templates.java,Java,,6,8,68,82
/jdk1.7.0_80/javax/xml/transform/Transformer.java,Java,,28,19,292,339
/jdk1.7.0_80/javax/xml/transform/TransformerConfigurationException.java,Java,,24,8,70,102
/jdk1.7.0_80/javax/xml/transform/TransformerException.java,Java,,164,60,146,370
/jdk1.7.0_80/javax/xml/transform/TransformerFactory.java,Java,,47,20,356,423
/jdk1.7.0_80/javax/xml/transform/TransformerFactoryConfigurationError.java,Java,,35,20,75,130
/jdk1.7.0_80/javax/xml/transform/URIResolver.java,Java,,5,3,42,50
/jdk1.7.0_80/javax/xml/validation/Schema.java,Java,,7,5,92,104
/jdk1.7.0_80/javax/xml/validation/SchemaFactory.java,Java,,93,32,664,789
/jdk1.7.0_80/javax/xml/validation/SchemaFactoryFinder.java,Java,,340,63,153,556
/jdk1.7.0_80/javax/xml/validation/SchemaFactoryLoader.java,Java,,6,4,58,68
/jdk1.7.0_80/javax/xml/validation/SecuritySupport.java,Java,,117,13,33,163
/jdk1.7.0_80/javax/xml/validation/TypeInfoProvider.java,Java,,10,8,179,197
/jdk1.7.0_80/javax/xml/validation/Validator.java,Java,,52,28,444,524
/jdk1.7.0_80/javax/xml/validation/ValidatorHandler.java,Java,,45,24,416,485
/jdk1.7.0_80/javax/xml/ws/Action.java,Java,,14,6,127,147
/jdk1.7.0_80/javax/xml/ws/AsyncHandler.java,Java,,4,3,35,42
/jdk1.7.0_80/javax/xml/ws/Binding.java,Java,,6,6,55,67
/jdk1.7.0_80/javax/xml/ws/BindingProvider.java,Java,,22,16,144,182
/jdk1.7.0_80/javax/xml/ws/BindingType.java,Java,,12,3,47,62
/jdk1.7.0_80/javax/xml/ws/Dispatch.java,Java,,8,7,101,116
/jdk1.7.0_80/javax/xml/ws/Endpoint.java,Java,,50,32,416,498
/jdk1.7.0_80/javax/xml/ws/EndpointContext.java,Java,,6,5,48,59
/jdk1.7.0_80/javax/xml/ws/EndpointReference.java,Java,,26,8,158,192
/jdk1.7.0_80/javax/xml/ws/FaultAction.java,Java,,13,5,146,164
/jdk1.7.0_80/javax/xml/ws/handler/Handler.java,Java,,8,6,73,87
/jdk1.7.0_80/javax/xml/ws/handler/HandlerResolver.java,Java,,4,3,46,53
/jdk1.7.0_80/javax/xml/ws/handler/LogicalHandler.java,Java,,3,2,29,34
/jdk1.7.0_80/javax/xml/ws/handler/LogicalMessageContext.java,Java,,6,4,36,46
/jdk1.7.0_80/javax/xml/ws/handler/MessageContext.java,Java,,43,23,139,205
/jdk1.7.0_80/javax/xml/ws/handler/PortInfo.java,Java,,7,7,52,66
/jdk1.7.0_80/javax/xml/ws/handler/soap/SOAPHandler.java,Java,,8,4,37,49
/jdk1.7.0_80/javax/xml/ws/handler/soap/SOAPMessageContext.java,Java,,13,7,79,99
/jdk1.7.0_80/javax/xml/ws/Holder.java,Java,,11,7,40,58
/jdk1.7.0_80/javax/xml/ws/http/HTTPBinding.java,Java,,5,5,32,42
/jdk1.7.0_80/javax/xml/ws/http/HTTPException.java,Java,,11,6,39,56
/jdk1.7.0_80/javax/xml/ws/LogicalMessage.java,Java,,9,7,76,92
/jdk1.7.0_80/javax/xml/ws/ProtocolException.java,Java,,15,5,68,88
/jdk1.7.0_80/javax/xml/ws/Provider.java,Java,,4,3,56,63
/jdk1.7.0_80/javax/xml/ws/RequestWrapper.java,Java,,15,8,49,72
/jdk1.7.0_80/javax/xml/ws/RespectBinding.java,Java,,14,4,50,68
/jdk1.7.0_80/javax/xml/ws/RespectBindingFeature.java,Java,,14,7,96,117
/jdk1.7.0_80/javax/xml/ws/Response.java,Java,,6,3,43,52
/jdk1.7.0_80/javax/xml/ws/ResponseWrapper.java,Java,,15,8,49,72
/jdk1.7.0_80/javax/xml/ws/Service.java,Java,,105,38,617,760
/jdk1.7.0_80/javax/xml/ws/ServiceMode.java,Java,,14,3,36,53
/jdk1.7.0_80/javax/xml/ws/soap/Addressing.java,Java,,21,7,85,113
/jdk1.7.0_80/javax/xml/ws/soap/AddressingFeature.java,Java,,38,17,223,278
/jdk1.7.0_80/javax/xml/ws/soap/MTOM.java,Java,,17,5,53,75
/jdk1.7.0_80/javax/xml/ws/soap/MTOMFeature.java,Java,,34,13,95,142
/jdk1.7.0_80/javax/xml/ws/soap/SOAPBinding.java,Java,,17,16,77,110
/jdk1.7.0_80/javax/xml/ws/soap/SOAPFaultException.java,Java,,12,6,57,75
/jdk1.7.0_80/javax/xml/ws/spi/FactoryFinder.java,Java,,99,20,59,178
/jdk1.7.0_80/javax/xml/ws/spi/http/HttpContext.java,Java,,12,9,78,99
/jdk1.7.0_80/javax/xml/ws/spi/http/HttpExchange.java,Java,,40,29,259,328
/jdk1.7.0_80/javax/xml/ws/spi/http/HttpHandler.java,Java,,6,3,45,54
/jdk1.7.0_80/javax/xml/ws/spi/http/package-info.java,Java,,1,1,93,95
/jdk1.7.0_80/javax/xml/ws/spi/Invoker.java,Java,,11,7,73,91
/jdk1.7.0_80/javax/xml/ws/spi/Provider.java,Java,,112,29,380,521
/jdk1.7.0_80/javax/xml/ws/spi/ServiceDelegate.java,Java,,46,34,542,622
/jdk1.7.0_80/javax/xml/ws/spi/WebServiceFeatureAnnotation.java,Java,,19,4,63,86
/jdk1.7.0_80/javax/xml/ws/WebEndpoint.java,Java,,12,3,41,56
/jdk1.7.0_80/javax/xml/ws/WebFault.java,Java,,15,8,44,67
/jdk1.7.0_80/javax/xml/ws/WebServiceClient.java,Java,,14,5,44,63
/jdk1.7.0_80/javax/xml/ws/WebServiceContext.java,Java,,13,9,129,151
/jdk1.7.0_80/javax/xml/ws/WebServiceException.java,Java,,15,8,56,79
/jdk1.7.0_80/javax/xml/ws/WebServiceFeature.java,Java,,9,9,63,81
/jdk1.7.0_80/javax/xml/ws/WebServicePermission.java,Java,,11,7,67,85
/jdk1.7.0_80/javax/xml/ws/WebServiceProvider.java,Java,,15,5,42,62
/jdk1.7.0_80/javax/xml/ws/WebServiceRef.java,Java,,19,10,121,150
/jdk1.7.0_80/javax/xml/ws/WebServiceRefs.java,Java,,12,4,67,83
/jdk1.7.0_80/javax/xml/ws/wsaddressing/package-info.java,Java,,3,1,24,28
/jdk1.7.0_80/javax/xml/ws/wsaddressing/W3CEndpointReference.java,Java,,79,18,61,158
/jdk1.7.0_80/javax/xml/ws/wsaddressing/W3CEndpointReferenceBuilder.java,Java,,85,18,253,356
/jdk1.7.0_80/javax/xml/XMLConstants.java,Java,,24,21,347,392
/jdk1.7.0_80/javax/xml/xpath/SecuritySupport.java,Java,,116,13,31,160
/jdk1.7.0_80/javax/xml/xpath/XPath.java,Java,,26,15,278,319
/jdk1.7.0_80/javax/xml/xpath/XPathConstants.java,Java,,11,10,63,84
/jdk1.7.0_80/javax/xml/xpath/XPathException.java,Java,,65,17,94,176
/jdk1.7.0_80/javax/xml/xpath/XPathExpression.java,Java,,13,7,180,200
/jdk1.7.0_80/javax/xml/xpath/XPathExpressionException.java,Java,,10,5,59,74
/jdk1.7.0_80/javax/xml/xpath/XPathFactory.java,Java,,82,30,272,384
/jdk1.7.0_80/javax/xml/xpath/XPathFactoryConfigurationException.java,Java,,10,5,58,73
/jdk1.7.0_80/javax/xml/xpath/XPathFactoryFinder.java,Java,,343,63,150,556
/jdk1.7.0_80/javax/xml/xpath/XPathFunction.java,Java,,6,3,47,56
/jdk1.7.0_80/javax/xml/xpath/XPathFunctionException.java,Java,,10,5,57,72
/jdk1.7.0_80/javax/xml/xpath/XPathFunctionResolver.java,Java,,5,3,58,66
/jdk1.7.0_80/javax/xml/xpath/XPathVariableResolver.java,Java,,5,3,50,58
/jdk1.7.0_80/launcher/defines.h,h,,45,10,35,90
/jdk1.7.0_80/launcher/emessages.h,h,,59,19,29,107
/jdk1.7.0_80/launcher/java.c,C/C++/ObjC,,1278,184,471,1933
/jdk1.7.0_80/launcher/java.h,h,,121,42,92,255
/jdk1.7.0_80/launcher/java_md.c,C/C++/ObjC,,903,152,433,1488
/jdk1.7.0_80/launcher/java_md.h,h,,19,8,30,57
/jdk1.7.0_80/launcher/jli_util.c,C/C++/ObjC,,67,11,43,121
/jdk1.7.0_80/launcher/jli_util.h,h,,49,9,28,86
/jdk1.7.0_80/launcher/main.c,C/C++/ObjC,,72,15,47,134
/jdk1.7.0_80/launcher/manifest_info.h,h,,73,16,67,156
/jdk1.7.0_80/launcher/parse_manifest.c,C/C++/ObjC,,335,36,242,613
/jdk1.7.0_80/launcher/splashscreen.h,h,,5,2,24,31
/jdk1.7.0_80/launcher/splashscreen_stubs.c,C/C++/ObjC,,31,10,37,78
/jdk1.7.0_80/launcher/version_comp.c,C/C++/ObjC,,212,25,120,357
/jdk1.7.0_80/launcher/version_comp.h,h,,7,3,27,37
/jdk1.7.0_80/launcher/wildcard.c,C/C++/ObjC,,329,39,126,494
/jdk1.7.0_80/launcher/wildcard.h,h,,4,3,24,31
/jdk1.7.0_80/org/ietf/jgss/ChannelBinding.java,Java,,63,23,126,212
/jdk1.7.0_80/org/ietf/jgss/GSSContext.java,Java,,62,45,1240,1347
/jdk1.7.0_80/org/ietf/jgss/GSSCredential.java,Java,,21,23,326,370
/jdk1.7.0_80/org/ietf/jgss/GSSException.java,Java,,108,60,235,403
/jdk1.7.0_80/org/ietf/jgss/GSSManager.java,Java,,38,19,672,729
/jdk1.7.0_80/org/ietf/jgss/GSSName.java,Java,,27,19,249,295
/jdk1.7.0_80/org/ietf/jgss/MessageProp.java,Java,,67,21,147,235
/jdk1.7.0_80/org/ietf/jgss/Oid.java,Java,,83,23,110,216
/jdk1.7.0_80/org/omg/CORBA/ACTIVITY_COMPLETED.java,Java,,18,7,61,86
/jdk1.7.0_80/org/omg/CORBA/ACTIVITY_REQUIRED.java,Java,,18,7,59,84
/jdk1.7.0_80/org/omg/CORBA/Any.java,Java,,81,58,582,721
/jdk1.7.0_80/org/omg/CORBA/AnyHolder.java,Java,,21,9,77,107
/jdk1.7.0_80/org/omg/CORBA/AnySeqHelper.java,Java,,46,10,45,101
/jdk1.7.0_80/org/omg/CORBA/AnySeqHolder.java,Java,,24,9,33,66
/jdk1.7.0_80/org/omg/CORBA/ARG_IN.java,Java,,4,3,46,53
/jdk1.7.0_80/org/omg/CORBA/ARG_INOUT.java,Java,,4,3,47,54
/jdk1.7.0_80/org/omg/CORBA/ARG_OUT.java,Java,,4,3,46,53
/jdk1.7.0_80/org/omg/CORBA/BAD_CONTEXT.java,Java,,15,7,64,86
/jdk1.7.0_80/org/omg/CORBA/BAD_INV_ORDER.java,Java,,15,8,62,85
/jdk1.7.0_80/org/omg/CORBA/BAD_OPERATION.java,Java,,15,7,60,82
/jdk1.7.0_80/org/omg/CORBA/BAD_PARAM.java,Java,,15,7,69,91
/jdk1.7.0_80/org/omg/CORBA/BAD_POLICY.java,Java,,4,2,33,39
/jdk1.7.0_80/org/omg/CORBA/BAD_POLICY_TYPE.java,Java,,4,2,33,39
/jdk1.7.0_80/org/omg/CORBA/BAD_POLICY_VALUE.java,Java,,4,2,35,41
/jdk1.7.0_80/org/omg/CORBA/BAD_QOS.java,Java,,18,7,58,83
/jdk1.7.0_80/org/omg/CORBA/BAD_TYPECODE.java,Java,,15,7,61,83
/jdk1.7.0_80/org/omg/CORBA/BooleanHolder.java,Java,,21,9,79,109
/jdk1.7.0_80/org/omg/CORBA/BooleanSeqHelper.java,Java,,44,10,45,99
/jdk1.7.0_80/org/omg/CORBA/BooleanSeqHolder.java,Java,,24,9,33,66
/jdk1.7.0_80/org/omg/CORBA/Bounds.java,Java,,9,5,40,54
/jdk1.7.0_80/org/omg/CORBA/ByteHolder.java,Java,,21,10,79,110
/jdk1.7.0_80/org/omg/CORBA/CharHolder.java,Java,,21,10,80,111
/jdk1.7.0_80/org/omg/CORBA/CharSeqHelper.java,Java,,44,10,45,99
/jdk1.7.0_80/org/omg/CORBA/CharSeqHolder.java,Java,,24,9,33,66
/jdk1.7.0_80/org/omg/CORBA/CODESET_INCOMPATIBLE.java,Java,,18,7,57,82
/jdk1.7.0_80/org/omg/CORBA/COMM_FAILURE.java,Java,,15,7,68,90
/jdk1.7.0_80/org/omg/CORBA/CompletionStatus.java,Java,,27,13,102,142
/jdk1.7.0_80/org/omg/CORBA/CompletionStatusHelper.java,Java,,37,10,32,79
/jdk1.7.0_80/org/omg/CORBA/Context.java,Java,,11,18,215,244
/jdk1.7.0_80/org/omg/CORBA/ContextList.java,Java,,7,12,87,106
/jdk1.7.0_80/org/omg/CORBA/CTX_RESTRICT_SCOPE.java,Java,,4,3,45,52
/jdk1.7.0_80/org/omg/CORBA/Current.java,Java,,4,3,41,48
/jdk1.7.0_80/org/omg/CORBA/CurrentHelper.java,Java,,43,11,33,87
/jdk1.7.0_80/org/omg/CORBA/CurrentHolder.java,Java,,24,8,33,65
/jdk1.7.0_80/org/omg/CORBA/CurrentOperations.java,Java,,4,3,34,41
/jdk1.7.0_80/org/omg/CORBA/CustomMarshal.java,Java,,7,3,47,57
/jdk1.7.0_80/org/omg/CORBA/DataInputStream.java,Java,,36,33,275,344
/jdk1.7.0_80/org/omg/CORBA/DataOutputStream.java,Java,,36,34,213,283
/jdk1.7.0_80/org/omg/CORBA/DATA_CONVERSION.java,Java,,15,7,63,85
/jdk1.7.0_80/org/omg/CORBA/DefinitionKind.java,Java,,114,113,274,501
/jdk1.7.0_80/org/omg/CORBA/DefinitionKindHelper.java,Java,,37,10,33,80
/jdk1.7.0_80/org/omg/CORBA/DomainManager.java,Java,,5,3,35,43
/jdk1.7.0_80/org/omg/CORBA/DomainManagerOperations.java,Java,,5,3,41,49
/jdk1.7.0_80/org/omg/CORBA/DoubleHolder.java,Java,,21,12,76,109
/jdk1.7.0_80/org/omg/CORBA/DoubleSeqHelper.java,Java,,44,10,45,99
/jdk1.7.0_80/org/omg/CORBA/DoubleSeqHolder.java,Java,,24,9,33,66
/jdk1.7.0_80/org/omg/CORBA/DynamicImplementation.java,Java,,12,5,30,47
/jdk1.7.0_80/org/omg/CORBA/DynAny.java,Java,,90,66,575,731
/jdk1.7.0_80/org/omg/CORBA/DynAnyPackage/Invalid.java,Java,,10,5,36,51
/jdk1.7.0_80/org/omg/CORBA/DynAnyPackage/InvalidSeq.java,Java,,10,5,37,52
/jdk1.7.0_80/org/omg/CORBA/DynAnyPackage/InvalidValue.java,Java,,10,4,39,53
/jdk1.7.0_80/org/omg/CORBA/DynAnyPackage/TypeMismatch.java,Java,,10,5,37,52
/jdk1.7.0_80/org/omg/CORBA/DynArray.java,Java,,8,5,43,56
/jdk1.7.0_80/org/omg/CORBA/DynEnum.java,Java,,9,6,49,64
/jdk1.7.0_80/org/omg/CORBA/DynFixed.java,Java,,8,4,45,57
/jdk1.7.0_80/org/omg/CORBA/DynSequence.java,Java,,10,7,56,73
/jdk1.7.0_80/org/omg/CORBA/DynStruct.java,Java,,10,6,54,70
/jdk1.7.0_80/org/omg/CORBA/DynUnion.java,Java,,13,10,71,94
/jdk1.7.0_80/org/omg/CORBA/DynValue.java,Java,,9,6,58,73
/jdk1.7.0_80/org/omg/CORBA/Environment.java,Java,,6,10,45,61
/jdk1.7.0_80/org/omg/CORBA/ExceptionList.java,Java,,9,11,90,110
/jdk1.7.0_80/org/omg/CORBA/FieldNameHelper.java,Java,,40,10,32,82
/jdk1.7.0_80/org/omg/CORBA/FixedHolder.java,Java,,21,11,66,98
/jdk1.7.0_80/org/omg/CORBA/FloatHolder.java,Java,,21,9,75,105
/jdk1.7.0_80/org/omg/CORBA/FloatSeqHelper.java,Java,,44,10,45,99
/jdk1.7.0_80/org/omg/CORBA/FloatSeqHolder.java,Java,,24,9,33,66
/jdk1.7.0_80/org/omg/CORBA/FREE_MEM.java,Java,,15,6,60,81
/jdk1.7.0_80/org/omg/CORBA/IdentifierHelper.java,Java,,40,10,33,83
/jdk1.7.0_80/org/omg/CORBA/IDLType.java,Java,,4,3,42,49
/jdk1.7.0_80/org/omg/CORBA/IDLTypeHelper.java,Java,,51,11,33,95
/jdk1.7.0_80/org/omg/CORBA/IDLTypeOperations.java,Java,,5,4,49,58
/jdk1.7.0_80/org/omg/CORBA/IMP_LIMIT.java,Java,,15,7,63,85
/jdk1.7.0_80/org/omg/CORBA/INITIALIZE.java,Java,,15,6,66,87
/jdk1.7.0_80/org/omg/CORBA/INTERNAL.java,Java,,15,6,66,87
/jdk1.7.0_80/org/omg/CORBA/INTF_REPOS.java,Java,,15,6,59,80
/jdk1.7.0_80/org/omg/CORBA/IntHolder.java,Java,,21,9,82,112
/jdk1.7.0_80/org/omg/CORBA/INVALID_ACTIVITY.java,Java,,18,7,60,85
/jdk1.7.0_80/org/omg/CORBA/INVALID_TRANSACTION.java,Java,,15,6,61,82
/jdk1.7.0_80/org/omg/CORBA/INV_FLAG.java,Java,,15,6,61,82
/jdk1.7.0_80/org/omg/CORBA/INV_IDENT.java,Java,,15,6,62,83
/jdk1.7.0_80/org/omg/CORBA/INV_OBJREF.java,Java,,15,6,68,89
/jdk1.7.0_80/org/omg/CORBA/INV_POLICY.java,Java,,15,6,59,80
/jdk1.7.0_80/org/omg/CORBA/IRObject.java,Java,,5,2,35,42
/jdk1.7.0_80/org/omg/CORBA/IRObjectOperations.java,Java,,6,6,71,83
/jdk1.7.0_80/org/omg/CORBA/LocalObject.java,Java,,89,32,379,500
/jdk1.7.0_80/org/omg/CORBA/LongHolder.java,Java,,21,10,77,108
/jdk1.7.0_80/org/omg/CORBA/LongLongSeqHelper.java,Java,,44,10,45,99
/jdk1.7.0_80/org/omg/CORBA/LongLongSeqHolder.java,Java,,24,9,33,66
/jdk1.7.0_80/org/omg/CORBA/LongSeqHelper.java,Java,,44,10,45,99
/jdk1.7.0_80/org/omg/CORBA/LongSeqHolder.java,Java,,24,9,33,66
/jdk1.7.0_80/org/omg/CORBA/MARSHAL.java,Java,,15,6,66,87
/jdk1.7.0_80/org/omg/CORBA/NamedValue.java,Java,,6,10,109,125
/jdk1.7.0_80/org/omg/CORBA/NameValuePair.java,Java,,10,8,45,63
/jdk1.7.0_80/org/omg/CORBA/NameValuePairHelper.java,Java,,67,10,32,109
/jdk1.7.0_80/org/omg/CORBA/NO_IMPLEMENT.java,Java,,15,6,65,86
/jdk1.7.0_80/org/omg/CORBA/NO_MEMORY.java,Java,,15,6,58,79
/jdk1.7.0_80/org/omg/CORBA/NO_PERMISSION.java,Java,,15,6,58,79
/jdk1.7.0_80/org/omg/CORBA/NO_RESOURCES.java,Java,,15,6,59,80
/jdk1.7.0_80/org/omg/CORBA/NO_RESPONSE.java,Java,,15,6,59,80
/jdk1.7.0_80/org/omg/CORBA/NVList.java,Java,,9,16,153,178
/jdk1.7.0_80/org/omg/CORBA/Object.java,Java,,25,35,222,282
/jdk1.7.0_80/org/omg/CORBA/ObjectHelper.java,Java,,37,11,35,83
/jdk1.7.0_80/org/omg/CORBA/ObjectHolder.java,Java,,21,9,81,111
/jdk1.7.0_80/org/omg/CORBA/OBJECT_NOT_EXIST.java,Java,,15,6,68,89
/jdk1.7.0_80/org/omg/CORBA/OBJ_ADAPTER.java,Java,,15,6,63,84
/jdk1.7.0_80/org/omg/CORBA/OctetSeqHelper.java,Java,,44,10,45,99
/jdk1.7.0_80/org/omg/CORBA/OctetSeqHolder.java,Java,,24,9,33,66
/jdk1.7.0_80/org/omg/CORBA/OMGVMCID.java,Java,,4,4,34,42
/jdk1.7.0_80/org/omg/CORBA/ORB.java,Java,,313,99,913,1325
/jdk1.7.0_80/org/omg/CORBA/ORBPackage/InconsistentTypeCode.java,Java,,10,4,38,52
/jdk1.7.0_80/org/omg/CORBA/ORBPackage/InvalidName.java,Java,,9,4,40,53
/jdk1.7.0_80/org/omg/CORBA/ParameterMode.java,Java,,29,8,14,51
/jdk1.7.0_80/org/omg/CORBA/ParameterModeHelper.java,Java,,37,11,14,62
/jdk1.7.0_80/org/omg/CORBA/ParameterModeHolder.java,Java,,24,9,14,47
/jdk1.7.0_80/org/omg/CORBA/PERSIST_STORE.java,Java,,15,6,58,79
/jdk1.7.0_80/org/omg/CORBA/Policy.java,Java,,4,3,40,47
/jdk1.7.0_80/org/omg/CORBA/PolicyError.java,Java,,15,7,49,71
/jdk1.7.0_80/org/omg/CORBA/PolicyErrorCodeHelper.java,Java,,40,11,11,62
/jdk1.7.0_80/org/omg/CORBA/PolicyErrorHelper.java,Java,,62,11,12,85
/jdk1.7.0_80/org/omg/CORBA/PolicyErrorHolder.java,Java,,24,9,10,43
/jdk1.7.0_80/org/omg/CORBA/PolicyHelper.java,Java,,51,11,33,95
/jdk1.7.0_80/org/omg/CORBA/PolicyHolder.java,Java,,24,8,33,65
/jdk1.7.0_80/org/omg/CORBA/PolicyListHelper.java,Java,,46,10,33,89
/jdk1.7.0_80/org/omg/CORBA/PolicyListHolder.java,Java,,24,9,33,66
/jdk1.7.0_80/org/omg/CORBA/PolicyOperations.java,Java,,7,6,59,72
/jdk1.7.0_80/org/omg/CORBA/PolicyTypeHelper.java,Java,,40,11,34,85
/jdk1.7.0_80/org/omg/CORBA/portable/ApplicationException.java,Java,,16,6,42,64
/jdk1.7.0_80/org/omg/CORBA/portable/BoxedValueHelper.java,Java,,7,2,30,39
/jdk1.7.0_80/org/omg/CORBA/portable/CustomValue.java,Java,,4,4,37,45
/jdk1.7.0_80/org/omg/CORBA/portable/Delegate.java,Java,,84,30,294,408
/jdk1.7.0_80/org/omg/CORBA/portable/IDLEntity.java,Java,,3,3,31,37
/jdk1.7.0_80/org/omg/CORBA/portable/IndirectionException.java,Java,,9,4,55,68
/jdk1.7.0_80/org/omg/CORBA/portable/InputStream.java,Java,,68,12,240,320
/jdk1.7.0_80/org/omg/CORBA/portable/InvokeHandler.java,Java,,6,3,63,72
/jdk1.7.0_80/org/omg/CORBA/portable/ObjectImpl.java,Java,,155,37,342,534
/jdk1.7.0_80/org/omg/CORBA/portable/OutputStream.java,Java,,66,11,210,287
/jdk1.7.0_80/org/omg/CORBA/portable/RemarshalException.java,Java,,6,2,38,46
/jdk1.7.0_80/org/omg/CORBA/portable/ResponseHandler.java,Java,,5,3,46,54
/jdk1.7.0_80/org/omg/CORBA/portable/ServantObject.java,Java,,5,4,39,48
/jdk1.7.0_80/org/omg/CORBA/portable/Streamable.java,Java,,7,4,49,60
/jdk1.7.0_80/org/omg/CORBA/portable/StreamableValue.java,Java,,3,4,34,41
/jdk1.7.0_80/org/omg/CORBA/portable/UnknownException.java,Java,,8,1,49,58
/jdk1.7.0_80/org/omg/CORBA/portable/ValueBase.java,Java,,4,1,45,50
/jdk1.7.0_80/org/omg/CORBA/portable/ValueFactory.java,Java,,5,3,49,57
/jdk1.7.0_80/org/omg/CORBA/portable/ValueInputStream.java,Java,,5,4,42,51
/jdk1.7.0_80/org/omg/CORBA/portable/ValueOutputStream.java,Java,,5,3,41,49
/jdk1.7.0_80/org/omg/CORBA/Principal.java,Java,,12,4,42,58
/jdk1.7.0_80/org/omg/CORBA/PrincipalHolder.java,Java,,22,10,61,93
/jdk1.7.0_80/org/omg/CORBA/PRIVATE_MEMBER.java,Java,,4,2,40,46
/jdk1.7.0_80/org/omg/CORBA/PUBLIC_MEMBER.java,Java,,4,2,41,47
/jdk1.7.0_80/org/omg/CORBA/REBIND.java,Java,,18,7,61,86
/jdk1.7.0_80/org/omg/CORBA/RepositoryIdHelper.java,Java,,40,10,34,84
/jdk1.7.0_80/org/omg/CORBA/Request.java,Java,,25,50,226,301
/jdk1.7.0_80/org/omg/CORBA/ServerRequest.java,Java,,39,19,256,314
/jdk1.7.0_80/org/omg/CORBA/ServiceDetail.java,Java,,11,5,52,68
/jdk1.7.0_80/org/omg/CORBA/ServiceDetailHelper.java,Java,,50,6,29,85
/jdk1.7.0_80/org/omg/CORBA/ServiceInformation.java,Java,,13,6,42,61
/jdk1.7.0_80/org/omg/CORBA/ServiceInformationHelper.java,Java,,58,7,29,94
/jdk1.7.0_80/org/omg/CORBA/ServiceInformationHolder.java,Java,,20,9,81,110
/jdk1.7.0_80/org/omg/CORBA/SetOverrideType.java,Java,,25,11,86,122
/jdk1.7.0_80/org/omg/CORBA/SetOverrideTypeHelper.java,Java,,37,10,32,79
/jdk1.7.0_80/org/omg/CORBA/ShortHolder.java,Java,,21,9,80,110
/jdk1.7.0_80/org/omg/CORBA/ShortSeqHelper.java,Java,,44,10,45,99
/jdk1.7.0_80/org/omg/CORBA/ShortSeqHolder.java,Java,,24,9,33,66
/jdk1.7.0_80/org/omg/CORBA/StringHolder.java,Java,,21,9,79,109
/jdk1.7.0_80/org/omg/CORBA/StringSeqHelper.java,Java,,46,11,7,64
/jdk1.7.0_80/org/omg/CORBA/StringSeqHolder.java,Java,,24,10,7,41
/jdk1.7.0_80/org/omg/CORBA/StringValueHelper.java,Java,,73,14,51,138
/jdk1.7.0_80/org/omg/CORBA/StructMember.java,Java,,12,8,69,89
/jdk1.7.0_80/org/omg/CORBA/StructMemberHelper.java,Java,,74,10,33,117
/jdk1.7.0_80/org/omg/CORBA/SystemException.java,Java,,45,11,63,119
/jdk1.7.0_80/org/omg/CORBA/TCKind.java,Java,,149,79,326,554
/jdk1.7.0_80/org/omg/CORBA/TIMEOUT.java,Java,,18,7,58,83
/jdk1.7.0_80/org/omg/CORBA/TRANSACTION_MODE.java,Java,,15,6,61,82
/jdk1.7.0_80/org/omg/CORBA/TRANSACTION_REQUIRED.java,Java,,15,6,58,79
/jdk1.7.0_80/org/omg/CORBA/TRANSACTION_ROLLEDBACK.java,Java,,15,6,62,83
/jdk1.7.0_80/org/omg/CORBA/TRANSACTION_UNAVAILABLE.java,Java,,16,6,61,83
/jdk1.7.0_80/org/omg/CORBA/TRANSIENT.java,Java,,15,6,61,82
/jdk1.7.0_80/org/omg/CORBA/TypeCode.java,Java,,29,39,465,533
/jdk1.7.0_80/org/omg/CORBA/TypeCodeHolder.java,Java,,21,9,80,110
/jdk1.7.0_80/org/omg/CORBA/TypeCodePackage/BadKind.java,Java,,9,4,42,55
/jdk1.7.0_80/org/omg/CORBA/TypeCodePackage/Bounds.java,Java,,9,5,41,55
/jdk1.7.0_80/org/omg/CORBA/ULongLongSeqHelper.java,Java,,44,10,45,99
/jdk1.7.0_80/org/omg/CORBA/ULongLongSeqHolder.java,Java,,24,9,33,66
/jdk1.7.0_80/org/omg/CORBA/ULongSeqHelper.java,Java,,44,10,45,99
/jdk1.7.0_80/org/omg/CORBA/ULongSeqHolder.java,Java,,24,9,33,66
/jdk1.7.0_80/org/omg/CORBA/UnionMember.java,Java,,14,9,72,95
/jdk1.7.0_80/org/omg/CORBA/UnionMemberHelper.java,Java,,81,10,33,124
/jdk1.7.0_80/org/omg/CORBA/UNKNOWN.java,Java,,15,6,67,88
/jdk1.7.0_80/org/omg/CORBA/UnknownUserException.java,Java,,11,6,49,66
/jdk1.7.0_80/org/omg/CORBA/UnknownUserExceptionHelper.java,Java,,61,10,35,106
/jdk1.7.0_80/org/omg/CORBA/UnknownUserExceptionHolder.java,Java,,24,8,33,65
/jdk1.7.0_80/org/omg/CORBA/UNSUPPORTED_POLICY.java,Java,,4,2,34,40
/jdk1.7.0_80/org/omg/CORBA/UNSUPPORTED_POLICY_VALUE.java,Java,,4,2,35,41
/jdk1.7.0_80/org/omg/CORBA/UserException.java,Java,,9,4,44,57
/jdk1.7.0_80/org/omg/CORBA/UShortSeqHelper.java,Java,,44,10,45,99
/jdk1.7.0_80/org/omg/CORBA/UShortSeqHolder.java,Java,,24,9,33,66
/jdk1.7.0_80/org/omg/CORBA/ValueBaseHelper.java,Java,,37,12,37,86
/jdk1.7.0_80/org/omg/CORBA/ValueBaseHolder.java,Java,,21,10,76,107
/jdk1.7.0_80/org/omg/CORBA/ValueMember.java,Java,,20,12,89,121
/jdk1.7.0_80/org/omg/CORBA/ValueMemberHelper.java,Java,,106,10,33,149
/jdk1.7.0_80/org/omg/CORBA/VersionSpecHelper.java,Java,,40,10,33,83
/jdk1.7.0_80/org/omg/CORBA/VisibilityHelper.java,Java,,40,11,34,85
/jdk1.7.0_80/org/omg/CORBA/VM_ABSTRACT.java,Java,,4,2,33,39
/jdk1.7.0_80/org/omg/CORBA/VM_CUSTOM.java,Java,,4,2,33,39
/jdk1.7.0_80/org/omg/CORBA/VM_NONE.java,Java,,4,4,36,44
/jdk1.7.0_80/org/omg/CORBA/VM_TRUNCATABLE.java,Java,,4,2,35,41
/jdk1.7.0_80/org/omg/CORBA/WCharSeqHelper.java,Java,,44,10,45,99
/jdk1.7.0_80/org/omg/CORBA/WCharSeqHolder.java,Java,,24,9,33,66
/jdk1.7.0_80/org/omg/CORBA/WrongTransaction.java,Java,,9,4,43,56
/jdk1.7.0_80/org/omg/CORBA/WrongTransactionHelper.java,Java,,54,9,35,98
/jdk1.7.0_80/org/omg/CORBA/WrongTransactionHolder.java,Java,,24,8,33,65
/jdk1.7.0_80/org/omg/CORBA/WStringSeqHelper.java,Java,,46,11,7,64
/jdk1.7.0_80/org/omg/CORBA/WStringSeqHolder.java,Java,,24,10,7,41
/jdk1.7.0_80/org/omg/CORBA/WStringValueHelper.java,Java,,73,16,53,142
/jdk1.7.0_80/org/omg/CORBA/_IDLTypeStub.java,Java,,90,13,50,153
/jdk1.7.0_80/org/omg/CORBA/_PolicyStub.java,Java,,89,14,61,164
/jdk1.7.0_80/org/omg/CORBA_2_3/ORB.java,Java,,23,13,53,89
/jdk1.7.0_80/org/omg/CORBA_2_3/portable/Delegate.java,Java,,6,4,44,54
/jdk1.7.0_80/org/omg/CORBA_2_3/portable/InputStream.java,Java,,50,18,84,152
/jdk1.7.0_80/org/omg/CORBA_2_3/portable/ObjectImpl.java,Java,,10,6,43,59
/jdk1.7.0_80/org/omg/CORBA_2_3/portable/OutputStream.java,Java,,44,13,72,129
/jdk1.7.0_80/org/omg/CosNaming/Binding.java,Java,,14,7,7,28
/jdk1.7.0_80/org/omg/CosNaming/BindingHelper.java,Java,,68,10,6,84
/jdk1.7.0_80/org/omg/CosNaming/BindingHolder.java,Java,,24,8,6,38
/jdk1.7.0_80/org/omg/CosNaming/BindingIterator.java,Java,,4,4,14,22
/jdk1.7.0_80/org/omg/CosNaming/BindingIteratorHelper.java,Java,,67,13,14,94
/jdk1.7.0_80/org/omg/CosNaming/BindingIteratorHolder.java,Java,,24,9,14,47
/jdk1.7.0_80/org/omg/CosNaming/BindingIteratorOperations.java,Java,,7,7,30,44
/jdk1.7.0_80/org/omg/CosNaming/BindingIteratorPOA.java,Java,,70,21,32,123
/jdk1.7.0_80/org/omg/CosNaming/BindingListHelper.java,Java,,46,11,9,66
/jdk1.7.0_80/org/omg/CosNaming/BindingListHolder.java,Java,,24,10,9,43
/jdk1.7.0_80/org/omg/CosNaming/BindingType.java,Java,,27,8,10,45
/jdk1.7.0_80/org/omg/CosNaming/BindingTypeHelper.java,Java,,37,11,10,58
/jdk1.7.0_80/org/omg/CosNaming/BindingTypeHolder.java,Java,,24,9,10,43
/jdk1.7.0_80/org/omg/CosNaming/IstringHelper.java,Java,,40,10,6,56
/jdk1.7.0_80/org/omg/CosNaming/NameComponent.java,Java,,14,6,6,26
/jdk1.7.0_80/org/omg/CosNaming/NameComponentHelper.java,Java,,68,10,6,84
/jdk1.7.0_80/org/omg/CosNaming/NameComponentHolder.java,Java,,24,8,6,38
/jdk1.7.0_80/org/omg/CosNaming/NameHelper.java,Java,,46,11,9,66
/jdk1.7.0_80/org/omg/CosNaming/NameHolder.java,Java,,24,10,9,43
/jdk1.7.0_80/org/omg/CosNaming/NamingContext.java,Java,,4,4,15,23
/jdk1.7.0_80/org/omg/CosNaming/NamingContextExt.java,Java,,4,4,19,27
/jdk1.7.0_80/org/omg/CosNaming/NamingContextExtHelper.java,Java,,67,13,19,99
/jdk1.7.0_80/org/omg/CosNaming/NamingContextExtHolder.java,Java,,24,9,19,52
/jdk1.7.0_80/org/omg/CosNaming/NamingContextExtOperations.java,Java,,8,8,67,83
/jdk1.7.0_80/org/omg/CosNaming/NamingContextExtPackage/AddressHelper.java,Java,,40,11,9,60
/jdk1.7.0_80/org/omg/CosNaming/NamingContextExtPackage/InvalidAddress.java,Java,,12,7,6,25
/jdk1.7.0_80/org/omg/CosNaming/NamingContextExtPackage/InvalidAddressHelper.java,Java,,54,10,8,72
/jdk1.7.0_80/org/omg/CosNaming/NamingContextExtPackage/InvalidAddressHolder.java,Java,,24,8,6,38
/jdk1.7.0_80/org/omg/CosNaming/NamingContextExtPackage/StringNameHelper.java,Java,,40,11,10,61
/jdk1.7.0_80/org/omg/CosNaming/NamingContextExtPackage/URLStringHelper.java,Java,,40,11,10,61
/jdk1.7.0_80/org/omg/CosNaming/NamingContextExtPOA.java,Java,,294,43,230,567
/jdk1.7.0_80/org/omg/CosNaming/NamingContextHelper.java,Java,,67,13,15,95
/jdk1.7.0_80/org/omg/CosNaming/NamingContextHolder.java,Java,,24,9,15,48
/jdk1.7.0_80/org/omg/CosNaming/NamingContextOperations.java,Java,,14,14,176,204
/jdk1.7.0_80/org/omg/CosNaming/NamingContextPackage/AlreadyBound.java,Java,,12,7,6,25
/jdk1.7.0_80/org/omg/CosNaming/NamingContextPackage/AlreadyBoundHelper.java,Java,,54,10,8,72
/jdk1.7.0_80/org/omg/CosNaming/NamingContextPackage/AlreadyBoundHolder.java,Java,,24,8,6,38
/jdk1.7.0_80/org/omg/CosNaming/NamingContextPackage/CannotProceed.java,Java,,22,8,6,36
/jdk1.7.0_80/org/omg/CosNaming/NamingContextPackage/CannotProceedHelper.java,Java,,70,10,8,88
/jdk1.7.0_80/org/omg/CosNaming/NamingContextPackage/CannotProceedHolder.java,Java,,24,8,6,38
/jdk1.7.0_80/org/omg/CosNaming/NamingContextPackage/InvalidName.java,Java,,12,7,6,25
/jdk1.7.0_80/org/omg/CosNaming/NamingContextPackage/InvalidNameHelper.java,Java,,54,10,8,72
/jdk1.7.0_80/org/omg/CosNaming/NamingContextPackage/InvalidNameHolder.java,Java,,24,8,6,38
/jdk1.7.0_80/org/omg/CosNaming/NamingContextPackage/NotEmpty.java,Java,,12,7,6,25
/jdk1.7.0_80/org/omg/CosNaming/NamingContextPackage/NotEmptyHelper.java,Java,,54,10,8,72
/jdk1.7.0_80/org/omg/CosNaming/NamingContextPackage/NotEmptyHolder.java,Java,,24,8,6,38
/jdk1.7.0_80/org/omg/CosNaming/NamingContextPackage/NotFound.java,Java,,22,8,6,36
/jdk1.7.0_80/org/omg/CosNaming/NamingContextPackage/NotFoundHelper.java,Java,,70,10,8,88
/jdk1.7.0_80/org/omg/CosNaming/NamingContextPackage/NotFoundHolder.java,Java,,24,8,6,38
/jdk1.7.0_80/org/omg/CosNaming/NamingContextPackage/NotFoundReason.java,Java,,29,8,9,46
/jdk1.7.0_80/org/omg/CosNaming/NamingContextPackage/NotFoundReasonHelper.java,Java,,37,11,9,57
/jdk1.7.0_80/org/omg/CosNaming/NamingContextPackage/NotFoundReasonHolder.java,Java,,24,9,9,42
/jdk1.7.0_80/org/omg/CosNaming/NamingContextPOA.java,Java,,223,35,178,436
/jdk1.7.0_80/org/omg/CosNaming/_BindingIteratorImplBase.java,Java,,71,3,34,108
/jdk1.7.0_80/org/omg/CosNaming/_BindingIteratorStub.java,Java,,82,14,31,127
/jdk1.7.0_80/org/omg/CosNaming/_NamingContextExtStub.java,Java,,367,36,229,632
/jdk1.7.0_80/org/omg/CosNaming/_NamingContextImplBase.java,Java,,370,3,34,407
/jdk1.7.0_80/org/omg/CosNaming/_NamingContextStub.java,Java,,271,28,177,476
/jdk1.7.0_80/org/omg/Dynamic/Parameter.java,Java,,14,6,6,26
/jdk1.7.0_80/org/omg/DynamicAny/AnySeqHelper.java,Java,,46,10,6,62
/jdk1.7.0_80/org/omg/DynamicAny/DynAny.java,Java,,4,4,73,81
/jdk1.7.0_80/org/omg/DynamicAny/DynAnyFactory.java,Java,,4,4,27,35
/jdk1.7.0_80/org/omg/DynamicAny/DynAnyFactoryHelper.java,Java,,67,13,27,107
/jdk1.7.0_80/org/omg/DynamicAny/DynAnyFactoryOperations.java,Java,,6,6,68,80
/jdk1.7.0_80/org/omg/DynamicAny/DynAnyFactoryPackage/InconsistentTypeCode.java,Java,,12,7,6,25
/jdk1.7.0_80/org/omg/DynamicAny/DynAnyFactoryPackage/InconsistentTypeCodeHelper.java,Java,,54,10,8,72
/jdk1.7.0_80/org/omg/DynamicAny/DynAnyHelper.java,Java,,67,13,73,153
/jdk1.7.0_80/org/omg/DynamicAny/DynAnyOperations.java,Java,,54,54,461,569
/jdk1.7.0_80/org/omg/DynamicAny/DynAnyPackage/InvalidValue.java,Java,,12,7,6,25
/jdk1.7.0_80/org/omg/DynamicAny/DynAnyPackage/InvalidValueHelper.java,Java,,54,10,8,72
/jdk1.7.0_80/org/omg/DynamicAny/DynAnyPackage/TypeMismatch.java,Java,,12,7,6,25
/jdk1.7.0_80/org/omg/DynamicAny/DynAnyPackage/TypeMismatchHelper.java,Java,,54,10,8,72
/jdk1.7.0_80/org/omg/DynamicAny/DynAnySeqHelper.java,Java,,46,10,6,62
/jdk1.7.0_80/org/omg/DynamicAny/DynArray.java,Java,,4,4,11,19
/jdk1.7.0_80/org/omg/DynamicAny/DynArrayHelper.java,Java,,67,13,11,91
/jdk1.7.0_80/org/omg/DynamicAny/DynArrayOperations.java,Java,,8,8,29,45
/jdk1.7.0_80/org/omg/DynamicAny/DynEnum.java,Java,,4,4,10,18
/jdk1.7.0_80/org/omg/DynamicAny/DynEnumHelper.java,Java,,67,13,10,90
/jdk1.7.0_80/org/omg/DynamicAny/DynEnumOperations.java,Java,,8,8,30,46
/jdk1.7.0_80/org/omg/DynamicAny/DynFixed.java,Java,,4,4,11,19
/jdk1.7.0_80/org/omg/DynamicAny/DynFixedHelper.java,Java,,67,13,11,91
/jdk1.7.0_80/org/omg/DynamicAny/DynFixedOperations.java,Java,,6,6,26,38
/jdk1.7.0_80/org/omg/DynamicAny/DynSequence.java,Java,,4,4,9,17
/jdk1.7.0_80/org/omg/DynamicAny/DynSequenceHelper.java,Java,,67,13,9,89
/jdk1.7.0_80/org/omg/DynamicAny/DynSequenceOperations.java,Java,,10,10,57,77
/jdk1.7.0_80/org/omg/DynamicAny/DynStruct.java,Java,,4,4,10,18
/jdk1.7.0_80/org/omg/DynamicAny/DynStructHelper.java,Java,,67,13,10,90
/jdk1.7.0_80/org/omg/DynamicAny/DynStructOperations.java,Java,,10,10,66,86
/jdk1.7.0_80/org/omg/DynamicAny/DynUnion.java,Java,,4,4,16,24
/jdk1.7.0_80/org/omg/DynamicAny/DynUnionHelper.java,Java,,67,13,16,96
/jdk1.7.0_80/org/omg/DynamicAny/DynUnionOperations.java,Java,,13,13,75,101
/jdk1.7.0_80/org/omg/DynamicAny/DynValue.java,Java,,4,4,18,26
/jdk1.7.0_80/org/omg/DynamicAny/DynValueBox.java,Java,,4,4,13,21
/jdk1.7.0_80/org/omg/DynamicAny/DynValueBoxOperations.java,Java,,8,8,37,53
/jdk1.7.0_80/org/omg/DynamicAny/DynValueCommon.java,Java,,4,4,9,17
/jdk1.7.0_80/org/omg/DynamicAny/DynValueCommonOperations.java,Java,,7,7,20,34
/jdk1.7.0_80/org/omg/DynamicAny/DynValueHelper.java,Java,,67,13,18,98
/jdk1.7.0_80/org/omg/DynamicAny/DynValueOperations.java,Java,,10,10,80,100
/jdk1.7.0_80/org/omg/DynamicAny/FieldNameHelper.java,Java,,40,10,6,56
/jdk1.7.0_80/org/omg/DynamicAny/NameDynAnyPair.java,Java,,14,8,12,34
/jdk1.7.0_80/org/omg/DynamicAny/NameDynAnyPairHelper.java,Java,,67,10,6,83
/jdk1.7.0_80/org/omg/DynamicAny/NameDynAnyPairSeqHelper.java,Java,,46,10,6,62
/jdk1.7.0_80/org/omg/DynamicAny/NameValuePair.java,Java,,14,8,12,34
/jdk1.7.0_80/org/omg/DynamicAny/NameValuePairHelper.java,Java,,67,10,6,83
/jdk1.7.0_80/org/omg/DynamicAny/NameValuePairSeqHelper.java,Java,,46,10,6,62
/jdk1.7.0_80/org/omg/DynamicAny/_DynAnyFactoryStub.java,Java,,47,15,69,131
/jdk1.7.0_80/org/omg/DynamicAny/_DynAnyStub.java,Java,,527,159,462,1148
/jdk1.7.0_80/org/omg/DynamicAny/_DynArrayStub.java,Java,,568,171,418,1157
/jdk1.7.0_80/org/omg/DynamicAny/_DynEnumStub.java,Java,,568,171,419,1158
/jdk1.7.0_80/org/omg/DynamicAny/_DynFixedStub.java,Java,,548,165,415,1128
/jdk1.7.0_80/org/omg/DynamicAny/_DynSequenceStub.java,Java,,588,177,446,1211
/jdk1.7.0_80/org/omg/DynamicAny/_DynStructStub.java,Java,,588,177,455,1220
/jdk1.7.0_80/org/omg/DynamicAny/_DynUnionStub.java,Java,,618,186,464,1268
/jdk1.7.0_80/org/omg/DynamicAny/_DynValueStub.java,Java,,619,186,480,1285
/jdk1.7.0_80/org/omg/IOP/Codec.java,Java,,4,4,17,25
/jdk1.7.0_80/org/omg/IOP/CodecFactory.java,Java,,4,4,11,19
/jdk1.7.0_80/org/omg/IOP/CodecFactoryHelper.java,Java,,55,13,11,79
/jdk1.7.0_80/org/omg/IOP/CodecFactoryOperations.java,Java,,5,5,19,29
/jdk1.7.0_80/org/omg/IOP/CodecFactoryPackage/UnknownEncoding.java,Java,,12,7,6,25
/jdk1.7.0_80/org/omg/IOP/CodecFactoryPackage/UnknownEncodingHelper.java,Java,,54,10,8,72
/jdk1.7.0_80/org/omg/IOP/CodecOperations.java,Java,,8,8,61,77
/jdk1.7.0_80/org/omg/IOP/CodecPackage/FormatMismatch.java,Java,,12,7,6,25
/jdk1.7.0_80/org/omg/IOP/CodecPackage/FormatMismatchHelper.java,Java,,54,10,8,72
/jdk1.7.0_80/org/omg/IOP/CodecPackage/InvalidTypeForEncoding.java,Java,,12,7,6,25
/jdk1.7.0_80/org/omg/IOP/CodecPackage/InvalidTypeForEncodingHelper.java,Java,,54,10,8,72
/jdk1.7.0_80/org/omg/IOP/CodecPackage/TypeMismatch.java,Java,,12,7,6,25
/jdk1.7.0_80/org/omg/IOP/CodecPackage/TypeMismatchHelper.java,Java,,54,10,8,72
/jdk1.7.0_80/org/omg/IOP/CodeSets.java,Java,,5,4,11,20
/jdk1.7.0_80/org/omg/IOP/ComponentIdHelper.java,Java,,40,11,10,61
/jdk1.7.0_80/org/omg/IOP/Encoding.java,Java,,16,9,15,40
/jdk1.7.0_80/org/omg/IOP/ENCODING_CDR_ENCAPS.java,Java,,5,4,10,19
/jdk1.7.0_80/org/omg/IOP/ExceptionDetailMessage.java,Java,,5,4,26,35
/jdk1.7.0_80/org/omg/IOP/IOR.java,Java,,14,8,11,33
/jdk1.7.0_80/org/omg/IOP/IORHelper.java,Java,,72,10,6,88
/jdk1.7.0_80/org/omg/IOP/IORHolder.java,Java,,24,8,6,38
/jdk1.7.0_80/org/omg/IOP/MultipleComponentProfileHelper.java,Java,,46,11,7,64
/jdk1.7.0_80/org/omg/IOP/MultipleComponentProfileHolder.java,Java,,24,10,7,41
/jdk1.7.0_80/org/omg/IOP/ProfileIdHelper.java,Java,,40,11,7,58
/jdk1.7.0_80/org/omg/IOP/RMICustomMaxStreamFormat.java,Java,,5,4,13,22
/jdk1.7.0_80/org/omg/IOP/ServiceContext.java,Java,,14,8,8,30
/jdk1.7.0_80/org/omg/IOP/ServiceContextHelper.java,Java,,71,10,6,87
/jdk1.7.0_80/org/omg/IOP/ServiceContextHolder.java,Java,,24,8,6,38
/jdk1.7.0_80/org/omg/IOP/ServiceContextListHelper.java,Java,,46,11,7,64
/jdk1.7.0_80/org/omg/IOP/ServiceContextListHolder.java,Java,,24,10,7,41
/jdk1.7.0_80/org/omg/IOP/ServiceIdHelper.java,Java,,40,11,7,58
/jdk1.7.0_80/org/omg/IOP/TaggedComponent.java,Java,,14,8,8,30
/jdk1.7.0_80/org/omg/IOP/TaggedComponentHelper.java,Java,,71,10,6,87
/jdk1.7.0_80/org/omg/IOP/TaggedComponentHolder.java,Java,,24,8,6,38
/jdk1.7.0_80/org/omg/IOP/TaggedProfile.java,Java,,14,8,8,30
/jdk1.7.0_80/org/omg/IOP/TaggedProfileHelper.java,Java,,71,10,6,87
/jdk1.7.0_80/org/omg/IOP/TaggedProfileHolder.java,Java,,24,8,6,38
/jdk1.7.0_80/org/omg/IOP/TAG_ALTERNATE_IIOP_ADDRESS.java,Java,,5,4,32,41
/jdk1.7.0_80/org/omg/IOP/TAG_CODE_SETS.java,Java,,5,4,16,25
/jdk1.7.0_80/org/omg/IOP/TAG_INTERNET_IOP.java,Java,,5,4,31,40
/jdk1.7.0_80/org/omg/IOP/TAG_JAVA_CODEBASE.java,Java,,5,4,19,28
/jdk1.7.0_80/org/omg/IOP/TAG_MULTIPLE_COMPONENTS.java,Java,,5,4,17,26
/jdk1.7.0_80/org/omg/IOP/TAG_ORB_TYPE.java,Java,,5,4,24,33
/jdk1.7.0_80/org/omg/IOP/TAG_POLICIES.java,Java,,5,4,10,19
/jdk1.7.0_80/org/omg/IOP/TAG_RMI_CUSTOM_MAX_STREAM_FORMAT.java,Java,,5,4,15,24
/jdk1.7.0_80/org/omg/IOP/TransactionService.java,Java,,5,4,11,20
/jdk1.7.0_80/org/omg/Messaging/SyncScopeHelper.java,Java,,40,11,7,58
/jdk1.7.0_80/org/omg/Messaging/SYNC_WITH_TRANSPORT.java,Java,,5,4,10,19
/jdk1.7.0_80/org/omg/PortableInterceptor/ACTIVE.java,Java,,5,4,8,17
/jdk1.7.0_80/org/omg/PortableInterceptor/AdapterManagerIdHelper.java,Java,,40,11,12,63
/jdk1.7.0_80/org/omg/PortableInterceptor/AdapterNameHelper.java,Java,,42,11,9,62
/jdk1.7.0_80/org/omg/PortableInterceptor/AdapterStateHelper.java,Java,,40,11,9,60
/jdk1.7.0_80/org/omg/PortableInterceptor/ClientRequestInfo.java,Java,,4,4,220,228
/jdk1.7.0_80/org/omg/PortableInterceptor/ClientRequestInfoOperations.java,Java,,13,13,319,345
/jdk1.7.0_80/org/omg/PortableInterceptor/ClientRequestInterceptor.java,Java,,4,4,22,30
/jdk1.7.0_80/org/omg/PortableInterceptor/ClientRequestInterceptorOperations.java,Java,,9,9,175,193
/jdk1.7.0_80/org/omg/PortableInterceptor/Current.java,Java,,4,4,23,31
/jdk1.7.0_80/org/omg/PortableInterceptor/CurrentHelper.java,Java,,55,13,23,91
/jdk1.7.0_80/org/omg/PortableInterceptor/CurrentOperations.java,Java,,6,6,52,64
/jdk1.7.0_80/org/omg/PortableInterceptor/DISCARDING.java,Java,,5,4,8,17
/jdk1.7.0_80/org/omg/PortableInterceptor/ForwardRequest.java,Java,,19,9,9,37
/jdk1.7.0_80/org/omg/PortableInterceptor/ForwardRequestHelper.java,Java,,61,10,8,79
/jdk1.7.0_80/org/omg/PortableInterceptor/HOLDING.java,Java,,5,4,9,18
/jdk1.7.0_80/org/omg/PortableInterceptor/INACTIVE.java,Java,,5,4,9,18
/jdk1.7.0_80/org/omg/PortableInterceptor/Interceptor.java,Java,,4,4,9,17
/jdk1.7.0_80/org/omg/PortableInterceptor/InterceptorOperations.java,Java,,6,6,38,50
/jdk1.7.0_80/org/omg/PortableInterceptor/InvalidSlot.java,Java,,12,7,6,25
/jdk1.7.0_80/org/omg/PortableInterceptor/InvalidSlotHelper.java,Java,,54,10,8,72
/jdk1.7.0_80/org/omg/PortableInterceptor/IORInfo.java,Java,,4,4,14,22
/jdk1.7.0_80/org/omg/PortableInterceptor/IORInfoOperations.java,Java,,12,12,82,106
/jdk1.7.0_80/org/omg/PortableInterceptor/IORInterceptor.java,Java,,4,4,20,28
/jdk1.7.0_80/org/omg/PortableInterceptor/IORInterceptorOperations.java,Java,,5,5,40,50
/jdk1.7.0_80/org/omg/PortableInterceptor/IORInterceptor_3_0.java,Java,,4,3,6,13
/jdk1.7.0_80/org/omg/PortableInterceptor/IORInterceptor_3_0Helper.java,Java,,55,12,6,73
/jdk1.7.0_80/org/omg/PortableInterceptor/IORInterceptor_3_0Holder.java,Java,,24,8,6,38
/jdk1.7.0_80/org/omg/PortableInterceptor/IORInterceptor_3_0Operations.java,Java,,7,6,34,47
/jdk1.7.0_80/org/omg/PortableInterceptor/LOCATION_FORWARD.java,Java,,5,4,15,24
/jdk1.7.0_80/org/omg/PortableInterceptor/NON_EXISTENT.java,Java,,5,4,8,17
/jdk1.7.0_80/org/omg/PortableInterceptor/ObjectIdHelper.java,Java,,42,11,9,62
/jdk1.7.0_80/org/omg/PortableInterceptor/ObjectReferenceFactory.java,Java,,5,6,13,24
/jdk1.7.0_80/org/omg/PortableInterceptor/ObjectReferenceFactoryHelper.java,Java,,52,13,9,74
/jdk1.7.0_80/org/omg/PortableInterceptor/ObjectReferenceFactoryHolder.java,Java,,24,9,9,42
/jdk1.7.0_80/org/omg/PortableInterceptor/ObjectReferenceTemplate.java,Java,,7,7,13,27
/jdk1.7.0_80/org/omg/PortableInterceptor/ObjectReferenceTemplateHelper.java,Java,,52,13,13,78
/jdk1.7.0_80/org/omg/PortableInterceptor/ObjectReferenceTemplateHolder.java,Java,,24,9,13,46
/jdk1.7.0_80/org/omg/PortableInterceptor/ObjectReferenceTemplateSeqHelper.java,Java,,46,11,9,66
/jdk1.7.0_80/org/omg/PortableInterceptor/ObjectReferenceTemplateSeqHolder.java,Java,,24,10,9,43
/jdk1.7.0_80/org/omg/PortableInterceptor/ORBIdHelper.java,Java,,40,11,7,58
/jdk1.7.0_80/org/omg/PortableInterceptor/ORBInitializer.java,Java,,4,4,116,124
/jdk1.7.0_80/org/omg/PortableInterceptor/ORBInitializerOperations.java,Java,,6,6,144,156
/jdk1.7.0_80/org/omg/PortableInterceptor/ORBInitInfo.java,Java,,4,4,19,27
/jdk1.7.0_80/org/omg/PortableInterceptor/ORBInitInfoOperations.java,Java,,14,14,106,134
/jdk1.7.0_80/org/omg/PortableInterceptor/ORBInitInfoPackage/DuplicateName.java,Java,,19,9,9,37
/jdk1.7.0_80/org/omg/PortableInterceptor/ORBInitInfoPackage/DuplicateNameHelper.java,Java,,61,10,8,79
/jdk1.7.0_80/org/omg/PortableInterceptor/ORBInitInfoPackage/InvalidName.java,Java,,12,7,6,25
/jdk1.7.0_80/org/omg/PortableInterceptor/ORBInitInfoPackage/InvalidNameHelper.java,Java,,54,10,8,72
/jdk1.7.0_80/org/omg/PortableInterceptor/ORBInitInfoPackage/ObjectIdHelper.java,Java,,40,11,7,58
/jdk1.7.0_80/org/omg/PortableInterceptor/PolicyFactory.java,Java,,4,4,19,27
/jdk1.7.0_80/org/omg/PortableInterceptor/PolicyFactoryOperations.java,Java,,5,5,40,50
/jdk1.7.0_80/org/omg/PortableInterceptor/RequestInfo.java,Java,,4,4,21,29
/jdk1.7.0_80/org/omg/PortableInterceptor/RequestInfoOperations.java,Java,,18,18,256,292
/jdk1.7.0_80/org/omg/PortableInterceptor/ServerIdHelper.java,Java,,40,11,7,58
/jdk1.7.0_80/org/omg/PortableInterceptor/ServerRequestInfo.java,Java,,4,4,218,226
/jdk1.7.0_80/org/omg/PortableInterceptor/ServerRequestInfoOperations.java,Java,,15,15,306,336
/jdk1.7.0_80/org/omg/PortableInterceptor/ServerRequestInterceptor.java,Java,,4,4,22,30
/jdk1.7.0_80/org/omg/PortableInterceptor/ServerRequestInterceptorOperations.java,Java,,9,9,180,198
/jdk1.7.0_80/org/omg/PortableInterceptor/SUCCESSFUL.java,Java,,5,4,15,24
/jdk1.7.0_80/org/omg/PortableInterceptor/SYSTEM_EXCEPTION.java,Java,,5,4,15,24
/jdk1.7.0_80/org/omg/PortableInterceptor/TRANSPORT_RETRY.java,Java,,5,4,15,24
/jdk1.7.0_80/org/omg/PortableInterceptor/UNKNOWN.java,Java,,5,4,9,18
/jdk1.7.0_80/org/omg/PortableInterceptor/USER_EXCEPTION.java,Java,,5,4,15,24
/jdk1.7.0_80/org/omg/PortableServer/AdapterActivator.java,Java,,4,4,13,21
/jdk1.7.0_80/org/omg/PortableServer/AdapterActivatorOperations.java,Java,,5,5,26,36
/jdk1.7.0_80/org/omg/PortableServer/Current.java,Java,,4,4,24,32
/jdk1.7.0_80/org/omg/PortableServer/CurrentHelper.java,Java,,52,13,48,113
/jdk1.7.0_80/org/omg/PortableServer/CurrentOperations.java,Java,,6,6,44,56
/jdk1.7.0_80/org/omg/PortableServer/CurrentPackage/NoContext.java,Java,,12,7,6,25
/jdk1.7.0_80/org/omg/PortableServer/CurrentPackage/NoContextHelper.java,Java,,54,10,8,72
/jdk1.7.0_80/org/omg/PortableServer/DynamicImplementation.java,Java,,4,2,37,43
/jdk1.7.0_80/org/omg/PortableServer/ForwardRequest.java,Java,,19,8,6,33
/jdk1.7.0_80/org/omg/PortableServer/ForwardRequestHelper.java,Java,,61,10,8,79
/jdk1.7.0_80/org/omg/PortableServer/IdAssignmentPolicy.java,Java,,4,4,11,19
/jdk1.7.0_80/org/omg/PortableServer/IdAssignmentPolicyOperations.java,Java,,5,5,14,24
/jdk1.7.0_80/org/omg/PortableServer/IdAssignmentPolicyValue.java,Java,,27,8,15,50
/jdk1.7.0_80/org/omg/PortableServer/IdUniquenessPolicy.java,Java,,4,4,11,19
/jdk1.7.0_80/org/omg/PortableServer/IdUniquenessPolicyOperations.java,Java,,5,5,14,24
/jdk1.7.0_80/org/omg/PortableServer/IdUniquenessPolicyValue.java,Java,,27,8,13,48
/jdk1.7.0_80/org/omg/PortableServer/ID_ASSIGNMENT_POLICY_ID.java,Java,,5,4,9,18
/jdk1.7.0_80/org/omg/PortableServer/ID_UNIQUENESS_POLICY_ID.java,Java,,5,4,9,18
/jdk1.7.0_80/org/omg/PortableServer/ImplicitActivationPolicy.java,Java,,4,4,10,18
/jdk1.7.0_80/org/omg/PortableServer/ImplicitActivationPolicyOperations.java,Java,,5,5,13,23
/jdk1.7.0_80/org/omg/PortableServer/ImplicitActivationPolicyValue.java,Java,,27,8,15,50
/jdk1.7.0_80/org/omg/PortableServer/IMPLICIT_ACTIVATION_POLICY_ID.java,Java,,5,4,9,18
/jdk1.7.0_80/org/omg/PortableServer/LifespanPolicy.java,Java,,4,4,11,19
/jdk1.7.0_80/org/omg/PortableServer/LifespanPolicyOperations.java,Java,,5,5,14,24
/jdk1.7.0_80/org/omg/PortableServer/LifespanPolicyValue.java,Java,,27,8,14,49
/jdk1.7.0_80/org/omg/PortableServer/LIFESPAN_POLICY_ID.java,Java,,5,4,9,18
/jdk1.7.0_80/org/omg/PortableServer/POA.java,Java,,4,4,16,24
/jdk1.7.0_80/org/omg/PortableServer/POAHelper.java,Java,,50,11,40,101
/jdk1.7.0_80/org/omg/PortableServer/POAManager.java,Java,,4,4,12,20
/jdk1.7.0_80/org/omg/PortableServer/POAManagerOperations.java,Java,,9,9,60,78
/jdk1.7.0_80/org/omg/PortableServer/POAManagerPackage/AdapterInactive.java,Java,,12,7,6,25
/jdk1.7.0_80/org/omg/PortableServer/POAManagerPackage/AdapterInactiveHelper.java,Java,,54,10,8,72
/jdk1.7.0_80/org/omg/PortableServer/POAManagerPackage/State.java,Java,,31,8,9,48
/jdk1.7.0_80/org/omg/PortableServer/POAOperations.java,Java,,36,36,395,467
/jdk1.7.0_80/org/omg/PortableServer/POAPackage/AdapterAlreadyExists.java,Java,,12,7,6,25
/jdk1.7.0_80/org/omg/PortableServer/POAPackage/AdapterAlreadyExistsHelper.java,Java,,54,10,8,72
/jdk1.7.0_80/org/omg/PortableServer/POAPackage/AdapterNonExistent.java,Java,,12,7,6,25
/jdk1.7.0_80/org/omg/PortableServer/POAPackage/AdapterNonExistentHelper.java,Java,,54,10,8,72
/jdk1.7.0_80/org/omg/PortableServer/POAPackage/InvalidPolicy.java,Java,,19,8,6,33
/jdk1.7.0_80/org/omg/PortableServer/POAPackage/InvalidPolicyHelper.java,Java,,61,10,8,79
/jdk1.7.0_80/org/omg/PortableServer/POAPackage/NoServant.java,Java,,12,7,6,25
/jdk1.7.0_80/org/omg/PortableServer/POAPackage/NoServantHelper.java,Java,,54,10,8,72
/jdk1.7.0_80/org/omg/PortableServer/POAPackage/ObjectAlreadyActive.java,Java,,12,7,6,25
/jdk1.7.0_80/org/omg/PortableServer/POAPackage/ObjectAlreadyActiveHelper.java,Java,,54,10,8,72
/jdk1.7.0_80/org/omg/PortableServer/POAPackage/ObjectNotActive.java,Java,,12,7,6,25
/jdk1.7.0_80/org/omg/PortableServer/POAPackage/ObjectNotActiveHelper.java,Java,,54,10,8,72
/jdk1.7.0_80/org/omg/PortableServer/POAPackage/ServantAlreadyActive.java,Java,,12,7,6,25
/jdk1.7.0_80/org/omg/PortableServer/POAPackage/ServantAlreadyActiveHelper.java,Java,,54,10,8,72
/jdk1.7.0_80/org/omg/PortableServer/POAPackage/ServantNotActive.java,Java,,12,7,6,25
/jdk1.7.0_80/org/omg/PortableServer/POAPackage/ServantNotActiveHelper.java,Java,,54,10,8,72
/jdk1.7.0_80/org/omg/PortableServer/POAPackage/WrongAdapter.java,Java,,12,7,6,25
/jdk1.7.0_80/org/omg/PortableServer/POAPackage/WrongAdapterHelper.java,Java,,54,10,8,72
/jdk1.7.0_80/org/omg/PortableServer/POAPackage/WrongPolicy.java,Java,,12,7,6,25
/jdk1.7.0_80/org/omg/PortableServer/POAPackage/WrongPolicyHelper.java,Java,,54,10,8,72
/jdk1.7.0_80/org/omg/PortableServer/portable/Delegate.java,Java,,13,10,92,115
/jdk1.7.0_80/org/omg/PortableServer/RequestProcessingPolicy.java,Java,,4,4,11,19
/jdk1.7.0_80/org/omg/PortableServer/RequestProcessingPolicyOperations.java,Java,,5,5,14,24
/jdk1.7.0_80/org/omg/PortableServer/RequestProcessingPolicyValue.java,Java,,29,8,24,61
/jdk1.7.0_80/org/omg/PortableServer/REQUEST_PROCESSING_POLICY_ID.java,Java,,5,4,9,18
/jdk1.7.0_80/org/omg/PortableServer/Servant.java,Java,,80,18,168,266
/jdk1.7.0_80/org/omg/PortableServer/ServantActivator.java,Java,,4,4,10,18
/jdk1.7.0_80/org/omg/PortableServer/ServantActivatorHelper.java,Java,,67,13,10,90
/jdk1.7.0_80/org/omg/PortableServer/ServantActivatorOperations.java,Java,,6,6,48,60
/jdk1.7.0_80/org/omg/PortableServer/ServantActivatorPOA.java,Java,,34,13,12,59
/jdk1.7.0_80/org/omg/PortableServer/ServantLocator.java,Java,,4,4,24,32
/jdk1.7.0_80/org/omg/PortableServer/ServantLocatorHelper.java,Java,,67,13,24,104
/jdk1.7.0_80/org/omg/PortableServer/ServantLocatorOperations.java,Java,,6,6,55,67
/jdk1.7.0_80/org/omg/PortableServer/ServantLocatorPackage/CookieHolder.java,Java,,18,8,31,57
/jdk1.7.0_80/org/omg/PortableServer/ServantLocatorPOA.java,Java,,34,13,26,73
/jdk1.7.0_80/org/omg/PortableServer/ServantManager.java,Java,,4,4,17,25
/jdk1.7.0_80/org/omg/PortableServer/ServantManagerOperations.java,Java,,4,4,17,25
/jdk1.7.0_80/org/omg/PortableServer/ServantRetentionPolicy.java,Java,,4,4,10,18
/jdk1.7.0_80/org/omg/PortableServer/ServantRetentionPolicyOperations.java,Java,,5,5,13,23
/jdk1.7.0_80/org/omg/PortableServer/ServantRetentionPolicyValue.java,Java,,27,8,14,49
/jdk1.7.0_80/org/omg/PortableServer/SERVANT_RETENTION_POLICY_ID.java,Java,,5,4,9,18
/jdk1.7.0_80/org/omg/PortableServer/ThreadPolicy.java,Java,,4,4,11,19
/jdk1.7.0_80/org/omg/PortableServer/ThreadPolicyOperations.java,Java,,5,5,14,24
/jdk1.7.0_80/org/omg/PortableServer/ThreadPolicyValue.java,Java,,27,8,13,48
/jdk1.7.0_80/org/omg/PortableServer/THREAD_POLICY_ID.java,Java,,5,4,9,18
/jdk1.7.0_80/org/omg/PortableServer/_ServantActivatorStub.java,Java,,48,15,49,112
/jdk1.7.0_80/org/omg/PortableServer/_ServantLocatorStub.java,Java,,48,15,56,119
/jdk1.7.0_80/org/omg/SendingContext/RunTime.java,Java,,4,2,37,43
/jdk1.7.0_80/org/omg/SendingContext/RunTimeOperations.java,Java,,4,2,37,43
/jdk1.7.0_80/org/omg/stub/java/rmi/_Remote_Stub.java,Java,,11,6,44,61
/jdk1.7.0_80/org/w3c/dom/Attr.java,Java,,11,9,284,304
/jdk1.7.0_80/org/w3c/dom/bootstrap/DOMImplementationRegistry.java,Java,,209,23,197,429
/jdk1.7.0_80/org/w3c/dom/CDATASection.java,Java,,3,3,77,83
/jdk1.7.0_80/org/w3c/dom/CharacterData.java,Java,,23,10,149,182
/jdk1.7.0_80/org/w3c/dom/Comment.java,Java,,3,3,53,59
/jdk1.7.0_80/org/w3c/dom/css/Counter.java,Java,,6,6,55,67
/jdk1.7.0_80/org/w3c/dom/css/CSS2Properties.java,Java,,370,126,1310,1806
/jdk1.7.0_80/org/w3c/dom/css/CSSCharsetRule.java,Java,,7,5,68,80
/jdk1.7.0_80/org/w3c/dom/css/CSSFontFaceRule.java,Java,,4,4,49,57
/jdk1.7.0_80/org/w3c/dom/css/CSSImportRule.java,Java,,7,7,59,73
/jdk1.7.0_80/org/w3c/dom/css/CSSMediaRule.java,Java,,12,8,85,105
/jdk1.7.0_80/org/w3c/dom/css/CSSPageRule.java,Java,,8,6,59,73
/jdk1.7.0_80/org/w3c/dom/css/CSSPrimitiveValue.java,Java,,47,13,265,325
/jdk1.7.0_80/org/w3c/dom/css/CSSRule.java,Java,,17,9,100,126
/jdk1.7.0_80/org/w3c/dom/css/CSSRuleList.java,Java,,5,5,62,72
/jdk1.7.0_80/org/w3c/dom/css/CSSStyleDeclaration.java,Java,,19,13,159,191
/jdk1.7.0_80/org/w3c/dom/css/CSSStyleRule.java,Java,,8,6,62,76
/jdk1.7.0_80/org/w3c/dom/css/CSSStyleSheet.java,Java,,12,8,94,114
/jdk1.7.0_80/org/w3c/dom/css/CSSUnknownRule.java,Java,,3,3,45,51
/jdk1.7.0_80/org/w3c/dom/css/CSSValue.java,Java,,12,7,81,100
/jdk1.7.0_80/org/w3c/dom/css/CSSValueList.java,Java,,5,5,65,75
/jdk1.7.0_80/org/w3c/dom/css/DocumentCSS.java,Java,,7,5,67,79
/jdk1.7.0_80/org/w3c/dom/css/DOMImplementationCSS.java,Java,,8,5,56,69
/jdk1.7.0_80/org/w3c/dom/css/ElementCSSInlineStyle.java,Java,,4,4,53,61
/jdk1.7.0_80/org/w3c/dom/css/Rect.java,Java,,7,7,59,73
/jdk1.7.0_80/org/w3c/dom/css/RGBColor.java,Java,,6,6,64,76
/jdk1.7.0_80/org/w3c/dom/css/ViewCSS.java,Java,,7,5,60,72
/jdk1.7.0_80/org/w3c/dom/Document.java,Java,,53,30,761,844
/jdk1.7.0_80/org/w3c/dom/DocumentFragment.java,Java,,3,3,76,82
/jdk1.7.0_80/org/w3c/dom/DocumentType.java,Java,,9,9,94,112
/jdk1.7.0_80/org/w3c/dom/DOMConfiguration.java,Java,,11,7,424,442
/jdk1.7.0_80/org/w3c/dom/DOMError.java,Java,,12,10,94,116
/jdk1.7.0_80/org/w3c/dom/DOMErrorHandler.java,Java,,4,4,66,74
/jdk1.7.0_80/org/w3c/dom/DOMException.java,Java,,26,4,132,162
/jdk1.7.0_80/org/w3c/dom/DOMImplementation.java,Java,,15,7,143,165
/jdk1.7.0_80/org/w3c/dom/DOMImplementationList.java,Java,,5,5,62,72
/jdk1.7.0_80/org/w3c/dom/DOMImplementationSource.java,Java,,5,5,78,88
/jdk1.7.0_80/org/w3c/dom/DOMLocator.java,Java,,9,9,69,87
/jdk1.7.0_80/org/w3c/dom/DOMStringList.java,Java,,6,6,67,79
/jdk1.7.0_80/org/w3c/dom/Element.java,Java,,49,23,396,468
/jdk1.7.0_80/org/w3c/dom/Entity.java,Java,,9,9,101,119
/jdk1.7.0_80/org/w3c/dom/EntityReference.java,Java,,3,3,66,72
/jdk1.7.0_80/org/w3c/dom/events/DocumentEvent.java,Java,,6,5,74,85
/jdk1.7.0_80/org/w3c/dom/events/Event.java,Java,,18,14,138,170
/jdk1.7.0_80/org/w3c/dom/events/EventException.java,Java,,9,4,52,65
/jdk1.7.0_80/org/w3c/dom/events/EventListener.java,Java,,4,4,62,70
/jdk1.7.0_80/org/w3c/dom/events/EventTarget.java,Java,,11,6,114,131
/jdk1.7.0_80/org/w3c/dom/events/MouseEvent.java,Java,,29,15,141,185
/jdk1.7.0_80/org/w3c/dom/events/MutationEvent.java,Java,,20,11,106,137
/jdk1.7.0_80/org/w3c/dom/events/UIEvent.java,Java,,11,7,69,87
/jdk1.7.0_80/org/w3c/dom/html/HTMLAnchorElement.java,Java,,29,17,94,140
/jdk1.7.0_80/org/w3c/dom/html/HTMLAppletElement.java,Java,,25,14,92,131
/jdk1.7.0_80/org/w3c/dom/html/HTMLAreaElement.java,Java,,19,11,77,107
/jdk1.7.0_80/org/w3c/dom/html/HTMLBaseElement.java,Java,,7,5,50,62
/jdk1.7.0_80/org/w3c/dom/html/HTMLBaseFontElement.java,Java,,9,6,56,71
/jdk1.7.0_80/org/w3c/dom/html/HTMLBodyElement.java,Java,,15,9,73,97
/jdk1.7.0_80/org/w3c/dom/html/HTMLBRElement.java,Java,,5,4,47,56
/jdk1.7.0_80/org/w3c/dom/html/HTMLButtonElement.java,Java,,15,10,70,95
/jdk1.7.0_80/org/w3c/dom/html/HTMLCollection.java,Java,,7,7,71,85
/jdk1.7.0_80/org/w3c/dom/html/HTMLDirectoryElement.java,Java,,5,4,48,57
/jdk1.7.0_80/org/w3c/dom/html/HTMLDivElement.java,Java,,5,4,47,56
/jdk1.7.0_80/org/w3c/dom/html/HTMLDListElement.java,Java,,5,4,47,56
/jdk1.7.0_80/org/w3c/dom/html/HTMLDocument.java,Java,,24,20,139,183
/jdk1.7.0_80/org/w3c/dom/html/HTMLDOMImplementation.java,Java,,5,5,53,63
/jdk1.7.0_80/org/w3c/dom/html/HTMLElement.java,Java,,14,9,71,94
/jdk1.7.0_80/org/w3c/dom/html/HTMLFieldSetElement.java,Java,,4,4,48,56
/jdk1.7.0_80/org/w3c/dom/html/HTMLFontElement.java,Java,,9,6,56,71
/jdk1.7.0_80/org/w3c/dom/html/HTMLFormElement.java,Java,,19,13,83,115
/jdk1.7.0_80/org/w3c/dom/html/HTMLFrameElement.java,Java,,21,13,80,114
/jdk1.7.0_80/org/w3c/dom/html/HTMLFrameSetElement.java,Java,,7,5,51,63
/jdk1.7.0_80/org/w3c/dom/html/HTMLHeadElement.java,Java,,5,4,47,56
/jdk1.7.0_80/org/w3c/dom/html/HTMLHeadingElement.java,Java,,5,4,48,57
/jdk1.7.0_80/org/w3c/dom/html/HTMLHRElement.java,Java,,11,7,60,78
/jdk1.7.0_80/org/w3c/dom/html/HTMLHtmlElement.java,Java,,5,4,48,57
/jdk1.7.0_80/org/w3c/dom/html/HTMLIFrameElement.java,Java,,25,15,87,127
/jdk1.7.0_80/org/w3c/dom/html/HTMLImageElement.java,Java,,29,16,93,138
/jdk1.7.0_80/org/w3c/dom/html/HTMLInputElement.java,Java,,41,25,159,225
/jdk1.7.0_80/org/w3c/dom/html/HTMLIsIndexElement.java,Java,,6,5,52,63
/jdk1.7.0_80/org/w3c/dom/html/HTMLLabelElement.java,Java,,8,6,56,70
/jdk1.7.0_80/org/w3c/dom/html/HTMLLegendElement.java,Java,,8,6,57,71
/jdk1.7.0_80/org/w3c/dom/html/HTMLLIElement.java,Java,,7,5,52,64
/jdk1.7.0_80/org/w3c/dom/html/HTMLLinkElement.java,Java,,21,12,79,112
/jdk1.7.0_80/org/w3c/dom/html/HTMLMapElement.java,Java,,6,5,50,61
/jdk1.7.0_80/org/w3c/dom/html/HTMLMenuElement.java,Java,,5,4,48,57
/jdk1.7.0_80/org/w3c/dom/html/HTMLMetaElement.java,Java,,11,7,59,77
/jdk1.7.0_80/org/w3c/dom/html/HTMLModElement.java,Java,,7,5,52,64
/jdk1.7.0_80/org/w3c/dom/html/HTMLObjectElement.java,Java,,40,23,125,188
/jdk1.7.0_80/org/w3c/dom/html/HTMLOListElement.java,Java,,9,6,55,70
/jdk1.7.0_80/org/w3c/dom/html/HTMLOptGroupElement.java,Java,,7,5,52,64
/jdk1.7.0_80/org/w3c/dom/html/HTMLOptionElement.java,Java,,16,11,79,106
/jdk1.7.0_80/org/w3c/dom/html/HTMLParagraphElement.java,Java,,5,4,47,56
/jdk1.7.0_80/org/w3c/dom/html/HTMLParamElement.java,Java,,11,7,61,79
/jdk1.7.0_80/org/w3c/dom/html/HTMLPreElement.java,Java,,5,4,47,56
/jdk1.7.0_80/org/w3c/dom/html/HTMLQuoteElement.java,Java,,5,4,48,57
/jdk1.7.0_80/org/w3c/dom/html/HTMLScriptElement.java,Java,,17,10,68,95
/jdk1.7.0_80/org/w3c/dom/html/HTMLSelectElement.java,Java,,28,19,115,162
/jdk1.7.0_80/org/w3c/dom/html/HTMLStyleElement.java,Java,,9,6,55,70
/jdk1.7.0_80/org/w3c/dom/html/HTMLTableCaptionElement.java,Java,,5,4,47,56
/jdk1.7.0_80/org/w3c/dom/html/HTMLTableCellElement.java,Java,,32,18,104,154
/jdk1.7.0_80/org/w3c/dom/html/HTMLTableColElement.java,Java,,15,9,67,91
/jdk1.7.0_80/org/w3c/dom/html/HTMLTableElement.java,Java,,40,26,151,217
/jdk1.7.0_80/org/w3c/dom/html/HTMLTableRowElement.java,Java,,21,14,96,131
/jdk1.7.0_80/org/w3c/dom/html/HTMLTableSectionElement.java,Java,,17,11,85,113
/jdk1.7.0_80/org/w3c/dom/html/HTMLTextAreaElement.java,Java,,26,17,99,142
/jdk1.7.0_80/org/w3c/dom/html/HTMLTitleElement.java,Java,,5,4,46,55
/jdk1.7.0_80/org/w3c/dom/html/HTMLUListElement.java,Java,,7,5,51,63
/jdk1.7.0_80/org/w3c/dom/ls/DOMImplementationLS.java,Java,,12,9,130,151
/jdk1.7.0_80/org/w3c/dom/ls/LSException.java,Java,,10,4,62,76
/jdk1.7.0_80/org/w3c/dom/ls/LSInput.java,Java,,19,11,217,247
/jdk1.7.0_80/org/w3c/dom/ls/LSLoadEvent.java,Java,,7,6,51,64
/jdk1.7.0_80/org/w3c/dom/ls/LSOutput.java,Java,,11,7,117,135
/jdk1.7.0_80/org/w3c/dom/ls/LSParser.java,Java,,26,13,456,495
/jdk1.7.0_80/org/w3c/dom/ls/LSParserFilter.java,Java,,12,8,181,201
/jdk1.7.0_80/org/w3c/dom/ls/LSProgressEvent.java,Java,,7,7,63,77
/jdk1.7.0_80/org/w3c/dom/ls/LSResourceResolver.java,Java,,8,4,98,110
/jdk1.7.0_80/org/w3c/dom/ls/LSSerializer.java,Java,,19,10,436,465
/jdk1.7.0_80/org/w3c/dom/ls/LSSerializerFilter.java,Java,,5,5,82,92
/jdk1.7.0_80/org/w3c/dom/NamedNodeMap.java,Java,,18,11,183,212
/jdk1.7.0_80/org/w3c/dom/NameList.java,Java,,9,8,80,97
/jdk1.7.0_80/org/w3c/dom/Node.java,Java,,74,39,840,953
/jdk1.7.0_80/org/w3c/dom/NodeList.java,Java,,5,5,60,70
/jdk1.7.0_80/org/w3c/dom/Notation.java,Java,,5,5,59,69
/jdk1.7.0_80/org/w3c/dom/ProcessingInstruction.java,Java,,7,5,68,80
/jdk1.7.0_80/org/w3c/dom/ranges/DocumentRange.java,Java,,4,4,54,62
/jdk1.7.0_80/org/w3c/dom/ranges/Range.java,Java,,61,29,355,445
/jdk1.7.0_80/org/w3c/dom/ranges/RangeException.java,Java,,10,4,54,68
/jdk1.7.0_80/org/w3c/dom/stylesheets/DocumentStyle.java,Java,,4,4,55,63
/jdk1.7.0_80/org/w3c/dom/stylesheets/LinkStyle.java,Java,,4,4,52,60
/jdk1.7.0_80/org/w3c/dom/stylesheets/MediaList.java,Java,,13,9,92,114
/jdk1.7.0_80/org/w3c/dom/stylesheets/StyleSheet.java,Java,,12,11,109,132
/jdk1.7.0_80/org/w3c/dom/stylesheets/StyleSheetList.java,Java,,5,5,61,71
/jdk1.7.0_80/org/w3c/dom/Text.java,Java,,9,7,171,187
/jdk1.7.0_80/org/w3c/dom/traversal/DocumentTraversal.java,Java,,15,6,101,122
/jdk1.7.0_80/org/w3c/dom/traversal/NodeFilter.java,Java,,21,7,145,173
/jdk1.7.0_80/org/w3c/dom/traversal/NodeIterator.java,Java,,14,11,113,138
/jdk1.7.0_80/org/w3c/dom/traversal/TreeWalker.java,Java,,19,16,173,208
/jdk1.7.0_80/org/w3c/dom/TypeInfo.java,Java,,12,7,195,214
/jdk1.7.0_80/org/w3c/dom/UserDataHandler.java,Java,,13,5,83,101
/jdk1.7.0_80/org/w3c/dom/views/AbstractView.java,Java,,4,4,48,56
/jdk1.7.0_80/org/w3c/dom/views/DocumentView.java,Java,,4,4,51,59
/jdk1.7.0_80/org/w3c/dom/xpath/XPathEvaluator.java,Java,,15,8,139,162
/jdk1.7.0_80/org/w3c/dom/xpath/XPathException.java,Java,,10,4,54,68
/jdk1.7.0_80/org/w3c/dom/xpath/XPathExpression.java,Java,,9,6,80,95
/jdk1.7.0_80/org/w3c/dom/xpath/XPathNamespace.java,Java,,7,7,80,94
/jdk1.7.0_80/org/w3c/dom/xpath/XPathNSResolver.java,Java,,4,5,55,64
/jdk1.7.0_80/org/w3c/dom/xpath/XPathResult.java,Java,,31,15,195,241
/jdk1.7.0_80/org/xml/sax/AttributeList.java,Java,,9,22,186,217
/jdk1.7.0_80/org/xml/sax/Attributes.java,Java,,16,35,230,281
/jdk1.7.0_80/org/xml/sax/ContentHandler.java,Java,,27,26,390,443
/jdk1.7.0_80/org/xml/sax/DocumentHandler.java,Java,,18,21,217,256
/jdk1.7.0_80/org/xml/sax/DTDHandler.java,Java,,12,9,120,141
/jdk1.7.0_80/org/xml/sax/EntityResolver.java,Java,,7,9,127,143
/jdk1.7.0_80/org/xml/sax/ErrorHandler.java,Java,,9,12,142,163
/jdk1.7.0_80/org/xml/sax/ext/Attributes2.java,Java,,11,10,135,156
/jdk1.7.0_80/org/xml/sax/ext/Attributes2Impl.java,Java,,129,47,156,332
/jdk1.7.0_80/org/xml/sax/ext/DeclHandler.java,Java,,18,14,138,170
/jdk1.7.0_80/org/xml/sax/ext/DefaultHandler2.java,Java,,55,25,74,154
/jdk1.7.0_80/org/xml/sax/ext/EntityResolver2.java,Java,,17,7,197,221
/jdk1.7.0_80/org/xml/sax/ext/LexicalHandler.java,Java,,20,19,197,236
/jdk1.7.0_80/org/xml/sax/ext/Locator2.java,Java,,7,6,86,99
/jdk1.7.0_80/org/xml/sax/ext/Locator2Impl.java,Java,,26,16,83,125
/jdk1.7.0_80/org/xml/sax/HandlerBase.java,Java,,61,43,289,393
/jdk1.7.0_80/org/xml/sax/helpers/AttributeListImpl.java,Java,,90,44,202,336
/jdk1.7.0_80/org/xml/sax/helpers/AttributesImpl.java,Java,,255,75,311,641
/jdk1.7.0_80/org/xml/sax/helpers/DefaultHandler.java,Java,,86,52,353,491
/jdk1.7.0_80/org/xml/sax/helpers/LocatorImpl.java,Java,,51,37,150,238
/jdk1.7.0_80/org/xml/sax/helpers/NamespaceSupport.java,Java,,277,94,477,848
/jdk1.7.0_80/org/xml/sax/helpers/NewInstance.java,Java,,24,6,57,87
/jdk1.7.0_80/org/xml/sax/helpers/ParserAdapter.java,Java,,452,143,476,1071
/jdk1.7.0_80/org/xml/sax/helpers/ParserFactory.java,Java,,31,11,105,147
/jdk1.7.0_80/org/xml/sax/helpers/SecuritySupport.java,Java,,63,12,33,108
/jdk1.7.0_80/org/xml/sax/helpers/XMLFilterImpl.java,Java,,255,107,375,737
/jdk1.7.0_80/org/xml/sax/helpers/XMLReaderAdapter.java,Java,,178,86,298,562
/jdk1.7.0_80/org/xml/sax/helpers/XMLReaderFactory.java,Java,,88,19,137,244
/jdk1.7.0_80/org/xml/sax/InputSource.java,Java,,65,37,258,360
/jdk1.7.0_80/org/xml/sax/Locator.java,Java,,7,14,139,160
/jdk1.7.0_80/org/xml/sax/Parser.java,Java,,16,20,197,233
/jdk1.7.0_80/org/xml/sax/SAXException.java,Java,,48,25,115,188
/jdk1.7.0_80/org/xml/sax/SAXNotRecognizedException.java,Java,,13,9,57,79
/jdk1.7.0_80/org/xml/sax/SAXNotSupportedException.java,Java,,13,8,58,79
/jdk1.7.0_80/org/xml/sax/SAXParseException.java,Java,,73,36,204,313
/jdk1.7.0_80/org/xml/sax/XMLFilter.java,Java,,6,9,74,89
/jdk1.7.0_80/org/xml/sax/XMLReader.java,Java,,25,41,362,428
/jdk1.7.0_80/sunw/io/Serializable.java,Java,,3,3,48,54
/jdk1.7.0_80/sunw/util/EventListener.java,Java,,3,3,48,54
/jdk1.7.0_80/sunw/util/EventObject.java,Java,,7,6,48,61
