Applet.java,Java,,100,25,316,441
AppletContext.java,Java,,15,9,106,130
AppletStub.java,Java,,10,7,68,85
AudioClip.java,Java,,6,4,32,42
Adjustable.java,Java,,21,22,79,122
AWTError.java,Java,,7,4,21,32
AWTEvent.java,Java,,176,40,109,325
AWTEventMulticaster.java,Java,,250,62,333,645
AWTException.java,Java,,7,4,23,34
BorderLayout.java,Java,,199,35,229,463
Button.java,Java,,99,34,164,297
Canvas.java,Java,,26,10,51,87
CardLayout.java,Java,,211,30,199,440
Checkbox.java,Java,,158,40,224,422
CheckboxGroup.java,Java,,32,9,86,127
CheckboxMenuItem.java,Java,,104,31,152,287
Choice.java,Java,,182,48,217,447
Color.java,Java,,218,43,344,605
Component.java,Java,,1336,243,1463,3042
Container.java,Java,,1061,179,724,1964
Cursor.java,Java,,41,24,72,137
Clipboard.java,Java,,22,13,35,70
ClipboardOwner.java,Java,,4,5,19,28
DataFlavor.java,Java,,64,27,127,218
StringSelection.java,Java,,29,12,29,70
Transferable.java,Java,,7,8,36,51
UnsupportedFlavorException.java,Java,,7,5,20,32
Dialog.java,Java,,128,20,151,299
Dimension.java,Java,,36,12,99,147
ActionEvent.java,Java,,40,19,56,115
ActionListener.java,Java,,5,5,15,25
AdjustmentEvent.java,Java,,64,18,64,146
AdjustmentListener.java,Java,,5,5,15,25
ComponentAdapter.java,Java,,7,2,15,24
ComponentEvent.java,Java,,45,14,49,108
ComponentListener.java,Java,,8,6,28,42
ContainerAdapter.java,Java,,5,2,15,22
ContainerEvent.java,Java,,36,13,47,96
ContainerListener.java,Java,,6,5,22,33
FocusAdapter.java,Java,,5,2,15,22
FocusEvent.java,Java,,35,14,58,107
FocusListener.java,Java,,6,5,19,30
InputEvent.java,Java,,43,22,75,140
ItemEvent.java,Java,,51,17,52,120
ItemListener.java,Java,,5,5,16,26
KeyAdapter.java,Java,,6,2,15,23
KeyEvent.java,Java,,314,43,107,464
KeyListener.java,Java,,7,6,22,35
MouseAdapter.java,Java,,8,2,15,25
MouseEvent.java,Java,,83,23,75,181
MouseListener.java,Java,,9,8,27,44
MouseMotionAdapter.java,Java,,5,2,15,22
MouseMotionListener.java,Java,,6,6,23,35
PaintEvent.java,Java,,36,13,49,98
TextEvent.java,Java,,23,13,33,69
TextListener.java,Java,,5,5,15,25
WindowAdapter.java,Java,,10,2,16,28
WindowEvent.java,Java,,50,17,59,126
WindowListener.java,Java,,11,9,34,54
Event.java,Java,,223,104,500,827
EventDispatchThread.java,Java,,57,9,25,91
EventQueue.java,Java,,176,32,90,298
EventQueueListener.java,Java,,6,3,14,23
FileDialog.java,Java,,88,22,145,255
FlowLayout.java,Java,,145,26,191,362
Font.java,Java,,118,38,186,342
FontMetrics.java,Java,,68,20,242,330
Frame.java,Java,,206,54,190,450
Graphics.java,Java,,140,54,900,1094
GridBagConstraints.java,Java,,54,32,241,327
GridBagLayout.java,Java,,558,121,571,1250
GridLayout.java,Java,,142,23,219,384
IllegalComponentStateException.java,Java,,10,4,26,40
AreaAveragingScaleFilter.java,Java,,151,11,61,223
ColorModel.java,Java,,37,14,57,108
CropImageFilter.java,Java,,77,8,48,133
DirectColorModel.java,Java,,126,17,86,229
FilteredImageSource.java,Java,,60,10,61,131
ImageConsumer.java,Java,,22,18,136,176
ImageFilter.java,Java,,52,13,97,162
ImageObserver.java,Java,,14,11,92,117
ImageProducer.java,Java,,8,6,69,83
IndexColorModel.java,Java,,120,21,138,279
MemoryImageSource.java,Java,,215,24,233,472
PixelGrabber.java,Java,,308,28,223,559
ReplicateScaleFilter.java,Java,,110,10,48,168
RGBImageFilter.java,Java,,101,11,114,226
Image.java,Java,,32,14,143,189
BorderLayout-1.gif,–¢‘Î‰ž,,,,,
Button-1.gif,–¢‘Î‰ž,,,,,
Checkbox-1.gif,–¢‘Î‰ž,,,,,
CheckboxGroup-1.gif,–¢‘Î‰ž,,,,,
Choice-1.gif,–¢‘Î‰ž,,,,,
FlowLayout-1.gif,–¢‘Î‰ž,,,,,
FontMetrics-1.gif,–¢‘Î‰ž,,,,,
GridBagLayout-1.gif,–¢‘Î‰ž,,,,,
GridLayout-1.gif,–¢‘Î‰ž,,,,,
Label-1.gif,–¢‘Î‰ž,,,,,
List-1.gif,–¢‘Î‰ž,,,,,
MenuBar-1.gif,–¢‘Î‰ž,,,,,
Scrollbar-1.gif,–¢‘Î‰ž,,,,,
Scrollbar-2.gif,–¢‘Î‰ž,,,,,
TextArea-1.gif,–¢‘Î‰ž,,,,,
TextField-1.gif,–¢‘Î‰ž,,,,,
Insets.java,Java,,32,11,69,112
ItemSelectable.java,Java,,7,8,27,42
Label.java,Java,,71,19,115,205
LayoutManager.java,Java,,8,5,42,55
LayoutManager2.java,Java,,8,7,55,70
List.java,Java,,368,79,479,926
MediaTracker.java,Java,,390,55,471,916
Menu.java,Java,,212,45,190,447
MenuBar.java,Java,,173,28,140,341
MenuComponent.java,Java,,106,22,112,240
MenuContainer.java,Java,,6,3,16,25
MenuItem.java,Java,,185,48,248,481
MenuShortcut.java,Java,,43,11,45,99
Panel.java,Java,,24,10,41,75
ActiveEvent.java,Java,,4,3,23,30
ButtonPeer.java,Java,,5,3,6,14
CanvasPeer.java,Java,,4,2,6,12
CheckboxMenuItemPeer.java,Java,,4,1,6,11
CheckboxPeer.java,Java,,7,2,6,15
ChoicePeer.java,Java,,8,3,9,20
ComponentPeer.java,Java,,39,12,27,78
ContainerPeer.java,Java,,8,3,9,20
DialogPeer.java,Java,,6,5,6,17
FileDialogPeer.java,Java,,8,3,6,17
FontPeer.java,Java,,3,2,6,11
FramePeer.java,Java,,8,5,6,19
LabelPeer.java,Java,,7,2,6,15
LightweightPeer.java,Java,,3,3,15,21
ListPeer.java,Java,,19,7,21,47
MenuBarPeer.java,Java,,7,2,6,15
MenuComponentPeer.java,Java,,4,1,6,11
MenuItemPeer.java,Java,,7,4,12,23
MenuPeer.java,Java,,7,2,6,15
PanelPeer.java,Java,,4,2,6,12
PopupMenuPeer.java,Java,,5,2,6,13
ScrollbarPeer.java,Java,,6,1,6,13
ScrollPanePeer.java,Java,,11,2,6,19
TextAreaPeer.java,Java,,12,6,18,36
TextComponentPeer.java,Java,,11,1,6,18
TextFieldPeer.java,Java,,10,5,15,30
WindowPeer.java,Java,,6,5,6,17
Point.java,Java,,46,14,121,181
Polygon.java,Java,,125,28,125,278
PopupMenu.java,Java,,51,11,41,103
PrintGraphics.java,Java,,4,4,16,24
PrintJob.java,Java,,11,9,43,63
Rectangle.java,Java,,151,41,360,552
Scrollbar.java,Java,,213,58,477,748
ScrollPane.java,Java,,343,77,227,647
Shape.java,Java,,4,3,23,30
SystemColor.java,Java,,101,62,203,366
VisualTest.html,HTML,,3,1,0,4
VisualTest.java,Java,,379,42,7,428
TextArea.java,Java,,167,41,252,460
TextComponent.java,Java,,206,48,225,479
TextField.java,Java,,167,46,247,460
Toolkit.java,Java,,201,89,511,801
Window.java,Java,,449,80,207,736
BeanDescriptor.java,Java,,23,9,32,64
BeanInfo.java,Java,,15,15,115,145
Beans.java,Java,,242,56,170,468
Customizer.java,Java,,6,8,34,48
EventSetDescriptor.java,Java,,127,36,134,297
FeatureDescriptor.java,Java,,91,21,88,200
IndexedPropertyDescriptor.java,Java,,109,19,91,219
IntrospectionException.java,Java,,7,4,17,28
Introspector.java,Java,,599,118,212,929
MethodDescriptor.java,Java,,30,13,32,75
ParameterDescriptor.java,Java,,3,4,14,21
PropertyChangeEvent.java,Java,,29,10,55,94
PropertyChangeListener.java,Java,,4,6,16,26
PropertyChangeSupport.java,Java,,71,27,33,131
PropertyDescriptor.java,Java,,123,22,113,258
PropertyEditor.java,Java,,15,25,138,178
PropertyEditorManager.java,Java,,96,20,63,179
PropertyEditorSupport.java,Java,,78,33,120,231
PropertyVetoException.java,Java,,12,8,14,34
SimpleBeanInfo.java,Java,,36,13,60,109
VetoableChangeListener.java,Java,,5,2,19,26
VetoableChangeSupport.java,Java,,86,21,41,148
Visibility.java,Java,,7,8,30,45
BufferedInputStream.java,Java,,90,18,209,317
BufferedOutputStream.java,Java,,41,9,78,128
BufferedReader.java,Java,,191,28,149,368
BufferedWriter.java,Java,,94,22,117,233
ByteArrayInputStream.java,Java,,57,14,128,199
ByteArrayOutputStream.java,Java,,54,18,110,182
CharArrayReader.java,Java,,85,16,91,192
CharArrayWriter.java,Java,,73,15,78,166
CharConversionException.java,Java,,10,1,21,32
DataInput.java,Java,,19,16,158,193
DataInputStream.java,Java,,176,26,407,609
DataOutput.java,Java,,18,15,119,152
DataOutputStream.java,Java,,123,21,183,327
EOFException.java,Java,,10,3,33,46
Externalizable.java,Java,,7,4,53,64
File.java,Java,,215,43,421,679
FileDescriptor.java,Java,,14,9,74,97
FileInputStream.java,Java,,54,16,145,215
FilenameFilter.java,Java,,5,2,30,37
FileNotFoundException.java,Java,,9,3,25,37
FileOutputStream.java,Java,,71,15,133,219
FileReader.java,Java,,12,8,19,39
FileWriter.java,Java,,15,9,19,43
FilterInputStream.java,Java,,35,12,193,240
FilterOutputStream.java,Java,,29,8,106,143
FilterReader.java,Java,,32,15,58,105
FilterWriter.java,Java,,23,12,52,87
InputStream.java,Java,,46,12,168,226
InputStreamReader.java,Java,,130,31,93,254
InterruptedIOException.java,Java,,11,4,35,50
InvalidClassException.java,Java,,17,5,34,56
InvalidObjectException.java,Java,,6,2,25,33
IOException.java,Java,,10,3,27,40
LineNumberInputStream.java,Java,,73,15,164,252
LineNumberReader.java,Java,,95,22,93,210
NotActiveException.java,Java,,9,3,22,34
NotSerializableException.java,Java,,9,3,19,31
ObjectInput.java,Java,,11,8,76,95
ObjectInputStream.java,Java,,800,148,774,1722
ObjectInputValidation.java,Java,,4,2,22,28
ObjectOutput.java,Java,,10,7,61,78
ObjectOutputStream.java,Java,,603,129,603,1335
ObjectStreamClass.java,Java,,426,111,314,851
ObjectStreamConstants.java,Java,,23,6,15,44
ObjectStreamException.java,Java,,9,3,21,33
ObjectStreamField.java,Java,,42,11,35,88
OptionalDataException.java,Java,,13,4,35,52
OutputStream.java,Java,,16,6,81,103
OutputStreamWriter.java,Java,,113,23,103,239
PipedInputStream.java,Java,,125,20,134,279
PipedOutputStream.java,Java,,40,11,77,128
PipedReader.java,Java,,54,14,42,110
PipedWriter.java,Java,,50,16,42,108
PrintStream.java,Java,,233,46,233,512
PrintWriter.java,Java,,212,47,112,371
PushbackInputStream.java,Java,,65,13,137,215
PushbackReader.java,Java,,83,19,95,197
RandomAccessFile.java,Java,,220,53,581,854
Reader.java,Java,,51,19,138,208
SequenceInputStream.java,Java,,69,11,95,175
Serializable.java,Java,,3,2,74,79
StreamCorruptedException.java,Java,,9,3,22,34
StreamTokenizer.java,Java,,345,40,356,741
StringBufferInputStream.java,Java,,47,11,101,159
StringReader.java,Java,,65,16,69,150
StringWriter.java,Java,,34,16,55,105
SyncFailedException.java,Java,,6,2,21,29
UnsupportedEncodingException.java,Java,,11,1,22,34
UTFDataFormatException.java,Java,,10,3,32,45
WriteAbortedException.java,Java,,14,4,28,46
Writer.java,Java,,33,15,100,148
AbstractMethodError.java,Java,,10,3,29,42
ArithmeticException.java,Java,,10,3,28,41
ArrayIndexOutOfBoundsException.java,Java,,13,4,35,52
ArrayStoreException.java,Java,,10,4,31,45
Boolean.java,Java,,42,15,116,173
Byte.java,Java,,76,24,152,252
Character.java,Java,,637,49,796,1482
Class.java,Java,,146,40,524,710
ClassCastException.java,Java,,10,3,31,44
ClassCircularityError.java,Java,,9,3,25,37
ClassFormatError.java,Java,,10,3,27,40
ClassLoader.java,Java,,110,24,281,415
ClassNotFoundException.java,Java,,10,3,37,50
Cloneable.java,Java,,3,3,21,27
CloneNotSupportedException.java,Java,,10,4,35,49
Compiler.java,Java,,24,9,71,104
Double.java,Java,,70,29,287,386
Error.java,Java,,10,3,35,48
Exception.java,Java,,10,3,27,40
ExceptionInInitializerError.java,Java,,17,6,38,61
Float.java,Java,,70,29,281,380
FloatingDecimal.java,Java,,934,57,369,1360
IllegalAccessError.java,Java,,9,3,30,42
IllegalAccessException.java,Java,,10,3,46,59
IllegalArgumentException.java,Java,,10,3,28,41
IllegalMonitorStateException.java,Java,,10,3,33,46
IllegalStateException.java,Java,,10,3,30,43
IllegalThreadStateException.java,Java,,9,3,31,43
IncompatibleClassChangeError.java,Java,,10,3,28,41
IndexOutOfBoundsException.java,Java,,10,3,29,42
InstantiationError.java,Java,,10,5,30,45
InstantiationException.java,Java,,10,3,29,42
Integer.java,Java,,255,51,372,678
InternalError.java,Java,,10,3,26,39
InterruptedException.java,Java,,10,3,33,46
LinkageError.java,Java,,10,3,28,41
Long.java,Java,,196,38,340,574
Math.java,Java,,92,41,382,515
NegativeArraySizeException.java,Java,,10,3,26,39
NoClassDefFoundError.java,Java,,10,3,32,45
NoSuchFieldError.java,Java,,10,3,30,43
NoSuchFieldException.java,Java,,9,3,23,35
NoSuchMethodError.java,Java,,10,3,31,44
NoSuchMethodException.java,Java,,10,3,24,37
NullPointerException.java,Java,,10,3,38,51
Number.java,Java,,14,8,76,98
NumberFormatException.java,Java,,10,3,28,41
Object.java,Java,,32,15,273,320
OutOfMemoryError.java,Java,,10,3,27,40
Process.java,Java,,11,8,71,90
Array.java,Java,,56,29,370,455
Constructor.java,Java,,75,13,140,228
Field.java,Java,,93,31,304,428
InvocationTargetException.java,Java,,19,8,27,54
Member.java,Java,,9,8,42,59
Method.java,Java,,91,15,165,271
Modifier.java,Java,,66,20,74,160
Runnable.java,Java,,5,2,42,49
Runtime.java,Java,,139,34,310,483
RuntimeException.java,Java,,10,3,32,45
SecurityException.java,Java,,9,2,26,37
SecurityManager.java,Java,,158,47,626,831
Short.java,Java,,76,23,150,249
StackOverflowError.java,Java,,10,3,26,39
String.java,Java,,625,95,804,1524
StringBuffer.java,Java,,220,45,533,798
StringIndexOutOfBoundsException.java,Java,,13,4,37,54
System.java,Java,,114,34,441,589
Thread.java,Java,,229,68,670,967
ThreadDeath.java,Java,,2,3,30,35
ThreadGroup.java,Java,,413,42,374,829
Throwable.java,Java,,38,15,117,170
UnknownError.java,Java,,10,3,26,39
UnsatisfiedLinkError.java,Java,,10,3,27,40
VerifyError.java,Java,,10,3,26,39
VirtualMachineError.java,Java,,10,3,27,40
Void.java,Java,,6,4,23,33
BigDecimal.java,Java,,267,75,312,654
BigInteger.java,Java,,743,202,512,1457
BindException.java,Java,,7,5,25,37
ConnectException.java,Java,,7,3,26,36
ContentHandler.java,Java,,5,3,43,51
ContentHandlerFactory.java,Java,,4,2,32,38
DatagramPacket.java,Java,,60,12,90,162
DatagramSocket.java,Java,,117,27,138,282
DatagramSocketImpl.java,Java,,24,18,70,112
FileNameMap.java,Java,,4,2,17,23
HttpURLConnection.java,Java,,98,27,111,236
InetAddress.java,Java,,252,51,224,527
MalformedURLException.java,Java,,9,4,27,40
MulticastSocket.java,Java,,71,17,135,223
NoRouteToHostException.java,Java,,7,3,26,36
PlainDatagramSocketImpl.java,Java,,76,25,67,168
PlainSocketImpl.java,Java,,245,68,117,430
ProtocolException.java,Java,,10,4,26,40
ServerSocket.java,Java,,104,22,169,295
Socket.java,Java,,142,32,249,423
SocketException.java,Java,,10,4,26,40
SocketImpl.java,Java,,43,22,157,222
SocketImplFactory.java,Java,,5,2,25,32
SocketInputStream.java,Java,,62,14,67,143
SocketOptions.java,Java,,12,27,177,216
SocketOutputStream.java,Java,,28,10,52,90
UnknownHostException.java,Java,,10,4,26,40
UnknownServiceException.java,Java,,9,4,29,42
URL.java,Java,,218,47,438,703
URLConnection.java,Java,,293,72,731,1096
URLEncoder.java,Java,,67,9,42,118
URLStreamHandler.java,Java,,98,9,123,230
URLStreamHandlerFactory.java,Java,,4,2,29,35
AccessException.java,Java,,11,5,12,28
AlreadyBoundException.java,Java,,11,4,6,21
ConnectException.java,Java,,10,5,13,28
ConnectIOException.java,Java,,10,5,13,28
DGC.java,Java,,9,4,72,85
Lease.java,Java,,19,6,21,46
VMID.java,Java,,73,13,45,131
MarshalException.java,Java,,10,5,13,28
Naming.java,Java,,104,24,58,186
NoSuchObjectException.java,Java,,8,4,9,21
NotBoundException.java,Java,,11,4,6,21
LocateRegistry.java,Java,,57,13,60,130
Registry.java,Java,,15,8,53,76
RegistryHandler.java,Java,,9,6,18,33
Remote.java,Java,,2,3,23,28
RemoteException.java,Java,,21,8,20,49
RMISecurityException.java,Java,,16,4,18,38
RMISecurityManager.java,Java,,236,45,154,435
ExportException.java,Java,,10,6,13,29
LoaderHandler.java,Java,,12,7,29,48
LogStream.java,Java,,107,25,67,199
ObjID.java,Java,,57,14,50,121
Operation.java,Java,,13,5,15,33
RemoteCall.java,Java,,16,10,55,81
RemoteObject.java,Java,,60,15,52,127
RemoteRef.java,Java,,14,12,65,91
RemoteServer.java,Java,,48,8,34,90
RemoteStub.java,Java,,14,5,19,38
RMIClassLoader.java,Java,,34,8,47,89
RMIFailureHandler.java,Java,,4,5,33,42
RMISocketFactory.java,Java,,35,13,48,96
ServerCloneException.java,Java,,20,7,17,44
ServerNotActiveException.java,Java,,9,5,9,23
ServerRef.java,Java,,7,5,23,35
Skeleton.java,Java,,7,3,17,27
SkeletonMismatchException.java,Java,,8,6,16,30
SkeletonNotFoundException.java,Java,,11,6,12,29
SocketSecurityException.java,Java,,10,6,13,29
UID.java,Java,,85,15,39,139
UnicastRemoteObject.java,Java,,43,7,43,93
Unreferenced.java,Java,,4,2,13,19
ServerError.java,Java,,7,4,10,21
ServerException.java,Java,,10,5,13,28
ServerRuntimeException.java,Java,,7,4,10,21
StubNotFoundException.java,Java,,10,5,12,27
UnexpectedException.java,Java,,10,5,13,28
UnknownHostException.java,Java,,10,5,13,28
UnmarshalException.java,Java,,10,5,13,28
Acl.java,Java,,16,28,192,236
AclEntry.java,Java,,15,15,104,134
AclNotFoundException.java,Java,,5,4,15,24
Group.java,Java,,9,9,51,69
LastOwnerException.java,Java,,5,3,17,25
NotOwnerException.java,Java,,5,3,16,24
Owner.java,Java,,9,7,61,77
Permission.java,Java,,5,6,25,36
Certificate.java,Java,,14,12,106,132
DigestException.java,Java,,9,4,24,37
DigestInputStream.java,Java,,41,18,113,172
DigestOutputStream.java,Java,,39,17,99,155
Identity.java,Java,,173,38,183,394
IdentityScope.java,Java,,56,23,130,209
DSAKey.java,Java,,4,3,26,33
DSAKeyPairGenerator.java,Java,,8,5,79,92
DSAParams.java,Java,,7,6,34,47
DSAPrivateKey.java,Java,,5,6,24,35
DSAPublicKey.java,Java,,5,6,22,33
InvalidKeyException.java,Java,,9,6,25,40
InvalidParameterException.java,Java,,9,5,25,39
Key.java,Java,,6,6,81,93
KeyException.java,Java,,9,5,27,41
KeyManagementException.java,Java,,9,5,35,49
KeyPair.java,Java,,17,6,34,57
KeyPairGenerator.java,Java,,33,11,137,181
MessageDigest.java,Java,,114,35,232,381
NoSuchAlgorithmException.java,Java,,9,5,26,40
NoSuchProviderException.java,Java,,9,5,25,39
Principal.java,Java,,7,6,46,59
PrivateKey.java,Java,,3,4,25,32
Provider.java,Java,,46,20,70,136
ProviderException.java,Java,,9,5,24,38
PublicKey.java,Java,,4,3,24,31
SecureRandom.java,Java,,111,33,145,289
Security.java,Java,,256,80,199,535
SeedGenerator.java,Java,,185,43,85,313
Signature.java,Java,,129,44,408,581
SignatureException.java,Java,,9,6,24,39
Signer.java,Java,,43,15,59,117
CallableStatement.java,Java,,25,24,194,243
Connection.java,Java,,28,27,244,299
DatabaseMetaData.java,Java,,205,184,1621,2010
DataTruncation.java,Java,,38,11,56,105
Date.java,Java,,82,23,43,148
Driver.java,Java,,11,12,99,122
DriverManager.java,Java,,210,46,153,409
DriverPropertyInfo.java,Java,,12,9,39,60
PreparedStatement.java,Java,,35,29,268,332
ResultSet.java,Java,,48,53,468,569
ResultSetMetaData.java,Java,,26,26,159,211
SQLException.java,Java,,65,12,66,143
SQLWarning.java,Java,,32,11,53,96
Statement.java,Java,,21,22,214,257
Time.java,Java,,91,18,43,152
Timestamp.java,Java,,199,26,84,309
Types.java,Java,,25,11,17,53
BreakIterator.java,Java,,70,24,303,397
CharacterBreakData.java,Java,,168,22,78,268
CharacterIterator.java,Java,,15,16,142,173
ChoiceFormat.java,Java,,187,26,232,445
CollationElementIterator.java,Java,,173,12,156,341
CollationKey.java,Java,,42,15,126,183
CollationRules.java,Java,,193,10,50,253
Collator.java,Java,,113,27,322,462
CompactByteArray.java,Java,,267,13,125,405
CompactCharArray.java,Java,,269,26,125,420
CompactIntArray.java,Java,,266,27,125,418
CompactShortArray.java,Java,,268,13,124,405
CompactStringArray.java,Java,,306,12,132,450
DateFormat.java,Java,,180,39,402,621
DateFormatSymbols.java,Java,,182,37,231,450
DecimalFormat.java,Java,,868,147,633,1648
DecimalFormatSymbols.java,Java,,197,47,145,389
DecompositionIterator.java,Java,,1288,41,216,1545
DigitList.java,Java,,237,56,243,536
EntryPair.java,Java,,12,4,34,50
FieldPosition.java,Java,,24,12,92,128
Format.java,Java,,27,6,181,214
LineBreakData.java,Java,,295,15,106,416
MergeCollation.java,Java,,198,19,100,317
MessageFormat.java,Java,,469,44,334,847
NumberFormat.java,Java,,177,46,340,563
ParseException.java,Java,,12,5,49,66
ParsePosition.java,Java,,13,9,61,83
PatternEntry.java,Java,,202,18,61,281
DateFormatZoneData.java,Java,,33,6,56,95
DateFormatZoneData_ar.java,Java,,16,6,60,82
DateFormatZoneData_be.java,Java,,16,6,60,82
DateFormatZoneData_bg.java,Java,,16,6,60,82
DateFormatZoneData_ca.java,Java,,16,6,60,82
DateFormatZoneData_cs.java,Java,,16,6,60,82
DateFormatZoneData_da.java,Java,,16,6,60,82
DateFormatZoneData_de.java,Java,,16,6,60,82
DateFormatZoneData_de_AT.java,Java,,16,6,60,82
DateFormatZoneData_de_CH.java,Java,,16,6,60,82
DateFormatZoneData_el.java,Java,,16,6,60,82
DateFormatZoneData_en.java,Java,,73,6,190,269
DateFormatZoneData_en_CA.java,Java,,53,7,64,124
DateFormatZoneData_en_GB.java,Java,,17,6,61,84
DateFormatZoneData_en_IE.java,Java,,17,6,61,84
DateFormatZoneData_es.java,Java,,16,6,60,82
DateFormatZoneData_et.java,Java,,16,6,60,82
DateFormatZoneData_fi.java,Java,,16,6,60,82
DateFormatZoneData_fr.java,Java,,16,6,60,82
DateFormatZoneData_fr_BE.java,Java,,16,6,60,82
DateFormatZoneData_fr_CA.java,Java,,16,6,60,82
DateFormatZoneData_fr_CH.java,Java,,16,6,60,82
DateFormatZoneData_hr.java,Java,,16,6,60,82
DateFormatZoneData_hu.java,Java,,16,6,60,82
DateFormatZoneData_is.java,Java,,16,6,60,82
DateFormatZoneData_it.java,Java,,16,6,60,82
DateFormatZoneData_it_CH.java,Java,,16,6,60,82
DateFormatZoneData_iw.java,Java,,16,6,60,82
DateFormatZoneData_ja.java,Java,,19,6,60,85
DateFormatZoneData_ko.java,Java,,16,6,60,82
DateFormatZoneData_lt.java,Java,,16,6,60,82
DateFormatZoneData_lv.java,Java,,16,6,60,82
DateFormatZoneData_mk.java,Java,,16,6,60,82
DateFormatZoneData_nl.java,Java,,16,6,60,82
DateFormatZoneData_nl_BE.java,Java,,16,6,60,82
DateFormatZoneData_no.java,Java,,16,6,60,82
DateFormatZoneData_no_NO_NY.java,Java,,16,6,60,82
DateFormatZoneData_pl.java,Java,,16,6,60,82
DateFormatZoneData_pt.java,Java,,16,6,60,82
DateFormatZoneData_ro.java,Java,,16,6,60,82
DateFormatZoneData_ru.java,Java,,16,6,60,82
DateFormatZoneData_sh.java,Java,,16,6,60,82
DateFormatZoneData_sk.java,Java,,16,6,60,82
DateFormatZoneData_sl.java,Java,,16,6,60,82
DateFormatZoneData_sq.java,Java,,16,6,60,82
DateFormatZoneData_sr.java,Java,,16,6,60,82
DateFormatZoneData_sv.java,Java,,16,6,60,82
DateFormatZoneData_th.java,Java,,17,6,52,75
DateFormatZoneData_tr.java,Java,,16,6,60,82
DateFormatZoneData_uk.java,Java,,16,6,60,82
DateFormatZoneData_zh.java,Java,,16,6,60,82
DateFormatZoneData_zh_TW.java,Java,,16,6,60,82
LocaleData.java,Java,,100,6,42,148
LocaleElements.java,Java,,479,5,50,534
LocaleElements_ar.java,Java,,309,5,49,363
LocaleElements_be.java,Java,,223,5,45,273
LocaleElements_bg.java,Java,,223,5,46,274
LocaleElements_ca.java,Java,,121,5,45,171
LocaleElements_cs.java,Java,,140,5,50,195
LocaleElements_da.java,Java,,137,5,45,187
LocaleElements_de.java,Java,,161,5,45,211
LocaleElements_de_AT.java,Java,,78,5,45,128
LocaleElements_de_AT_EURO.java,Java,,15,5,12,32
LocaleElements_de_CH.java,Java,,40,5,45,90
LocaleElements_de_DE_EURO.java,Java,,15,5,12,32
LocaleElements_de_LU.java,Java,,17,5,13,35
LocaleElements_de_LU_EURO.java,Java,,15,5,12,32
LocaleElements_el.java,Java,,197,5,47,249
LocaleElements_en.java,Java,,21,5,45,71
LocaleElements_en_AU.java,Java,,53,5,45,103
LocaleElements_en_CA.java,Java,,53,5,45,103
LocaleElements_en_GB.java,Java,,59,5,45,109
LocaleElements_en_IE.java,Java,,59,5,45,109
LocaleElements_en_IE_EURO.java,Java,,15,5,12,32
LocaleElements_en_NZ.java,Java,,53,5,45,103
LocaleElements_en_ZA.java,Java,,52,5,45,102
LocaleElements_es.java,Java,,145,5,45,195
LocaleElements_es_AR.java,Java,,38,5,45,88
LocaleElements_es_BO.java,Java,,53,5,45,103
LocaleElements_es_CL.java,Java,,38,5,45,88
LocaleElements_es_CO.java,Java,,53,5,45,103
LocaleElements_es_CR.java,Java,,53,5,45,103
LocaleElements_es_DO.java,Java,,53,5,45,103
LocaleElements_es_EC.java,Java,,53,5,45,103
LocaleElements_es_ES_EURO.java,Java,,15,5,12,32
LocaleElements_es_GT.java,Java,,53,5,45,103
LocaleElements_es_HN.java,Java,,53,5,45,103
LocaleElements_es_MX.java,Java,,53,5,45,103
LocaleElements_es_NI.java,Java,,53,5,45,103
LocaleElements_es_PA.java,Java,,53,5,45,103
LocaleElements_es_PE.java,Java,,38,5,45,88
LocaleElements_es_PR.java,Java,,53,5,45,103
LocaleElements_es_PY.java,Java,,38,5,45,88
LocaleElements_es_SV.java,Java,,53,5,45,103
LocaleElements_es_UY.java,Java,,38,5,45,88
LocaleElements_es_VE.java,Java,,38,5,45,88
LocaleElements_et.java,Java,,136,5,46,187
LocaleElements_fi.java,Java,,134,5,45,184
LocaleElements_fi_FI_EURO.java,Java,,15,5,12,32
LocaleElements_fr.java,Java,,163,5,45,213
LocaleElements_fr_BE.java,Java,,53,5,45,103
LocaleElements_fr_BE_EURO.java,Java,,15,5,12,32
LocaleElements_fr_CA.java,Java,,44,5,45,94
LocaleElements_fr_CH.java,Java,,59,5,45,109
LocaleElements_fr_FR_EURO.java,Java,,15,5,12,32
LocaleElements_fr_LU.java,Java,,17,5,13,35
LocaleElements_fr_LU_EURO.java,Java,,15,5,12,32
LocaleElements_hr.java,Java,,134,6,52,192
LocaleElements_hu.java,Java,,144,5,54,203
LocaleElements_is.java,Java,,132,6,52,190
LocaleElements_it.java,Java,,133,5,45,183
LocaleElements_it_CH.java,Java,,53,5,45,103
LocaleElements_it_IT_EURO.java,Java,,15,5,12,32
LocaleElements_iw.java,Java,,186,5,49,240
LocaleElements_ja.java,Java,,1399,49,61,1509
LocaleElements_ko.java,Java,,1290,5,47,1342
LocaleElements_lt.java,Java,,135,5,46,186
LocaleElements_lv.java,Java,,137,6,46,189
LocaleElements_mk.java,Java,,223,6,46,275
LocaleElements_nl.java,Java,,127,5,45,177
LocaleElements_nl_BE.java,Java,,44,5,45,94
LocaleElements_nl_BE_EURO.java,Java,,15,5,12,32
LocaleElements_nl_NL_EURO.java,Java,,15,5,12,32
LocaleElements_no.java,Java,,135,5,45,185
LocaleElements_no_NO_NY.java,Java,,37,5,45,87
LocaleElements_pl.java,Java,,138,5,49,192
LocaleElements_pt.java,Java,,127,5,45,177
LocaleElements_pt_BR.java,Java,,38,5,45,88
LocaleElements_pt_PT_EURO.java,Java,,15,5,12,32
LocaleElements_ro.java,Java,,134,5,45,184
LocaleElements_ru.java,Java,,229,5,46,280
LocaleElements_sh.java,Java,,132,7,52,191
LocaleElements_sk.java,Java,,139,6,50,195
LocaleElements_sl.java,Java,,140,6,50,196
LocaleElements_sq.java,Java,,133,5,45,183
LocaleElements_sr.java,Java,,223,5,46,274
LocaleElements_sv.java,Java,,135,5,45,185
LocaleElements_th.java,Java,,117,5,45,167
LocaleElements_tr.java,Java,,136,5,45,186
LocaleElements_uk.java,Java,,223,5,46,274
LocaleElements_zh.java,Java,,1187,5,47,1239
LocaleElements_zh_TW.java,Java,,2006,5,47,2058
RuleBasedCollator.java,Java,,572,64,564,1200
SentenceBreakData.java,Java,,234,38,103,375
SimpleDateFormat.java,Java,,747,85,456,1288
SimpleTextBoundary.java,Java,,170,28,108,306
SpecialMapping.java,Java,,17,5,54,76
StringCharacterIterator.java,Java,,116,25,155,296
TextBoundaryData.java,Java,,237,5,37,279
UnicodeClassMapping.java,Java,,43,7,51,101
Utility.java,Java,,273,29,151,453
WordBreakData.java,Java,,294,39,104,437
WordBreakTable.java,Java,,31,8,62,101
BitSet.java,Java,,217,20,90,327
Calendar.java,Java,,338,84,817,1239
Date.java,Java,,362,42,518,922
Dictionary.java,Java,,11,8,93,112
EmptyStackException.java,Java,,6,2,20,28
Enumeration.java,Java,,5,3,50,58
EventListener.java,Java,,3,2,9,14
EventObject.java,Java,,15,6,6,27
GregorianCalendar.java,Java,,734,160,699,1593
Hashtable.java,Java,,250,47,240,537
ListResourceBundle.java,Java,,54,11,128,193
Locale.java,Java,,398,102,473,973
MissingResourceException.java,Java,,17,7,56,80
NoSuchElementException.java,Java,,10,3,29,42
Observable.java,Java,,53,15,119,187
Observer.java,Java,,4,1,26,31
Properties.java,Java,,219,28,128,375
PropertyResourceBundle.java,Java,,46,10,89,145
Random.java,Java,,67,17,108,192
ResourceBundle.java,Java,,168,38,339,545
SimpleTimeZone.java,Java,,409,57,423,889
Stack.java,Java,,32,12,54,98
StringTokenizer.java,Java,,85,19,152,256
TimeZone.java,Java,,281,42,1013,1336
TooManyListenersException.java,Java,,9,8,36,53
Vector.java,Java,,219,38,293,550
Adler32.java,Java,,22,9,33,64
CheckedInputStream.java,Java,,42,8,43,93
CheckedOutputStream.java,Java,,23,7,36,66
Checksum.java,Java,,8,5,24,37
CRC32.java,Java,,22,9,31,62
DataFormatException.java,Java,,10,3,20,33
Deflater.java,Java,,95,32,164,291
DeflaterOutputStream.java,Java,,55,12,65,132
GZIPInputStream.java,Java,,107,16,80,203
GZIPOutputStream.java,Java,,55,13,61,129
Inflater.java,Java,,62,22,134,218
InflaterInputStream.java,Java,,66,12,67,145
ZipConstants.java,Java,,43,7,31,81
ZipEntry.java,Java,,111,25,103,239
ZipException.java,Java,,11,4,6,21
ZipFile.java,Java,,244,25,133,402
ZipInputStream.java,Java,,174,15,71,260
ZipOutputStream.java,Java,,279,22,116,417
TTY.java,Java,,1427,135,66,1628
Serializable.java,Java,,3,3,30,36
EventListener.java,Java,,3,3,30,36
EventObject.java,Java,,6,5,30,41
