/jdk1.6.0_45/com/sun/corba/se/impl/activation/CommandHandler.java,Java,,13,8,11,32
/jdk1.6.0_45/com/sun/corba/se/impl/activation/NameServiceStartThread.java,Java,,29,7,9,45
/jdk1.6.0_45/com/sun/corba/se/impl/activation/ORBD.java,Java,,244,50,56,350
/jdk1.6.0_45/com/sun/corba/se/impl/activation/ProcessMonitorThread.java,Java,,55,12,21,88
/jdk1.6.0_45/com/sun/corba/se/impl/activation/RepositoryImpl.java,Java,,348,78,46,472
/jdk1.6.0_45/com/sun/corba/se/impl/activation/ServerMain.java,Java,,247,71,60,378
/jdk1.6.0_45/com/sun/corba/se/impl/activation/ServerManagerImpl.java,Java,,467,109,52,628
/jdk1.6.0_45/com/sun/corba/se/impl/activation/ServerTableEntry.java,Java,,380,91,55,526
/jdk1.6.0_45/com/sun/corba/se/impl/activation/ServerTool.java,Java,,729,166,61,956
/jdk1.6.0_45/com/sun/corba/se/impl/copyobject/CopierManagerImpl.java,Java,,38,12,6,56
/jdk1.6.0_45/com/sun/corba/se/impl/copyobject/FallbackObjectCopierImpl.java,Java,,22,5,10,37
/jdk1.6.0_45/com/sun/corba/se/impl/copyobject/JavaStreamObjectCopierImpl.java,Java,,39,13,8,60
/jdk1.6.0_45/com/sun/corba/se/impl/copyobject/ORBStreamObjectCopierImpl.java,Java,,27,10,8,45
/jdk1.6.0_45/com/sun/corba/se/impl/copyobject/ReferenceObjectCopierImpl.java,Java,,9,4,6,19
/jdk1.6.0_45/com/sun/corba/se/impl/corba/AnyImpl.java,Java,,817,136,366,1319
/jdk1.6.0_45/com/sun/corba/se/impl/corba/AnyImplHelper.java,Java,,37,9,17,63
/jdk1.6.0_45/com/sun/corba/se/impl/corba/AsynchInvoke.java,Java,,25,15,36,76
/jdk1.6.0_45/com/sun/corba/se/impl/corba/ContextImpl.java,Java,,53,16,14,83
/jdk1.6.0_45/com/sun/corba/se/impl/corba/ContextListImpl.java,Java,,43,10,15,68
/jdk1.6.0_45/com/sun/corba/se/impl/corba/CORBAObjectImpl.java,Java,,8,2,17,27
/jdk1.6.0_45/com/sun/corba/se/impl/corba/EnvironmentImpl.java,Java,,22,9,14,45
/jdk1.6.0_45/com/sun/corba/se/impl/corba/ExceptionListImpl.java,Java,,40,14,14,68
/jdk1.6.0_45/com/sun/corba/se/impl/corba/NamedValueImpl.java,Java,,38,9,16,63
/jdk1.6.0_45/com/sun/corba/se/impl/corba/NVListImpl.java,Java,,65,16,16,97
/jdk1.6.0_45/com/sun/corba/se/impl/corba/PrincipalImpl.java,Java,,13,5,14,32
/jdk1.6.0_45/com/sun/corba/se/impl/corba/RequestImpl.java,Java,,249,49,60,358
/jdk1.6.0_45/com/sun/corba/se/impl/corba/ServerRequestImpl.java,Java,,139,41,61,241
/jdk1.6.0_45/com/sun/corba/se/impl/corba/TCUtility.java,Java,,233,55,25,313
/jdk1.6.0_45/com/sun/corba/se/impl/corba/TypeCodeFactory.java,Java,,7,5,6,18
/jdk1.6.0_45/com/sun/corba/se/impl/corba/TypeCodeImpl.java,Java,,1745,288,364,2397
/jdk1.6.0_45/com/sun/corba/se/impl/corba/TypeCodeImplHelper.java,Java,,41,10,14,65
/jdk1.6.0_45/com/sun/corba/se/impl/dynamicany/DynAnyBasicImpl.java,Java,,535,58,25,618
/jdk1.6.0_45/com/sun/corba/se/impl/dynamicany/DynAnyCollectionImpl.java,Java,,117,25,45,187
/jdk1.6.0_45/com/sun/corba/se/impl/dynamicany/DynAnyComplexImpl.java,Java,,278,40,85,403
/jdk1.6.0_45/com/sun/corba/se/impl/dynamicany/DynAnyConstructedImpl.java,Java,,790,72,57,919
/jdk1.6.0_45/com/sun/corba/se/impl/dynamicany/DynAnyFactoryImpl.java,Java,,36,15,16,67
/jdk1.6.0_45/com/sun/corba/se/impl/dynamicany/DynAnyImpl.java,Java,,118,27,35,180
/jdk1.6.0_45/com/sun/corba/se/impl/dynamicany/DynAnyUtil.java,Java,,214,17,89,320
/jdk1.6.0_45/com/sun/corba/se/impl/dynamicany/DynArrayImpl.java,Java,,65,18,37,120
/jdk1.6.0_45/com/sun/corba/se/impl/dynamicany/DynEnumImpl.java,Java,,110,21,41,172
/jdk1.6.0_45/com/sun/corba/se/impl/dynamicany/DynFixedImpl.java,Java,,122,11,59,192
/jdk1.6.0_45/com/sun/corba/se/impl/dynamicany/DynSequenceImpl.java,Java,,129,25,85,239
/jdk1.6.0_45/com/sun/corba/se/impl/dynamicany/DynStructImpl.java,Java,,40,10,19,69
/jdk1.6.0_45/com/sun/corba/se/impl/dynamicany/DynUnionImpl.java,Java,,249,32,86,367
/jdk1.6.0_45/com/sun/corba/se/impl/dynamicany/DynValueBoxImpl.java,Java,,88,15,12,115
/jdk1.6.0_45/com/sun/corba/se/impl/dynamicany/DynValueCommonImpl.java,Java,,79,18,32,129
/jdk1.6.0_45/com/sun/corba/se/impl/dynamicany/DynValueImpl.java,Java,,25,7,9,41
/jdk1.6.0_45/com/sun/corba/se/impl/encoding/BufferManagerFactory.java,Java,,92,14,19,125
/jdk1.6.0_45/com/sun/corba/se/impl/encoding/BufferManagerRead.java,Java,,15,13,49,77
/jdk1.6.0_45/com/sun/corba/se/impl/encoding/BufferManagerReadGrow.java,Java,,48,18,15,81
/jdk1.6.0_45/com/sun/corba/se/impl/encoding/BufferManagerReadStream.java,Java,,237,50,52,339
/jdk1.6.0_45/com/sun/corba/se/impl/encoding/BufferManagerWrite.java,Java,,29,20,84,133
/jdk1.6.0_45/com/sun/corba/se/impl/encoding/BufferManagerWriteCollect.java,Java,,128,39,46,213
/jdk1.6.0_45/com/sun/corba/se/impl/encoding/BufferManagerWriteGrow.java,Java,,38,17,19,74
/jdk1.6.0_45/com/sun/corba/se/impl/encoding/BufferManagerWriteStream.java,Java,,61,25,30,116
/jdk1.6.0_45/com/sun/corba/se/impl/encoding/BufferQueue.java,Java,,24,6,12,42
/jdk1.6.0_45/com/sun/corba/se/impl/encoding/ByteBufferWithInfo.java,Java,,153,36,50,239
/jdk1.6.0_45/com/sun/corba/se/impl/encoding/CachedCodeBase.java,Java,,109,41,43,193
/jdk1.6.0_45/com/sun/corba/se/impl/encoding/CDRInputObject.java,Java,,136,46,67,249
/jdk1.6.0_45/com/sun/corba/se/impl/encoding/CDRInputStream.java,Java,,349,109,66,524
/jdk1.6.0_45/com/sun/corba/se/impl/encoding/CDRInputStreamBase.java,Java,,111,31,41,183
/jdk1.6.0_45/com/sun/corba/se/impl/encoding/CDRInputStream_1_0.java,Java,,1487,445,500,2432
/jdk1.6.0_45/com/sun/corba/se/impl/encoding/CDRInputStream_1_1.java,Java,,75,45,51,171
/jdk1.6.0_45/com/sun/corba/se/impl/encoding/CDRInputStream_1_2.java,Java,,56,25,45,126
/jdk1.6.0_45/com/sun/corba/se/impl/encoding/CDROutputObject.java,Java,,195,42,68,305
/jdk1.6.0_45/com/sun/corba/se/impl/encoding/CDROutputStream.java,Java,,312,67,39,418
/jdk1.6.0_45/com/sun/corba/se/impl/encoding/CDROutputStreamBase.java,Java,,101,31,27,159
/jdk1.6.0_45/com/sun/corba/se/impl/encoding/CDROutputStream_1_0.java,Java,,1240,377,296,1913
/jdk1.6.0_45/com/sun/corba/se/impl/encoding/CDROutputStream_1_1.java,Java,,54,30,48,132
/jdk1.6.0_45/com/sun/corba/se/impl/encoding/CDROutputStream_1_2.java,Java,,138,69,134,341
/jdk1.6.0_45/com/sun/corba/se/impl/encoding/CodeSetCache.java,Java,,33,15,43,91
/jdk1.6.0_45/com/sun/corba/se/impl/encoding/CodeSetComponentInfo.java,Java,,197,60,68,325
/jdk1.6.0_45/com/sun/corba/se/impl/encoding/CodeSetConversion.java,Java,,314,113,262,689
/jdk1.6.0_45/com/sun/corba/se/impl/encoding/EncapsInputStream.java,Java,,92,26,49,167
/jdk1.6.0_45/com/sun/corba/se/impl/encoding/EncapsOutputStream.java,Java,,59,20,46,125
/jdk1.6.0_45/com/sun/corba/se/impl/encoding/IDLJavaSerializationInputStream.java,Java,,748,161,156,1065
/jdk1.6.0_45/com/sun/corba/se/impl/encoding/IDLJavaSerializationOutputStream.java,Java,,557,129,94,780
/jdk1.6.0_45/com/sun/corba/se/impl/encoding/MarkAndResetHandler.java,Java,,7,4,10,21
/jdk1.6.0_45/com/sun/corba/se/impl/encoding/MarshalInputStream.java,Java,,44,10,30,84
/jdk1.6.0_45/com/sun/corba/se/impl/encoding/MarshalOutputStream.java,Java,,46,13,12,71
/jdk1.6.0_45/com/sun/corba/se/impl/encoding/OSFCodeSetRegistry.java,Java,,104,21,87,212
/jdk1.6.0_45/com/sun/corba/se/impl/encoding/RestorableInputStream.java,Java,,6,2,11,19
/jdk1.6.0_45/com/sun/corba/se/impl/encoding/TypeCodeInputStream.java,Java,,117,21,35,173
/jdk1.6.0_45/com/sun/corba/se/impl/encoding/TypeCodeOutputStream.java,Java,,132,26,84,242
/jdk1.6.0_45/com/sun/corba/se/impl/encoding/TypeCodeReader.java,Java,,44,7,8,59
/jdk1.6.0_45/com/sun/corba/se/impl/encoding/WrapperInputStream.java,Java,,154,21,18,193
/jdk1.6.0_45/com/sun/corba/se/impl/interceptors/CDREncapsCodec.java,Java,,94,29,75,198
/jdk1.6.0_45/com/sun/corba/se/impl/interceptors/ClientRequestInfoImpl.java,Java,,498,135,327,960
/jdk1.6.0_45/com/sun/corba/se/impl/interceptors/CodecFactoryImpl.java,Java,,51,16,37,104
/jdk1.6.0_45/com/sun/corba/se/impl/interceptors/InterceptorInvoker.java,Java,,335,74,235,644
/jdk1.6.0_45/com/sun/corba/se/impl/interceptors/InterceptorList.java,Java,,130,30,83,243
/jdk1.6.0_45/com/sun/corba/se/impl/interceptors/IORInfoImpl.java,Java,,151,53,96,300
/jdk1.6.0_45/com/sun/corba/se/impl/interceptors/ORBInitInfoImpl.java,Java,,175,50,138,363
/jdk1.6.0_45/com/sun/corba/se/impl/interceptors/PICurrent.java,Java,,69,25,61,155
/jdk1.6.0_45/com/sun/corba/se/impl/interceptors/PIHandlerImpl.java,Java,,567,150,259,976
/jdk1.6.0_45/com/sun/corba/se/impl/interceptors/PINoOpHandlerImpl.java,Java,,121,48,12,181
/jdk1.6.0_45/com/sun/corba/se/impl/interceptors/RequestInfoImpl.java,Java,,394,120,393,907
/jdk1.6.0_45/com/sun/corba/se/impl/interceptors/ServerRequestInfoImpl.java,Java,,452,138,299,889
/jdk1.6.0_45/com/sun/corba/se/impl/interceptors/SlotTable.java,Java,,44,13,33,90
/jdk1.6.0_45/com/sun/corba/se/impl/interceptors/SlotTableStack.java,Java,,78,25,67,170
/jdk1.6.0_45/com/sun/corba/se/impl/io/FVDCodeBaseImpl.java,Java,,103,28,35,166
/jdk1.6.0_45/com/sun/corba/se/impl/io/IIOPInputStream.java,Java,,1720,372,627,2719
/jdk1.6.0_45/com/sun/corba/se/impl/io/IIOPOutputStream.java,Java,,534,127,141,802
/jdk1.6.0_45/com/sun/corba/se/impl/io/InputStreamHook.java,Java,,267,85,101,453
/jdk1.6.0_45/com/sun/corba/se/impl/io/JavaCorbaAccess.java,Java,,4,2,4,10
/jdk1.6.0_45/com/sun/corba/se/impl/io/ObjectStreamClass.java,Java,,1022,220,565,1807
/jdk1.6.0_45/com/sun/corba/se/impl/io/ObjectStreamClassCorbaExt.java,Java,,51,14,29,94
/jdk1.6.0_45/com/sun/corba/se/impl/io/ObjectStreamField.java,Java,,154,36,65,255
/jdk1.6.0_45/com/sun/corba/se/impl/io/OptionalDataException.java,Java,,13,6,41,60
/jdk1.6.0_45/com/sun/corba/se/impl/io/OutputStreamHook.java,Java,,141,66,89,296
/jdk1.6.0_45/com/sun/corba/se/impl/io/SharedSecrets.java,Java,,15,6,15,36
/jdk1.6.0_45/com/sun/corba/se/impl/io/TypeMismatchException.java,Java,,12,3,14,29
/jdk1.6.0_45/com/sun/corba/se/impl/io/ValueHandlerImpl.java,Java,,630,134,145,909
/jdk1.6.0_45/com/sun/corba/se/impl/io/ValueUtility.java,Java,,329,66,65,460
/jdk1.6.0_45/com/sun/corba/se/impl/ior/ByteBuffer.java,Java,,80,18,92,190
/jdk1.6.0_45/com/sun/corba/se/impl/ior/EncapsulationUtility.java,Java,,72,18,31,121
/jdk1.6.0_45/com/sun/corba/se/impl/ior/FreezableList.java,Java,,85,24,15,124
/jdk1.6.0_45/com/sun/corba/se/impl/ior/GenericIdentifiable.java,Java,,54,16,10,80
/jdk1.6.0_45/com/sun/corba/se/impl/ior/GenericTaggedComponent.java,Java,,23,8,14,45
/jdk1.6.0_45/com/sun/corba/se/impl/ior/GenericTaggedProfile.java,Java,,58,17,10,85
/jdk1.6.0_45/com/sun/corba/se/impl/ior/IdentifiableFactoryFinderBase.java,Java,,45,14,6,65
/jdk1.6.0_45/com/sun/corba/se/impl/ior/iiop/AlternateIIOPAddressComponentImpl.java,Java,,43,15,9,67
/jdk1.6.0_45/com/sun/corba/se/impl/ior/iiop/CodeSetsComponentImpl.java,Java,,57,18,10,85
/jdk1.6.0_45/com/sun/corba/se/impl/ior/iiop/IIOPAddressBase.java,Java,,42,12,15,69
/jdk1.6.0_45/com/sun/corba/se/impl/ior/iiop/IIOPAddressClosureImpl.java,Java,,24,8,9,41
/jdk1.6.0_45/com/sun/corba/se/impl/ior/iiop/IIOPAddressImpl.java,Java,,38,13,9,60
/jdk1.6.0_45/com/sun/corba/se/impl/ior/iiop/IIOPProfileImpl.java,Java,,228,65,37,330
/jdk1.6.0_45/com/sun/corba/se/impl/ior/iiop/IIOPProfileTemplateImpl.java,Java,,101,33,19,153
/jdk1.6.0_45/com/sun/corba/se/impl/ior/iiop/JavaCodebaseComponentImpl.java,Java,,43,16,9,68
/jdk1.6.0_45/com/sun/corba/se/impl/ior/iiop/JavaSerializationComponent.java,Java,,42,13,15,70
/jdk1.6.0_45/com/sun/corba/se/impl/ior/iiop/MaxStreamFormatVersionComponentImpl.java,Java,,51,19,11,81
/jdk1.6.0_45/com/sun/corba/se/impl/ior/iiop/ORBTypeComponentImpl.java,Java,,41,15,9,65
/jdk1.6.0_45/com/sun/corba/se/impl/ior/iiop/RequestPartitioningComponentImpl.java,Java,,56,16,3,75
/jdk1.6.0_45/com/sun/corba/se/impl/ior/IORImpl.java,Java,,202,65,51,318
/jdk1.6.0_45/com/sun/corba/se/impl/ior/IORTemplateImpl.java,Java,,81,25,14,120
/jdk1.6.0_45/com/sun/corba/se/impl/ior/IORTemplateListImpl.java,Java,,84,17,10,111
/jdk1.6.0_45/com/sun/corba/se/impl/ior/JIDLObjectKeyTemplate.java,Java,,37,14,14,65
/jdk1.6.0_45/com/sun/corba/se/impl/ior/NewObjectKeyTemplateBase.java,Java,,37,12,7,56
/jdk1.6.0_45/com/sun/corba/se/impl/ior/ObjectAdapterIdArray.java,Java,,28,8,8,44
/jdk1.6.0_45/com/sun/corba/se/impl/ior/ObjectAdapterIdBase.java,Java,,57,17,6,80
/jdk1.6.0_45/com/sun/corba/se/impl/ior/ObjectAdapterIdNumber.java,Java,,15,5,12,32
/jdk1.6.0_45/com/sun/corba/se/impl/ior/ObjectIdImpl.java,Java,,35,10,9,54
/jdk1.6.0_45/com/sun/corba/se/impl/ior/ObjectKeyFactoryImpl.java,Java,,119,35,66,220
/jdk1.6.0_45/com/sun/corba/se/impl/ior/ObjectKeyImpl.java,Java,,54,18,9,81
/jdk1.6.0_45/com/sun/corba/se/impl/ior/ObjectKeyTemplateBase.java,Java,,128,38,13,179
/jdk1.6.0_45/com/sun/corba/se/impl/ior/ObjectReferenceFactoryImpl.java,Java,,75,25,24,124
/jdk1.6.0_45/com/sun/corba/se/impl/ior/ObjectReferenceProducerBase.java,Java,,26,13,6,45
/jdk1.6.0_45/com/sun/corba/se/impl/ior/ObjectReferenceTemplateImpl.java,Java,,95,28,24,147
/jdk1.6.0_45/com/sun/corba/se/impl/ior/OldJIDLObjectKeyTemplate.java,Java,,52,20,29,101
/jdk1.6.0_45/com/sun/corba/se/impl/ior/OldObjectKeyTemplateBase.java,Java,,21,7,10,38
/jdk1.6.0_45/com/sun/corba/se/impl/ior/OldPOAObjectKeyTemplate.java,Java,,49,13,14,76
/jdk1.6.0_45/com/sun/corba/se/impl/ior/POAObjectKeyTemplate.java,Java,,43,16,14,73
/jdk1.6.0_45/com/sun/corba/se/impl/ior/StubIORImpl.java,Java,,172,37,42,251
/jdk1.6.0_45/com/sun/corba/se/impl/ior/TaggedComponentFactoryFinderImpl.java,Java,,33,11,10,54
/jdk1.6.0_45/com/sun/corba/se/impl/ior/TaggedProfileFactoryFinderImpl.java,Java,,17,7,9,33
/jdk1.6.0_45/com/sun/corba/se/impl/ior/TaggedProfileTemplateFactoryFinderImpl.java,Java,,18,8,9,35
/jdk1.6.0_45/com/sun/corba/se/impl/ior/WireObjectKeyTemplate.java,Java,,91,27,19,137
/jdk1.6.0_45/com/sun/corba/se/impl/javax/rmi/CORBA/StubDelegateImpl.java,Java,,92,31,67,190
/jdk1.6.0_45/com/sun/corba/se/impl/javax/rmi/CORBA/Util.java,Java,,469,81,209,759
/jdk1.6.0_45/com/sun/corba/se/impl/javax/rmi/PortableRemoteObject.java,Java,,181,54,111,346
/jdk1.6.0_45/com/sun/corba/se/impl/legacy/connection/DefaultSocketFactory.java,Java,,88,17,8,113
/jdk1.6.0_45/com/sun/corba/se/impl/legacy/connection/EndPointInfoImpl.java,Java,,76,16,7,99
/jdk1.6.0_45/com/sun/corba/se/impl/legacy/connection/LegacyServerSocketManagerImpl.java,Java,,121,23,26,170
/jdk1.6.0_45/com/sun/corba/se/impl/legacy/connection/SocketFactoryAcceptorImpl.java,Java,,46,12,18,76
/jdk1.6.0_45/com/sun/corba/se/impl/legacy/connection/SocketFactoryConnectionImpl.java,Java,,72,13,17,102
/jdk1.6.0_45/com/sun/corba/se/impl/legacy/connection/SocketFactoryContactInfoImpl.java,Java,,56,16,22,94
/jdk1.6.0_45/com/sun/corba/se/impl/legacy/connection/SocketFactoryContactInfoListImpl.java,Java,,23,8,15,46
/jdk1.6.0_45/com/sun/corba/se/impl/legacy/connection/SocketFactoryContactInfoListIteratorImpl.java,Java,,66,15,18,99
/jdk1.6.0_45/com/sun/corba/se/impl/legacy/connection/USLPort.java,Java,,14,6,7,27
/jdk1.6.0_45/com/sun/corba/se/impl/logging/ActivationSystemException.java,Java,,186,66,13,265
/jdk1.6.0_45/com/sun/corba/se/impl/logging/InterceptorsSystemException.java,Java,,702,238,25,965
/jdk1.6.0_45/com/sun/corba/se/impl/logging/IORSystemException.java,Java,,360,123,16,499
/jdk1.6.0_45/com/sun/corba/se/impl/logging/NamingSystemException.java,Java,,523,179,16,718
/jdk1.6.0_45/com/sun/corba/se/impl/logging/OMGSystemException.java,Java,,2814,951,64,3829
/jdk1.6.0_45/com/sun/corba/se/impl/logging/ORBUtilSystemException.java,Java,,6787,2227,49,9063
/jdk1.6.0_45/com/sun/corba/se/impl/logging/POASystemException.java,Java,,1539,521,34,2094
/jdk1.6.0_45/com/sun/corba/se/impl/logging/UtilSystemException.java,Java,,686,224,25,935
/jdk1.6.0_45/com/sun/corba/se/impl/monitoring/MonitoredAttributeInfoFactoryImpl.java,Java,,14,3,6,23
/jdk1.6.0_45/com/sun/corba/se/impl/monitoring/MonitoredAttributeInfoImpl.java,Java,,27,10,6,43
/jdk1.6.0_45/com/sun/corba/se/impl/monitoring/MonitoredObjectFactoryImpl.java,Java,,10,5,6,21
/jdk1.6.0_45/com/sun/corba/se/impl/monitoring/MonitoredObjectImpl.java,Java,,91,27,15,133
/jdk1.6.0_45/com/sun/corba/se/impl/monitoring/MonitoringManagerFactoryImpl.java,Java,,21,7,6,34
/jdk1.6.0_45/com/sun/corba/se/impl/monitoring/MonitoringManagerImpl.java,Java,,26,12,6,44
/jdk1.6.0_45/com/sun/corba/se/impl/naming/cosnaming/BindingIteratorImpl.java,Java,,57,18,92,167
/jdk1.6.0_45/com/sun/corba/se/impl/naming/cosnaming/InternalBindingKey.java,Java,,52,8,24,84
/jdk1.6.0_45/com/sun/corba/se/impl/naming/cosnaming/InternalBindingValue.java,Java,,15,5,13,33
/jdk1.6.0_45/com/sun/corba/se/impl/naming/cosnaming/InterOperableNamingImpl.java,Java,,297,22,77,396
/jdk1.6.0_45/com/sun/corba/se/impl/naming/cosnaming/NamingContextDataStore.java,Java,,25,11,61,97
/jdk1.6.0_45/com/sun/corba/se/impl/naming/cosnaming/NamingContextImpl.java,Java,,502,66,442,1010
/jdk1.6.0_45/com/sun/corba/se/impl/naming/cosnaming/NamingUtils.java,Java,,52,15,47,114
/jdk1.6.0_45/com/sun/corba/se/impl/naming/cosnaming/TransientBindingIterator.java,Java,,57,10,49,116
/jdk1.6.0_45/com/sun/corba/se/impl/naming/cosnaming/TransientNameServer.java,Java,,132,32,54,218
/jdk1.6.0_45/com/sun/corba/se/impl/naming/cosnaming/TransientNameService.java,Java,,68,19,53,140
/jdk1.6.0_45/com/sun/corba/se/impl/naming/cosnaming/TransientNamingContext.java,Java,,178,30,132,340
/jdk1.6.0_45/com/sun/corba/se/impl/naming/namingutil/CorbalocURL.java,Java,,140,18,112,270
/jdk1.6.0_45/com/sun/corba/se/impl/naming/namingutil/CorbanameURL.java,Java,,55,10,38,103
/jdk1.6.0_45/com/sun/corba/se/impl/naming/namingutil/IIOPEndpointInfo.java,Java,,41,14,20,75
/jdk1.6.0_45/com/sun/corba/se/impl/naming/namingutil/INSURL.java,Java,,9,9,17,35
/jdk1.6.0_45/com/sun/corba/se/impl/naming/namingutil/INSURLBase.java,Java,,32,11,16,59
/jdk1.6.0_45/com/sun/corba/se/impl/naming/namingutil/INSURLHandler.java,Java,,25,9,13,47
/jdk1.6.0_45/com/sun/corba/se/impl/naming/namingutil/NamingConstants.java,Java,,7,5,11,23
/jdk1.6.0_45/com/sun/corba/se/impl/naming/namingutil/Utility.java,Java,,48,12,25,85
/jdk1.6.0_45/com/sun/corba/se/impl/naming/pcosnaming/InternalBindingKey.java,Java,,79,13,41,133
/jdk1.6.0_45/com/sun/corba/se/impl/naming/pcosnaming/InternalBindingValue.java,Java,,25,8,33,66
/jdk1.6.0_45/com/sun/corba/se/impl/naming/pcosnaming/NameServer.java,Java,,48,17,21,86
/jdk1.6.0_45/com/sun/corba/se/impl/naming/pcosnaming/NameService.java,Java,,129,24,79,232
/jdk1.6.0_45/com/sun/corba/se/impl/naming/pcosnaming/NamingContextImpl.java,Java,,632,118,553,1303
/jdk1.6.0_45/com/sun/corba/se/impl/naming/pcosnaming/PersistentBindingIterator.java,Java,,66,12,61,139
/jdk1.6.0_45/com/sun/corba/se/impl/naming/pcosnaming/ServantManagerImpl.java,Java,,180,49,30,259
/jdk1.6.0_45/com/sun/corba/se/impl/oa/NullServantImpl.java,Java,,15,6,6,27
/jdk1.6.0_45/com/sun/corba/se/impl/oa/poa/ActiveObjectMap.java,Java,,187,44,17,248
/jdk1.6.0_45/com/sun/corba/se/impl/oa/poa/AOMEntry.java,Java,,169,36,24,229
/jdk1.6.0_45/com/sun/corba/se/impl/oa/poa/BadServerIdHandler.java,Java,,6,3,28,37
/jdk1.6.0_45/com/sun/corba/se/impl/oa/poa/DelegateImpl.java,Java,,101,19,9,129
/jdk1.6.0_45/com/sun/corba/se/impl/oa/poa/IdAssignmentPolicyImpl.java,Java,,30,10,6,46
/jdk1.6.0_45/com/sun/corba/se/impl/oa/poa/IdUniquenessPolicyImpl.java,Java,,29,10,6,45
/jdk1.6.0_45/com/sun/corba/se/impl/oa/poa/ImplicitActivationPolicyImpl.java,Java,,31,10,6,47
/jdk1.6.0_45/com/sun/corba/se/impl/oa/poa/LifespanPolicyImpl.java,Java,,29,10,6,45
/jdk1.6.0_45/com/sun/corba/se/impl/oa/poa/POACurrent.java,Java,,115,25,24,164
/jdk1.6.0_45/com/sun/corba/se/impl/oa/poa/POAFactory.java,Java,,169,43,18,230
/jdk1.6.0_45/com/sun/corba/se/impl/oa/poa/POAImpl.java,Java,,1055,261,358,1674
/jdk1.6.0_45/com/sun/corba/se/impl/oa/poa/POAManagerImpl.java,Java,,364,80,85,529
/jdk1.6.0_45/com/sun/corba/se/impl/oa/poa/POAPolicyMediator.java,Java,,30,19,58,107
/jdk1.6.0_45/com/sun/corba/se/impl/oa/poa/POAPolicyMediatorBase.java,Java,,92,25,14,131
/jdk1.6.0_45/com/sun/corba/se/impl/oa/poa/POAPolicyMediatorBase_R.java,Java,,131,41,14,186
/jdk1.6.0_45/com/sun/corba/se/impl/oa/poa/POAPolicyMediatorFactory.java,Java,,23,2,9,34
/jdk1.6.0_45/com/sun/corba/se/impl/oa/poa/POAPolicyMediatorImpl_NR_UDS.java,Java,,81,23,13,117
/jdk1.6.0_45/com/sun/corba/se/impl/oa/poa/POAPolicyMediatorImpl_NR_USM.java,Java,,109,28,13,150
/jdk1.6.0_45/com/sun/corba/se/impl/oa/poa/POAPolicyMediatorImpl_R_AOM.java,Java,,60,14,16,90
/jdk1.6.0_45/com/sun/corba/se/impl/oa/poa/POAPolicyMediatorImpl_R_UDS.java,Java,,69,19,12,100
/jdk1.6.0_45/com/sun/corba/se/impl/oa/poa/POAPolicyMediatorImpl_R_USM.java,Java,,260,53,49,362
/jdk1.6.0_45/com/sun/corba/se/impl/oa/poa/Policies.java,Java,,243,43,48,334
/jdk1.6.0_45/com/sun/corba/se/impl/oa/poa/RequestProcessingPolicyImpl.java,Java,,40,11,6,57
/jdk1.6.0_45/com/sun/corba/se/impl/oa/poa/ServantRetentionPolicyImpl.java,Java,,29,10,6,45
/jdk1.6.0_45/com/sun/corba/se/impl/oa/poa/ThreadPolicyImpl.java,Java,,29,10,6,45
/jdk1.6.0_45/com/sun/corba/se/impl/oa/toa/TOA.java,Java,,6,5,17,28
/jdk1.6.0_45/com/sun/corba/se/impl/oa/toa/TOAFactory.java,Java,,63,22,11,96
/jdk1.6.0_45/com/sun/corba/se/impl/oa/toa/TOAImpl.java,Java,,126,32,52,210
/jdk1.6.0_45/com/sun/corba/se/impl/oa/toa/TransientObjectManager.java,Java,,132,37,21,190
/jdk1.6.0_45/com/sun/corba/se/impl/orb/AppletDataCollector.java,Java,,23,9,8,40
/jdk1.6.0_45/com/sun/corba/se/impl/orb/DataCollectorBase.java,Java,,306,81,68,455
/jdk1.6.0_45/com/sun/corba/se/impl/orb/DataCollectorFactory.java,Java,,32,10,6,48
/jdk1.6.0_45/com/sun/corba/se/impl/orb/NormalDataCollector.java,Java,,26,9,6,41
/jdk1.6.0_45/com/sun/corba/se/impl/orb/NormalParserAction.java,Java,,18,6,10,34
/jdk1.6.0_45/com/sun/corba/se/impl/orb/NormalParserData.java,Java,,22,7,6,35
/jdk1.6.0_45/com/sun/corba/se/impl/orb/ORBConfiguratorImpl.java,Java,,441,89,80,610
/jdk1.6.0_45/com/sun/corba/se/impl/orb/ORBDataParserImpl.java,Java,,299,56,46,401
/jdk1.6.0_45/com/sun/corba/se/impl/orb/ORBImpl.java,Java,,1352,283,478,2113
/jdk1.6.0_45/com/sun/corba/se/impl/orb/ORBSingleton.java,Java,,557,142,58,757
/jdk1.6.0_45/com/sun/corba/se/impl/orb/ORBVersionImpl.java,Java,,51,19,10,80
/jdk1.6.0_45/com/sun/corba/se/impl/orb/ParserAction.java,Java,,8,6,16,30
/jdk1.6.0_45/com/sun/corba/se/impl/orb/ParserActionBase.java,Java,,51,16,6,73
/jdk1.6.0_45/com/sun/corba/se/impl/orb/ParserActionFactory.java,Java,,15,5,6,26
/jdk1.6.0_45/com/sun/corba/se/impl/orb/ParserDataBase.java,Java,,25,5,6,36
/jdk1.6.0_45/com/sun/corba/se/impl/orb/ParserTable.java,Java,,842,113,102,1057
/jdk1.6.0_45/com/sun/corba/se/impl/orb/PrefixParserAction.java,Java,,72,15,17,104
/jdk1.6.0_45/com/sun/corba/se/impl/orb/PrefixParserData.java,Java,,32,10,6,48
/jdk1.6.0_45/com/sun/corba/se/impl/orb/PropertyOnlyDataCollector.java,Java,,22,8,0,30
/jdk1.6.0_45/com/sun/corba/se/impl/orbutil/CacheTable.java,Java,,124,6,15,145
/jdk1.6.0_45/com/sun/corba/se/impl/orbutil/closure/Constant.java,Java,,13,6,6,25
/jdk1.6.0_45/com/sun/corba/se/impl/orbutil/closure/Future.java,Java,,21,6,6,33
/jdk1.6.0_45/com/sun/corba/se/impl/orbutil/concurrent/CondVar.java,Java,,112,28,176,316
/jdk1.6.0_45/com/sun/corba/se/impl/orbutil/concurrent/DebugMutex.java,Java,,68,12,108,188
/jdk1.6.0_45/com/sun/corba/se/impl/orbutil/concurrent/Mutex.java,Java,,54,10,105,169
/jdk1.6.0_45/com/sun/corba/se/impl/orbutil/concurrent/ReentrantMutex.java,Java,,180,33,113,326
/jdk1.6.0_45/com/sun/corba/se/impl/orbutil/concurrent/Sync.java,Java,,13,21,306,340
/jdk1.6.0_45/com/sun/corba/se/impl/orbutil/concurrent/SyncUtil.java,Java,,17,4,10,31
/jdk1.6.0_45/com/sun/corba/se/impl/orbutil/CorbaResourceUtil.java,Java,,57,14,6,77
/jdk1.6.0_45/com/sun/corba/se/impl/orbutil/DenseIntMapImpl.java,Java,,34,9,17,60
/jdk1.6.0_45/com/sun/corba/se/impl/orbutil/fsm/GuardedAction.java,Java,,38,9,6,53
/jdk1.6.0_45/com/sun/corba/se/impl/orbutil/fsm/NameBase.java,Java,,43,10,7,60
/jdk1.6.0_45/com/sun/corba/se/impl/orbutil/fsm/StateEngineImpl.java,Java,,221,55,35,311
/jdk1.6.0_45/com/sun/corba/se/impl/orbutil/GetPropertyAction.java,Java,,16,6,48,70
/jdk1.6.0_45/com/sun/corba/se/impl/orbutil/graph/Graph.java,Java,,7,4,6,17
/jdk1.6.0_45/com/sun/corba/se/impl/orbutil/graph/GraphImpl.java,Java,,112,29,28,169
/jdk1.6.0_45/com/sun/corba/se/impl/orbutil/graph/Node.java,Java,,6,3,10,19
/jdk1.6.0_45/com/sun/corba/se/impl/orbutil/graph/NodeData.java,Java,,31,8,13,52
/jdk1.6.0_45/com/sun/corba/se/impl/orbutil/HexOutputStream.java,Java,,30,10,23,63
/jdk1.6.0_45/com/sun/corba/se/impl/orbutil/LegacyHookGetFields.java,Java,,73,24,41,138
/jdk1.6.0_45/com/sun/corba/se/impl/orbutil/LegacyHookPutFields.java,Java,,37,13,42,92
/jdk1.6.0_45/com/sun/corba/se/impl/orbutil/LogKeywords.java,Java,,48,14,23,85
/jdk1.6.0_45/com/sun/corba/se/impl/orbutil/ObjectStreamClassUtil_1_3.java,Java,,370,71,112,553
/jdk1.6.0_45/com/sun/corba/se/impl/orbutil/ObjectStreamClass_1_3_1.java,Java,,707,161,392,1260
/jdk1.6.0_45/com/sun/corba/se/impl/orbutil/ObjectStreamField.java,Java,,139,34,81,254
/jdk1.6.0_45/com/sun/corba/se/impl/orbutil/ObjectUtility.java,Java,,46,12,11,69
/jdk1.6.0_45/com/sun/corba/se/impl/orbutil/ObjectWriter.java,Java,,145,36,17,198
/jdk1.6.0_45/com/sun/corba/se/impl/orbutil/ORBClassLoader.java,Java,,15,2,12,29
/jdk1.6.0_45/com/sun/corba/se/impl/orbutil/ORBConstants.java,Java,,196,95,162,453
/jdk1.6.0_45/com/sun/corba/se/impl/orbutil/ORBUtility.java,Java,,558,94,176,828
/jdk1.6.0_45/com/sun/corba/se/impl/orbutil/RepIdDelegator.java,Java,,108,33,18,159
/jdk1.6.0_45/com/sun/corba/se/impl/orbutil/RepositoryIdFactory.java,Java,,16,5,10,31
/jdk1.6.0_45/com/sun/corba/se/impl/orbutil/RepositoryIdInterface.java,Java,,14,6,10,30
/jdk1.6.0_45/com/sun/corba/se/impl/orbutil/RepositoryIdStrings.java,Java,,16,9,10,35
/jdk1.6.0_45/com/sun/corba/se/impl/orbutil/RepositoryIdUtility.java,Java,,20,6,15,41
/jdk1.6.0_45/com/sun/corba/se/impl/orbutil/StackImpl.java,Java,,35,9,17,61
/jdk1.6.0_45/com/sun/corba/se/impl/orbutil/threadpool/ThreadPoolImpl.java,Java,,331,82,115,528
/jdk1.6.0_45/com/sun/corba/se/impl/orbutil/threadpool/ThreadPoolManagerImpl.java,Java,,104,35,78,217
/jdk1.6.0_45/com/sun/corba/se/impl/orbutil/threadpool/TimeoutException.java,Java,,4,4,5,13
/jdk1.6.0_45/com/sun/corba/se/impl/orbutil/threadpool/WorkQueueImpl.java,Java,,122,36,21,179
/jdk1.6.0_45/com/sun/corba/se/impl/presentation/rmi/DynamicAccessPermission.java,Java,,12,6,27,45
/jdk1.6.0_45/com/sun/corba/se/impl/presentation/rmi/DynamicMethodMarshallerImpl.java,Java,,361,67,19,447
/jdk1.6.0_45/com/sun/corba/se/impl/presentation/rmi/DynamicStubImpl.java,Java,,106,27,9,142
/jdk1.6.0_45/com/sun/corba/se/impl/presentation/rmi/ExceptionHandler.java,Java,,10,6,23,39
/jdk1.6.0_45/com/sun/corba/se/impl/presentation/rmi/ExceptionHandlerImpl.java,Java,,192,50,36,278
/jdk1.6.0_45/com/sun/corba/se/impl/presentation/rmi/IDLNameTranslatorImpl.java,Java,,510,172,232,914
/jdk1.6.0_45/com/sun/corba/se/impl/presentation/rmi/IDLType.java,Java,,56,21,29,106
/jdk1.6.0_45/com/sun/corba/se/impl/presentation/rmi/IDLTypeException.java,Java,,7,5,10,22
/jdk1.6.0_45/com/sun/corba/se/impl/presentation/rmi/IDLTypesUtil.java,Java,,390,93,97,580
/jdk1.6.0_45/com/sun/corba/se/impl/presentation/rmi/InvocationHandlerFactoryImpl.java,Java,,82,23,35,140
/jdk1.6.0_45/com/sun/corba/se/impl/presentation/rmi/JNDIStateFactoryImpl.java,Java,,72,25,55,152
/jdk1.6.0_45/com/sun/corba/se/impl/presentation/rmi/PresentationManagerImpl.java,Java,,225,59,23,307
/jdk1.6.0_45/com/sun/corba/se/impl/presentation/rmi/ReflectiveTie.java,Java,,117,29,12,158
/jdk1.6.0_45/com/sun/corba/se/impl/presentation/rmi/StubConnectImpl.java,Java,,58,20,20,98
/jdk1.6.0_45/com/sun/corba/se/impl/presentation/rmi/StubFactoryBase.java,Java,,30,10,6,46
/jdk1.6.0_45/com/sun/corba/se/impl/presentation/rmi/StubFactoryDynamicBase.java,Java,,25,8,8,41
/jdk1.6.0_45/com/sun/corba/se/impl/presentation/rmi/StubFactoryFactoryBase.java,Java,,11,4,11,26
/jdk1.6.0_45/com/sun/corba/se/impl/presentation/rmi/StubFactoryFactoryDynamicBase.java,Java,,58,18,7,83
/jdk1.6.0_45/com/sun/corba/se/impl/presentation/rmi/StubFactoryFactoryProxyImpl.java,Java,,11,3,6,20
/jdk1.6.0_45/com/sun/corba/se/impl/presentation/rmi/StubFactoryFactoryStaticImpl.java,Java,,87,23,21,131
/jdk1.6.0_45/com/sun/corba/se/impl/presentation/rmi/StubFactoryProxyImpl.java,Java,,25,6,8,39
/jdk1.6.0_45/com/sun/corba/se/impl/presentation/rmi/StubFactoryStaticImpl.java,Java,,24,6,6,36
/jdk1.6.0_45/com/sun/corba/se/impl/presentation/rmi/StubInvocationHandlerImpl.java,Java,,141,32,22,195
/jdk1.6.0_45/com/sun/corba/se/impl/protocol/AddressingDispositionException.java,Java,,11,6,21,38
/jdk1.6.0_45/com/sun/corba/se/impl/protocol/BootstrapServerRequestDispatcher.java,Java,,73,21,37,131
/jdk1.6.0_45/com/sun/corba/se/impl/protocol/CorbaClientDelegateImpl.java,Java,,295,65,66,426
/jdk1.6.0_45/com/sun/corba/se/impl/protocol/CorbaClientRequestDispatcherImpl.java,Java,,670,170,195,1035
/jdk1.6.0_45/com/sun/corba/se/impl/protocol/CorbaInvocationInfo.java,Java,,68,21,11,100
/jdk1.6.0_45/com/sun/corba/se/impl/protocol/CorbaMessageMediatorImpl.java,Java,,1651,312,393,2356
/jdk1.6.0_45/com/sun/corba/se/impl/protocol/CorbaServerRequestDispatcherImpl.java,Java,,578,130,162,870
/jdk1.6.0_45/com/sun/corba/se/impl/protocol/FullServantCacheLocalCRDImpl.java,Java,,39,15,9,63
/jdk1.6.0_45/com/sun/corba/se/impl/protocol/giopmsgheaders/AddressingDispositionHelper.java,Java,,40,11,12,63
/jdk1.6.0_45/com/sun/corba/se/impl/protocol/giopmsgheaders/CancelRequestMessage.java,Java,,5,3,12,20
/jdk1.6.0_45/com/sun/corba/se/impl/protocol/giopmsgheaders/CancelRequestMessage_1_0.java,Java,,28,15,16,59
/jdk1.6.0_45/com/sun/corba/se/impl/protocol/giopmsgheaders/CancelRequestMessage_1_1.java,Java,,28,15,16,59
/jdk1.6.0_45/com/sun/corba/se/impl/protocol/giopmsgheaders/CancelRequestMessage_1_2.java,Java,,28,15,16,59
/jdk1.6.0_45/com/sun/corba/se/impl/protocol/giopmsgheaders/FragmentMessage.java,Java,,5,3,12,20
/jdk1.6.0_45/com/sun/corba/se/impl/protocol/giopmsgheaders/FragmentMessage_1_1.java,Java,,29,13,20,62
/jdk1.6.0_45/com/sun/corba/se/impl/protocol/giopmsgheaders/FragmentMessage_1_2.java,Java,,55,16,20,91
/jdk1.6.0_45/com/sun/corba/se/impl/protocol/giopmsgheaders/IORAddressingInfo.java,Java,,14,7,12,33
/jdk1.6.0_45/com/sun/corba/se/impl/protocol/giopmsgheaders/IORAddressingInfoHelper.java,Java,,66,11,12,89
/jdk1.6.0_45/com/sun/corba/se/impl/protocol/giopmsgheaders/KeyAddr.java,Java,,5,4,12,21
/jdk1.6.0_45/com/sun/corba/se/impl/protocol/giopmsgheaders/LocateReplyMessage.java,Java,,11,5,12,28
/jdk1.6.0_45/com/sun/corba/se/impl/protocol/giopmsgheaders/LocateReplyMessage_1_0.java,Java,,76,27,20,123
/jdk1.6.0_45/com/sun/corba/se/impl/protocol/giopmsgheaders/LocateReplyMessage_1_1.java,Java,,77,26,20,123
/jdk1.6.0_45/com/sun/corba/se/impl/protocol/giopmsgheaders/LocateReplyMessage_1_2.java,Java,,115,33,30,178
/jdk1.6.0_45/com/sun/corba/se/impl/protocol/giopmsgheaders/LocateReplyOrReplyMessage.java,Java,,10,6,7,23
/jdk1.6.0_45/com/sun/corba/se/impl/protocol/giopmsgheaders/LocateRequestMessage.java,Java,,6,4,12,22
/jdk1.6.0_45/com/sun/corba/se/impl/protocol/giopmsgheaders/LocateRequestMessage_1_0.java,Java,,48,18,17,83
/jdk1.6.0_45/com/sun/corba/se/impl/protocol/giopmsgheaders/LocateRequestMessage_1_1.java,Java,,49,19,17,85
/jdk1.6.0_45/com/sun/corba/se/impl/protocol/giopmsgheaders/LocateRequestMessage_1_2.java,Java,,46,18,17,81
/jdk1.6.0_45/com/sun/corba/se/impl/protocol/giopmsgheaders/Message.java,Java,,42,20,18,80
/jdk1.6.0_45/com/sun/corba/se/impl/protocol/giopmsgheaders/MessageBase.java,Java,,702,107,139,948
/jdk1.6.0_45/com/sun/corba/se/impl/protocol/giopmsgheaders/MessageHandler.java,Java,,21,10,24,55
/jdk1.6.0_45/com/sun/corba/se/impl/protocol/giopmsgheaders/Message_1_0.java,Java,,71,24,31,126
/jdk1.6.0_45/com/sun/corba/se/impl/protocol/giopmsgheaders/Message_1_1.java,Java,,96,32,51,179
/jdk1.6.0_45/com/sun/corba/se/impl/protocol/giopmsgheaders/Message_1_2.java,Java,,42,11,11,64
/jdk1.6.0_45/com/sun/corba/se/impl/protocol/giopmsgheaders/ProfileAddr.java,Java,,5,4,12,21
/jdk1.6.0_45/com/sun/corba/se/impl/protocol/giopmsgheaders/ReferenceAddr.java,Java,,5,4,12,21
/jdk1.6.0_45/com/sun/corba/se/impl/protocol/giopmsgheaders/ReplyMessage.java,Java,,15,6,14,35
/jdk1.6.0_45/com/sun/corba/se/impl/protocol/giopmsgheaders/ReplyMessage_1_0.java,Java,,131,32,22,185
/jdk1.6.0_45/com/sun/corba/se/impl/protocol/giopmsgheaders/ReplyMessage_1_1.java,Java,,132,31,22,185
/jdk1.6.0_45/com/sun/corba/se/impl/protocol/giopmsgheaders/ReplyMessage_1_2.java,Java,,141,37,37,215
/jdk1.6.0_45/com/sun/corba/se/impl/protocol/giopmsgheaders/RequestMessage.java,Java,,15,9,13,37
/jdk1.6.0_45/com/sun/corba/se/impl/protocol/giopmsgheaders/RequestMessage_1_0.java,Java,,97,26,21,144
/jdk1.6.0_45/com/sun/corba/se/impl/protocol/giopmsgheaders/RequestMessage_1_1.java,Java,,118,23,17,158
/jdk1.6.0_45/com/sun/corba/se/impl/protocol/giopmsgheaders/RequestMessage_1_2.java,Java,,116,28,39,183
/jdk1.6.0_45/com/sun/corba/se/impl/protocol/giopmsgheaders/TargetAddress.java,Java,,77,17,12,106
/jdk1.6.0_45/com/sun/corba/se/impl/protocol/giopmsgheaders/TargetAddressHelper.java,Java,,108,14,15,137
/jdk1.6.0_45/com/sun/corba/se/impl/protocol/InfoOnlyServantCacheLocalCRDImpl.java,Java,,29,12,9,50
/jdk1.6.0_45/com/sun/corba/se/impl/protocol/INSServerRequestDispatcher.java,Java,,40,11,32,83
/jdk1.6.0_45/com/sun/corba/se/impl/protocol/JIDLLocalCRDImpl.java,Java,,41,16,15,72
/jdk1.6.0_45/com/sun/corba/se/impl/protocol/LocalClientRequestDispatcherBase.java,Java,,66,21,35,122
/jdk1.6.0_45/com/sun/corba/se/impl/protocol/MinimalServantCacheLocalCRDImpl.java,Java,,27,10,6,43
/jdk1.6.0_45/com/sun/corba/se/impl/protocol/NotLocalLocalCRDImpl.java,Java,,25,9,15,49
/jdk1.6.0_45/com/sun/corba/se/impl/protocol/POALocalCRDImpl.java,Java,,91,24,30,145
/jdk1.6.0_45/com/sun/corba/se/impl/protocol/RequestCanceledException.java,Java,,10,5,9,24
/jdk1.6.0_45/com/sun/corba/se/impl/protocol/RequestDispatcherRegistryImpl.java,Java,,111,29,25,165
/jdk1.6.0_45/com/sun/corba/se/impl/protocol/ServantCacheLocalCRDBase.java,Java,,49,18,11,78
/jdk1.6.0_45/com/sun/corba/se/impl/protocol/SharedCDRClientRequestDispatcherImpl.java,Java,,132,29,43,204
/jdk1.6.0_45/com/sun/corba/se/impl/protocol/SpecialMethod.java,Java,,119,25,7,151
/jdk1.6.0_45/com/sun/corba/se/impl/resolver/BootstrapResolverImpl.java,Java,,85,30,25,140
/jdk1.6.0_45/com/sun/corba/se/impl/resolver/CompositeResolverImpl.java,Java,,27,6,0,33
/jdk1.6.0_45/com/sun/corba/se/impl/resolver/FileResolverImpl.java,Java,,65,16,11,92
/jdk1.6.0_45/com/sun/corba/se/impl/resolver/INSURLOperationImpl.java,Java,,210,35,64,309
/jdk1.6.0_45/com/sun/corba/se/impl/resolver/LocalResolverImpl.java,Java,,21,7,6,34
/jdk1.6.0_45/com/sun/corba/se/impl/resolver/ORBDefaultInitRefResolverImpl.java,Java,,29,9,6,44
/jdk1.6.0_45/com/sun/corba/se/impl/resolver/ORBInitRefResolverImpl.java,Java,,31,9,0,40
/jdk1.6.0_45/com/sun/corba/se/impl/resolver/SplitLocalResolverImpl.java,Java,,27,9,6,42
/jdk1.6.0_45/com/sun/corba/se/impl/transport/ByteBufferPoolImpl.java,Java,,93,25,71,189
/jdk1.6.0_45/com/sun/corba/se/impl/transport/CorbaConnectionCacheBase.java,Java,,166,36,48,250
/jdk1.6.0_45/com/sun/corba/se/impl/transport/CorbaContactInfoBase.java,Java,,189,43,42,274
/jdk1.6.0_45/com/sun/corba/se/impl/transport/CorbaContactInfoListImpl.java,Java,,139,30,53,222
/jdk1.6.0_45/com/sun/corba/se/impl/transport/CorbaContactInfoListIteratorImpl.java,Java,,147,37,57,241
/jdk1.6.0_45/com/sun/corba/se/impl/transport/CorbaInboundConnectionCacheImpl.java,Java,,133,25,26,184
/jdk1.6.0_45/com/sun/corba/se/impl/transport/CorbaOutboundConnectionCacheImpl.java,Java,,143,24,25,192
/jdk1.6.0_45/com/sun/corba/se/impl/transport/CorbaResponseWaitingRoomImpl.java,Java,,211,53,53,317
/jdk1.6.0_45/com/sun/corba/se/impl/transport/CorbaTransportManagerImpl.java,Java,,176,27,31,234
/jdk1.6.0_45/com/sun/corba/se/impl/transport/DefaultIORToSocketInfoImpl.java,Java,,47,10,12,69
/jdk1.6.0_45/com/sun/corba/se/impl/transport/DefaultSocketFactoryImpl.java,Java,,59,15,9,83
/jdk1.6.0_45/com/sun/corba/se/impl/transport/EventHandlerBase.java,Java,,95,19,18,132
/jdk1.6.0_45/com/sun/corba/se/impl/transport/ListenerThreadImpl.java,Java,,85,24,20,129
/jdk1.6.0_45/com/sun/corba/se/impl/transport/ReaderThreadImpl.java,Java,,90,24,21,135
/jdk1.6.0_45/com/sun/corba/se/impl/transport/ReadTCPTimeoutsImpl.java,Java,,23,6,11,40
/jdk1.6.0_45/com/sun/corba/se/impl/transport/SelectorImpl.java,Java,,429,52,50,531
/jdk1.6.0_45/com/sun/corba/se/impl/transport/SharedCDRContactInfoImpl.java,Java,,110,25,34,169
/jdk1.6.0_45/com/sun/corba/se/impl/transport/SocketOrChannelAcceptorImpl.java,Java,,450,80,97,627
/jdk1.6.0_45/com/sun/corba/se/impl/transport/SocketOrChannelConnectionImpl.java,Java,,1112,215,334,1661
/jdk1.6.0_45/com/sun/corba/se/impl/transport/SocketOrChannelContactInfoImpl.java,Java,,134,30,35,199
/jdk1.6.0_45/com/sun/corba/se/impl/util/IdentityHashtable.java,Java,,162,33,172,367
/jdk1.6.0_45/com/sun/corba/se/impl/util/IdentityHashtableEnumerator.java,Java,,37,7,18,62
/jdk1.6.0_45/com/sun/corba/se/impl/util/JDKBridge.java,Java,,91,20,71,182
/jdk1.6.0_45/com/sun/corba/se/impl/util/JDKClassLoader.java,Java,,86,25,65,176
/jdk1.6.0_45/com/sun/corba/se/impl/util/ORBProperties.java,Java,,29,11,16,56
/jdk1.6.0_45/com/sun/corba/se/impl/util/PackagePrefixChecker.java,Java,,35,14,11,60
/jdk1.6.0_45/com/sun/corba/se/impl/util/RepositoryId.java,Java,,677,176,125,978
/jdk1.6.0_45/com/sun/corba/se/impl/util/RepositoryIdCache.java,Java,,41,18,35,94
/jdk1.6.0_45/com/sun/corba/se/impl/util/SUNVMCID.java,Java,,4,4,15,23
/jdk1.6.0_45/com/sun/corba/se/impl/util/Utility.java,Java,,643,118,225,986
/jdk1.6.0_45/com/sun/corba/se/impl/util/Version.java,Java,,16,5,14,35
/jdk1.6.0_45/com/sun/corba/se/internal/corba/ORBSingleton.java,Java,,8,4,11,23
/jdk1.6.0_45/com/sun/corba/se/internal/CosNaming/BootstrapServer.java,Java,,59,21,35,115
/jdk1.6.0_45/com/sun/corba/se/internal/iiop/ORB.java,Java,,9,2,9,20
/jdk1.6.0_45/com/sun/corba/se/internal/Interceptors/PIORB.java,Java,,9,4,11,24
/jdk1.6.0_45/com/sun/corba/se/internal/io/IIOPInputStream.java,Java,,26,5,17,48
/jdk1.6.0_45/com/sun/corba/se/internal/io/IIOPOutputStream.java,Java,,14,6,13,33
/jdk1.6.0_45/com/sun/corba/se/internal/io/LibraryManager.java,Java,,7,4,14,25
/jdk1.6.0_45/com/sun/corba/se/internal/io/ObjectStreamClass.java,Java,,4,4,7,15
/jdk1.6.0_45/com/sun/corba/se/internal/POA/POAORB.java,Java,,8,2,9,19
/jdk1.6.0_45/com/sun/corba/se/org/omg/CORBA/ORB.java,Java,,11,3,25,39
/jdk1.6.0_45/com/sun/corba/se/pept/broker/Broker.java,Java,,10,5,10,25
/jdk1.6.0_45/com/sun/corba/se/pept/encoding/InputObject.java,Java,,9,8,29,46
/jdk1.6.0_45/com/sun/corba/se/pept/encoding/OutputObject.java,Java,,9,7,31,47
/jdk1.6.0_45/com/sun/corba/se/pept/protocol/ClientDelegate.java,Java,,8,5,28,41
/jdk1.6.0_45/com/sun/corba/se/pept/protocol/ClientInvocationInfo.java,Java,,18,14,10,42
/jdk1.6.0_45/com/sun/corba/se/pept/protocol/ClientRequestDispatcher.java,Java,,20,6,61,87
/jdk1.6.0_45/com/sun/corba/se/pept/protocol/MessageMediator.java,Java,,21,15,77,113
/jdk1.6.0_45/com/sun/corba/se/pept/protocol/ProtocolHandler.java,Java,,6,4,25,35
/jdk1.6.0_45/com/sun/corba/se/pept/protocol/ServerRequestDispatcher.java,Java,,6,4,20,30
/jdk1.6.0_45/com/sun/corba/se/pept/transport/Acceptor.java,Java,,28,21,145,194
/jdk1.6.0_45/com/sun/corba/se/pept/transport/ByteBufferPool.java,Java,,8,4,10,22
/jdk1.6.0_45/com/sun/corba/se/pept/transport/Connection.java,Java,,29,30,154,213
/jdk1.6.0_45/com/sun/corba/se/pept/transport/ConnectionCache.java,Java,,11,10,14,35
/jdk1.6.0_45/com/sun/corba/se/pept/transport/ContactInfo.java,Java,,33,20,162,215
/jdk1.6.0_45/com/sun/corba/se/pept/transport/ContactInfoList.java,Java,,6,4,24,34
/jdk1.6.0_45/com/sun/corba/se/pept/transport/ContactInfoListIterator.java,Java,,12,7,46,65
/jdk1.6.0_45/com/sun/corba/se/pept/transport/EventHandler.java,Java,,20,21,16,57
/jdk1.6.0_45/com/sun/corba/se/pept/transport/InboundConnectionCache.java,Java,,8,5,10,23
/jdk1.6.0_45/com/sun/corba/se/pept/transport/ListenerThread.java,Java,,6,11,10,27
/jdk1.6.0_45/com/sun/corba/se/pept/transport/OutboundConnectionCache.java,Java,,8,5,10,23
/jdk1.6.0_45/com/sun/corba/se/pept/transport/ReaderThread.java,Java,,5,11,10,26
/jdk1.6.0_45/com/sun/corba/se/pept/transport/ResponseWaitingRoom.java,Java,,11,9,11,31
/jdk1.6.0_45/com/sun/corba/se/pept/transport/Selector.java,Java,,10,11,10,31
/jdk1.6.0_45/com/sun/corba/se/pept/transport/TransportManager.java,Java,,20,14,10,44
/jdk1.6.0_45/com/sun/corba/se/PortableActivationIDL/Activator.java,Java,,4,3,6,13
/jdk1.6.0_45/com/sun/corba/se/PortableActivationIDL/ActivatorHelper.java,Java,,67,12,6,85
/jdk1.6.0_45/com/sun/corba/se/PortableActivationIDL/ActivatorHolder.java,Java,,24,8,6,38
/jdk1.6.0_45/com/sun/corba/se/PortableActivationIDL/ActivatorOperations.java,Java,,16,15,42,73
/jdk1.6.0_45/com/sun/corba/se/PortableActivationIDL/BadServerDefinition.java,Java,,19,8,6,33
/jdk1.6.0_45/com/sun/corba/se/PortableActivationIDL/BadServerDefinitionHelper.java,Java,,61,10,8,79
/jdk1.6.0_45/com/sun/corba/se/PortableActivationIDL/BadServerDefinitionHolder.java,Java,,24,8,6,38
/jdk1.6.0_45/com/sun/corba/se/PortableActivationIDL/EndPointInfo.java,Java,,14,6,6,26
/jdk1.6.0_45/com/sun/corba/se/PortableActivationIDL/EndPointInfoHelper.java,Java,,67,10,6,83
/jdk1.6.0_45/com/sun/corba/se/PortableActivationIDL/EndPointInfoHolder.java,Java,,24,8,6,38
/jdk1.6.0_45/com/sun/corba/se/PortableActivationIDL/EndpointInfoListHelper.java,Java,,46,11,8,65
/jdk1.6.0_45/com/sun/corba/se/PortableActivationIDL/EndpointInfoListHolder.java,Java,,24,10,8,42
/jdk1.6.0_45/com/sun/corba/se/PortableActivationIDL/IIOP_CLEAR_TEXT.java,Java,,5,4,11,20
/jdk1.6.0_45/com/sun/corba/se/PortableActivationIDL/InitialNameService.java,Java,,4,4,9,17
/jdk1.6.0_45/com/sun/corba/se/PortableActivationIDL/InitialNameServiceHelper.java,Java,,67,13,9,89
/jdk1.6.0_45/com/sun/corba/se/PortableActivationIDL/InitialNameServiceHolder.java,Java,,24,9,9,42
/jdk1.6.0_45/com/sun/corba/se/PortableActivationIDL/InitialNameServiceOperations.java,Java,,5,5,11,21
/jdk1.6.0_45/com/sun/corba/se/PortableActivationIDL/InitialNameServicePackage/NameAlreadyBound.java,Java,,12,7,6,25
/jdk1.6.0_45/com/sun/corba/se/PortableActivationIDL/InitialNameServicePackage/NameAlreadyBoundHelper.java,Java,,54,10,8,72
/jdk1.6.0_45/com/sun/corba/se/PortableActivationIDL/InitialNameServicePackage/NameAlreadyBoundHolder.java,Java,,24,8,6,38
/jdk1.6.0_45/com/sun/corba/se/PortableActivationIDL/InvalidORBid.java,Java,,12,7,6,25
/jdk1.6.0_45/com/sun/corba/se/PortableActivationIDL/InvalidORBidHelper.java,Java,,54,10,8,72
/jdk1.6.0_45/com/sun/corba/se/PortableActivationIDL/InvalidORBidHolder.java,Java,,24,8,6,38
/jdk1.6.0_45/com/sun/corba/se/PortableActivationIDL/Locator.java,Java,,4,3,6,13
/jdk1.6.0_45/com/sun/corba/se/PortableActivationIDL/LocatorHelper.java,Java,,67,12,6,85
/jdk1.6.0_45/com/sun/corba/se/PortableActivationIDL/LocatorHolder.java,Java,,24,8,6,38
/jdk1.6.0_45/com/sun/corba/se/PortableActivationIDL/LocatorOperations.java,Java,,8,7,19,34
/jdk1.6.0_45/com/sun/corba/se/PortableActivationIDL/LocatorPackage/ServerLocationPerORB.java,Java,,14,6,6,26
/jdk1.6.0_45/com/sun/corba/se/PortableActivationIDL/LocatorPackage/ServerLocationPerORBHelper.java,Java,,68,10,6,84
/jdk1.6.0_45/com/sun/corba/se/PortableActivationIDL/LocatorPackage/ServerLocationPerORBHolder.java,Java,,24,8,6,38
/jdk1.6.0_45/com/sun/corba/se/PortableActivationIDL/LocatorPackage/ServerLocationPerType.java,Java,,14,6,6,26
/jdk1.6.0_45/com/sun/corba/se/PortableActivationIDL/LocatorPackage/ServerLocationPerTypeHelper.java,Java,,68,10,6,84
/jdk1.6.0_45/com/sun/corba/se/PortableActivationIDL/LocatorPackage/ServerLocationPerTypeHolder.java,Java,,24,8,6,38
/jdk1.6.0_45/com/sun/corba/se/PortableActivationIDL/NoSuchEndPoint.java,Java,,12,7,6,25
/jdk1.6.0_45/com/sun/corba/se/PortableActivationIDL/NoSuchEndPointHelper.java,Java,,54,10,8,72
/jdk1.6.0_45/com/sun/corba/se/PortableActivationIDL/NoSuchEndPointHolder.java,Java,,24,8,6,38
/jdk1.6.0_45/com/sun/corba/se/PortableActivationIDL/ORBAlreadyRegistered.java,Java,,19,8,6,33
/jdk1.6.0_45/com/sun/corba/se/PortableActivationIDL/ORBAlreadyRegisteredHelper.java,Java,,62,10,8,80
/jdk1.6.0_45/com/sun/corba/se/PortableActivationIDL/ORBAlreadyRegisteredHolder.java,Java,,24,8,6,38
/jdk1.6.0_45/com/sun/corba/se/PortableActivationIDL/ORBidListHelper.java,Java,,47,11,8,66
/jdk1.6.0_45/com/sun/corba/se/PortableActivationIDL/ORBidListHolder.java,Java,,24,10,8,42
/jdk1.6.0_45/com/sun/corba/se/PortableActivationIDL/ORBPortInfo.java,Java,,14,6,6,26
/jdk1.6.0_45/com/sun/corba/se/PortableActivationIDL/ORBPortInfoHelper.java,Java,,68,10,6,84
/jdk1.6.0_45/com/sun/corba/se/PortableActivationIDL/ORBPortInfoHolder.java,Java,,24,8,6,38
/jdk1.6.0_45/com/sun/corba/se/PortableActivationIDL/ORBPortInfoListHelper.java,Java,,46,11,8,65
/jdk1.6.0_45/com/sun/corba/se/PortableActivationIDL/ORBPortInfoListHolder.java,Java,,24,10,8,42
/jdk1.6.0_45/com/sun/corba/se/PortableActivationIDL/ORBProxy.java,Java,,4,4,8,16
/jdk1.6.0_45/com/sun/corba/se/PortableActivationIDL/ORBProxyHelper.java,Java,,67,13,8,88
/jdk1.6.0_45/com/sun/corba/se/PortableActivationIDL/ORBProxyHolder.java,Java,,24,9,8,41
/jdk1.6.0_45/com/sun/corba/se/PortableActivationIDL/ORBProxyOperations.java,Java,,5,5,14,24
/jdk1.6.0_45/com/sun/corba/se/PortableActivationIDL/Repository.java,Java,,4,3,6,13
/jdk1.6.0_45/com/sun/corba/se/PortableActivationIDL/RepositoryHelper.java,Java,,67,12,6,85
/jdk1.6.0_45/com/sun/corba/se/PortableActivationIDL/RepositoryHolder.java,Java,,24,8,6,38
/jdk1.6.0_45/com/sun/corba/se/PortableActivationIDL/RepositoryOperations.java,Java,,13,12,29,54
/jdk1.6.0_45/com/sun/corba/se/PortableActivationIDL/RepositoryPackage/AppNamesHelper.java,Java,,46,11,8,65
/jdk1.6.0_45/com/sun/corba/se/PortableActivationIDL/RepositoryPackage/AppNamesHolder.java,Java,,24,10,8,42
/jdk1.6.0_45/com/sun/corba/se/PortableActivationIDL/RepositoryPackage/ServerDef.java,Java,,22,11,11,44
/jdk1.6.0_45/com/sun/corba/se/PortableActivationIDL/RepositoryPackage/ServerDefHelper.java,Java,,94,10,6,110
/jdk1.6.0_45/com/sun/corba/se/PortableActivationIDL/RepositoryPackage/ServerDefHolder.java,Java,,24,8,6,38
/jdk1.6.0_45/com/sun/corba/se/PortableActivationIDL/ServerAlreadyActive.java,Java,,19,8,6,33
/jdk1.6.0_45/com/sun/corba/se/PortableActivationIDL/ServerAlreadyActiveHelper.java,Java,,62,10,8,80
/jdk1.6.0_45/com/sun/corba/se/PortableActivationIDL/ServerAlreadyActiveHolder.java,Java,,24,8,6,38
/jdk1.6.0_45/com/sun/corba/se/PortableActivationIDL/ServerAlreadyInstalled.java,Java,,19,8,6,33
/jdk1.6.0_45/com/sun/corba/se/PortableActivationIDL/ServerAlreadyInstalledHelper.java,Java,,62,10,8,80
/jdk1.6.0_45/com/sun/corba/se/PortableActivationIDL/ServerAlreadyInstalledHolder.java,Java,,24,8,6,38
/jdk1.6.0_45/com/sun/corba/se/PortableActivationIDL/ServerAlreadyRegistered.java,Java,,19,8,6,33
/jdk1.6.0_45/com/sun/corba/se/PortableActivationIDL/ServerAlreadyRegisteredHelper.java,Java,,62,10,8,80
/jdk1.6.0_45/com/sun/corba/se/PortableActivationIDL/ServerAlreadyRegisteredHolder.java,Java,,24,8,6,38
/jdk1.6.0_45/com/sun/corba/se/PortableActivationIDL/ServerAlreadyUninstalled.java,Java,,19,8,6,33
/jdk1.6.0_45/com/sun/corba/se/PortableActivationIDL/ServerAlreadyUninstalledHelper.java,Java,,62,10,8,80
/jdk1.6.0_45/com/sun/corba/se/PortableActivationIDL/ServerAlreadyUninstalledHolder.java,Java,,24,8,6,38
/jdk1.6.0_45/com/sun/corba/se/PortableActivationIDL/ServerHeldDown.java,Java,,19,8,6,33
/jdk1.6.0_45/com/sun/corba/se/PortableActivationIDL/ServerHeldDownHelper.java,Java,,62,10,8,80
/jdk1.6.0_45/com/sun/corba/se/PortableActivationIDL/ServerHeldDownHolder.java,Java,,24,8,6,38
/jdk1.6.0_45/com/sun/corba/se/PortableActivationIDL/ServerIdsHelper.java,Java,,47,11,8,66
/jdk1.6.0_45/com/sun/corba/se/PortableActivationIDL/ServerIdsHolder.java,Java,,24,10,8,42
/jdk1.6.0_45/com/sun/corba/se/PortableActivationIDL/ServerManager.java,Java,,4,4,10,18
/jdk1.6.0_45/com/sun/corba/se/PortableActivationIDL/ServerManagerHelper.java,Java,,67,13,10,90
/jdk1.6.0_45/com/sun/corba/se/PortableActivationIDL/ServerManagerHolder.java,Java,,24,9,10,43
/jdk1.6.0_45/com/sun/corba/se/PortableActivationIDL/ServerManagerOperations.java,Java,,4,4,10,18
/jdk1.6.0_45/com/sun/corba/se/PortableActivationIDL/ServerNotActive.java,Java,,19,8,6,33
/jdk1.6.0_45/com/sun/corba/se/PortableActivationIDL/ServerNotActiveHelper.java,Java,,62,10,8,80
/jdk1.6.0_45/com/sun/corba/se/PortableActivationIDL/ServerNotActiveHolder.java,Java,,24,8,6,38
/jdk1.6.0_45/com/sun/corba/se/PortableActivationIDL/ServerNotRegistered.java,Java,,19,8,6,33
/jdk1.6.0_45/com/sun/corba/se/PortableActivationIDL/ServerNotRegisteredHelper.java,Java,,62,10,8,80
/jdk1.6.0_45/com/sun/corba/se/PortableActivationIDL/ServerNotRegisteredHolder.java,Java,,24,8,6,38
/jdk1.6.0_45/com/sun/corba/se/PortableActivationIDL/ServerProxy.java,Java,,4,4,8,16
/jdk1.6.0_45/com/sun/corba/se/PortableActivationIDL/ServerProxyHelper.java,Java,,67,13,8,88
/jdk1.6.0_45/com/sun/corba/se/PortableActivationIDL/ServerProxyHolder.java,Java,,24,9,8,41
/jdk1.6.0_45/com/sun/corba/se/PortableActivationIDL/ServerProxyOperations.java,Java,,7,7,16,30
/jdk1.6.0_45/com/sun/corba/se/PortableActivationIDL/TCPPortHelper.java,Java,,40,11,11,62
/jdk1.6.0_45/com/sun/corba/se/PortableActivationIDL/_ActivatorImplBase.java,Java,,208,36,44,288
/jdk1.6.0_45/com/sun/corba/se/PortableActivationIDL/_ActivatorStub.java,Java,,304,31,43,378
/jdk1.6.0_45/com/sun/corba/se/PortableActivationIDL/_InitialNameServiceImplBase.java,Java,,48,15,13,76
/jdk1.6.0_45/com/sun/corba/se/PortableActivationIDL/_InitialNameServiceStub.java,Java,,59,10,12,81
/jdk1.6.0_45/com/sun/corba/se/PortableActivationIDL/_LocatorImplBase.java,Java,,108,20,21,149
/jdk1.6.0_45/com/sun/corba/se/PortableActivationIDL/_LocatorStub.java,Java,,135,15,20,170
/jdk1.6.0_45/com/sun/corba/se/PortableActivationIDL/_ORBProxyImplBase.java,Java,,43,15,16,74
/jdk1.6.0_45/com/sun/corba/se/PortableActivationIDL/_ORBProxyStub.java,Java,,55,10,15,80
/jdk1.6.0_45/com/sun/corba/se/PortableActivationIDL/_RepositoryImplBase.java,Java,,159,30,31,220
/jdk1.6.0_45/com/sun/corba/se/PortableActivationIDL/_RepositoryStub.java,Java,,229,25,30,284
/jdk1.6.0_45/com/sun/corba/se/PortableActivationIDL/_ServerManagerImplBase.java,Java,,285,45,61,391
/jdk1.6.0_45/com/sun/corba/se/PortableActivationIDL/_ServerManagerStub.java,Java,,405,40,60,505
/jdk1.6.0_45/com/sun/corba/se/PortableActivationIDL/_ServerProxyImplBase.java,Java,,54,19,18,91
/jdk1.6.0_45/com/sun/corba/se/PortableActivationIDL/_ServerProxyStub.java,Java,,87,14,17,118
/jdk1.6.0_45/com/sun/corba/se/spi/activation/Activator.java,Java,,4,3,6,13
/jdk1.6.0_45/com/sun/corba/se/spi/activation/ActivatorHelper.java,Java,,67,12,6,85
/jdk1.6.0_45/com/sun/corba/se/spi/activation/ActivatorHolder.java,Java,,24,8,6,38
/jdk1.6.0_45/com/sun/corba/se/spi/activation/ActivatorOperations.java,Java,,12,11,14,37
/jdk1.6.0_45/com/sun/corba/se/spi/activation/BadServerDefinition.java,Java,,19,8,6,33
/jdk1.6.0_45/com/sun/corba/se/spi/activation/BadServerDefinitionHelper.java,Java,,61,10,8,79
/jdk1.6.0_45/com/sun/corba/se/spi/activation/BadServerDefinitionHolder.java,Java,,24,8,6,38
/jdk1.6.0_45/com/sun/corba/se/spi/activation/EndPointInfo.java,Java,,14,6,6,26
/jdk1.6.0_45/com/sun/corba/se/spi/activation/EndPointInfoHelper.java,Java,,67,10,6,83
/jdk1.6.0_45/com/sun/corba/se/spi/activation/EndPointInfoHolder.java,Java,,24,8,6,38
/jdk1.6.0_45/com/sun/corba/se/spi/activation/EndpointInfoListHelper.java,Java,,46,10,6,62
/jdk1.6.0_45/com/sun/corba/se/spi/activation/EndpointInfoListHolder.java,Java,,24,9,6,39
/jdk1.6.0_45/com/sun/corba/se/spi/activation/IIOP_CLEAR_TEXT.java,Java,,5,4,7,16
/jdk1.6.0_45/com/sun/corba/se/spi/activation/InitialNameService.java,Java,,4,3,6,13
/jdk1.6.0_45/com/sun/corba/se/spi/activation/InitialNameServiceHelper.java,Java,,67,12,6,85
/jdk1.6.0_45/com/sun/corba/se/spi/activation/InitialNameServiceHolder.java,Java,,24,8,6,38
/jdk1.6.0_45/com/sun/corba/se/spi/activation/InitialNameServiceOperations.java,Java,,5,4,7,16
/jdk1.6.0_45/com/sun/corba/se/spi/activation/InitialNameServicePackage/NameAlreadyBound.java,Java,,12,7,6,25
/jdk1.6.0_45/com/sun/corba/se/spi/activation/InitialNameServicePackage/NameAlreadyBoundHelper.java,Java,,54,10,8,72
/jdk1.6.0_45/com/sun/corba/se/spi/activation/InitialNameServicePackage/NameAlreadyBoundHolder.java,Java,,24,8,6,38
/jdk1.6.0_45/com/sun/corba/se/spi/activation/InvalidORBid.java,Java,,12,7,6,25
/jdk1.6.0_45/com/sun/corba/se/spi/activation/InvalidORBidHelper.java,Java,,54,10,8,72
/jdk1.6.0_45/com/sun/corba/se/spi/activation/InvalidORBidHolder.java,Java,,24,8,6,38
/jdk1.6.0_45/com/sun/corba/se/spi/activation/Locator.java,Java,,4,3,6,13
/jdk1.6.0_45/com/sun/corba/se/spi/activation/LocatorHelper.java,Java,,67,12,6,85
/jdk1.6.0_45/com/sun/corba/se/spi/activation/LocatorHolder.java,Java,,24,8,6,38
/jdk1.6.0_45/com/sun/corba/se/spi/activation/LocatorOperations.java,Java,,8,7,10,25
/jdk1.6.0_45/com/sun/corba/se/spi/activation/LocatorPackage/ServerLocation.java,Java,,14,6,6,26
/jdk1.6.0_45/com/sun/corba/se/spi/activation/LocatorPackage/ServerLocationHelper.java,Java,,68,10,6,84
/jdk1.6.0_45/com/sun/corba/se/spi/activation/LocatorPackage/ServerLocationHolder.java,Java,,24,8,6,38
/jdk1.6.0_45/com/sun/corba/se/spi/activation/LocatorPackage/ServerLocationPerORB.java,Java,,14,6,6,26
/jdk1.6.0_45/com/sun/corba/se/spi/activation/LocatorPackage/ServerLocationPerORBHelper.java,Java,,68,10,6,84
/jdk1.6.0_45/com/sun/corba/se/spi/activation/LocatorPackage/ServerLocationPerORBHolder.java,Java,,24,8,6,38
/jdk1.6.0_45/com/sun/corba/se/spi/activation/NoSuchEndPoint.java,Java,,12,7,6,25
/jdk1.6.0_45/com/sun/corba/se/spi/activation/NoSuchEndPointHelper.java,Java,,54,10,8,72
/jdk1.6.0_45/com/sun/corba/se/spi/activation/NoSuchEndPointHolder.java,Java,,24,8,6,38
/jdk1.6.0_45/com/sun/corba/se/spi/activation/ORBAlreadyRegistered.java,Java,,19,8,6,33
/jdk1.6.0_45/com/sun/corba/se/spi/activation/ORBAlreadyRegisteredHelper.java,Java,,62,10,8,80
/jdk1.6.0_45/com/sun/corba/se/spi/activation/ORBAlreadyRegisteredHolder.java,Java,,24,8,6,38
/jdk1.6.0_45/com/sun/corba/se/spi/activation/ORBidHelper.java,Java,,40,11,7,58
/jdk1.6.0_45/com/sun/corba/se/spi/activation/ORBidListHelper.java,Java,,47,10,6,63
/jdk1.6.0_45/com/sun/corba/se/spi/activation/ORBidListHolder.java,Java,,24,9,6,39
/jdk1.6.0_45/com/sun/corba/se/spi/activation/ORBPortInfo.java,Java,,14,6,6,26
/jdk1.6.0_45/com/sun/corba/se/spi/activation/ORBPortInfoHelper.java,Java,,68,10,6,84
/jdk1.6.0_45/com/sun/corba/se/spi/activation/ORBPortInfoHolder.java,Java,,24,8,6,38
/jdk1.6.0_45/com/sun/corba/se/spi/activation/ORBPortInfoListHelper.java,Java,,46,10,6,62
/jdk1.6.0_45/com/sun/corba/se/spi/activation/ORBPortInfoListHolder.java,Java,,24,9,6,39
/jdk1.6.0_45/com/sun/corba/se/spi/activation/POANameHelper.java,Java,,46,10,6,62
/jdk1.6.0_45/com/sun/corba/se/spi/activation/POANameHolder.java,Java,,24,9,6,39
/jdk1.6.0_45/com/sun/corba/se/spi/activation/Repository.java,Java,,4,3,6,13
/jdk1.6.0_45/com/sun/corba/se/spi/activation/RepositoryHelper.java,Java,,67,12,6,85
/jdk1.6.0_45/com/sun/corba/se/spi/activation/RepositoryHolder.java,Java,,24,8,6,38
/jdk1.6.0_45/com/sun/corba/se/spi/activation/RepositoryOperations.java,Java,,13,12,15,40
/jdk1.6.0_45/com/sun/corba/se/spi/activation/RepositoryPackage/ServerDef.java,Java,,20,9,9,38
/jdk1.6.0_45/com/sun/corba/se/spi/activation/RepositoryPackage/ServerDefHelper.java,Java,,87,10,6,103
/jdk1.6.0_45/com/sun/corba/se/spi/activation/RepositoryPackage/ServerDefHolder.java,Java,,24,8,6,38
/jdk1.6.0_45/com/sun/corba/se/spi/activation/RepositoryPackage/StringSeqHelper.java,Java,,46,10,6,62
/jdk1.6.0_45/com/sun/corba/se/spi/activation/RepositoryPackage/StringSeqHolder.java,Java,,24,9,6,39
/jdk1.6.0_45/com/sun/corba/se/spi/activation/Server.java,Java,,4,4,8,16
/jdk1.6.0_45/com/sun/corba/se/spi/activation/ServerAlreadyActive.java,Java,,19,8,6,33
/jdk1.6.0_45/com/sun/corba/se/spi/activation/ServerAlreadyActiveHelper.java,Java,,62,10,8,80
/jdk1.6.0_45/com/sun/corba/se/spi/activation/ServerAlreadyActiveHolder.java,Java,,24,8,6,38
/jdk1.6.0_45/com/sun/corba/se/spi/activation/ServerAlreadyInstalled.java,Java,,19,8,6,33
/jdk1.6.0_45/com/sun/corba/se/spi/activation/ServerAlreadyInstalledHelper.java,Java,,62,10,8,80
/jdk1.6.0_45/com/sun/corba/se/spi/activation/ServerAlreadyInstalledHolder.java,Java,,24,8,6,38
/jdk1.6.0_45/com/sun/corba/se/spi/activation/ServerAlreadyRegistered.java,Java,,19,8,6,33
/jdk1.6.0_45/com/sun/corba/se/spi/activation/ServerAlreadyRegisteredHelper.java,Java,,62,10,8,80
/jdk1.6.0_45/com/sun/corba/se/spi/activation/ServerAlreadyRegisteredHolder.java,Java,,24,8,6,38
/jdk1.6.0_45/com/sun/corba/se/spi/activation/ServerAlreadyUninstalled.java,Java,,19,8,6,33
/jdk1.6.0_45/com/sun/corba/se/spi/activation/ServerAlreadyUninstalledHelper.java,Java,,62,10,8,80
/jdk1.6.0_45/com/sun/corba/se/spi/activation/ServerAlreadyUninstalledHolder.java,Java,,24,8,6,38
/jdk1.6.0_45/com/sun/corba/se/spi/activation/ServerHeldDown.java,Java,,19,8,6,33
/jdk1.6.0_45/com/sun/corba/se/spi/activation/ServerHeldDownHelper.java,Java,,62,10,8,80
/jdk1.6.0_45/com/sun/corba/se/spi/activation/ServerHeldDownHolder.java,Java,,24,8,6,38
/jdk1.6.0_45/com/sun/corba/se/spi/activation/ServerHelper.java,Java,,67,13,8,88
/jdk1.6.0_45/com/sun/corba/se/spi/activation/ServerHolder.java,Java,,24,9,8,41
/jdk1.6.0_45/com/sun/corba/se/spi/activation/ServerIdHelper.java,Java,,40,10,6,56
/jdk1.6.0_45/com/sun/corba/se/spi/activation/ServerIdsHelper.java,Java,,47,10,6,63
/jdk1.6.0_45/com/sun/corba/se/spi/activation/ServerIdsHolder.java,Java,,24,9,6,39
/jdk1.6.0_45/com/sun/corba/se/spi/activation/ServerManager.java,Java,,4,3,6,13
/jdk1.6.0_45/com/sun/corba/se/spi/activation/ServerManagerHelper.java,Java,,67,12,6,85
/jdk1.6.0_45/com/sun/corba/se/spi/activation/ServerManagerHolder.java,Java,,24,8,6,38
/jdk1.6.0_45/com/sun/corba/se/spi/activation/ServerManagerOperations.java,Java,,4,3,6,13
/jdk1.6.0_45/com/sun/corba/se/spi/activation/ServerNotActive.java,Java,,19,8,6,33
/jdk1.6.0_45/com/sun/corba/se/spi/activation/ServerNotActiveHelper.java,Java,,62,10,8,80
/jdk1.6.0_45/com/sun/corba/se/spi/activation/ServerNotActiveHolder.java,Java,,24,8,6,38
/jdk1.6.0_45/com/sun/corba/se/spi/activation/ServerNotRegistered.java,Java,,19,8,6,33
/jdk1.6.0_45/com/sun/corba/se/spi/activation/ServerNotRegisteredHelper.java,Java,,62,10,8,80
/jdk1.6.0_45/com/sun/corba/se/spi/activation/ServerNotRegisteredHolder.java,Java,,24,8,6,38
/jdk1.6.0_45/com/sun/corba/se/spi/activation/ServerOperations.java,Java,,7,7,16,30
/jdk1.6.0_45/com/sun/corba/se/spi/activation/TCPPortHelper.java,Java,,40,10,6,56
/jdk1.6.0_45/com/sun/corba/se/spi/activation/_ActivatorImplBase.java,Java,,165,28,16,209
/jdk1.6.0_45/com/sun/corba/se/spi/activation/_ActivatorStub.java,Java,,223,23,15,261
/jdk1.6.0_45/com/sun/corba/se/spi/activation/_InitialNameServiceImplBase.java,Java,,48,14,9,71
/jdk1.6.0_45/com/sun/corba/se/spi/activation/_InitialNameServiceStub.java,Java,,59,9,8,76
/jdk1.6.0_45/com/sun/corba/se/spi/activation/_LocatorImplBase.java,Java,,108,20,12,140
/jdk1.6.0_45/com/sun/corba/se/spi/activation/_LocatorStub.java,Java,,135,15,11,161
/jdk1.6.0_45/com/sun/corba/se/spi/activation/_RepositoryImplBase.java,Java,,159,30,17,206
/jdk1.6.0_45/com/sun/corba/se/spi/activation/_RepositoryStub.java,Java,,229,25,16,270
/jdk1.6.0_45/com/sun/corba/se/spi/activation/_ServerImplBase.java,Java,,54,19,18,91
/jdk1.6.0_45/com/sun/corba/se/spi/activation/_ServerManagerImplBase.java,Java,,242,36,20,298
/jdk1.6.0_45/com/sun/corba/se/spi/activation/_ServerManagerStub.java,Java,,324,31,19,374
/jdk1.6.0_45/com/sun/corba/se/spi/activation/_ServerStub.java,Java,,87,14,17,118
/jdk1.6.0_45/com/sun/corba/se/spi/copyobject/CopierManager.java,Java,,9,6,19,34
/jdk1.6.0_45/com/sun/corba/se/spi/copyobject/CopyobjectDefaults.java,Java,,52,10,20,82
/jdk1.6.0_45/com/sun/corba/se/spi/copyobject/ObjectCopier.java,Java,,4,2,14,20
/jdk1.6.0_45/com/sun/corba/se/spi/copyobject/ObjectCopierFactory.java,Java,,5,3,10,18
/jdk1.6.0_45/com/sun/corba/se/spi/copyobject/ReflectiveCopyException.java,Java,,15,3,6,24
/jdk1.6.0_45/com/sun/corba/se/spi/encoding/CorbaInputObject.java,Java,,8,3,6,17
/jdk1.6.0_45/com/sun/corba/se/spi/encoding/CorbaOutputObject.java,Java,,22,7,6,35
/jdk1.6.0_45/com/sun/corba/se/spi/extension/CopyObjectPolicy.java,Java,,31,9,9,49
/jdk1.6.0_45/com/sun/corba/se/spi/extension/RequestPartitioningPolicy.java,Java,,45,11,10,66
/jdk1.6.0_45/com/sun/corba/se/spi/extension/ServantCachingPolicy.java,Java,,73,22,48,143
/jdk1.6.0_45/com/sun/corba/se/spi/extension/ZeroPortPolicy.java,Java,,36,11,9,56
/jdk1.6.0_45/com/sun/corba/se/spi/ior/EncapsulationFactoryBase.java,Java,,20,8,6,34
/jdk1.6.0_45/com/sun/corba/se/spi/ior/Identifiable.java,Java,,5,4,15,24
/jdk1.6.0_45/com/sun/corba/se/spi/ior/IdentifiableBase.java,Java,,14,5,16,35
/jdk1.6.0_45/com/sun/corba/se/spi/ior/IdentifiableContainerBase.java,Java,,44,11,18,73
/jdk1.6.0_45/com/sun/corba/se/spi/ior/IdentifiableFactory.java,Java,,7,5,14,26
/jdk1.6.0_45/com/sun/corba/se/spi/ior/IdentifiableFactoryFinder.java,Java,,7,4,20,31
/jdk1.6.0_45/com/sun/corba/se/spi/ior/iiop/AlternateIIOPAddressComponent.java,Java,,7,3,9,19
/jdk1.6.0_45/com/sun/corba/se/spi/ior/iiop/CodeSetsComponent.java,Java,,7,4,9,20
/jdk1.6.0_45/com/sun/corba/se/spi/ior/iiop/GIOPVersion.java,Java,,134,43,24,201
/jdk1.6.0_45/com/sun/corba/se/spi/ior/iiop/IIOPAddress.java,Java,,7,4,9,20
/jdk1.6.0_45/com/sun/corba/se/spi/ior/iiop/IIOPFactories.java,Java,,182,30,11,223
/jdk1.6.0_45/com/sun/corba/se/spi/ior/iiop/IIOPProfile.java,Java,,12,8,22,42
/jdk1.6.0_45/com/sun/corba/se/spi/ior/iiop/IIOPProfileTemplate.java,Java,,12,7,16,35
/jdk1.6.0_45/com/sun/corba/se/spi/ior/iiop/JavaCodebaseComponent.java,Java,,6,3,9,18
/jdk1.6.0_45/com/sun/corba/se/spi/ior/iiop/MaxStreamFormatVersionComponent.java,Java,,6,2,8,16
/jdk1.6.0_45/com/sun/corba/se/spi/ior/iiop/ORBTypeComponent.java,Java,,6,3,9,18
/jdk1.6.0_45/com/sun/corba/se/spi/ior/iiop/RequestPartitioningComponent.java,Java,,6,2,6,14
/jdk1.6.0_45/com/sun/corba/se/spi/ior/IOR.java,Java,,19,14,35,68
/jdk1.6.0_45/com/sun/corba/se/spi/ior/IORFactories.java,Java,,114,31,40,185
/jdk1.6.0_45/com/sun/corba/se/spi/ior/IORFactory.java,Java,,6,4,17,27
/jdk1.6.0_45/com/sun/corba/se/spi/ior/IORTemplate.java,Java,,7,4,12,23
/jdk1.6.0_45/com/sun/corba/se/spi/ior/IORTemplateList.java,Java,,4,4,12,20
/jdk1.6.0_45/com/sun/corba/se/spi/ior/MakeImmutable.java,Java,,4,2,6,12
/jdk1.6.0_45/com/sun/corba/se/spi/ior/ObjectAdapterId.java,Java,,7,5,17,29
/jdk1.6.0_45/com/sun/corba/se/spi/ior/ObjectId.java,Java,,5,2,9,16
/jdk1.6.0_45/com/sun/corba/se/spi/ior/ObjectKey.java,Java,,10,7,17,34
/jdk1.6.0_45/com/sun/corba/se/spi/ior/ObjectKeyFactory.java,Java,,9,5,14,28
/jdk1.6.0_45/com/sun/corba/se/spi/ior/ObjectKeyTemplate.java,Java,,16,12,28,56
/jdk1.6.0_45/com/sun/corba/se/spi/ior/TaggedComponent.java,Java,,7,3,12,22
/jdk1.6.0_45/com/sun/corba/se/spi/ior/TaggedComponentBase.java,Java,,16,6,10,32
/jdk1.6.0_45/com/sun/corba/se/spi/ior/TaggedComponentFactoryFinder.java,Java,,6,2,9,17
/jdk1.6.0_45/com/sun/corba/se/spi/ior/TaggedProfile.java,Java,,12,9,27,48
/jdk1.6.0_45/com/sun/corba/se/spi/ior/TaggedProfileTemplate.java,Java,,19,10,31,60
/jdk1.6.0_45/com/sun/corba/se/spi/ior/TaggedProfileTemplateBase.java,Java,,32,10,6,48
/jdk1.6.0_45/com/sun/corba/se/spi/ior/Writeable.java,Java,,6,3,11,20
/jdk1.6.0_45/com/sun/corba/se/spi/ior/WriteContents.java,Java,,5,3,6,14
/jdk1.6.0_45/com/sun/corba/se/spi/legacy/connection/Connection.java,Java,,5,3,9,17
/jdk1.6.0_45/com/sun/corba/se/spi/legacy/connection/GetEndPointInfoAgainException.java,Java,,15,6,13,34
/jdk1.6.0_45/com/sun/corba/se/spi/legacy/connection/LegacyServerSocketEndPointInfo.java,Java,,13,10,24,47
/jdk1.6.0_45/com/sun/corba/se/spi/legacy/connection/LegacyServerSocketManager.java,Java,,12,7,10,29
/jdk1.6.0_45/com/sun/corba/se/spi/legacy/connection/ORBSocketFactory.java,Java,,20,15,307,342
/jdk1.6.0_45/com/sun/corba/se/spi/legacy/interceptor/IORInfoExt.java,Java,,9,5,7,21
/jdk1.6.0_45/com/sun/corba/se/spi/legacy/interceptor/ORBInitInfoExt.java,Java,,6,3,14,23
/jdk1.6.0_45/com/sun/corba/se/spi/legacy/interceptor/RequestInfoExt.java,Java,,6,4,17,27
/jdk1.6.0_45/com/sun/corba/se/spi/legacy/interceptor/UnknownType.java,Java,,14,3,6,23
/jdk1.6.0_45/com/sun/corba/se/spi/logging/CORBALogDomains.java,Java,,29,27,87,143
/jdk1.6.0_45/com/sun/corba/se/spi/logging/LogWrapperBase.java,Java,,49,12,13,74
/jdk1.6.0_45/com/sun/corba/se/spi/logging/LogWrapperFactory.java,Java,,6,4,6,16
/jdk1.6.0_45/com/sun/corba/se/spi/monitoring/LongMonitoredAttributeBase.java,Java,,12,10,33,55
/jdk1.6.0_45/com/sun/corba/se/spi/monitoring/MonitoredAttribute.java,Java,,10,7,78,95
/jdk1.6.0_45/com/sun/corba/se/spi/monitoring/MonitoredAttributeBase.java,Java,,34,15,51,100
/jdk1.6.0_45/com/sun/corba/se/spi/monitoring/MonitoredAttributeInfo.java,Java,,8,5,56,69
/jdk1.6.0_45/com/sun/corba/se/spi/monitoring/MonitoredAttributeInfoFactory.java,Java,,5,2,22,29
/jdk1.6.0_45/com/sun/corba/se/spi/monitoring/MonitoredObject.java,Java,,19,8,146,173
/jdk1.6.0_45/com/sun/corba/se/spi/monitoring/MonitoredObjectFactory.java,Java,,4,1,20,25
/jdk1.6.0_45/com/sun/corba/se/spi/monitoring/MonitoringConstants.java,Java,,72,12,13,97
/jdk1.6.0_45/com/sun/corba/se/spi/monitoring/MonitoringFactories.java,Java,,24,7,62,93
/jdk1.6.0_45/com/sun/corba/se/spi/monitoring/MonitoringManager.java,Java,,9,5,37,51
/jdk1.6.0_45/com/sun/corba/se/spi/monitoring/MonitoringManagerFactory.java,Java,,6,2,19,27
/jdk1.6.0_45/com/sun/corba/se/spi/monitoring/StatisticMonitoredAttribute.java,Java,,31,18,66,115
/jdk1.6.0_45/com/sun/corba/se/spi/monitoring/StatisticsAccumulator.java,Java,,88,32,87,207
/jdk1.6.0_45/com/sun/corba/se/spi/monitoring/StringMonitoredAttributeBase.java,Java,,14,10,34,58
/jdk1.6.0_45/com/sun/corba/se/spi/oa/NullServant.java,Java,,6,3,18,27
/jdk1.6.0_45/com/sun/corba/se/spi/oa/OADefault.java,Java,,18,4,10,32
/jdk1.6.0_45/com/sun/corba/se/spi/oa/OADestroyed.java,Java,,3,1,9,13
/jdk1.6.0_45/com/sun/corba/se/spi/oa/OAInvocationInfo.java,Java,,51,18,23,92
/jdk1.6.0_45/com/sun/corba/se/spi/oa/ObjectAdapter.java,Java,,25,25,181,231
/jdk1.6.0_45/com/sun/corba/se/spi/oa/ObjectAdapterBase.java,Java,,129,38,18,185
/jdk1.6.0_45/com/sun/corba/se/spi/oa/ObjectAdapterFactory.java,Java,,10,8,14,32
/jdk1.6.0_45/com/sun/corba/se/spi/orb/DataCollector.java,Java,,10,5,32,47
/jdk1.6.0_45/com/sun/corba/se/spi/orb/Operation.java,Java,,4,1,11,16
/jdk1.6.0_45/com/sun/corba/se/spi/orb/OperationFactory.java,Java,,406,99,42,547
/jdk1.6.0_45/com/sun/corba/se/spi/orb/ORB.java,Java,,319,99,117,535
/jdk1.6.0_45/com/sun/corba/se/spi/orb/ORBConfigurator.java,Java,,4,2,13,19
/jdk1.6.0_45/com/sun/corba/se/spi/orb/ORBData.java,Java,,65,48,27,140
/jdk1.6.0_45/com/sun/corba/se/spi/orb/ORBVersion.java,Java,,14,6,6,26
/jdk1.6.0_45/com/sun/corba/se/spi/orb/ORBVersionFactory.java,Java,,53,14,28,95
/jdk1.6.0_45/com/sun/corba/se/spi/orb/ParserData.java,Java,,11,9,6,26
/jdk1.6.0_45/com/sun/corba/se/spi/orb/ParserDataFactory.java,Java,,19,3,6,28
/jdk1.6.0_45/com/sun/corba/se/spi/orb/ParserImplBase.java,Java,,80,20,18,118
/jdk1.6.0_45/com/sun/corba/se/spi/orb/ParserImplTableBase.java,Java,,113,25,17,155
/jdk1.6.0_45/com/sun/corba/se/spi/orb/PropertyParser.java,Java,,46,11,10,67
/jdk1.6.0_45/com/sun/corba/se/spi/orb/StringPair.java,Java,,32,10,6,48
/jdk1.6.0_45/com/sun/corba/se/spi/orbutil/closure/Closure.java,Java,,4,2,6,12
/jdk1.6.0_45/com/sun/corba/se/spi/orbutil/closure/ClosureFactory.java,Java,,14,5,6,25
/jdk1.6.0_45/com/sun/corba/se/spi/orbutil/fsm/Action.java,Java,,5,4,30,39
/jdk1.6.0_45/com/sun/corba/se/spi/orbutil/fsm/ActionBase.java,Java,,5,3,6,14
/jdk1.6.0_45/com/sun/corba/se/spi/orbutil/fsm/FSM.java,Java,,6,5,29,40
/jdk1.6.0_45/com/sun/corba/se/spi/orbutil/fsm/FSMImpl.java,Java,,44,14,40,98
/jdk1.6.0_45/com/sun/corba/se/spi/orbutil/fsm/FSMTest.java,Java,,172,31,6,209
/jdk1.6.0_45/com/sun/corba/se/spi/orbutil/fsm/Guard.java,Java,,44,14,28,86
/jdk1.6.0_45/com/sun/corba/se/spi/orbutil/fsm/GuardBase.java,Java,,5,3,6,14
/jdk1.6.0_45/com/sun/corba/se/spi/orbutil/fsm/Input.java,Java,,4,3,17,24
/jdk1.6.0_45/com/sun/corba/se/spi/orbutil/fsm/InputImpl.java,Java,,5,3,6,14
/jdk1.6.0_45/com/sun/corba/se/spi/orbutil/fsm/State.java,Java,,6,4,29,39
/jdk1.6.0_45/com/sun/corba/se/spi/orbutil/fsm/StateEngine.java,Java,,17,12,65,94
/jdk1.6.0_45/com/sun/corba/se/spi/orbutil/fsm/StateEngineFactory.java,Java,,9,4,12,25
/jdk1.6.0_45/com/sun/corba/se/spi/orbutil/fsm/StateImpl.java,Java,,54,17,10,81
/jdk1.6.0_45/com/sun/corba/se/spi/orbutil/proxy/CompositeInvocationHandler.java,Java,,9,3,5,17
/jdk1.6.0_45/com/sun/corba/se/spi/orbutil/proxy/CompositeInvocationHandlerImpl.java,Java,,42,11,3,56
/jdk1.6.0_45/com/sun/corba/se/spi/orbutil/proxy/DelegateInvocationHandlerImpl.java,Java,,31,6,10,47
/jdk1.6.0_45/com/sun/corba/se/spi/orbutil/proxy/InvocationHandlerFactory.java,Java,,7,6,11,24
/jdk1.6.0_45/com/sun/corba/se/spi/orbutil/proxy/LinkedInvocationHandler.java,Java,,8,5,10,23
/jdk1.6.0_45/com/sun/corba/se/spi/orbutil/threadpool/NoSuchThreadPoolException.java,Java,,4,4,5,13
/jdk1.6.0_45/com/sun/corba/se/spi/orbutil/threadpool/NoSuchWorkQueueException.java,Java,,4,4,5,13
/jdk1.6.0_45/com/sun/corba/se/spi/orbutil/threadpool/ThreadPool.java,Java,,17,17,64,98
/jdk1.6.0_45/com/sun/corba/se/spi/orbutil/threadpool/ThreadPoolChooser.java,Java,,7,5,21,33
/jdk1.6.0_45/com/sun/corba/se/spi/orbutil/threadpool/ThreadPoolManager.java,Java,,14,12,51,77
/jdk1.6.0_45/com/sun/corba/se/spi/orbutil/threadpool/Work.java,Java,,8,9,19,36
/jdk1.6.0_45/com/sun/corba/se/spi/orbutil/threadpool/WorkQueue.java,Java,,11,10,27,48
/jdk1.6.0_45/com/sun/corba/se/spi/presentation/rmi/DynamicMethodMarshaller.java,Java,,20,15,42,77
/jdk1.6.0_45/com/sun/corba/se/spi/presentation/rmi/DynamicStub.java,Java,,15,12,25,52
/jdk1.6.0_45/com/sun/corba/se/spi/presentation/rmi/IDLNameTranslator.java,Java,,9,7,23,39
/jdk1.6.0_45/com/sun/corba/se/spi/presentation/rmi/PresentationDefaults.java,Java,,28,11,6,45
/jdk1.6.0_45/com/sun/corba/se/spi/presentation/rmi/PresentationManager.java,Java,,38,23,91,152
/jdk1.6.0_45/com/sun/corba/se/spi/presentation/rmi/StubAdapter.java,Java,,134,25,32,191
/jdk1.6.0_45/com/sun/corba/se/spi/presentation/rmi/StubWrapper.java,Java,,108,27,9,144
/jdk1.6.0_45/com/sun/corba/se/spi/protocol/ClientDelegateFactory.java,Java,,6,4,8,18
/jdk1.6.0_45/com/sun/corba/se/spi/protocol/CorbaClientDelegate.java,Java,,6,3,7,16
/jdk1.6.0_45/com/sun/corba/se/spi/protocol/CorbaMessageMediator.java,Java,,80,25,24,129
/jdk1.6.0_45/com/sun/corba/se/spi/protocol/CorbaProtocolHandler.java,Java,,39,11,10,60
/jdk1.6.0_45/com/sun/corba/se/spi/protocol/CorbaServerRequestDispatcher.java,Java,,9,7,19,35
/jdk1.6.0_45/com/sun/corba/se/spi/protocol/ForwardException.java,Java,,38,15,13,66
/jdk1.6.0_45/com/sun/corba/se/spi/protocol/InitialServerRequestDispatcher.java,Java,,7,4,14,25
/jdk1.6.0_45/com/sun/corba/se/spi/protocol/LocalClientRequestDispatcher.java,Java,,12,8,35,55
/jdk1.6.0_45/com/sun/corba/se/spi/protocol/LocalClientRequestDispatcherFactory.java,Java,,5,4,6,15
/jdk1.6.0_45/com/sun/corba/se/spi/protocol/PIHandler.java,Java,,56,41,191,288
/jdk1.6.0_45/com/sun/corba/se/spi/protocol/RequestDispatcherDefault.java,Java,,74,16,7,97
/jdk1.6.0_45/com/sun/corba/se/spi/protocol/RequestDispatcherRegistry.java,Java,,19,17,42,78
/jdk1.6.0_45/com/sun/corba/se/spi/protocol/RetryType.java,Java,,13,6,15,34
/jdk1.6.0_45/com/sun/corba/se/spi/resolver/LocalResolver.java,Java,,5,3,12,20
/jdk1.6.0_45/com/sun/corba/se/spi/resolver/Resolver.java,Java,,5,3,18,26
/jdk1.6.0_45/com/sun/corba/se/spi/resolver/ResolverDefault.java,Java,,52,13,22,87
/jdk1.6.0_45/com/sun/corba/se/spi/servicecontext/CodeSetServiceContext.java,Java,,35,9,7,51
/jdk1.6.0_45/com/sun/corba/se/spi/servicecontext/MaxStreamFormatVersionServiceContext.java,Java,,41,17,11,69
/jdk1.6.0_45/com/sun/corba/se/spi/servicecontext/ORBVersionServiceContext.java,Java,,39,14,12,65
/jdk1.6.0_45/com/sun/corba/se/spi/servicecontext/SendingContextServiceContext.java,Java,,35,9,7,51
/jdk1.6.0_45/com/sun/corba/se/spi/servicecontext/ServiceContext.java,Java,,39,11,52,102
/jdk1.6.0_45/com/sun/corba/se/spi/servicecontext/ServiceContextData.java,Java,,109,22,13,144
/jdk1.6.0_45/com/sun/corba/se/spi/servicecontext/ServiceContextRegistry.java,Java,,49,13,17,79
/jdk1.6.0_45/com/sun/corba/se/spi/servicecontext/ServiceContexts.java,Java,,209,81,104,394
/jdk1.6.0_45/com/sun/corba/se/spi/servicecontext/UEInfoServiceContext.java,Java,,38,12,7,57
/jdk1.6.0_45/com/sun/corba/se/spi/servicecontext/UnknownServiceContext.java,Java,,37,11,6,54
/jdk1.6.0_45/com/sun/corba/se/spi/transport/CorbaAcceptor.java,Java,,14,6,11,31
/jdk1.6.0_45/com/sun/corba/se/spi/transport/CorbaConnection.java,Java,,75,40,40,155
/jdk1.6.0_45/com/sun/corba/se/spi/transport/CorbaConnectionCache.java,Java,,5,3,10,18
/jdk1.6.0_45/com/sun/corba/se/spi/transport/CorbaContactInfo.java,Java,,15,5,10,30
/jdk1.6.0_45/com/sun/corba/se/spi/transport/CorbaContactInfoList.java,Java,,15,9,10,34
/jdk1.6.0_45/com/sun/corba/se/spi/transport/CorbaContactInfoListFactory.java,Java,,8,5,19,32
/jdk1.6.0_45/com/sun/corba/se/spi/transport/CorbaContactInfoListIterator.java,Java,,11,8,8,27
/jdk1.6.0_45/com/sun/corba/se/spi/transport/CorbaResponseWaitingRoom.java,Java,,11,5,10,26
/jdk1.6.0_45/com/sun/corba/se/spi/transport/CorbaTransportManager.java,Java,,20,8,12,40
/jdk1.6.0_45/com/sun/corba/se/spi/transport/IIOPPrimaryToContactInfo.java,Java,,13,9,45,67
/jdk1.6.0_45/com/sun/corba/se/spi/transport/IORToSocketInfo.java,Java,,7,5,15,27
/jdk1.6.0_45/com/sun/corba/se/spi/transport/IORTransformer.java,Java,,8,4,10,22
/jdk1.6.0_45/com/sun/corba/se/spi/transport/ORBSocketFactory.java,Java,,22,10,10,42
/jdk1.6.0_45/com/sun/corba/se/spi/transport/ReadTimeouts.java,Java,,7,3,7,17
/jdk1.6.0_45/com/sun/corba/se/spi/transport/ReadTimeoutsFactory.java,Java,,8,2,1,11
/jdk1.6.0_45/com/sun/corba/se/spi/transport/SocketInfo.java,Java,,8,7,10,25
/jdk1.6.0_45/com/sun/corba/se/spi/transport/SocketOrChannelAcceptor.java,Java,,6,4,10,20
/jdk1.6.0_45/com/sun/corba/se/spi/transport/TransportDefault.java,Java,,57,9,11,77
/jdk1.6.0_45/com/sun/image/codec/jpeg/ImageFormatException.java,Java,,10,4,40,54
/jdk1.6.0_45/com/sun/image/codec/jpeg/JPEGCodec.java,Java,,49,13,90,152
/jdk1.6.0_45/com/sun/image/codec/jpeg/JPEGDecodeParam.java,Java,,62,45,265,372
/jdk1.6.0_45/com/sun/image/codec/jpeg/JPEGEncodeParam.java,Java,,27,20,211,258
/jdk1.6.0_45/com/sun/image/codec/jpeg/JPEGHuffmanTable.java,Java,,139,31,73,243
/jdk1.6.0_45/com/sun/image/codec/jpeg/JPEGImageDecoder.java,Java,,23,14,105,142
/jdk1.6.0_45/com/sun/image/codec/jpeg/JPEGImageEncoder.java,Java,,29,23,180,232
/jdk1.6.0_45/com/sun/image/codec/jpeg/JPEGQTable.java,Java,,62,20,70,152
/jdk1.6.0_45/com/sun/image/codec/jpeg/TruncatedFileException.java,Java,,19,8,57,84
/jdk1.6.0_45/com/sun/imageio/metadata/XmlChars.java,Java,,177,38,212,427
/jdk1.6.0_45/com/sun/imageio/metadata/XmlNames.java,Java,,72,23,135,230
/jdk1.6.0_45/com/sun/imageio/plugins/bmp/BMPConstants.java,Java,,21,5,9,35
/jdk1.6.0_45/com/sun/imageio/plugins/bmp/BMPImageReader.java,Java,,1383,267,153,1803
/jdk1.6.0_45/com/sun/imageio/plugins/bmp/BMPImageReaderSpi.java,Java,,58,13,6,77
/jdk1.6.0_45/com/sun/imageio/plugins/bmp/BMPImageWriter.java,Java,,1114,183,204,1501
/jdk1.6.0_45/com/sun/imageio/plugins/bmp/BMPImageWriterSpi.java,Java,,66,16,6,88
/jdk1.6.0_45/com/sun/imageio/plugins/bmp/BMPMetadata.java,Java,,221,51,17,289
/jdk1.6.0_45/com/sun/imageio/plugins/bmp/BMPMetadataFormat.java,Java,,156,22,12,190
/jdk1.6.0_45/com/sun/imageio/plugins/bmp/BMPMetadataFormatResources.java,Java,,34,10,7,51
/jdk1.6.0_45/com/sun/imageio/plugins/common/BitFile.java,Java,,73,10,22,105
/jdk1.6.0_45/com/sun/imageio/plugins/common/BogusColorSpace.java,Java,,61,23,34,118
/jdk1.6.0_45/com/sun/imageio/plugins/common/I18N.java,Java,,7,2,6,15
/jdk1.6.0_45/com/sun/imageio/plugins/common/I18NImpl.java,Java,,17,4,23,44
/jdk1.6.0_45/com/sun/imageio/plugins/common/ImageUtil.java,Java,,838,122,193,1153
/jdk1.6.0_45/com/sun/imageio/plugins/common/InputStreamAdapter.java,Java,,17,8,9,34
/jdk1.6.0_45/com/sun/imageio/plugins/common/LZWCompressor.java,Java,,73,20,35,128
/jdk1.6.0_45/com/sun/imageio/plugins/common/LZWStringTable.java,Java,,110,29,61,200
/jdk1.6.0_45/com/sun/imageio/plugins/common/PaletteBuilder.java,Java,,306,66,94,466
/jdk1.6.0_45/com/sun/imageio/plugins/common/ReaderUtil.java,Java,,84,12,87,183
/jdk1.6.0_45/com/sun/imageio/plugins/common/StandardMetadataFormat.java,Java,,363,61,57,481
/jdk1.6.0_45/com/sun/imageio/plugins/common/StandardMetadataFormatResources.java,Java,,129,55,8,192
/jdk1.6.0_45/com/sun/imageio/plugins/common/SubImageInputStream.java,Java,,42,11,11,64
/jdk1.6.0_45/com/sun/imageio/plugins/gif/GIFImageMetadata.java,Java,,313,72,46,431
/jdk1.6.0_45/com/sun/imageio/plugins/gif/GIFImageMetadataFormat.java,Java,,122,16,15,153
/jdk1.6.0_45/com/sun/imageio/plugins/gif/GIFImageMetadataFormatResources.java,Java,,70,8,8,86
/jdk1.6.0_45/com/sun/imageio/plugins/gif/GIFImageReader.java,Java,,745,158,110,1013
/jdk1.6.0_45/com/sun/imageio/plugins/gif/GIFImageReaderSpi.java,Java,,58,17,9,84
/jdk1.6.0_45/com/sun/imageio/plugins/gif/GIFImageWriter.java,Java,,920,196,171,1287
/jdk1.6.0_45/com/sun/imageio/plugins/gif/GIFImageWriterSpi.java,Java,,63,17,6,86
/jdk1.6.0_45/com/sun/imageio/plugins/gif/GIFMetadata.java,Java,,234,35,33,302
/jdk1.6.0_45/com/sun/imageio/plugins/gif/GIFStreamMetadata.java,Java,,210,56,39,305
/jdk1.6.0_45/com/sun/imageio/plugins/gif/GIFStreamMetadataFormat.java,Java,,67,11,10,88
/jdk1.6.0_45/com/sun/imageio/plugins/gif/GIFStreamMetadataFormatResources.java,Java,,37,8,8,53
/jdk1.6.0_45/com/sun/imageio/plugins/gif/GIFWritableImageMetadata.java,Java,,315,51,18,384
/jdk1.6.0_45/com/sun/imageio/plugins/gif/GIFWritableStreamMetadata.java,Java,,203,28,18,249
/jdk1.6.0_45/com/sun/imageio/plugins/jpeg/AdobeMarkerSegment.java,Java,,90,15,14,119
/jdk1.6.0_45/com/sun/imageio/plugins/jpeg/COMMarkerSegment.java,Java,,57,13,46,116
/jdk1.6.0_45/com/sun/imageio/plugins/jpeg/DHTMarkerSegment.java,Java,,177,30,35,242
/jdk1.6.0_45/com/sun/imageio/plugins/jpeg/DQTMarkerSegment.java,Java,,218,26,48,292
/jdk1.6.0_45/com/sun/imageio/plugins/jpeg/DRIMarkerSegment.java,Java,,37,12,17,66
/jdk1.6.0_45/com/sun/imageio/plugins/jpeg/JFIFMarkerSegment.java,Java,,1201,131,215,1547
/jdk1.6.0_45/com/sun/imageio/plugins/jpeg/JPEG.java,Java,,204,50,100,354
/jdk1.6.0_45/com/sun/imageio/plugins/jpeg/JPEGBuffer.java,Java,,134,20,83,237
/jdk1.6.0_45/com/sun/imageio/plugins/jpeg/JPEGImageMetadataFormat.java,Java,,302,37,9,348
/jdk1.6.0_45/com/sun/imageio/plugins/jpeg/JPEGImageMetadataFormatResources.java,Java,,106,7,12,125
/jdk1.6.0_45/com/sun/imageio/plugins/jpeg/JPEGImageReader.java,Java,,1234,209,339,1782
/jdk1.6.0_45/com/sun/imageio/plugins/jpeg/JPEGImageReaderResources.java,Java,,15,7,6,28
/jdk1.6.0_45/com/sun/imageio/plugins/jpeg/JPEGImageReaderSpi.java,Java,,53,9,8,70
/jdk1.6.0_45/com/sun/imageio/plugins/jpeg/JPEGImageWriter.java,Java,,1467,194,224,1885
/jdk1.6.0_45/com/sun/imageio/plugins/jpeg/JPEGImageWriterResources.java,Java,,51,7,6,64
/jdk1.6.0_45/com/sun/imageio/plugins/jpeg/JPEGImageWriterSpi.java,Java,,59,13,8,80
/jdk1.6.0_45/com/sun/imageio/plugins/jpeg/JPEGMetadata.java,Java,,1788,186,424,2398
/jdk1.6.0_45/com/sun/imageio/plugins/jpeg/JPEGMetadataFormat.java,Java,,105,17,17,139
/jdk1.6.0_45/com/sun/imageio/plugins/jpeg/JPEGMetadataFormatResources.java,Java,,30,5,8,43
/jdk1.6.0_45/com/sun/imageio/plugins/jpeg/JPEGStreamMetadataFormat.java,Java,,17,6,6,29
/jdk1.6.0_45/com/sun/imageio/plugins/jpeg/JPEGStreamMetadataFormatResources.java,Java,,14,5,9,28
/jdk1.6.0_45/com/sun/imageio/plugins/jpeg/MarkerSegment.java,Java,,139,21,47,207
/jdk1.6.0_45/com/sun/imageio/plugins/jpeg/SOFMarkerSegment.java,Java,,219,25,22,266
/jdk1.6.0_45/com/sun/imageio/plugins/jpeg/SOSMarkerSegment.java,Java,,179,24,20,223
/jdk1.6.0_45/com/sun/imageio/plugins/png/PNGImageReader.java,Java,,1208,229,138,1575
/jdk1.6.0_45/com/sun/imageio/plugins/png/PNGImageReaderSpi.java,Java,,63,16,9,88
/jdk1.6.0_45/com/sun/imageio/plugins/png/PNGImageWriter.java,Java,,897,181,81,1159
/jdk1.6.0_45/com/sun/imageio/plugins/png/PNGImageWriterSpi.java,Java,,76,19,16,111
/jdk1.6.0_45/com/sun/imageio/plugins/png/PNGMetadata.java,Java,,1595,242,159,1996
/jdk1.6.0_45/com/sun/imageio/plugins/png/PNGMetadataFormat.java,Java,,323,118,41,482
/jdk1.6.0_45/com/sun/imageio/plugins/png/PNGMetadataFormatResources.java,Java,,169,24,8,201
/jdk1.6.0_45/com/sun/imageio/plugins/png/RowFilter.java,Java,,132,33,12,177
/jdk1.6.0_45/com/sun/imageio/plugins/wbmp/WBMPImageReader.java,Java,,223,57,34,314
/jdk1.6.0_45/com/sun/imageio/plugins/wbmp/WBMPImageReaderSpi.java,Java,,60,14,7,81
/jdk1.6.0_45/com/sun/imageio/plugins/wbmp/WBMPImageWriter.java,Java,,222,44,31,297
/jdk1.6.0_45/com/sun/imageio/plugins/wbmp/WBMPImageWriterSpi.java,Java,,57,12,6,75
/jdk1.6.0_45/com/sun/imageio/plugins/wbmp/WBMPMetadata.java,Java,,82,27,7,116
/jdk1.6.0_45/com/sun/imageio/plugins/wbmp/WBMPMetadataFormat.java,Java,,33,12,7,52
/jdk1.6.0_45/com/sun/imageio/spi/FileImageInputStreamSpi.java,Java,,30,9,6,45
/jdk1.6.0_45/com/sun/imageio/spi/FileImageOutputStreamSpi.java,Java,,31,9,6,46
/jdk1.6.0_45/com/sun/imageio/spi/InputStreamImageInputStreamSpi.java,Java,,41,12,6,59
/jdk1.6.0_45/com/sun/imageio/spi/OutputStreamImageOutputStreamSpi.java,Java,,41,11,6,58
/jdk1.6.0_45/com/sun/imageio/spi/RAFImageInputStreamSpi.java,Java,,32,9,6,47
/jdk1.6.0_45/com/sun/imageio/spi/RAFImageOutputStreamSpi.java,Java,,33,9,6,48
/jdk1.6.0_45/com/sun/imageio/stream/CloseableDisposerRecord.java,Java,,20,5,11,36
/jdk1.6.0_45/com/sun/imageio/stream/StreamCloser.java,Java,,76,13,27,116
/jdk1.6.0_45/com/sun/imageio/stream/StreamFinalizer.java,Java,,18,5,31,54
/jdk1.6.0_45/com/sun/java/swing/Painter.java,Java,,5,2,80,87
/jdk1.6.0_45/com/sun/java/swing/plaf/gtk/GTKColorChooserPanel.java,Java,,857,148,278,1283
/jdk1.6.0_45/com/sun/java/swing/plaf/gtk/GTKColorType.java,Java,,108,14,28,150
/jdk1.6.0_45/com/sun/java/swing/plaf/gtk/GTKConstants.java,Java,,76,11,41,128
/jdk1.6.0_45/com/sun/java/swing/plaf/gtk/GTKDefaultEngine.java,Java,,979,114,83,1176
/jdk1.6.0_45/com/sun/java/swing/plaf/gtk/GTKDefaultStyle.java,Java,,198,26,53,277
/jdk1.6.0_45/com/sun/java/swing/plaf/gtk/GTKEngine.java,Java,,84,24,35,143
/jdk1.6.0_45/com/sun/java/swing/plaf/gtk/GTKFileChooserUI.java,Java,,1054,212,105,1371
/jdk1.6.0_45/com/sun/java/swing/plaf/gtk/GTKGraphicsUtils.java,Java,,79,9,29,117
/jdk1.6.0_45/com/sun/java/swing/plaf/gtk/GTKIconFactory.java,Java,,271,54,30,355
/jdk1.6.0_45/com/sun/java/swing/plaf/gtk/GTKLookAndFeel.java,Java,,1339,172,168,1679
/jdk1.6.0_45/com/sun/java/swing/plaf/gtk/GTKNativeEngine.java,Java,,419,59,51,529
/jdk1.6.0_45/com/sun/java/swing/plaf/gtk/GTKNativeStyle.java,Java,,119,32,77,228
/jdk1.6.0_45/com/sun/java/swing/plaf/gtk/GTKPainter.java,Java,,1084,137,187,1408
/jdk1.6.0_45/com/sun/java/swing/plaf/gtk/GTKRegion.java,Java,,9,3,13,25
/jdk1.6.0_45/com/sun/java/swing/plaf/gtk/GTKStyle.java,Java,,780,115,242,1137
/jdk1.6.0_45/com/sun/java/swing/plaf/gtk/GTKStyleFactory.java,Java,,121,18,40,179
/jdk1.6.0_45/com/sun/java/swing/plaf/gtk/Metacity.java,Java,,1819,238,39,2096
/jdk1.6.0_45/com/sun/java/swing/plaf/gtk/PangoFonts.java,Java,,83,21,108,212
/jdk1.6.0_45/com/sun/java/swing/plaf/gtk/resources/gtk.java,Java,,55,2,0,57
/jdk1.6.0_45/com/sun/java/swing/plaf/gtk/resources/gtk_de.java,Java,,55,2,0,57
/jdk1.6.0_45/com/sun/java/swing/plaf/gtk/resources/gtk_es.java,Java,,55,2,0,57
/jdk1.6.0_45/com/sun/java/swing/plaf/gtk/resources/gtk_fr.java,Java,,55,2,0,57
/jdk1.6.0_45/com/sun/java/swing/plaf/gtk/resources/gtk_it.java,Java,,55,2,0,57
/jdk1.6.0_45/com/sun/java/swing/plaf/gtk/resources/gtk_ja.java,Java,,55,2,0,57
/jdk1.6.0_45/com/sun/java/swing/plaf/gtk/resources/gtk_ko.java,Java,,55,2,0,57
/jdk1.6.0_45/com/sun/java/swing/plaf/gtk/resources/gtk_pt_BR.java,Java,,55,2,0,57
/jdk1.6.0_45/com/sun/java/swing/plaf/gtk/resources/gtk_sv.java,Java,,55,2,0,57
/jdk1.6.0_45/com/sun/java/swing/plaf/gtk/resources/gtk_zh_CN.java,Java,,55,2,0,57
/jdk1.6.0_45/com/sun/java/swing/plaf/gtk/resources/gtk_zh_HK.java,Java,,55,2,0,57
/jdk1.6.0_45/com/sun/java/swing/plaf/gtk/resources/gtk_zh_TW.java,Java,,55,2,0,57
/jdk1.6.0_45/com/sun/java/swing/plaf/gtk/XColors.java,Java,,788,16,10,814
/jdk1.6.0_45/com/sun/java/swing/plaf/motif/MotifBorders.java,Java,,524,130,95,749
/jdk1.6.0_45/com/sun/java/swing/plaf/motif/MotifButtonListener.java,Java,,14,7,13,34
/jdk1.6.0_45/com/sun/java/swing/plaf/motif/MotifButtonUI.java,Java,,75,24,36,135
/jdk1.6.0_45/com/sun/java/swing/plaf/motif/MotifCheckBoxMenuItemUI.java,Java,,62,23,14,99
/jdk1.6.0_45/com/sun/java/swing/plaf/motif/MotifCheckBoxUI.java,Java,,34,14,25,73
/jdk1.6.0_45/com/sun/java/swing/plaf/motif/MotifComboBoxUI.java,Java,,264,43,38,345
/jdk1.6.0_45/com/sun/java/swing/plaf/motif/MotifDesktopIconUI.java,Java,,262,54,32,348
/jdk1.6.0_45/com/sun/java/swing/plaf/motif/MotifDesktopPaneUI.java,Java,,177,31,42,250
/jdk1.6.0_45/com/sun/java/swing/plaf/motif/MotifEditorPaneUI.java,Java,,13,7,33,53
/jdk1.6.0_45/com/sun/java/swing/plaf/motif/MotifFileChooserUI.java,Java,,648,122,54,824
/jdk1.6.0_45/com/sun/java/swing/plaf/motif/MotifGraphicsUtils.java,Java,,317,62,80,459
/jdk1.6.0_45/com/sun/java/swing/plaf/motif/MotifIconFactory.java,Java,,350,56,36,442
/jdk1.6.0_45/com/sun/java/swing/plaf/motif/MotifInternalFrameTitlePane.java,Java,,289,50,18,357
/jdk1.6.0_45/com/sun/java/swing/plaf/motif/MotifInternalFrameUI.java,Java,,137,27,42,206
/jdk1.6.0_45/com/sun/java/swing/plaf/motif/MotifLabelUI.java,Java,,19,5,20,44
/jdk1.6.0_45/com/sun/java/swing/plaf/motif/MotifLookAndFeel.java,Java,,1094,128,47,1269
/jdk1.6.0_45/com/sun/java/swing/plaf/motif/MotifMenuBarUI.java,Java,,23,8,22,53
/jdk1.6.0_45/com/sun/java/swing/plaf/motif/MotifMenuItemUI.java,Java,,63,22,13,98
/jdk1.6.0_45/com/sun/java/swing/plaf/motif/MotifMenuMouseListener.java,Java,,17,2,12,31
/jdk1.6.0_45/com/sun/java/swing/plaf/motif/MotifMenuMouseMotionListener.java,Java,,11,3,12,26
/jdk1.6.0_45/com/sun/java/swing/plaf/motif/MotifMenuUI.java,Java,,89,23,27,139
/jdk1.6.0_45/com/sun/java/swing/plaf/motif/MotifOptionPaneUI.java,Java,,49,13,35,97
/jdk1.6.0_45/com/sun/java/swing/plaf/motif/MotifPasswordFieldUI.java,Java,,13,10,33,56
/jdk1.6.0_45/com/sun/java/swing/plaf/motif/MotifPopupMenuSeparatorUI.java,Java,,27,9,13,49
/jdk1.6.0_45/com/sun/java/swing/plaf/motif/MotifPopupMenuUI.java,Java,,63,15,23,101
/jdk1.6.0_45/com/sun/java/swing/plaf/motif/MotifProgressBarUI.java,Java,,13,6,22,41
/jdk1.6.0_45/com/sun/java/swing/plaf/motif/MotifRadioButtonMenuItemUI.java,Java,,62,22,20,104
/jdk1.6.0_45/com/sun/java/swing/plaf/motif/MotifRadioButtonUI.java,Java,,40,16,31,87
/jdk1.6.0_45/com/sun/java/swing/plaf/motif/MotifScrollBarButton.java,Java,,154,25,16,195
/jdk1.6.0_45/com/sun/java/swing/plaf/motif/MotifScrollBarUI.java,Java,,53,18,20,91
/jdk1.6.0_45/com/sun/java/swing/plaf/motif/MotifScrollPaneUI.java,Java,,86,20,21,127
/jdk1.6.0_45/com/sun/java/swing/plaf/motif/MotifSeparatorUI.java,Java,,16,9,21,46
/jdk1.6.0_45/com/sun/java/swing/plaf/motif/MotifSliderUI.java,Java,,82,29,32,143
/jdk1.6.0_45/com/sun/java/swing/plaf/motif/MotifSplitPaneDivider.java,Java,,181,36,61,278
/jdk1.6.0_45/com/sun/java/swing/plaf/motif/MotifSplitPaneUI.java,Java,,18,6,25,49
/jdk1.6.0_45/com/sun/java/swing/plaf/motif/MotifTabbedPaneUI.java,Java,,218,33,38,289
/jdk1.6.0_45/com/sun/java/swing/plaf/motif/MotifTextAreaUI.java,Java,,13,5,35,53
/jdk1.6.0_45/com/sun/java/swing/plaf/motif/MotifTextFieldUI.java,Java,,13,5,33,51
/jdk1.6.0_45/com/sun/java/swing/plaf/motif/MotifTextPaneUI.java,Java,,13,7,33,53
/jdk1.6.0_45/com/sun/java/swing/plaf/motif/MotifTextUI.java,Java,,69,13,76,158
/jdk1.6.0_45/com/sun/java/swing/plaf/motif/MotifToggleButtonUI.java,Java,,60,19,31,110
/jdk1.6.0_45/com/sun/java/swing/plaf/motif/MotifTreeCellRenderer.java,Java,,51,16,29,96
/jdk1.6.0_45/com/sun/java/swing/plaf/motif/MotifTreeUI.java,Java,,78,24,47,149
/jdk1.6.0_45/com/sun/java/swing/plaf/motif/resources/motif.java,Java,,27,2,0,29
/jdk1.6.0_45/com/sun/java/swing/plaf/motif/resources/motif_de.java,Java,,27,2,0,29
/jdk1.6.0_45/com/sun/java/swing/plaf/motif/resources/motif_es.java,Java,,27,2,0,29
/jdk1.6.0_45/com/sun/java/swing/plaf/motif/resources/motif_fr.java,Java,,27,2,0,29
/jdk1.6.0_45/com/sun/java/swing/plaf/motif/resources/motif_it.java,Java,,27,2,0,29
/jdk1.6.0_45/com/sun/java/swing/plaf/motif/resources/motif_ja.java,Java,,27,2,0,29
/jdk1.6.0_45/com/sun/java/swing/plaf/motif/resources/motif_ko.java,Java,,27,2,0,29
/jdk1.6.0_45/com/sun/java/swing/plaf/motif/resources/motif_pt_BR.java,Java,,27,2,0,29
/jdk1.6.0_45/com/sun/java/swing/plaf/motif/resources/motif_sv.java,Java,,27,2,0,29
/jdk1.6.0_45/com/sun/java/swing/plaf/motif/resources/motif_zh_CN.java,Java,,27,2,0,29
/jdk1.6.0_45/com/sun/java/swing/plaf/motif/resources/motif_zh_HK.java,Java,,27,2,0,29
/jdk1.6.0_45/com/sun/java/swing/plaf/motif/resources/motif_zh_TW.java,Java,,27,2,0,29
/jdk1.6.0_45/com/sun/java/swing/plaf/nimbus/AbstractRegionPainter.java,Java,,351,44,322,717
/jdk1.6.0_45/com/sun/java/swing/plaf/nimbus/ArrowButtonPainter.java,Java,,56,25,20,101
/jdk1.6.0_45/com/sun/java/swing/plaf/nimbus/ButtonPainter.java,Java,,554,61,20,635
/jdk1.6.0_45/com/sun/java/swing/plaf/nimbus/CheckBoxMenuItemPainter.java,Java,,93,32,20,145
/jdk1.6.0_45/com/sun/java/swing/plaf/nimbus/CheckBoxPainter.java,Java,,529,69,20,618
/jdk1.6.0_45/com/sun/java/swing/plaf/nimbus/ComboBoxComboBoxArrowButtonEditableState.java,Java,,12,5,8,25
/jdk1.6.0_45/com/sun/java/swing/plaf/nimbus/ComboBoxComboBoxArrowButtonPainter.java,Java,,382,57,20,459
/jdk1.6.0_45/com/sun/java/swing/plaf/nimbus/ComboBoxComboBoxTextFieldPainter.java,Java,,182,35,20,237
/jdk1.6.0_45/com/sun/java/swing/plaf/nimbus/ComboBoxEditableState.java,Java,,11,5,8,24
/jdk1.6.0_45/com/sun/java/swing/plaf/nimbus/ComboBoxPainter.java,Java,,628,68,20,716
/jdk1.6.0_45/com/sun/java/swing/plaf/nimbus/DerivedColor.java,Java,,110,16,38,164
/jdk1.6.0_45/com/sun/java/swing/plaf/nimbus/DesktopIconPainter.java,Java,,95,27,20,142
/jdk1.6.0_45/com/sun/java/swing/plaf/nimbus/DesktopPanePainter.java,Java,,274,39,20,333
/jdk1.6.0_45/com/sun/java/swing/plaf/nimbus/DropShadowEffect.java,Java,,65,5,41,111
/jdk1.6.0_45/com/sun/java/swing/plaf/nimbus/EditorPanePainter.java,Java,,60,27,20,107
/jdk1.6.0_45/com/sun/java/swing/plaf/nimbus/Effect.java,Java,,58,14,44,116
/jdk1.6.0_45/com/sun/java/swing/plaf/nimbus/EffectUtils.java,Java,,220,37,152,409
/jdk1.6.0_45/com/sun/java/swing/plaf/nimbus/FileChooserPainter.java,Java,,2035,176,20,2231
/jdk1.6.0_45/com/sun/java/swing/plaf/nimbus/FormattedTextFieldPainter.java,Java,,296,48,20,364
/jdk1.6.0_45/com/sun/java/swing/plaf/nimbus/ImageCache.java,Java,,125,15,60,200
/jdk1.6.0_45/com/sun/java/swing/plaf/nimbus/ImageScalingHelper.java,Java,,164,22,77,263
/jdk1.6.0_45/com/sun/java/swing/plaf/nimbus/InnerGlowEffect.java,Java,,8,2,12,22
/jdk1.6.0_45/com/sun/java/swing/plaf/nimbus/InnerShadowEffect.java,Java,,68,5,41,114
/jdk1.6.0_45/com/sun/java/swing/plaf/nimbus/InternalFrameInternalFrameTitlePaneInternalFrameTitlePaneCloseButtonPainter.java,Java,,377,49,20,446
/jdk1.6.0_45/com/sun/java/swing/plaf/nimbus/InternalFrameInternalFrameTitlePaneInternalFrameTitlePaneCloseButtonWindowNotFocusedState.java,Java,,21,5,8,34
/jdk1.6.0_45/com/sun/java/swing/plaf/nimbus/InternalFrameInternalFrameTitlePaneInternalFrameTitlePaneIconifyButtonPainter.java,Java,,518,51,20,589
/jdk1.6.0_45/com/sun/java/swing/plaf/nimbus/InternalFrameInternalFrameTitlePaneInternalFrameTitlePaneIconifyButtonWindowNotFocusedState.java,Java,,21,5,8,34
/jdk1.6.0_45/com/sun/java/swing/plaf/nimbus/InternalFrameInternalFrameTitlePaneInternalFrameTitlePaneMaximizeButtonPainter.java,Java,,927,81,20,1028
/jdk1.6.0_45/com/sun/java/swing/plaf/nimbus/InternalFrameInternalFrameTitlePaneInternalFrameTitlePaneMaximizeButtonWindowMaximizedState.java,Java,,21,5,8,34
/jdk1.6.0_45/com/sun/java/swing/plaf/nimbus/InternalFrameInternalFrameTitlePaneInternalFrameTitlePaneMaximizeButtonWindowNotFocusedState.java,Java,,21,5,8,34
/jdk1.6.0_45/com/sun/java/swing/plaf/nimbus/InternalFrameInternalFrameTitlePaneInternalFrameTitlePaneMenuButtonPainter.java,Java,,427,53,20,500
/jdk1.6.0_45/com/sun/java/swing/plaf/nimbus/InternalFrameInternalFrameTitlePaneInternalFrameTitlePaneMenuButtonWindowNotFocusedState.java,Java,,21,5,8,34
/jdk1.6.0_45/com/sun/java/swing/plaf/nimbus/InternalFrameInternalFrameTitlePanePainter.java,Java,,31,20,20,71
/jdk1.6.0_45/com/sun/java/swing/plaf/nimbus/InternalFrameInternalFrameTitlePaneWindowFocusedState.java,Java,,11,5,8,24
/jdk1.6.0_45/com/sun/java/swing/plaf/nimbus/InternalFramePainter.java,Java,,323,42,20,385
/jdk1.6.0_45/com/sun/java/swing/plaf/nimbus/InternalFrameWindowFocusedState.java,Java,,11,5,8,24
/jdk1.6.0_45/com/sun/java/swing/plaf/nimbus/LoweredBorder.java,Java,,94,13,77,184
/jdk1.6.0_45/com/sun/java/swing/plaf/nimbus/MenuBarMenuPainter.java,Java,,47,23,20,90
/jdk1.6.0_45/com/sun/java/swing/plaf/nimbus/MenuBarPainter.java,Java,,87,28,20,135
/jdk1.6.0_45/com/sun/java/swing/plaf/nimbus/MenuItemPainter.java,Java,,47,23,20,90
/jdk1.6.0_45/com/sun/java/swing/plaf/nimbus/MenuPainter.java,Java,,89,31,20,140
/jdk1.6.0_45/com/sun/java/swing/plaf/nimbus/NimbusDefaults.java,Java,,1283,125,335,1743
/jdk1.6.0_45/com/sun/java/swing/plaf/nimbus/NimbusIcon.java,Java,,158,10,38,206
/jdk1.6.0_45/com/sun/java/swing/plaf/nimbus/NimbusLookAndFeel.java,Java,,268,38,201,507
/jdk1.6.0_45/com/sun/java/swing/plaf/nimbus/NimbusStyle.java,Java,,588,89,573,1250
/jdk1.6.0_45/com/sun/java/swing/plaf/nimbus/OptionPaneOptionPaneMessageAreaOptionPaneLabelPainter.java,Java,,45,23,20,88
/jdk1.6.0_45/com/sun/java/swing/plaf/nimbus/OptionPaneOptionPaneMessageAreaPainter.java,Java,,31,20,20,71
/jdk1.6.0_45/com/sun/java/swing/plaf/nimbus/OptionPanePainter.java,Java,,491,55,20,566
/jdk1.6.0_45/com/sun/java/swing/plaf/nimbus/OuterGlowEffect.java,Java,,8,2,12,22
/jdk1.6.0_45/com/sun/java/swing/plaf/nimbus/PasswordFieldPainter.java,Java,,296,48,20,364
/jdk1.6.0_45/com/sun/java/swing/plaf/nimbus/PopupMenuPainter.java,Java,,97,29,20,146
/jdk1.6.0_45/com/sun/java/swing/plaf/nimbus/PopupMenuSeparatorPainter.java,Java,,45,23,20,88
/jdk1.6.0_45/com/sun/java/swing/plaf/nimbus/ProgressBarFinishedState.java,Java,,11,6,8,25
/jdk1.6.0_45/com/sun/java/swing/plaf/nimbus/ProgressBarIndeterminateState.java,Java,,11,6,8,25
/jdk1.6.0_45/com/sun/java/swing/plaf/nimbus/ProgressBarPainter.java,Java,,515,60,20,595
/jdk1.6.0_45/com/sun/java/swing/plaf/nimbus/RadioButtonMenuItemPainter.java,Java,,101,33,20,154
/jdk1.6.0_45/com/sun/java/swing/plaf/nimbus/RadioButtonPainter.java,Java,,595,72,20,687
/jdk1.6.0_45/com/sun/java/swing/plaf/nimbus/ScrollBarPainter.java,Java,,30,20,20,70
/jdk1.6.0_45/com/sun/java/swing/plaf/nimbus/ScrollBarScrollBarButtonPainter.java,Java,,302,41,20,363
/jdk1.6.0_45/com/sun/java/swing/plaf/nimbus/ScrollBarScrollBarThumbPainter.java,Java,,301,41,20,362
/jdk1.6.0_45/com/sun/java/swing/plaf/nimbus/ScrollBarScrollBarTrackPainter.java,Java,,203,35,20,258
/jdk1.6.0_45/com/sun/java/swing/plaf/nimbus/ScrollPanePainter.java,Java,,112,29,20,161
/jdk1.6.0_45/com/sun/java/swing/plaf/nimbus/SeparatorPainter.java,Java,,45,23,20,88
/jdk1.6.0_45/com/sun/java/swing/plaf/nimbus/ShadowEffect.java,Java,,52,15,19,86
/jdk1.6.0_45/com/sun/java/swing/plaf/nimbus/SliderArrowShapeState.java,Java,,11,4,8,23
/jdk1.6.0_45/com/sun/java/swing/plaf/nimbus/SliderPainter.java,Java,,30,20,20,70
/jdk1.6.0_45/com/sun/java/swing/plaf/nimbus/SliderSliderThumbArrowShapeState.java,Java,,11,4,8,23
/jdk1.6.0_45/com/sun/java/swing/plaf/nimbus/SliderSliderThumbPainter.java,Java,,544,73,20,637
/jdk1.6.0_45/com/sun/java/swing/plaf/nimbus/SliderSliderTrackArrowShapeState.java,Java,,11,4,8,23
/jdk1.6.0_45/com/sun/java/swing/plaf/nimbus/SliderSliderTrackPainter.java,Java,,159,33,20,212
/jdk1.6.0_45/com/sun/java/swing/plaf/nimbus/SpinnerPainter.java,Java,,31,20,20,71
/jdk1.6.0_45/com/sun/java/swing/plaf/nimbus/SpinnerPanelSpinnerFormattedTextFieldPainter.java,Java,,242,41,20,303
/jdk1.6.0_45/com/sun/java/swing/plaf/nimbus/SpinnerSpinnerNextButtonPainter.java,Java,,474,71,20,565
/jdk1.6.0_45/com/sun/java/swing/plaf/nimbus/SpinnerSpinnerPreviousButtonPainter.java,Java,,402,65,20,487
/jdk1.6.0_45/com/sun/java/swing/plaf/nimbus/SplitPanePainter.java,Java,,31,20,20,71
/jdk1.6.0_45/com/sun/java/swing/plaf/nimbus/SplitPaneSplitPaneDividerPainter.java,Java,,213,39,20,272
/jdk1.6.0_45/com/sun/java/swing/plaf/nimbus/SplitPaneSplitPaneDividerVerticalState.java,Java,,11,5,8,24
/jdk1.6.0_45/com/sun/java/swing/plaf/nimbus/SplitPaneVerticalState.java,Java,,11,5,8,24
/jdk1.6.0_45/com/sun/java/swing/plaf/nimbus/State.java,Java,,81,16,98,195
/jdk1.6.0_45/com/sun/java/swing/plaf/nimbus/SynthPainterImpl.java,Java,,961,149,1678,2788
/jdk1.6.0_45/com/sun/java/swing/plaf/nimbus/TabbedPanePainter.java,Java,,35,20,20,75
/jdk1.6.0_45/com/sun/java/swing/plaf/nimbus/TabbedPaneTabbedPaneTabAreaPainter.java,Java,,149,34,20,203
/jdk1.6.0_45/com/sun/java/swing/plaf/nimbus/TabbedPaneTabbedPaneTabPainter.java,Java,,570,70,20,660
/jdk1.6.0_45/com/sun/java/swing/plaf/nimbus/TableEditorPainter.java,Java,,71,26,20,117
/jdk1.6.0_45/com/sun/java/swing/plaf/nimbus/TableHeaderPainter.java,Java,,76,27,20,123
/jdk1.6.0_45/com/sun/java/swing/plaf/nimbus/TableHeaderTableHeaderRendererPainter.java,Java,,297,46,20,363
/jdk1.6.0_45/com/sun/java/swing/plaf/nimbus/TableHeaderTableHeaderRendererSortedState.java,Java,,12,5,8,25
/jdk1.6.0_45/com/sun/java/swing/plaf/nimbus/TableScrollPaneCorner.java,Java,,28,4,18,50
/jdk1.6.0_45/com/sun/java/swing/plaf/nimbus/TextAreaNotInScrollPaneState.java,Java,,11,5,8,24
/jdk1.6.0_45/com/sun/java/swing/plaf/nimbus/TextAreaPainter.java,Java,,321,53,20,394
/jdk1.6.0_45/com/sun/java/swing/plaf/nimbus/TextFieldPainter.java,Java,,296,48,20,364
/jdk1.6.0_45/com/sun/java/swing/plaf/nimbus/TextPanePainter.java,Java,,60,27,20,107
/jdk1.6.0_45/com/sun/java/swing/plaf/nimbus/ToggleButtonPainter.java,Java,,601,67,20,688
/jdk1.6.0_45/com/sun/java/swing/plaf/nimbus/ToolBarButtonPainter.java,Java,,213,38,20,271
/jdk1.6.0_45/com/sun/java/swing/plaf/nimbus/ToolBarEastState.java,Java,,12,6,8,26
/jdk1.6.0_45/com/sun/java/swing/plaf/nimbus/ToolBarNorthState.java,Java,,12,6,8,26
/jdk1.6.0_45/com/sun/java/swing/plaf/nimbus/ToolBarPainter.java,Java,,137,37,20,194
/jdk1.6.0_45/com/sun/java/swing/plaf/nimbus/ToolBarSeparatorPainter.java,Java,,25,6,25,56
/jdk1.6.0_45/com/sun/java/swing/plaf/nimbus/ToolBarSouthState.java,Java,,12,6,8,26
/jdk1.6.0_45/com/sun/java/swing/plaf/nimbus/ToolBarToggleButtonPainter.java,Java,,435,63,20,518
/jdk1.6.0_45/com/sun/java/swing/plaf/nimbus/ToolBarWestState.java,Java,,12,6,8,26
/jdk1.6.0_45/com/sun/java/swing/plaf/nimbus/ToolTipPainter.java,Java,,86,27,20,133
/jdk1.6.0_45/com/sun/java/swing/plaf/nimbus/TreeCellEditorPainter.java,Java,,80,26,20,126
/jdk1.6.0_45/com/sun/java/swing/plaf/nimbus/TreePainter.java,Java,,553,62,20,635
/jdk1.6.0_45/com/sun/java/swing/plaf/nimbus/TreeTreeCellPainter.java,Java,,80,28,20,128
/jdk1.6.0_45/com/sun/java/swing/plaf/windows/AnimationController.java,Java,,305,44,61,410
/jdk1.6.0_45/com/sun/java/swing/plaf/windows/DesktopProperty.java,Java,,129,29,106,264
/jdk1.6.0_45/com/sun/java/swing/plaf/windows/resources/windows.java,Java,,33,2,0,35
/jdk1.6.0_45/com/sun/java/swing/plaf/windows/resources/windows_de.java,Java,,33,2,0,35
/jdk1.6.0_45/com/sun/java/swing/plaf/windows/resources/windows_es.java,Java,,33,2,0,35
/jdk1.6.0_45/com/sun/java/swing/plaf/windows/resources/windows_fr.java,Java,,33,2,0,35
/jdk1.6.0_45/com/sun/java/swing/plaf/windows/resources/windows_it.java,Java,,33,2,0,35
/jdk1.6.0_45/com/sun/java/swing/plaf/windows/resources/windows_ja.java,Java,,33,2,0,35
/jdk1.6.0_45/com/sun/java/swing/plaf/windows/resources/windows_ko.java,Java,,33,2,0,35
/jdk1.6.0_45/com/sun/java/swing/plaf/windows/resources/windows_pt_BR.java,Java,,33,2,0,35
/jdk1.6.0_45/com/sun/java/swing/plaf/windows/resources/windows_sv.java,Java,,33,2,0,35
/jdk1.6.0_45/com/sun/java/swing/plaf/windows/resources/windows_zh_CN.java,Java,,33,2,0,35
/jdk1.6.0_45/com/sun/java/swing/plaf/windows/resources/windows_zh_HK.java,Java,,33,2,0,35
/jdk1.6.0_45/com/sun/java/swing/plaf/windows/resources/windows_zh_TW.java,Java,,33,2,0,35
/jdk1.6.0_45/com/sun/java/swing/plaf/windows/TMSchema.java,Java,,400,94,54,548
/jdk1.6.0_45/com/sun/java/swing/plaf/windows/WindowsBorders.java,Java,,234,44,47,325
/jdk1.6.0_45/com/sun/java/swing/plaf/windows/WindowsButtonListener.java,Java,,9,7,23,39
/jdk1.6.0_45/com/sun/java/swing/plaf/windows/WindowsButtonUI.java,Java,,204,37,63,304
/jdk1.6.0_45/com/sun/java/swing/plaf/windows/WindowsCheckBoxMenuItemUI.java,Java,,48,14,25,87
/jdk1.6.0_45/com/sun/java/swing/plaf/windows/WindowsCheckBoxUI.java,Java,,36,15,28,79
/jdk1.6.0_45/com/sun/java/swing/plaf/windows/WindowsClassicLookAndFeel.java,Java,,3,2,19,24
/jdk1.6.0_45/com/sun/java/swing/plaf/windows/WindowsComboBoxUI.java,Java,,383,51,112,546
/jdk1.6.0_45/com/sun/java/swing/plaf/windows/WindowsDesktopIconUI.java,Java,,42,14,24,80
/jdk1.6.0_45/com/sun/java/swing/plaf/windows/WindowsDesktopManager.java,Java,,48,8,30,86
/jdk1.6.0_45/com/sun/java/swing/plaf/windows/WindowsDesktopPaneUI.java,Java,,27,7,20,54
/jdk1.6.0_45/com/sun/java/swing/plaf/windows/WindowsEditorPaneUI.java,Java,,14,7,30,51
/jdk1.6.0_45/com/sun/java/swing/plaf/windows/WindowsFileChooserUI.java,Java,,937,196,140,1273
/jdk1.6.0_45/com/sun/java/swing/plaf/windows/WindowsGraphicsUtils.java,Java,,129,21,45,195
/jdk1.6.0_45/com/sun/java/swing/plaf/windows/WindowsIconFactory.java,Java,,738,85,64,887
/jdk1.6.0_45/com/sun/java/swing/plaf/windows/WindowsInternalFrameTitlePane.java,Java,,422,57,41,520
/jdk1.6.0_45/com/sun/java/swing/plaf/windows/WindowsInternalFrameUI.java,Java,,74,24,22,120
/jdk1.6.0_45/com/sun/java/swing/plaf/windows/WindowsLabelUI.java,Java,,59,15,21,95
/jdk1.6.0_45/com/sun/java/swing/plaf/windows/WindowsLookAndFeel.java,Java,,2035,244,368,2647
/jdk1.6.0_45/com/sun/java/swing/plaf/windows/WindowsMenuBarUI.java,Java,,129,13,27,169
/jdk1.6.0_45/com/sun/java/swing/plaf/windows/WindowsMenuItemUI.java,Java,,106,21,34,161
/jdk1.6.0_45/com/sun/java/swing/plaf/windows/WindowsMenuItemUIAccessor.java,Java,,11,5,13,29
/jdk1.6.0_45/com/sun/java/swing/plaf/windows/WindowsMenuUI.java,Java,,187,40,51,278
/jdk1.6.0_45/com/sun/java/swing/plaf/windows/WindowsOptionPaneUI.java,Java,,8,6,16,30
/jdk1.6.0_45/com/sun/java/swing/plaf/windows/WindowsPasswordFieldUI.java,Java,,13,9,30,52
/jdk1.6.0_45/com/sun/java/swing/plaf/windows/WindowsPopupMenuSeparatorUI.java,Java,,47,12,18,77
/jdk1.6.0_45/com/sun/java/swing/plaf/windows/WindowsPopupMenuUI.java,Java,,120,17,64,201
/jdk1.6.0_45/com/sun/java/swing/plaf/windows/WindowsPopupWindow.java,Java,,34,10,34,78
/jdk1.6.0_45/com/sun/java/swing/plaf/windows/WindowsProgressBarUI.java,Java,,270,48,66,384
/jdk1.6.0_45/com/sun/java/swing/plaf/windows/WindowsRadioButtonMenuItemUI.java,Java,,47,14,25,86
/jdk1.6.0_45/com/sun/java/swing/plaf/windows/WindowsRadioButtonUI.java,Java,,59,20,34,113
/jdk1.6.0_45/com/sun/java/swing/plaf/windows/WindowsRootPaneUI.java,Java,,140,20,16,176
/jdk1.6.0_45/com/sun/java/swing/plaf/windows/WindowsScrollBarUI.java,Java,,355,46,60,461
/jdk1.6.0_45/com/sun/java/swing/plaf/windows/WindowsScrollPaneUI.java,Java,,5,6,16,27
/jdk1.6.0_45/com/sun/java/swing/plaf/windows/WindowsSeparatorUI.java,Java,,3,3,12,18
/jdk1.6.0_45/com/sun/java/swing/plaf/windows/WindowsSliderUI.java,Java,,160,34,23,217
/jdk1.6.0_45/com/sun/java/swing/plaf/windows/WindowsSpinnerUI.java,Java,,63,13,10,86
/jdk1.6.0_45/com/sun/java/swing/plaf/windows/WindowsSplitPaneDivider.java,Java,,23,7,25,55
/jdk1.6.0_45/com/sun/java/swing/plaf/windows/WindowsSplitPaneUI.java,Java,,18,10,22,50
/jdk1.6.0_45/com/sun/java/swing/plaf/windows/WindowsTabbedPaneUI.java,Java,,151,26,33,210
/jdk1.6.0_45/com/sun/java/swing/plaf/windows/WindowsTableHeaderUI.java,Java,,184,17,28,229
/jdk1.6.0_45/com/sun/java/swing/plaf/windows/WindowsTextAreaUI.java,Java,,13,8,30,51
/jdk1.6.0_45/com/sun/java/swing/plaf/windows/WindowsTextFieldUI.java,Java,,68,17,72,157
/jdk1.6.0_45/com/sun/java/swing/plaf/windows/WindowsTextPaneUI.java,Java,,14,6,30,50
/jdk1.6.0_45/com/sun/java/swing/plaf/windows/WindowsTextUI.java,Java,,139,15,65,219
/jdk1.6.0_45/com/sun/java/swing/plaf/windows/WindowsToggleButtonUI.java,Java,,103,28,34,165
/jdk1.6.0_45/com/sun/java/swing/plaf/windows/WindowsToolBarSeparatorUI.java,Java,,75,20,13,108
/jdk1.6.0_45/com/sun/java/swing/plaf/windows/WindowsToolBarUI.java,Java,,56,16,10,82
/jdk1.6.0_45/com/sun/java/swing/plaf/windows/WindowsTreeUI.java,Java,,132,29,56,217
/jdk1.6.0_45/com/sun/java/swing/plaf/windows/XPStyle.java,Java,,475,98,187,760
/jdk1.6.0_45/com/sun/java/swing/SwingUtilities3.java,Java,,133,20,54,207
/jdk1.6.0_45/com/sun/javadoc/AnnotationDesc.java,Java,,9,9,45,63
/jdk1.6.0_45/com/sun/javadoc/AnnotationTypeDoc.java,Java,,4,4,19,27
/jdk1.6.0_45/com/sun/javadoc/AnnotationTypeElementDoc.java,Java,,4,4,19,27
/jdk1.6.0_45/com/sun/javadoc/AnnotationValue.java,Java,,5,5,32,42
/jdk1.6.0_45/com/sun/javadoc/ClassDoc.java,Java,,30,31,263,324
/jdk1.6.0_45/com/sun/javadoc/ConstructorDoc.java,Java,,3,2,12,17
/jdk1.6.0_45/com/sun/javadoc/Doc.java,Java,,29,27,191,247
/jdk1.6.0_45/com/sun/javadoc/DocErrorReporter.java,Java,,9,8,48,65
/jdk1.6.0_45/com/sun/javadoc/Doclet.java,Java,,16,7,71,94
/jdk1.6.0_45/com/sun/javadoc/ExecutableMemberDoc.java,Java,,15,14,93,122
/jdk1.6.0_45/com/sun/javadoc/FieldDoc.java,Java,,9,8,44,61
/jdk1.6.0_45/com/sun/javadoc/LanguageVersion.java,Java,,5,5,20,30
/jdk1.6.0_45/com/sun/javadoc/MemberDoc.java,Java,,4,3,22,29
/jdk1.6.0_45/com/sun/javadoc/MethodDoc.java,Java,,9,9,59,77
/jdk1.6.0_45/com/sun/javadoc/PackageDoc.java,Java,,13,12,86,111
/jdk1.6.0_45/com/sun/javadoc/Parameter.java,Java,,8,9,41,58
/jdk1.6.0_45/com/sun/javadoc/ParameterizedType.java,Java,,8,8,76,92
/jdk1.6.0_45/com/sun/javadoc/ParamTag.java,Java,,6,5,38,49
/jdk1.6.0_45/com/sun/javadoc/ProgramElementDoc.java,Java,,15,13,79,107
/jdk1.6.0_45/com/sun/javadoc/RootDoc.java,Java,,9,8,74,91
/jdk1.6.0_45/com/sun/javadoc/SeeTag.java,Java,,9,8,92,109
/jdk1.6.0_45/com/sun/javadoc/SerialFieldTag.java,Java,,8,7,54,69
/jdk1.6.0_45/com/sun/javadoc/SourcePosition.java,Java,,8,6,23,37
/jdk1.6.0_45/com/sun/javadoc/Tag.java,Java,,13,11,116,140
/jdk1.6.0_45/com/sun/javadoc/ThrowsTag.java,Java,,7,6,48,61
/jdk1.6.0_45/com/sun/javadoc/Type.java,Java,,14,13,108,135
/jdk1.6.0_45/com/sun/javadoc/TypeVariable.java,Java,,5,5,32,42
/jdk1.6.0_45/com/sun/javadoc/WildcardType.java,Java,,5,5,35,45
/jdk1.6.0_45/com/sun/java_cup/internal/runtime/lr_parser.java,Java,,490,203,535,1228
/jdk1.6.0_45/com/sun/java_cup/internal/runtime/Scanner.java,Java,,4,2,15,21
/jdk1.6.0_45/com/sun/java_cup/internal/runtime/Symbol.java,Java,,38,25,48,111
/jdk1.6.0_45/com/sun/java_cup/internal/runtime/virtual_parse_stack.java,Java,,49,32,64,145
/jdk1.6.0_45/com/sun/jmx/defaults/JmxProperties.java,Java,,14,13,68,95
/jdk1.6.0_45/com/sun/jmx/defaults/ServiceName.java,Java,,14,11,54,79
/jdk1.6.0_45/com/sun/jmx/interceptor/DefaultMBeanServerInterceptor.java,Java,,1208,243,422,1873
/jdk1.6.0_45/com/sun/jmx/interceptor/MBeanServerInterceptor.java,Java,,106,35,543,684
/jdk1.6.0_45/com/sun/jmx/mbeanserver/ClassLoaderRepositorySupport.java,Java,,182,46,82,310
/jdk1.6.0_45/com/sun/jmx/mbeanserver/ConvertingMethod.java,Java,,151,24,27,202
/jdk1.6.0_45/com/sun/jmx/mbeanserver/DescriptorCache.java,Java,,35,8,6,49
/jdk1.6.0_45/com/sun/jmx/mbeanserver/DynamicMBean2.java,Java,,11,6,42,59
/jdk1.6.0_45/com/sun/jmx/mbeanserver/GetPropertyAction.java,Java,,11,5,12,28
/jdk1.6.0_45/com/sun/jmx/mbeanserver/Introspector.java,Java,,253,41,185,479
/jdk1.6.0_45/com/sun/jmx/mbeanserver/JmxMBeanServer.java,Java,,469,123,906,1498
/jdk1.6.0_45/com/sun/jmx/mbeanserver/JmxMBeanServerBuilder.java,Java,,15,5,77,97
/jdk1.6.0_45/com/sun/jmx/mbeanserver/MBeanAnalyzer.java,Java,,154,29,68,251
/jdk1.6.0_45/com/sun/jmx/mbeanserver/MBeanInstantiator.java,Java,,417,93,246,756
/jdk1.6.0_45/com/sun/jmx/mbeanserver/MBeanIntrospector.java,Java,,255,43,142,440
/jdk1.6.0_45/com/sun/jmx/mbeanserver/MBeanServerDelegateImpl.java,Java,,184,36,107,327
/jdk1.6.0_45/com/sun/jmx/mbeanserver/MBeanSupport.java,Java,,160,24,104,288
/jdk1.6.0_45/com/sun/jmx/mbeanserver/ModifiableClassLoaderRepository.java,Java,,11,9,33,53
/jdk1.6.0_45/com/sun/jmx/mbeanserver/MXBeanIntrospector.java,Java,,236,34,50,320
/jdk1.6.0_45/com/sun/jmx/mbeanserver/MXBeanLookup.java,Java,,82,10,54,146
/jdk1.6.0_45/com/sun/jmx/mbeanserver/MXBeanProxy.java,Java,,114,23,16,153
/jdk1.6.0_45/com/sun/jmx/mbeanserver/MXBeanSupport.java,Java,,94,14,51,159
/jdk1.6.0_45/com/sun/jmx/mbeanserver/NamedObject.java,Java,,37,17,51,105
/jdk1.6.0_45/com/sun/jmx/mbeanserver/ObjectInputStreamWithLoader.java,Java,,24,12,18,54
/jdk1.6.0_45/com/sun/jmx/mbeanserver/OpenConverter.java,Java,,1146,165,208,1519
/jdk1.6.0_45/com/sun/jmx/mbeanserver/PerInterface.java,Java,,196,25,41,262
/jdk1.6.0_45/com/sun/jmx/mbeanserver/Repository.java,Java,,338,78,229,645
/jdk1.6.0_45/com/sun/jmx/mbeanserver/SecureClassLoaderRepository.java,Java,,23,3,20,46
/jdk1.6.0_45/com/sun/jmx/mbeanserver/StandardMBeanIntrospector.java,Java,,129,24,21,174
/jdk1.6.0_45/com/sun/jmx/mbeanserver/StandardMBeanSupport.java,Java,,74,9,33,116
/jdk1.6.0_45/com/sun/jmx/mbeanserver/SunJmxMBeanServer.java,Java,,12,10,53,75
/jdk1.6.0_45/com/sun/jmx/mbeanserver/Util.java,Java,,54,14,15,83
/jdk1.6.0_45/com/sun/jmx/mbeanserver/WeakIdentityHashMap.java,Java,,64,19,36,119
/jdk1.6.0_45/com/sun/jmx/remote/internal/ArrayNotificationBuffer.java,Java,,538,90,190,818
/jdk1.6.0_45/com/sun/jmx/remote/internal/ArrayQueue.java,Java,,63,9,7,79
/jdk1.6.0_45/com/sun/jmx/remote/internal/ClientCommunicatorAdmin.java,Java,,149,44,39,232
/jdk1.6.0_45/com/sun/jmx/remote/internal/ClientListenerInfo.java,Java,,57,19,12,88
/jdk1.6.0_45/com/sun/jmx/remote/internal/ClientNotifForwarder.java,Java,,576,137,148,861
/jdk1.6.0_45/com/sun/jmx/remote/internal/NotificationBuffer.java,Java,,13,4,37,54
/jdk1.6.0_45/com/sun/jmx/remote/internal/NotificationBufferFilter.java,Java,,9,3,10,22
/jdk1.6.0_45/com/sun/jmx/remote/internal/ProxyInputStream.java,Java,,152,49,6,207
/jdk1.6.0_45/com/sun/jmx/remote/internal/ProxyRef.java,Java,,50,15,6,71
/jdk1.6.0_45/com/sun/jmx/remote/internal/RMIExporter.java,Java,,18,5,18,41
/jdk1.6.0_45/com/sun/jmx/remote/internal/ServerCommunicatorAdmin.java,Java,,135,38,41,214
/jdk1.6.0_45/com/sun/jmx/remote/internal/ServerNotifForwarder.java,Java,,363,56,56,475
/jdk1.6.0_45/com/sun/jmx/remote/internal/Unmarshal.java,Java,,7,3,6,16
/jdk1.6.0_45/com/sun/jmx/remote/protocol/iiop/ClientProvider.java,Java,,19,5,6,30
/jdk1.6.0_45/com/sun/jmx/remote/protocol/iiop/ServerProvider.java,Java,,21,6,6,33
/jdk1.6.0_45/com/sun/jmx/remote/protocol/rmi/ClientProvider.java,Java,,19,5,6,30
/jdk1.6.0_45/com/sun/jmx/remote/protocol/rmi/ServerProvider.java,Java,,21,6,6,33
/jdk1.6.0_45/com/sun/jmx/remote/security/FileLoginModule.java,Java,,287,65,193,545
/jdk1.6.0_45/com/sun/jmx/remote/security/JMXPluggableAuthenticator.java,Java,,187,37,104,328
/jdk1.6.0_45/com/sun/jmx/remote/security/JMXSubjectDomainCombiner.java,Java,,42,9,37,88
/jdk1.6.0_45/com/sun/jmx/remote/security/MBeanServerAccessController.java,Java,,374,51,219,644
/jdk1.6.0_45/com/sun/jmx/remote/security/MBeanServerFileAccessController.java,Java,,297,36,192,525
/jdk1.6.0_45/com/sun/jmx/remote/security/NotificationAccessController.java,Java,,19,6,67,92
/jdk1.6.0_45/com/sun/jmx/remote/security/SubjectDelegator.java,Java,,78,15,37,130
/jdk1.6.0_45/com/sun/jmx/remote/util/CacheMap.java,Java,,46,10,44,100
/jdk1.6.0_45/com/sun/jmx/remote/util/ClassLoaderWithRepository.java,Java,,24,7,6,37
/jdk1.6.0_45/com/sun/jmx/remote/util/ClassLogger.java,Java,,171,44,13,228
/jdk1.6.0_45/com/sun/jmx/remote/util/EnvHelp.java,Java,,374,75,244,693
/jdk1.6.0_45/com/sun/jmx/remote/util/OrderClassLoaders.java,Java,,19,5,6,30
/jdk1.6.0_45/com/sun/jmx/remote/util/Service.java,Java,,150,23,157,330
/jdk1.6.0_45/com/sun/jmx/snmp/agent/SnmpEntryOid.java,Java,,11,2,21,34
/jdk1.6.0_45/com/sun/jmx/snmp/agent/SnmpErrorHandlerAgent.java,Java,,71,43,88,202
/jdk1.6.0_45/com/sun/jmx/snmp/agent/SnmpGenericMetaServer.java,Java,,15,10,93,118
/jdk1.6.0_45/com/sun/jmx/snmp/agent/SnmpGenericObjectServer.java,Java,,260,54,244,558
/jdk1.6.0_45/com/sun/jmx/snmp/agent/SnmpIndex.java,Java,,66,21,90,177
/jdk1.6.0_45/com/sun/jmx/snmp/agent/SnmpMib.java,Java,,429,143,418,990
/jdk1.6.0_45/com/sun/jmx/snmp/agent/SnmpMibAgent.java,Java,,293,68,391,752
/jdk1.6.0_45/com/sun/jmx/snmp/agent/SnmpMibAgentMBean.java,Java,,38,30,237,305
/jdk1.6.0_45/com/sun/jmx/snmp/agent/SnmpMibEntry.java,Java,,31,13,137,181
/jdk1.6.0_45/com/sun/jmx/snmp/agent/SnmpMibGroup.java,Java,,155,61,290,506
/jdk1.6.0_45/com/sun/jmx/snmp/agent/SnmpMibHandler.java,Java,,17,13,113,143
/jdk1.6.0_45/com/sun/jmx/snmp/agent/SnmpMibNode.java,Java,,116,44,242,402
/jdk1.6.0_45/com/sun/jmx/snmp/agent/SnmpMibOid.java,Java,,266,80,200,546
/jdk1.6.0_45/com/sun/jmx/snmp/agent/SnmpMibRequest.java,Java,,23,12,125,160
/jdk1.6.0_45/com/sun/jmx/snmp/agent/SnmpMibRequestImpl.java,Java,,79,25,123,227
/jdk1.6.0_45/com/sun/jmx/snmp/agent/SnmpMibSubRequest.java,Java,,22,12,162,196
/jdk1.6.0_45/com/sun/jmx/snmp/agent/SnmpMibTable.java,Java,,813,224,1475,2512
/jdk1.6.0_45/com/sun/jmx/snmp/agent/SnmpRequestTree.java,Java,,534,163,359,1056
/jdk1.6.0_45/com/sun/jmx/snmp/agent/SnmpStandardMetaServer.java,Java,,11,6,87,104
/jdk1.6.0_45/com/sun/jmx/snmp/agent/SnmpStandardObjectServer.java,Java,,54,14,180,248
/jdk1.6.0_45/com/sun/jmx/snmp/agent/SnmpTableCallbackHandler.java,Java,,13,3,45,61
/jdk1.6.0_45/com/sun/jmx/snmp/agent/SnmpTableEntryFactory.java,Java,,10,6,61,77
/jdk1.6.0_45/com/sun/jmx/snmp/agent/SnmpTableEntryNotification.java,Java,,25,18,86,129
/jdk1.6.0_45/com/sun/jmx/snmp/agent/SnmpTableSupport.java,Java,,125,51,380,556
/jdk1.6.0_45/com/sun/jmx/snmp/agent/SnmpUserDataFactory.java,Java,,10,4,95,109
/jdk1.6.0_45/com/sun/jmx/snmp/BerDecoder.java,Java,,380,121,246,747
/jdk1.6.0_45/com/sun/jmx/snmp/BerEncoder.java,Java,,196,94,177,467
/jdk1.6.0_45/com/sun/jmx/snmp/BerException.java,Java,,17,13,20,50
/jdk1.6.0_45/com/sun/jmx/snmp/daemon/ClientHandler.java,Java,,78,27,41,146
/jdk1.6.0_45/com/sun/jmx/snmp/daemon/CommunicationException.java,Java,,20,10,35,65
/jdk1.6.0_45/com/sun/jmx/snmp/daemon/CommunicatorServer.java,Java,,610,140,622,1372
/jdk1.6.0_45/com/sun/jmx/snmp/daemon/CommunicatorServerMBean.java,Java,,13,16,130,159
/jdk1.6.0_45/com/sun/jmx/snmp/daemon/SnmpAdaptorServer.java,Java,,1171,269,1174,2614
/jdk1.6.0_45/com/sun/jmx/snmp/daemon/SnmpAdaptorServerMBean.java,Java,,98,73,515,686
/jdk1.6.0_45/com/sun/jmx/snmp/daemon/SnmpInformHandler.java,Java,,8,7,51,66
/jdk1.6.0_45/com/sun/jmx/snmp/daemon/SnmpInformRequest.java,Java,,693,156,354,1203
/jdk1.6.0_45/com/sun/jmx/snmp/daemon/SnmpMibTree.java,Java,,158,46,50,254
/jdk1.6.0_45/com/sun/jmx/snmp/daemon/SnmpQManager.java,Java,,251,64,35,350
/jdk1.6.0_45/com/sun/jmx/snmp/daemon/SnmpRequestCounter.java,Java,,10,6,25,41
/jdk1.6.0_45/com/sun/jmx/snmp/daemon/SnmpRequestHandler.java,Java,,759,135,257,1151
/jdk1.6.0_45/com/sun/jmx/snmp/daemon/SnmpResponseHandler.java,Java,,90,28,30,148
/jdk1.6.0_45/com/sun/jmx/snmp/daemon/SnmpSendServer.java,Java,,143,34,38,215
/jdk1.6.0_45/com/sun/jmx/snmp/daemon/SnmpSession.java,Java,,289,65,157,511
/jdk1.6.0_45/com/sun/jmx/snmp/daemon/SnmpSocket.java,Java,,182,53,94,329
/jdk1.6.0_45/com/sun/jmx/snmp/daemon/SnmpSubBulkRequestHandler.java,Java,,190,42,81,313
/jdk1.6.0_45/com/sun/jmx/snmp/daemon/SnmpSubNextRequestHandler.java,Java,,143,26,80,249
/jdk1.6.0_45/com/sun/jmx/snmp/daemon/SnmpSubRequestHandler.java,Java,,342,96,207,645
/jdk1.6.0_45/com/sun/jmx/snmp/daemon/SnmpTimerServer.java,Java,,92,26,27,145
/jdk1.6.0_45/com/sun/jmx/snmp/defaults/DefaultPaths.java,Java,,105,20,105,230
/jdk1.6.0_45/com/sun/jmx/snmp/defaults/SnmpProperties.java,Java,,32,19,114,165
/jdk1.6.0_45/com/sun/jmx/snmp/Enumerated.java,Java,,60,39,107,206
/jdk1.6.0_45/com/sun/jmx/snmp/EnumRowStatus.java,Java,,89,31,171,291
/jdk1.6.0_45/com/sun/jmx/snmp/InetAddressAcl.java,Java,,15,14,85,114
/jdk1.6.0_45/com/sun/jmx/snmp/internal/SnmpAccessControlModel.java,Java,,25,3,50,78
/jdk1.6.0_45/com/sun/jmx/snmp/internal/SnmpAccessControlSubSystem.java,Java,,21,2,39,62
/jdk1.6.0_45/com/sun/jmx/snmp/internal/SnmpDecryptedPdu.java,Java,,7,1,28,36
/jdk1.6.0_45/com/sun/jmx/snmp/internal/SnmpEngineImpl.java,Java,,200,53,182,435
/jdk1.6.0_45/com/sun/jmx/snmp/internal/SnmpIncomingRequest.java,Java,,36,9,105,150
/jdk1.6.0_45/com/sun/jmx/snmp/internal/SnmpIncomingResponse.java,Java,,29,9,70,108
/jdk1.6.0_45/com/sun/jmx/snmp/internal/SnmpLcd.java,Java,,54,15,50,119
/jdk1.6.0_45/com/sun/jmx/snmp/internal/SnmpModel.java,Java,,5,1,24,30
/jdk1.6.0_45/com/sun/jmx/snmp/internal/SnmpModelLcd.java,Java,,3,2,12,17
/jdk1.6.0_45/com/sun/jmx/snmp/internal/SnmpMsgProcessingModel.java,Java,,38,9,86,133
/jdk1.6.0_45/com/sun/jmx/snmp/internal/SnmpMsgProcessingSubSystem.java,Java,,51,9,90,150
/jdk1.6.0_45/com/sun/jmx/snmp/internal/SnmpOutgoingRequest.java,Java,,21,5,48,74
/jdk1.6.0_45/com/sun/jmx/snmp/internal/SnmpSecurityCache.java,Java,,3,1,16,20
/jdk1.6.0_45/com/sun/jmx/snmp/internal/SnmpSecurityModel.java,Java,,64,4,94,162
/jdk1.6.0_45/com/sun/jmx/snmp/internal/SnmpSecuritySubSystem.java,Java,,66,5,95,166
/jdk1.6.0_45/com/sun/jmx/snmp/internal/SnmpSubSystem.java,Java,,12,6,41,59
/jdk1.6.0_45/com/sun/jmx/snmp/internal/SnmpTools.java,Java,,67,7,37,111
/jdk1.6.0_45/com/sun/jmx/snmp/IPAcl/AclEntryImpl.java,Java,,94,39,125,258
/jdk1.6.0_45/com/sun/jmx/snmp/IPAcl/AclImpl.java,Java,,87,30,161,278
/jdk1.6.0_45/com/sun/jmx/snmp/IPAcl/ASCII_CharStream.java,Java,,306,56,22,384
/jdk1.6.0_45/com/sun/jmx/snmp/IPAcl/GroupImpl.java,Java,,43,21,67,131
/jdk1.6.0_45/com/sun/jmx/snmp/IPAcl/Host.java,Java,,128,30,28,186
/jdk1.6.0_45/com/sun/jmx/snmp/IPAcl/JDMAccess.java,Java,,25,10,19,54
/jdk1.6.0_45/com/sun/jmx/snmp/IPAcl/JDMAclBlock.java,Java,,18,10,23,51
/jdk1.6.0_45/com/sun/jmx/snmp/IPAcl/JDMAclItem.java,Java,,23,10,15,48
/jdk1.6.0_45/com/sun/jmx/snmp/IPAcl/JDMCommunities.java,Java,,19,9,15,43
/jdk1.6.0_45/com/sun/jmx/snmp/IPAcl/JDMCommunity.java,Java,,19,9,15,43
/jdk1.6.0_45/com/sun/jmx/snmp/IPAcl/JDMEnterprise.java,Java,,16,8,15,39
/jdk1.6.0_45/com/sun/jmx/snmp/IPAcl/JDMHost.java,Java,,15,11,15,41
/jdk1.6.0_45/com/sun/jmx/snmp/IPAcl/JDMHostInform.java,Java,,16,7,10,33
/jdk1.6.0_45/com/sun/jmx/snmp/IPAcl/JDMHostName.java,Java,,24,11,15,50
/jdk1.6.0_45/com/sun/jmx/snmp/IPAcl/JDMHostTrap.java,Java,,16,8,15,39
/jdk1.6.0_45/com/sun/jmx/snmp/IPAcl/JDMInformBlock.java,Java,,18,9,18,45
/jdk1.6.0_45/com/sun/jmx/snmp/IPAcl/JDMInformCommunity.java,Java,,19,7,10,36
/jdk1.6.0_45/com/sun/jmx/snmp/IPAcl/JDMInformInterestedHost.java,Java,,15,6,10,31
/jdk1.6.0_45/com/sun/jmx/snmp/IPAcl/JDMInformItem.java,Java,,19,7,10,36
/jdk1.6.0_45/com/sun/jmx/snmp/IPAcl/JDMIpAddress.java,Java,,25,11,15,51
/jdk1.6.0_45/com/sun/jmx/snmp/IPAcl/JDMIpMask.java,Java,,25,12,15,52
/jdk1.6.0_45/com/sun/jmx/snmp/IPAcl/JDMIpV6Address.java,Java,,9,5,11,25
/jdk1.6.0_45/com/sun/jmx/snmp/IPAcl/JDMManagers.java,Java,,15,7,15,37
/jdk1.6.0_45/com/sun/jmx/snmp/IPAcl/JDMNetMask.java,Java,,25,6,11,42
/jdk1.6.0_45/com/sun/jmx/snmp/IPAcl/JDMNetMaskV6.java,Java,,14,5,11,30
/jdk1.6.0_45/com/sun/jmx/snmp/IPAcl/JDMSecurityDefs.java,Java,,15,7,15,37
/jdk1.6.0_45/com/sun/jmx/snmp/IPAcl/JDMTrapBlock.java,Java,,18,10,19,47
/jdk1.6.0_45/com/sun/jmx/snmp/IPAcl/JDMTrapCommunity.java,Java,,19,8,15,42
/jdk1.6.0_45/com/sun/jmx/snmp/IPAcl/JDMTrapInterestedHost.java,Java,,15,7,15,37
/jdk1.6.0_45/com/sun/jmx/snmp/IPAcl/JDMTrapItem.java,Java,,19,9,15,43
/jdk1.6.0_45/com/sun/jmx/snmp/IPAcl/JDMTrapNum.java,Java,,17,8,15,40
/jdk1.6.0_45/com/sun/jmx/snmp/IPAcl/JJTParserState.java,Java,,81,20,29,130
/jdk1.6.0_45/com/sun/jmx/snmp/IPAcl/NetMaskImpl.java,Java,,166,37,70,273
/jdk1.6.0_45/com/sun/jmx/snmp/IPAcl/Node.java,Java,,10,11,25,46
/jdk1.6.0_45/com/sun/jmx/snmp/IPAcl/OwnerImpl.java,Java,,44,18,61,123
/jdk1.6.0_45/com/sun/jmx/snmp/IPAcl/ParseError.java,Java,,8,3,11,22
/jdk1.6.0_45/com/sun/jmx/snmp/IPAcl/ParseException.java,Java,,109,14,75,198
/jdk1.6.0_45/com/sun/jmx/snmp/IPAcl/Parser.java,Java,,1174,57,35,1266
/jdk1.6.0_45/com/sun/jmx/snmp/IPAcl/ParserConstants.java,Java,,80,6,7,93
/jdk1.6.0_45/com/sun/jmx/snmp/IPAcl/ParserTokenManager.java,Java,,1481,8,7,1496
/jdk1.6.0_45/com/sun/jmx/snmp/IPAcl/ParserTreeConstants.java,Java,,58,5,7,70
/jdk1.6.0_45/com/sun/jmx/snmp/IPAcl/PermissionImpl.java,Java,,24,14,38,76
/jdk1.6.0_45/com/sun/jmx/snmp/IPAcl/PrincipalImpl.java,Java,,49,18,68,135
/jdk1.6.0_45/com/sun/jmx/snmp/IPAcl/SimpleNode.java,Java,,85,24,35,144
/jdk1.6.0_45/com/sun/jmx/snmp/IPAcl/SnmpAcl.java,Java,,251,49,187,487
/jdk1.6.0_45/com/sun/jmx/snmp/IPAcl/Token.java,Java,,19,12,62,93
/jdk1.6.0_45/com/sun/jmx/snmp/IPAcl/TokenMgrError.java,Java,,72,14,54,140
/jdk1.6.0_45/com/sun/jmx/snmp/mpm/SnmpMsgTranslator.java,Java,,19,1,58,78
/jdk1.6.0_45/com/sun/jmx/snmp/ServiceName.java,Java,,24,23,108,155
/jdk1.6.0_45/com/sun/jmx/snmp/SnmpAckPdu.java,Java,,4,0,21,25
/jdk1.6.0_45/com/sun/jmx/snmp/SnmpBadSecurityLevelException.java,Java,,6,0,16,22
/jdk1.6.0_45/com/sun/jmx/snmp/SnmpCounter.java,Java,,19,12,55,86
/jdk1.6.0_45/com/sun/jmx/snmp/SnmpCounter64.java,Java,,70,23,108,201
/jdk1.6.0_45/com/sun/jmx/snmp/SnmpDataTypeEnums.java,Java,,25,33,92,150
/jdk1.6.0_45/com/sun/jmx/snmp/SnmpDefinitions.java,Java,,82,80,349,511
/jdk1.6.0_45/com/sun/jmx/snmp/SnmpEngine.java,Java,,7,3,46,56
/jdk1.6.0_45/com/sun/jmx/snmp/SnmpEngineFactory.java,Java,,6,2,36,44
/jdk1.6.0_45/com/sun/jmx/snmp/SnmpEngineId.java,Java,,238,48,187,473
/jdk1.6.0_45/com/sun/jmx/snmp/SnmpEngineParameters.java,Java,,35,11,54,100
/jdk1.6.0_45/com/sun/jmx/snmp/SnmpGauge.java,Java,,19,12,55,86
/jdk1.6.0_45/com/sun/jmx/snmp/SnmpInt.java,Java,,98,29,142,269
/jdk1.6.0_45/com/sun/jmx/snmp/SnmpIpAddress.java,Java,,91,22,91,204
/jdk1.6.0_45/com/sun/jmx/snmp/SnmpMessage.java,Java,,224,39,126,389
/jdk1.6.0_45/com/sun/jmx/snmp/SnmpMsg.java,Java,,273,36,156,465
/jdk1.6.0_45/com/sun/jmx/snmp/SnmpNull.java,Java,,64,22,82,168
/jdk1.6.0_45/com/sun/jmx/snmp/SnmpOid.java,Java,,324,62,256,642
/jdk1.6.0_45/com/sun/jmx/snmp/SnmpOidDatabase.java,Java,,13,13,53,79
/jdk1.6.0_45/com/sun/jmx/snmp/SnmpOidDatabaseSupport.java,Java,,67,16,61,144
/jdk1.6.0_45/com/sun/jmx/snmp/SnmpOidRecord.java,Java,,20,11,65,96
/jdk1.6.0_45/com/sun/jmx/snmp/SnmpOidTable.java,Java,,9,11,52,72
/jdk1.6.0_45/com/sun/jmx/snmp/SnmpOidTableSupport.java,Java,,87,30,87,204
/jdk1.6.0_45/com/sun/jmx/snmp/SnmpOpaque.java,Java,,26,12,49,87
/jdk1.6.0_45/com/sun/jmx/snmp/SnmpParameters.java,Java,,89,24,120,233
/jdk1.6.0_45/com/sun/jmx/snmp/SnmpParams.java,Java,,16,5,41,62
/jdk1.6.0_45/com/sun/jmx/snmp/SnmpPdu.java,Java,,34,10,66,110
/jdk1.6.0_45/com/sun/jmx/snmp/SnmpPduBulk.java,Java,,30,16,62,108
/jdk1.6.0_45/com/sun/jmx/snmp/SnmpPduBulkType.java,Java,,7,5,32,44
/jdk1.6.0_45/com/sun/jmx/snmp/SnmpPduFactory.java,Java,,6,9,67,82
/jdk1.6.0_45/com/sun/jmx/snmp/SnmpPduFactoryBER.java,Java,,34,10,72,116
/jdk1.6.0_45/com/sun/jmx/snmp/SnmpPduPacket.java,Java,,6,7,38,51
/jdk1.6.0_45/com/sun/jmx/snmp/SnmpPduRequest.java,Java,,26,16,58,100
/jdk1.6.0_45/com/sun/jmx/snmp/SnmpPduRequestType.java,Java,,7,1,38,46
/jdk1.6.0_45/com/sun/jmx/snmp/SnmpPduTrap.java,Java,,12,19,54,85
/jdk1.6.0_45/com/sun/jmx/snmp/SnmpPeer.java,Java,,139,57,251,447
/jdk1.6.0_45/com/sun/jmx/snmp/SnmpScopedPduBulk.java,Java,,36,10,49,95
/jdk1.6.0_45/com/sun/jmx/snmp/SnmpScopedPduPacket.java,Java,,17,12,62,91
/jdk1.6.0_45/com/sun/jmx/snmp/SnmpScopedPduRequest.java,Java,,32,10,43,85
/jdk1.6.0_45/com/sun/jmx/snmp/SnmpSecurityException.java,Java,,12,1,38,51
/jdk1.6.0_45/com/sun/jmx/snmp/SnmpSecurityParameters.java,Java,,8,2,30,40
/jdk1.6.0_45/com/sun/jmx/snmp/SnmpStatusException.java,Java,,32,30,78,140
/jdk1.6.0_45/com/sun/jmx/snmp/SnmpString.java,Java,,117,27,121,265
/jdk1.6.0_45/com/sun/jmx/snmp/SnmpStringFixed.java,Java,,75,16,90,181
/jdk1.6.0_45/com/sun/jmx/snmp/SnmpTimeticks.java,Java,,45,17,76,138
/jdk1.6.0_45/com/sun/jmx/snmp/SnmpTooBigException.java,Java,,13,15,47,75
/jdk1.6.0_45/com/sun/jmx/snmp/SnmpUnknownAccContrModelException.java,Java,,7,2,22,31
/jdk1.6.0_45/com/sun/jmx/snmp/SnmpUnknownModelException.java,Java,,6,0,20,26
/jdk1.6.0_45/com/sun/jmx/snmp/SnmpUnknownModelLcdException.java,Java,,6,0,20,26
/jdk1.6.0_45/com/sun/jmx/snmp/SnmpUnknownMsgProcModelException.java,Java,,7,2,20,29
/jdk1.6.0_45/com/sun/jmx/snmp/SnmpUnknownSecModelException.java,Java,,7,2,20,29
/jdk1.6.0_45/com/sun/jmx/snmp/SnmpUnknownSubSystemException.java,Java,,6,0,20,26
/jdk1.6.0_45/com/sun/jmx/snmp/SnmpUnsignedInt.java,Java,,32,15,66,113
/jdk1.6.0_45/com/sun/jmx/snmp/SnmpUsmKeyHandler.java,Java,,10,8,66,84
/jdk1.6.0_45/com/sun/jmx/snmp/SnmpV3Message.java,Java,,283,48,159,490
/jdk1.6.0_45/com/sun/jmx/snmp/SnmpValue.java,Java,,19,14,51,84
/jdk1.6.0_45/com/sun/jmx/snmp/SnmpVarBind.java,Java,,270,84,391,745
/jdk1.6.0_45/com/sun/jmx/snmp/SnmpVarBindList.java,Java,,244,53,260,557
/jdk1.6.0_45/com/sun/jmx/snmp/tasks/Task.java,Java,,4,1,47,52
/jdk1.6.0_45/com/sun/jmx/snmp/tasks/TaskServer.java,Java,,4,4,34,42
/jdk1.6.0_45/com/sun/jmx/snmp/tasks/ThreadService.java,Java,,142,44,56,242
/jdk1.6.0_45/com/sun/jmx/snmp/ThreadContext.java,Java,,80,22,211,313
/jdk1.6.0_45/com/sun/jmx/snmp/Timestamp.java,Java,,41,22,75,138
/jdk1.6.0_45/com/sun/jmx/snmp/UserAcl.java,Java,,11,11,61,83
/jdk1.6.0_45/com/sun/jmx/trace/Trace.java,Java,,85,19,94,198
/jdk1.6.0_45/com/sun/jmx/trace/TraceDestination.java,Java,,16,7,52,75
/jdk1.6.0_45/com/sun/jmx/trace/TraceImplementation.java,Java,,135,34,88,257
/jdk1.6.0_45/com/sun/jmx/trace/TraceManager.java,Java,,95,14,170,279
/jdk1.6.0_45/com/sun/jmx/trace/TraceTags.java,Java,,16,16,54,86
/jdk1.6.0_45/com/sun/mirror/apt/AnnotationProcessor.java,Java,,6,7,34,47
/jdk1.6.0_45/com/sun/mirror/apt/AnnotationProcessorEnvironment.java,Java,,20,22,118,160
/jdk1.6.0_45/com/sun/mirror/apt/AnnotationProcessorFactory.java,Java,,10,10,66,86
/jdk1.6.0_45/com/sun/mirror/apt/AnnotationProcessorListener.java,Java,,2,2,14,18
/jdk1.6.0_45/com/sun/mirror/apt/AnnotationProcessors.java,Java,,31,15,56,102
/jdk1.6.0_45/com/sun/mirror/apt/Filer.java,Java,,17,12,104,133
/jdk1.6.0_45/com/sun/mirror/apt/Messager.java,Java,,10,12,49,71
/jdk1.6.0_45/com/sun/mirror/apt/RoundCompleteEvent.java,Java,,15,5,31,51
/jdk1.6.0_45/com/sun/mirror/apt/RoundCompleteListener.java,Java,,4,2,19,25
/jdk1.6.0_45/com/sun/mirror/apt/RoundState.java,Java,,7,5,30,42
/jdk1.6.0_45/com/sun/mirror/declaration/AnnotationMirror.java,Java,,9,8,47,64
/jdk1.6.0_45/com/sun/mirror/declaration/AnnotationTypeDeclaration.java,Java,,5,7,22,34
/jdk1.6.0_45/com/sun/mirror/declaration/AnnotationTypeElementDeclaration.java,Java,,5,6,23,34
/jdk1.6.0_45/com/sun/mirror/declaration/AnnotationValue.java,Java,,7,7,45,59
/jdk1.6.0_45/com/sun/mirror/declaration/ClassDeclaration.java,Java,,8,10,48,66
/jdk1.6.0_45/com/sun/mirror/declaration/ConstructorDeclaration.java,Java,,3,4,14,21
/jdk1.6.0_45/com/sun/mirror/declaration/Declaration.java,Java,,15,15,116,146
/jdk1.6.0_45/com/sun/mirror/declaration/EnumConstantDeclaration.java,Java,,4,4,17,25
/jdk1.6.0_45/com/sun/mirror/declaration/EnumDeclaration.java,Java,,5,7,20,32
/jdk1.6.0_45/com/sun/mirror/declaration/ExecutableDeclaration.java,Java,,9,11,42,62
/jdk1.6.0_45/com/sun/mirror/declaration/FieldDeclaration.java,Java,,7,9,40,56
/jdk1.6.0_45/com/sun/mirror/declaration/InterfaceDeclaration.java,Java,,4,6,24,34
/jdk1.6.0_45/com/sun/mirror/declaration/MemberDeclaration.java,Java,,4,5,25,34
/jdk1.6.0_45/com/sun/mirror/declaration/MethodDeclaration.java,Java,,6,7,23,36
/jdk1.6.0_45/com/sun/mirror/declaration/Modifier.java,Java,,21,9,25,55
/jdk1.6.0_45/com/sun/mirror/declaration/PackageDeclaration.java,Java,,9,11,58,78
/jdk1.6.0_45/com/sun/mirror/declaration/ParameterDeclaration.java,Java,,5,7,19,31
/jdk1.6.0_45/com/sun/mirror/declaration/TypeDeclaration.java,Java,,12,14,97,123
/jdk1.6.0_45/com/sun/mirror/declaration/TypeParameterDeclaration.java,Java,,7,9,30,46
/jdk1.6.0_45/com/sun/mirror/type/AnnotationType.java,Java,,5,7,17,29
/jdk1.6.0_45/com/sun/mirror/type/ArrayType.java,Java,,4,5,21,30
/jdk1.6.0_45/com/sun/mirror/type/ClassType.java,Java,,6,8,37,51
/jdk1.6.0_45/com/sun/mirror/type/DeclaredType.java,Java,,9,11,68,88
/jdk1.6.0_45/com/sun/mirror/type/EnumType.java,Java,,5,7,17,29
/jdk1.6.0_45/com/sun/mirror/type/InterfaceType.java,Java,,5,7,24,36
/jdk1.6.0_45/com/sun/mirror/type/MirroredTypeException.java,Java,,19,11,33,63
/jdk1.6.0_45/com/sun/mirror/type/MirroredTypesException.java,Java,,27,11,34,72
/jdk1.6.0_45/com/sun/mirror/type/PrimitiveType.java,Java,,14,6,24,44
/jdk1.6.0_45/com/sun/mirror/type/ReferenceType.java,Java,,3,4,15,22
/jdk1.6.0_45/com/sun/mirror/type/TypeMirror.java,Java,,9,9,44,62
/jdk1.6.0_45/com/sun/mirror/type/TypeVariable.java,Java,,5,7,22,34
/jdk1.6.0_45/com/sun/mirror/type/VoidType.java,Java,,4,6,16,26
/jdk1.6.0_45/com/sun/mirror/type/WildcardType.java,Java,,6,8,37,51
/jdk1.6.0_45/com/sun/mirror/util/DeclarationFilter.java,Java,,106,39,151,296
/jdk1.6.0_45/com/sun/mirror/util/Declarations.java,Java,,6,8,32,46
/jdk1.6.0_45/com/sun/mirror/util/DeclarationScanner.java,Java,,103,38,103,244
/jdk1.6.0_45/com/sun/mirror/util/DeclarationVisitor.java,Java,,21,21,84,126
/jdk1.6.0_45/com/sun/mirror/util/DeclarationVisitors.java,Java,,13,5,62,80
/jdk1.6.0_45/com/sun/mirror/util/SimpleDeclarationVisitor.java,Java,,53,23,117,193
/jdk1.6.0_45/com/sun/mirror/util/SimpleTypeVisitor.java,Java,,40,19,93,152
/jdk1.6.0_45/com/sun/mirror/util/SourceOrderDeclScanner.java,Java,,144,50,36,230
/jdk1.6.0_45/com/sun/mirror/util/SourcePosition.java,Java,,7,9,33,49
/jdk1.6.0_45/com/sun/mirror/util/Types.java,Java,,20,17,129,166
/jdk1.6.0_45/com/sun/mirror/util/TypeVisitor.java,Java,,16,18,80,114
/jdk1.6.0_45/com/sun/naming/internal/FactoryEnumeration.java,Java,,50,10,33,93
/jdk1.6.0_45/com/sun/naming/internal/NamedWeakReference.java,Java,,11,8,12,31
/jdk1.6.0_45/com/sun/naming/internal/ResourceManager.java,Java,,263,53,228,544
/jdk1.6.0_45/com/sun/naming/internal/VersionHelper.java,Java,,65,21,52,138
/jdk1.6.0_45/com/sun/naming/internal/VersionHelper12.java,Java,,174,29,36,239
/jdk1.6.0_45/com/sun/org/apache/bcel/internal/classfile/AccessFlags.java,Java,,74,22,75,171
/jdk1.6.0_45/com/sun/org/apache/bcel/internal/classfile/Attribute.java,Java,,111,40,151,302
/jdk1.6.0_45/com/sun/org/apache/bcel/internal/classfile/AttributeReader.java,Java,,7,2,88,97
/jdk1.6.0_45/com/sun/org/apache/bcel/internal/classfile/ClassFormatException.java,Java,,5,3,61,69
/jdk1.6.0_45/com/sun/org/apache/bcel/internal/classfile/ClassParser.java,Java,,120,41,167,328
/jdk1.6.0_45/com/sun/org/apache/bcel/internal/classfile/Code.java,Java,,152,50,171,373
/jdk1.6.0_45/com/sun/org/apache/bcel/internal/classfile/CodeException.java,Java,,74,21,134,229
/jdk1.6.0_45/com/sun/org/apache/bcel/internal/classfile/Constant.java,Java,,43,13,92,148
/jdk1.6.0_45/com/sun/org/apache/bcel/internal/classfile/ConstantClass.java,Java,,39,14,101,154
/jdk1.6.0_45/com/sun/org/apache/bcel/internal/classfile/ConstantCP.java,Java,,40,12,102,154
/jdk1.6.0_45/com/sun/org/apache/bcel/internal/classfile/ConstantDouble.java,Java,,36,8,98,142
/jdk1.6.0_45/com/sun/org/apache/bcel/internal/classfile/ConstantFieldref.java,Java,,19,6,79,104
/jdk1.6.0_45/com/sun/org/apache/bcel/internal/classfile/ConstantFloat.java,Java,,36,6,99,141
/jdk1.6.0_45/com/sun/org/apache/bcel/internal/classfile/ConstantInteger.java,Java,,36,14,98,148
/jdk1.6.0_45/com/sun/org/apache/bcel/internal/classfile/ConstantInterfaceMethodref.java,Java,,19,6,79,104
/jdk1.6.0_45/com/sun/org/apache/bcel/internal/classfile/ConstantLong.java,Java,,36,5,98,139
/jdk1.6.0_45/com/sun/org/apache/bcel/internal/classfile/ConstantMethodref.java,Java,,19,6,79,104
/jdk1.6.0_45/com/sun/org/apache/bcel/internal/classfile/ConstantNameAndType.java,Java,,48,15,108,171
/jdk1.6.0_45/com/sun/org/apache/bcel/internal/classfile/ConstantObject.java,Java,,4,2,63,69
/jdk1.6.0_45/com/sun/org/apache/bcel/internal/classfile/ConstantPool.java,Java,,160,42,170,372
/jdk1.6.0_45/com/sun/org/apache/bcel/internal/classfile/ConstantString.java,Java,,41,6,100,147
/jdk1.6.0_45/com/sun/org/apache/bcel/internal/classfile/ConstantUtf8.java,Java,,37,14,96,147
/jdk1.6.0_45/com/sun/org/apache/bcel/internal/classfile/ConstantValue.java,Java,,58,14,106,178
/jdk1.6.0_45/com/sun/org/apache/bcel/internal/classfile/Deprecated.java,Java,,48,16,105,169
/jdk1.6.0_45/com/sun/org/apache/bcel/internal/classfile/DescendingVisitor.java,Java,,224,56,77,357
/jdk1.6.0_45/com/sun/org/apache/bcel/internal/classfile/EmptyVisitor.java,Java,,38,4,63,105
/jdk1.6.0_45/com/sun/org/apache/bcel/internal/classfile/ExceptionTable.java,Java,,70,17,115,202
/jdk1.6.0_45/com/sun/org/apache/bcel/internal/classfile/Field.java,Java,,51,16,98,165
/jdk1.6.0_45/com/sun/org/apache/bcel/internal/classfile/FieldOrMethod.java,Java,,83,25,115,223
/jdk1.6.0_45/com/sun/org/apache/bcel/internal/classfile/InnerClass.java,Java,,84,15,122,221
/jdk1.6.0_45/com/sun/org/apache/bcel/internal/classfile/InnerClasses.java,Java,,56,17,108,181
/jdk1.6.0_45/com/sun/org/apache/bcel/internal/classfile/JavaClass.java,Java,,420,121,280,821
/jdk1.6.0_45/com/sun/org/apache/bcel/internal/classfile/LineNumber.java,Java,,44,15,105,164
/jdk1.6.0_45/com/sun/org/apache/bcel/internal/classfile/LineNumberTable.java,Java,,91,28,121,240
/jdk1.6.0_45/com/sun/org/apache/bcel/internal/classfile/LocalVariable.java,Java,,89,28,142,259
/jdk1.6.0_45/com/sun/org/apache/bcel/internal/classfile/LocalVariableTable.java,Java,,70,22,104,196
/jdk1.6.0_45/com/sun/org/apache/bcel/internal/classfile/Method.java,Java,,84,26,118,228
/jdk1.6.0_45/com/sun/org/apache/bcel/internal/classfile/Node.java,Java,,4,2,59,65
/jdk1.6.0_45/com/sun/org/apache/bcel/internal/classfile/PMGClass.java,Java,,56,16,117,189
/jdk1.6.0_45/com/sun/org/apache/bcel/internal/classfile/Signature.java,Java,,134,44,118,296
/jdk1.6.0_45/com/sun/org/apache/bcel/internal/classfile/SourceFile.java,Java,,44,13,116,173
/jdk1.6.0_45/com/sun/org/apache/bcel/internal/classfile/StackMap.java,Java,,56,22,107,185
/jdk1.6.0_45/com/sun/org/apache/bcel/internal/classfile/StackMapEntry.java,Java,,90,26,93,209
/jdk1.6.0_45/com/sun/org/apache/bcel/internal/classfile/StackMapType.java,Java,,59,18,95,172
/jdk1.6.0_45/com/sun/org/apache/bcel/internal/classfile/Synthetic.java,Java,,51,14,111,176
/jdk1.6.0_45/com/sun/org/apache/bcel/internal/classfile/Unknown.java,Java,,73,21,119,213
/jdk1.6.0_45/com/sun/org/apache/bcel/internal/classfile/Utility.java,Java,,780,215,399,1394
/jdk1.6.0_45/com/sun/org/apache/bcel/internal/classfile/Visitor.java,Java,,35,2,64,101
/jdk1.6.0_45/com/sun/org/apache/bcel/internal/Constants.java,Java,,628,35,122,785
/jdk1.6.0_45/com/sun/org/apache/bcel/internal/ExceptionConstants.java,Java,,36,12,75,123
/jdk1.6.0_45/com/sun/org/apache/bcel/internal/generic/AALOAD.java,Java,,13,4,70,87
/jdk1.6.0_45/com/sun/org/apache/bcel/internal/generic/AASTORE.java,Java,,13,4,70,87
/jdk1.6.0_45/com/sun/org/apache/bcel/internal/generic/ACONST_NULL.java,Java,,16,5,73,94
/jdk1.6.0_45/com/sun/org/apache/bcel/internal/generic/AllocationInstruction.java,Java,,2,3,59,64
/jdk1.6.0_45/com/sun/org/apache/bcel/internal/generic/ALOAD.java,Java,,13,4,75,92
/jdk1.6.0_45/com/sun/org/apache/bcel/internal/generic/ANEWARRAY.java,Java,,33,9,72,114
/jdk1.6.0_45/com/sun/org/apache/bcel/internal/generic/ARETURN.java,Java,,13,4,71,88
/jdk1.6.0_45/com/sun/org/apache/bcel/internal/generic/ArithmeticInstruction.java,Java,,31,7,68,106
/jdk1.6.0_45/com/sun/org/apache/bcel/internal/generic/ArrayInstruction.java,Java,,32,6,68,106
/jdk1.6.0_45/com/sun/org/apache/bcel/internal/generic/ARRAYLENGTH.java,Java,,15,5,72,92
/jdk1.6.0_45/com/sun/org/apache/bcel/internal/generic/ArrayType.java,Java,,53,17,86,156
/jdk1.6.0_45/com/sun/org/apache/bcel/internal/generic/ASTORE.java,Java,,13,4,75,92
/jdk1.6.0_45/com/sun/org/apache/bcel/internal/generic/ATHROW.java,Java,,14,5,73,92
/jdk1.6.0_45/com/sun/org/apache/bcel/internal/generic/BALOAD.java,Java,,13,4,70,87
/jdk1.6.0_45/com/sun/org/apache/bcel/internal/generic/BasicType.java,Java,,28,6,67,101
/jdk1.6.0_45/com/sun/org/apache/bcel/internal/generic/BASTORE.java,Java,,13,4,70,87
/jdk1.6.0_45/com/sun/org/apache/bcel/internal/generic/BIPUSH.java,Java,,34,11,86,131
/jdk1.6.0_45/com/sun/org/apache/bcel/internal/generic/BranchHandle.java,Java,,48,18,85,151
/jdk1.6.0_45/com/sun/org/apache/bcel/internal/generic/BranchInstruction.java,Java,,87,26,133,246
/jdk1.6.0_45/com/sun/org/apache/bcel/internal/generic/BREAKPOINT.java,Java,,9,3,67,79
/jdk1.6.0_45/com/sun/org/apache/bcel/internal/generic/CALOAD.java,Java,,13,4,70,87
/jdk1.6.0_45/com/sun/org/apache/bcel/internal/generic/CASTORE.java,Java,,13,4,70,87
/jdk1.6.0_45/com/sun/org/apache/bcel/internal/generic/CHECKCAST.java,Java,,32,8,77,117
/jdk1.6.0_45/com/sun/org/apache/bcel/internal/generic/ClassGen.java,Java,,224,69,158,451
/jdk1.6.0_45/com/sun/org/apache/bcel/internal/generic/ClassGenException.java,Java,,5,3,60,68
/jdk1.6.0_45/com/sun/org/apache/bcel/internal/generic/ClassObserver.java,Java,,4,3,60,67
/jdk1.6.0_45/com/sun/org/apache/bcel/internal/generic/CodeExceptionGen.java,Java,,72,20,110,202
/jdk1.6.0_45/com/sun/org/apache/bcel/internal/generic/CompoundInstruction.java,Java,,4,3,69,76
/jdk1.6.0_45/com/sun/org/apache/bcel/internal/generic/ConstantPoolGen.java,Java,,374,152,260,786
/jdk1.6.0_45/com/sun/org/apache/bcel/internal/generic/ConstantPushInstruction.java,Java,,4,3,63,70
/jdk1.6.0_45/com/sun/org/apache/bcel/internal/generic/ConversionInstruction.java,Java,,29,5,68,102
/jdk1.6.0_45/com/sun/org/apache/bcel/internal/generic/CPInstruction.java,Java,,48,17,101,166
/jdk1.6.0_45/com/sun/org/apache/bcel/internal/generic/D2F.java,Java,,13,4,70,87
/jdk1.6.0_45/com/sun/org/apache/bcel/internal/generic/D2I.java,Java,,13,4,70,87
/jdk1.6.0_45/com/sun/org/apache/bcel/internal/generic/D2L.java,Java,,13,4,70,87
/jdk1.6.0_45/com/sun/org/apache/bcel/internal/generic/DADD.java,Java,,13,4,71,88
/jdk1.6.0_45/com/sun/org/apache/bcel/internal/generic/DALOAD.java,Java,,13,4,70,87
/jdk1.6.0_45/com/sun/org/apache/bcel/internal/generic/DASTORE.java,Java,,13,4,70,87
/jdk1.6.0_45/com/sun/org/apache/bcel/internal/generic/DCMPG.java,Java,,16,6,71,93
/jdk1.6.0_45/com/sun/org/apache/bcel/internal/generic/DCMPL.java,Java,,16,5,71,92
/jdk1.6.0_45/com/sun/org/apache/bcel/internal/generic/DCONST.java,Java,,27,9,75,111
/jdk1.6.0_45/com/sun/org/apache/bcel/internal/generic/DDIV.java,Java,,13,4,71,88
/jdk1.6.0_45/com/sun/org/apache/bcel/internal/generic/DLOAD.java,Java,,13,4,75,92
/jdk1.6.0_45/com/sun/org/apache/bcel/internal/generic/DMUL.java,Java,,13,4,71,88
/jdk1.6.0_45/com/sun/org/apache/bcel/internal/generic/DNEG.java,Java,,13,4,68,85
/jdk1.6.0_45/com/sun/org/apache/bcel/internal/generic/DREM.java,Java,,13,4,71,88
/jdk1.6.0_45/com/sun/org/apache/bcel/internal/generic/DRETURN.java,Java,,13,4,70,87
/jdk1.6.0_45/com/sun/org/apache/bcel/internal/generic/DSTORE.java,Java,,13,4,75,92
/jdk1.6.0_45/com/sun/org/apache/bcel/internal/generic/DSUB.java,Java,,13,4,71,88
/jdk1.6.0_45/com/sun/org/apache/bcel/internal/generic/DUP.java,Java,,12,4,68,84
/jdk1.6.0_45/com/sun/org/apache/bcel/internal/generic/DUP2.java,Java,,12,4,68,84
/jdk1.6.0_45/com/sun/org/apache/bcel/internal/generic/DUP2_X1.java,Java,,10,4,68,82
/jdk1.6.0_45/com/sun/org/apache/bcel/internal/generic/DUP2_X2.java,Java,,10,4,68,82
/jdk1.6.0_45/com/sun/org/apache/bcel/internal/generic/DUP_X1.java,Java,,10,4,68,82
/jdk1.6.0_45/com/sun/org/apache/bcel/internal/generic/DUP_X2.java,Java,,10,4,68,82
/jdk1.6.0_45/com/sun/org/apache/bcel/internal/generic/EmptyVisitor.java,Java,,183,2,59,244
/jdk1.6.0_45/com/sun/org/apache/bcel/internal/generic/ExceptionThrower.java,Java,,4,2,73,79
/jdk1.6.0_45/com/sun/org/apache/bcel/internal/generic/F2D.java,Java,,13,4,70,87
/jdk1.6.0_45/com/sun/org/apache/bcel/internal/generic/F2I.java,Java,,13,4,70,87
/jdk1.6.0_45/com/sun/org/apache/bcel/internal/generic/F2L.java,Java,,13,4,70,87
/jdk1.6.0_45/com/sun/org/apache/bcel/internal/generic/FADD.java,Java,,13,4,70,87
/jdk1.6.0_45/com/sun/org/apache/bcel/internal/generic/FALOAD.java,Java,,13,4,70,87
/jdk1.6.0_45/com/sun/org/apache/bcel/internal/generic/FASTORE.java,Java,,13,4,70,87
/jdk1.6.0_45/com/sun/org/apache/bcel/internal/generic/FCMPG.java,Java,,16,5,70,91
/jdk1.6.0_45/com/sun/org/apache/bcel/internal/generic/FCMPL.java,Java,,16,5,70,91
/jdk1.6.0_45/com/sun/org/apache/bcel/internal/generic/FCONST.java,Java,,29,9,75,113
/jdk1.6.0_45/com/sun/org/apache/bcel/internal/generic/FDIV.java,Java,,13,4,70,87
/jdk1.6.0_45/com/sun/org/apache/bcel/internal/generic/FieldGen.java,Java,,154,53,103,310
/jdk1.6.0_45/com/sun/org/apache/bcel/internal/generic/FieldGenOrMethodGen.java,Java,,40,14,81,135
/jdk1.6.0_45/com/sun/org/apache/bcel/internal/generic/FieldInstruction.java,Java,,29,10,77,116
/jdk1.6.0_45/com/sun/org/apache/bcel/internal/generic/FieldObserver.java,Java,,4,3,60,67
/jdk1.6.0_45/com/sun/org/apache/bcel/internal/generic/FieldOrMethod.java,Java,,31,9,77,117
/jdk1.6.0_45/com/sun/org/apache/bcel/internal/generic/FLOAD.java,Java,,13,4,75,92
/jdk1.6.0_45/com/sun/org/apache/bcel/internal/generic/FMUL.java,Java,,13,4,70,87
/jdk1.6.0_45/com/sun/org/apache/bcel/internal/generic/FNEG.java,Java,,13,4,68,85
/jdk1.6.0_45/com/sun/org/apache/bcel/internal/generic/FREM.java,Java,,13,4,70,87
/jdk1.6.0_45/com/sun/org/apache/bcel/internal/generic/FRETURN.java,Java,,13,4,70,87
/jdk1.6.0_45/com/sun/org/apache/bcel/internal/generic/FSTORE.java,Java,,13,4,75,92
/jdk1.6.0_45/com/sun/org/apache/bcel/internal/generic/FSUB.java,Java,,13,4,70,87
/jdk1.6.0_45/com/sun/org/apache/bcel/internal/generic/GETFIELD.java,Java,,32,11,74,117
/jdk1.6.0_45/com/sun/org/apache/bcel/internal/generic/GETSTATIC.java,Java,,29,10,74,113
/jdk1.6.0_45/com/sun/org/apache/bcel/internal/generic/GOTO.java,Java,,35,9,78,122
/jdk1.6.0_45/com/sun/org/apache/bcel/internal/generic/GotoInstruction.java,Java,,9,3,63,75
/jdk1.6.0_45/com/sun/org/apache/bcel/internal/generic/GOTO_W.java,Java,,26,6,78,110
/jdk1.6.0_45/com/sun/org/apache/bcel/internal/generic/I2B.java,Java,,13,4,70,87
/jdk1.6.0_45/com/sun/org/apache/bcel/internal/generic/I2C.java,Java,,13,4,70,87
/jdk1.6.0_45/com/sun/org/apache/bcel/internal/generic/I2D.java,Java,,13,4,70,87
/jdk1.6.0_45/com/sun/org/apache/bcel/internal/generic/I2F.java,Java,,13,4,70,87
/jdk1.6.0_45/com/sun/org/apache/bcel/internal/generic/I2L.java,Java,,13,4,70,87
/jdk1.6.0_45/com/sun/org/apache/bcel/internal/generic/I2S.java,Java,,13,4,68,85
/jdk1.6.0_45/com/sun/org/apache/bcel/internal/generic/IADD.java,Java,,13,4,70,87
/jdk1.6.0_45/com/sun/org/apache/bcel/internal/generic/IALOAD.java,Java,,13,4,71,88
/jdk1.6.0_45/com/sun/org/apache/bcel/internal/generic/IAND.java,Java,,13,4,68,85
/jdk1.6.0_45/com/sun/org/apache/bcel/internal/generic/IASTORE.java,Java,,13,4,71,88
/jdk1.6.0_45/com/sun/org/apache/bcel/internal/generic/ICONST.java,Java,,26,8,75,109
/jdk1.6.0_45/com/sun/org/apache/bcel/internal/generic/IDIV.java,Java,,17,5,72,94
/jdk1.6.0_45/com/sun/org/apache/bcel/internal/generic/IFEQ.java,Java,,16,6,76,98
/jdk1.6.0_45/com/sun/org/apache/bcel/internal/generic/IFGE.java,Java,,16,6,76,98
/jdk1.6.0_45/com/sun/org/apache/bcel/internal/generic/IFGT.java,Java,,16,6,76,98
/jdk1.6.0_45/com/sun/org/apache/bcel/internal/generic/IfInstruction.java,Java,,8,5,69,82
/jdk1.6.0_45/com/sun/org/apache/bcel/internal/generic/IFLE.java,Java,,16,6,76,98
/jdk1.6.0_45/com/sun/org/apache/bcel/internal/generic/IFLT.java,Java,,16,6,76,98
/jdk1.6.0_45/com/sun/org/apache/bcel/internal/generic/IFNE.java,Java,,16,6,76,98
/jdk1.6.0_45/com/sun/org/apache/bcel/internal/generic/IFNONNULL.java,Java,,16,5,76,97
/jdk1.6.0_45/com/sun/org/apache/bcel/internal/generic/IFNULL.java,Java,,16,6,76,98
/jdk1.6.0_45/com/sun/org/apache/bcel/internal/generic/IF_ACMPEQ.java,Java,,16,5,76,97
/jdk1.6.0_45/com/sun/org/apache/bcel/internal/generic/IF_ACMPNE.java,Java,,16,6,76,98
/jdk1.6.0_45/com/sun/org/apache/bcel/internal/generic/IF_ICMPEQ.java,Java,,16,6,76,98
/jdk1.6.0_45/com/sun/org/apache/bcel/internal/generic/IF_ICMPGE.java,Java,,16,6,76,98
/jdk1.6.0_45/com/sun/org/apache/bcel/internal/generic/IF_ICMPGT.java,Java,,16,6,76,98
/jdk1.6.0_45/com/sun/org/apache/bcel/internal/generic/IF_ICMPLE.java,Java,,16,6,76,98
/jdk1.6.0_45/com/sun/org/apache/bcel/internal/generic/IF_ICMPLT.java,Java,,16,6,76,98
/jdk1.6.0_45/com/sun/org/apache/bcel/internal/generic/IF_ICMPNE.java,Java,,16,6,76,98
/jdk1.6.0_45/com/sun/org/apache/bcel/internal/generic/IINC.java,Java,,68,19,96,183
/jdk1.6.0_45/com/sun/org/apache/bcel/internal/generic/ILOAD.java,Java,,13,4,75,92
/jdk1.6.0_45/com/sun/org/apache/bcel/internal/generic/IMPDEP1.java,Java,,9,4,67,80
/jdk1.6.0_45/com/sun/org/apache/bcel/internal/generic/IMPDEP2.java,Java,,9,4,67,80
/jdk1.6.0_45/com/sun/org/apache/bcel/internal/generic/IMUL.java,Java,,13,4,70,87
/jdk1.6.0_45/com/sun/org/apache/bcel/internal/generic/IndexedInstruction.java,Java,,5,3,60,68
/jdk1.6.0_45/com/sun/org/apache/bcel/internal/generic/INEG.java,Java,,13,4,68,85
/jdk1.6.0_45/com/sun/org/apache/bcel/internal/generic/INSTANCEOF.java,Java,,26,8,72,106
/jdk1.6.0_45/com/sun/org/apache/bcel/internal/generic/Instruction.java,Java,,108,39,158,305
/jdk1.6.0_45/com/sun/org/apache/bcel/internal/generic/InstructionComparator.java,Java,,37,6,66,109
/jdk1.6.0_45/com/sun/org/apache/bcel/internal/generic/InstructionConstants.java,Java,,237,8,81,326
/jdk1.6.0_45/com/sun/org/apache/bcel/internal/generic/InstructionFactory.java,Java,,421,66,136,623
/jdk1.6.0_45/com/sun/org/apache/bcel/internal/generic/InstructionHandle.java,Java,,110,35,139,284
/jdk1.6.0_45/com/sun/org/apache/bcel/internal/generic/InstructionList.java,Java,,612,195,480,1287
/jdk1.6.0_45/com/sun/org/apache/bcel/internal/generic/InstructionListObserver.java,Java,,4,3,60,67
/jdk1.6.0_45/com/sun/org/apache/bcel/internal/generic/InstructionTargeter.java,Java,,5,2,63,70
/jdk1.6.0_45/com/sun/org/apache/bcel/internal/generic/InvokeInstruction.java,Java,,45,14,87,146
/jdk1.6.0_45/com/sun/org/apache/bcel/internal/generic/INVOKEINTERFACE.java,Java,,59,18,86,163
/jdk1.6.0_45/com/sun/org/apache/bcel/internal/generic/INVOKESPECIAL.java,Java,,30,9,74,113
/jdk1.6.0_45/com/sun/org/apache/bcel/internal/generic/INVOKESTATIC.java,Java,,28,9,73,110
/jdk1.6.0_45/com/sun/org/apache/bcel/internal/generic/INVOKEVIRTUAL.java,Java,,30,9,73,112
/jdk1.6.0_45/com/sun/org/apache/bcel/internal/generic/IOR.java,Java,,13,4,68,85
/jdk1.6.0_45/com/sun/org/apache/bcel/internal/generic/IREM.java,Java,,17,5,72,94
/jdk1.6.0_45/com/sun/org/apache/bcel/internal/generic/IRETURN.java,Java,,13,4,70,87
/jdk1.6.0_45/com/sun/org/apache/bcel/internal/generic/ISHL.java,Java,,13,4,68,85
/jdk1.6.0_45/com/sun/org/apache/bcel/internal/generic/ISHR.java,Java,,13,4,68,85
/jdk1.6.0_45/com/sun/org/apache/bcel/internal/generic/ISTORE.java,Java,,13,4,75,92
/jdk1.6.0_45/com/sun/org/apache/bcel/internal/generic/ISUB.java,Java,,13,4,70,87
/jdk1.6.0_45/com/sun/org/apache/bcel/internal/generic/IUSHR.java,Java,,13,4,68,85
/jdk1.6.0_45/com/sun/org/apache/bcel/internal/generic/IXOR.java,Java,,13,4,68,85
/jdk1.6.0_45/com/sun/org/apache/bcel/internal/generic/JSR.java,Java,,35,9,75,119
/jdk1.6.0_45/com/sun/org/apache/bcel/internal/generic/JsrInstruction.java,Java,,26,10,79,115
/jdk1.6.0_45/com/sun/org/apache/bcel/internal/generic/JSR_W.java,Java,,26,6,78,110
/jdk1.6.0_45/com/sun/org/apache/bcel/internal/generic/L2D.java,Java,,13,4,68,85
/jdk1.6.0_45/com/sun/org/apache/bcel/internal/generic/L2F.java,Java,,13,4,68,85
/jdk1.6.0_45/com/sun/org/apache/bcel/internal/generic/L2I.java,Java,,13,4,68,85
/jdk1.6.0_45/com/sun/org/apache/bcel/internal/generic/LADD.java,Java,,13,4,69,86
/jdk1.6.0_45/com/sun/org/apache/bcel/internal/generic/LALOAD.java,Java,,13,4,70,87
/jdk1.6.0_45/com/sun/org/apache/bcel/internal/generic/LAND.java,Java,,13,4,69,86
/jdk1.6.0_45/com/sun/org/apache/bcel/internal/generic/LASTORE.java,Java,,13,4,70,87
/jdk1.6.0_45/com/sun/org/apache/bcel/internal/generic/LCMP.java,Java,,17,4,71,92
/jdk1.6.0_45/com/sun/org/apache/bcel/internal/generic/LCONST.java,Java,,27,9,75,111
/jdk1.6.0_45/com/sun/org/apache/bcel/internal/generic/LDC.java,Java,,72,16,84,172
/jdk1.6.0_45/com/sun/org/apache/bcel/internal/generic/LDC2_W.java,Java,,34,9,73,116
/jdk1.6.0_45/com/sun/org/apache/bcel/internal/generic/LDC_W.java,Java,,15,4,69,88
/jdk1.6.0_45/com/sun/org/apache/bcel/internal/generic/LDIV.java,Java,,17,5,69,91
/jdk1.6.0_45/com/sun/org/apache/bcel/internal/generic/LineNumberGen.java,Java,,40,11,80,131
/jdk1.6.0_45/com/sun/org/apache/bcel/internal/generic/LLOAD.java,Java,,13,4,72,89
/jdk1.6.0_45/com/sun/org/apache/bcel/internal/generic/LMUL.java,Java,,13,4,69,86
/jdk1.6.0_45/com/sun/org/apache/bcel/internal/generic/LNEG.java,Java,,13,4,68,85
/jdk1.6.0_45/com/sun/org/apache/bcel/internal/generic/LoadClass.java,Java,,5,3,78,86
/jdk1.6.0_45/com/sun/org/apache/bcel/internal/generic/LoadInstruction.java,Java,,18,5,78,101
/jdk1.6.0_45/com/sun/org/apache/bcel/internal/generic/LocalVariableGen.java,Java,,82,22,100,204
/jdk1.6.0_45/com/sun/org/apache/bcel/internal/generic/LocalVariableInstruction.java,Java,,99,21,106,226
/jdk1.6.0_45/com/sun/org/apache/bcel/internal/generic/LOOKUPSWITCH.java,Java,,40,12,81,133
/jdk1.6.0_45/com/sun/org/apache/bcel/internal/generic/LOR.java,Java,,13,4,68,85
/jdk1.6.0_45/com/sun/org/apache/bcel/internal/generic/LREM.java,Java,,15,5,68,88
/jdk1.6.0_45/com/sun/org/apache/bcel/internal/generic/LRETURN.java,Java,,13,4,68,85
/jdk1.6.0_45/com/sun/org/apache/bcel/internal/generic/LSHL.java,Java,,13,4,68,85
/jdk1.6.0_45/com/sun/org/apache/bcel/internal/generic/LSHR.java,Java,,13,4,68,85
/jdk1.6.0_45/com/sun/org/apache/bcel/internal/generic/LSTORE.java,Java,,13,4,72,89
/jdk1.6.0_45/com/sun/org/apache/bcel/internal/generic/LSUB.java,Java,,13,4,69,86
/jdk1.6.0_45/com/sun/org/apache/bcel/internal/generic/LUSHR.java,Java,,13,4,68,85
/jdk1.6.0_45/com/sun/org/apache/bcel/internal/generic/LXOR.java,Java,,13,4,68,85
/jdk1.6.0_45/com/sun/org/apache/bcel/internal/generic/MethodGen.java,Java,,530,149,296,975
/jdk1.6.0_45/com/sun/org/apache/bcel/internal/generic/MethodObserver.java,Java,,4,3,60,67
/jdk1.6.0_45/com/sun/org/apache/bcel/internal/generic/MONITORENTER.java,Java,,15,5,68,88
/jdk1.6.0_45/com/sun/org/apache/bcel/internal/generic/MONITOREXIT.java,Java,,15,5,68,88
/jdk1.6.0_45/com/sun/org/apache/bcel/internal/generic/MULTIANEWARRAY.java,Java,,59,20,93,172
/jdk1.6.0_45/com/sun/org/apache/bcel/internal/generic/NamedAndTyped.java,Java,,7,4,60,71
/jdk1.6.0_45/com/sun/org/apache/bcel/internal/generic/NEW.java,Java,,30,9,72,111
/jdk1.6.0_45/com/sun/org/apache/bcel/internal/generic/NEWARRAY.java,Java,,40,11,89,140
/jdk1.6.0_45/com/sun/org/apache/bcel/internal/generic/NOP.java,Java,,9,4,67,80
/jdk1.6.0_45/com/sun/org/apache/bcel/internal/generic/ObjectType.java,Java,,45,12,79,136
/jdk1.6.0_45/com/sun/org/apache/bcel/internal/generic/POP.java,Java,,12,4,69,85
/jdk1.6.0_45/com/sun/org/apache/bcel/internal/generic/POP2.java,Java,,12,4,69,85
/jdk1.6.0_45/com/sun/org/apache/bcel/internal/generic/PopInstruction.java,Java,,3,3,62,68
/jdk1.6.0_45/com/sun/org/apache/bcel/internal/generic/PUSH.java,Java,,80,15,101,196
/jdk1.6.0_45/com/sun/org/apache/bcel/internal/generic/PushInstruction.java,Java,,3,3,67,73
/jdk1.6.0_45/com/sun/org/apache/bcel/internal/generic/PUTFIELD.java,Java,,33,11,74,118
/jdk1.6.0_45/com/sun/org/apache/bcel/internal/generic/PUTSTATIC.java,Java,,30,10,74,114
/jdk1.6.0_45/com/sun/org/apache/bcel/internal/generic/ReferenceType.java,Java,,140,40,169,349
/jdk1.6.0_45/com/sun/org/apache/bcel/internal/generic/RET.java,Java,,54,16,91,161
/jdk1.6.0_45/com/sun/org/apache/bcel/internal/generic/RETURN.java,Java,,13,4,68,85
/jdk1.6.0_45/com/sun/org/apache/bcel/internal/generic/ReturnaddressType.java,Java,,22,8,72,102
/jdk1.6.0_45/com/sun/org/apache/bcel/internal/generic/ReturnInstruction.java,Java,,28,8,68,104
/jdk1.6.0_45/com/sun/org/apache/bcel/internal/generic/SALOAD.java,Java,,13,4,68,85
/jdk1.6.0_45/com/sun/org/apache/bcel/internal/generic/SASTORE.java,Java,,13,4,68,85
/jdk1.6.0_45/com/sun/org/apache/bcel/internal/generic/Select.java,Java,,96,36,122,254
/jdk1.6.0_45/com/sun/org/apache/bcel/internal/generic/SIPUSH.java,Java,,34,10,84,128
/jdk1.6.0_45/com/sun/org/apache/bcel/internal/generic/StackConsumer.java,Java,,4,3,61,68
/jdk1.6.0_45/com/sun/org/apache/bcel/internal/generic/StackInstruction.java,Java,,10,5,68,83
/jdk1.6.0_45/com/sun/org/apache/bcel/internal/generic/StackProducer.java,Java,,4,3,62,69
/jdk1.6.0_45/com/sun/org/apache/bcel/internal/generic/StoreInstruction.java,Java,,18,5,78,101
/jdk1.6.0_45/com/sun/org/apache/bcel/internal/generic/SWAP.java,Java,,12,4,68,84
/jdk1.6.0_45/com/sun/org/apache/bcel/internal/generic/SWITCH.java,Java,,79,22,82,183
/jdk1.6.0_45/com/sun/org/apache/bcel/internal/generic/TABLESWITCH.java,Java,,44,16,87,147
/jdk1.6.0_45/com/sun/org/apache/bcel/internal/generic/TargetLostException.java,Java,,9,4,87,100
/jdk1.6.0_45/com/sun/org/apache/bcel/internal/generic/Type.java,Java,,147,33,107,287
/jdk1.6.0_45/com/sun/org/apache/bcel/internal/generic/TypedInstruction.java,Java,,4,3,60,67
/jdk1.6.0_45/com/sun/org/apache/bcel/internal/generic/UnconditionalBranch.java,Java,,2,3,62,67
/jdk1.6.0_45/com/sun/org/apache/bcel/internal/generic/VariableLengthInstruction.java,Java,,2,3,65,70
/jdk1.6.0_45/com/sun/org/apache/bcel/internal/generic/Visitor.java,Java,,183,2,62,247
/jdk1.6.0_45/com/sun/org/apache/bcel/internal/Repository.java,Java,,85,26,137,248
/jdk1.6.0_45/com/sun/org/apache/bcel/internal/util/AttributeHTML.java,Java,,138,47,70,255
/jdk1.6.0_45/com/sun/org/apache/bcel/internal/util/BCELFactory.java,Java,,231,64,62,357
/jdk1.6.0_45/com/sun/org/apache/bcel/internal/util/BCELifier.java,Java,,183,51,70,304
/jdk1.6.0_45/com/sun/org/apache/bcel/internal/util/ByteSequence.java,Java,,16,5,61,82
/jdk1.6.0_45/com/sun/org/apache/bcel/internal/util/Class2HTML.java,Java,,138,31,93,262
/jdk1.6.0_45/com/sun/org/apache/bcel/internal/util/ClassLoader.java,Java,,91,26,104,221
/jdk1.6.0_45/com/sun/org/apache/bcel/internal/util/ClassLoaderRepository.java,Java,,56,19,80,155
/jdk1.6.0_45/com/sun/org/apache/bcel/internal/util/ClassPath.java,Java,,188,68,125,381
/jdk1.6.0_45/com/sun/org/apache/bcel/internal/util/ClassQueue.java,Java,,14,6,61,81
/jdk1.6.0_45/com/sun/org/apache/bcel/internal/util/ClassSet.java,Java,,26,8,62,96
/jdk1.6.0_45/com/sun/org/apache/bcel/internal/util/ClassStack.java,Java,,10,3,60,73
/jdk1.6.0_45/com/sun/org/apache/bcel/internal/util/ClassVector.java,Java,,14,4,61,79
/jdk1.6.0_45/com/sun/org/apache/bcel/internal/util/CodeHTML.java,Java,,381,100,137,618
/jdk1.6.0_45/com/sun/org/apache/bcel/internal/util/ConstantHTML.java,Java,,151,39,72,262
/jdk1.6.0_45/com/sun/org/apache/bcel/internal/util/InstructionFinder.java,Java,,203,59,178,440
/jdk1.6.0_45/com/sun/org/apache/bcel/internal/util/JavaWrapper.java,Java,,54,17,81,152
/jdk1.6.0_45/com/sun/org/apache/bcel/internal/util/MethodHTML.java,Java,,94,27,78,199
/jdk1.6.0_45/com/sun/org/apache/bcel/internal/util/Repository.java,Java,,12,11,82,105
/jdk1.6.0_45/com/sun/org/apache/bcel/internal/util/SecuritySupport.java,Java,,147,21,55,223
/jdk1.6.0_45/com/sun/org/apache/bcel/internal/util/SyntheticRepository.java,Java,,82,28,94,204
/jdk1.6.0_45/com/sun/org/apache/regexp/internal/CharacterArrayCharacterIterator.java,Java,,37,7,29,73
/jdk1.6.0_45/com/sun/org/apache/regexp/internal/CharacterIterator.java,Java,,8,5,26,39
/jdk1.6.0_45/com/sun/org/apache/regexp/internal/RE.java,Java,,895,166,696,1757
/jdk1.6.0_45/com/sun/org/apache/regexp/internal/ReaderCharacterIterator.java,Java,,112,17,32,161
/jdk1.6.0_45/com/sun/org/apache/regexp/internal/recompile.java,Java,,56,11,67,134
/jdk1.6.0_45/com/sun/org/apache/regexp/internal/RECompiler.java,Java,,993,181,343,1517
/jdk1.6.0_45/com/sun/org/apache/regexp/internal/REDebugCompiler.java,Java,,103,25,94,222
/jdk1.6.0_45/com/sun/org/apache/regexp/internal/REProgram.java,Java,,73,15,67,155
/jdk1.6.0_45/com/sun/org/apache/regexp/internal/RESyntaxException.java,Java,,8,2,30,40
/jdk1.6.0_45/com/sun/org/apache/regexp/internal/RETest.java,Java,,640,82,158,880
/jdk1.6.0_45/com/sun/org/apache/regexp/internal/REUtil.java,Java,,17,4,37,58
/jdk1.6.0_45/com/sun/org/apache/regexp/internal/StreamCharacterIterator.java,Java,,109,17,32,158
/jdk1.6.0_45/com/sun/org/apache/regexp/internal/StringCharacterIterator.java,Java,,25,7,27,59
/jdk1.6.0_45/com/sun/org/apache/xalan/internal/extensions/ExpressionContext.java,Java,,17,11,63,91
/jdk1.6.0_45/com/sun/org/apache/xalan/internal/lib/ExsltBase.java,Java,,43,4,35,82
/jdk1.6.0_45/com/sun/org/apache/xalan/internal/lib/ExsltCommon.java,Java,,31,4,69,104
/jdk1.6.0_45/com/sun/org/apache/xalan/internal/lib/ExsltDatetime.java,Java,,564,81,473,1118
/jdk1.6.0_45/com/sun/org/apache/xalan/internal/lib/ExsltDynamic.java,Java,,296,70,246,612
/jdk1.6.0_45/com/sun/org/apache/xalan/internal/lib/ExsltMath.java,Java,,157,36,194,387
/jdk1.6.0_45/com/sun/org/apache/xalan/internal/lib/ExsltSets.java,Java,,103,28,106,237
/jdk1.6.0_45/com/sun/org/apache/xalan/internal/lib/ExsltStrings.java,Java,,156,34,163,353
/jdk1.6.0_45/com/sun/org/apache/xalan/internal/lib/Extensions.java,Java,,187,44,185,416
/jdk1.6.0_45/com/sun/org/apache/xalan/internal/lib/NodeInfo.java,Java,,105,24,117,246
/jdk1.6.0_45/com/sun/org/apache/xalan/internal/res/XSLMessages.java,Java,,31,8,50,89
/jdk1.6.0_45/com/sun/org/apache/xalan/internal/res/XSLTErrorResources.java,Java,,966,283,196,1445
/jdk1.6.0_45/com/sun/org/apache/xalan/internal/res/XSLTErrorResources_de.java,Java,,910,646,853,2409
/jdk1.6.0_45/com/sun/org/apache/xalan/internal/res/XSLTErrorResources_en.java,Java,,4,2,23,29
/jdk1.6.0_45/com/sun/org/apache/xalan/internal/res/XSLTErrorResources_es.java,Java,,910,646,853,2409
/jdk1.6.0_45/com/sun/org/apache/xalan/internal/res/XSLTErrorResources_fr.java,Java,,910,646,853,2409
/jdk1.6.0_45/com/sun/org/apache/xalan/internal/res/XSLTErrorResources_it.java,Java,,910,646,853,2409
/jdk1.6.0_45/com/sun/org/apache/xalan/internal/res/XSLTErrorResources_ja.java,Java,,910,646,853,2409
/jdk1.6.0_45/com/sun/org/apache/xalan/internal/res/XSLTErrorResources_ko.java,Java,,910,646,853,2409
/jdk1.6.0_45/com/sun/org/apache/xalan/internal/res/XSLTErrorResources_pt_BR.java,Java,,966,284,196,1446
/jdk1.6.0_45/com/sun/org/apache/xalan/internal/res/XSLTErrorResources_sv.java,Java,,1130,972,595,2697
/jdk1.6.0_45/com/sun/org/apache/xalan/internal/res/XSLTErrorResources_zh_CN.java,Java,,910,646,853,2409
/jdk1.6.0_45/com/sun/org/apache/xalan/internal/res/XSLTErrorResources_zh_TW.java,Java,,910,646,853,2409
/jdk1.6.0_45/com/sun/org/apache/xalan/internal/templates/Constants.java,Java,,278,36,83,397
/jdk1.6.0_45/com/sun/org/apache/xalan/internal/utils/ConfigurationError.java,Java,,12,9,76,97
/jdk1.6.0_45/com/sun/org/apache/xalan/internal/utils/FactoryImpl.java,Java,,23,6,43,72
/jdk1.6.0_45/com/sun/org/apache/xalan/internal/utils/ObjectFactory.java,Java,,332,51,315,698
/jdk1.6.0_45/com/sun/org/apache/xalan/internal/utils/SecuritySupport.java,Java,,137,21,84,242
/jdk1.6.0_45/com/sun/org/apache/xalan/internal/Version.java,Java,,46,11,94,151
/jdk1.6.0_45/com/sun/org/apache/xalan/internal/XalanConstants.java,Java,,7,6,67,80
/jdk1.6.0_45/com/sun/org/apache/xalan/internal/xslt/EnvironmentCheck.java,Java,,708,168,407,1283
/jdk1.6.0_45/com/sun/org/apache/xalan/internal/xslt/Process.java,Java,,796,116,310,1222
/jdk1.6.0_45/com/sun/org/apache/xalan/internal/xsltc/cmdline/Compile.java,Java,,111,17,39,167
/jdk1.6.0_45/com/sun/org/apache/xalan/internal/xsltc/cmdline/getopt/GetOpt.java,Java,,144,19,92,255
/jdk1.6.0_45/com/sun/org/apache/xalan/internal/xsltc/cmdline/getopt/GetOptsException.java,Java,,7,2,21,30
/jdk1.6.0_45/com/sun/org/apache/xalan/internal/xsltc/cmdline/getopt/IllegalArgumentException.java,Java,,7,3,18,28
/jdk1.6.0_45/com/sun/org/apache/xalan/internal/xsltc/cmdline/getopt/MissingOptArgException.java,Java,,7,3,21,31
/jdk1.6.0_45/com/sun/org/apache/xalan/internal/xsltc/cmdline/Transform.java,Java,,224,30,39,293
/jdk1.6.0_45/com/sun/org/apache/xalan/internal/xsltc/CollatorFactory.java,Java,,7,4,22,33
/jdk1.6.0_45/com/sun/org/apache/xalan/internal/xsltc/compiler/AbsoluteLocationPath.java,Java,,77,13,34,124
/jdk1.6.0_45/com/sun/org/apache/xalan/internal/xsltc/compiler/AbsolutePathPattern.java,Java,,94,17,27,138
/jdk1.6.0_45/com/sun/org/apache/xalan/internal/xsltc/compiler/AlternativePattern.java,Java,,54,15,29,98
/jdk1.6.0_45/com/sun/org/apache/xalan/internal/xsltc/compiler/AncestorPattern.java,Java,,121,26,33,180
/jdk1.6.0_45/com/sun/org/apache/xalan/internal/xsltc/compiler/ApplyImports.java,Java,,83,22,52,157
/jdk1.6.0_45/com/sun/org/apache/xalan/internal/xsltc/compiler/ApplyTemplates.java,Java,,141,22,37,200
/jdk1.6.0_45/com/sun/org/apache/xalan/internal/xsltc/compiler/ArgumentList.java,Java,,14,4,22,40
/jdk1.6.0_45/com/sun/org/apache/xalan/internal/xsltc/compiler/Attribute.java,Java,,14,5,24,43
/jdk1.6.0_45/com/sun/org/apache/xalan/internal/xsltc/compiler/AttributeSet.java,Java,,118,29,62,209
/jdk1.6.0_45/com/sun/org/apache/xalan/internal/xsltc/compiler/AttributeValue.java,Java,,19,5,22,46
/jdk1.6.0_45/com/sun/org/apache/xalan/internal/xsltc/compiler/AttributeValueTemplate.java,Java,,201,19,39,259
/jdk1.6.0_45/com/sun/org/apache/xalan/internal/xsltc/compiler/BinOpExpr.java,Java,,85,14,29,128
/jdk1.6.0_45/com/sun/org/apache/xalan/internal/xsltc/compiler/BooleanCall.java,Java,,25,8,22,55
/jdk1.6.0_45/com/sun/org/apache/xalan/internal/xsltc/compiler/BooleanExpr.java,Java,,43,10,24,77
/jdk1.6.0_45/com/sun/org/apache/xalan/internal/xsltc/compiler/CallTemplate.java,Java,,143,29,67,239
/jdk1.6.0_45/com/sun/org/apache/xalan/internal/xsltc/compiler/CastCall.java,Java,,48,13,37,98
/jdk1.6.0_45/com/sun/org/apache/xalan/internal/xsltc/compiler/CastExpr.java,Java,,160,28,47,235
/jdk1.6.0_45/com/sun/org/apache/xalan/internal/xsltc/compiler/CeilingCall.java,Java,,19,5,22,46
/jdk1.6.0_45/com/sun/org/apache/xalan/internal/xsltc/compiler/Choose.java,Java,,100,19,45,164
/jdk1.6.0_45/com/sun/org/apache/xalan/internal/xsltc/compiler/Closure.java,Java,,7,6,35,48
/jdk1.6.0_45/com/sun/org/apache/xalan/internal/xsltc/compiler/Comment.java,Java,,68,12,34,114
/jdk1.6.0_45/com/sun/org/apache/xalan/internal/xsltc/compiler/CompilerException.java,Java,,23,8,21,52
/jdk1.6.0_45/com/sun/org/apache/xalan/internal/xsltc/compiler/ConcatCall.java,Java,,59,11,23,93
/jdk1.6.0_45/com/sun/org/apache/xalan/internal/xsltc/compiler/Constants.java,Java,,429,41,34,504
/jdk1.6.0_45/com/sun/org/apache/xalan/internal/xsltc/compiler/ContainsCall.java,Java,,50,14,41,105
/jdk1.6.0_45/com/sun/org/apache/xalan/internal/xsltc/compiler/Copy.java,Java,,103,15,37,155
/jdk1.6.0_45/com/sun/org/apache/xalan/internal/xsltc/compiler/CopyOf.java,Java,,97,15,27,139
/jdk1.6.0_45/com/sun/org/apache/xalan/internal/xsltc/compiler/CurrentCall.java,Java,,11,4,22,37
/jdk1.6.0_45/com/sun/org/apache/xalan/internal/xsltc/compiler/DecimalFormatting.java,Java,,170,28,56,254
/jdk1.6.0_45/com/sun/org/apache/xalan/internal/xsltc/compiler/DocumentCall.java,Java,,88,23,43,154
/jdk1.6.0_45/com/sun/org/apache/xalan/internal/xsltc/compiler/ElementAvailableCall.java,Java,,44,9,38,91
/jdk1.6.0_45/com/sun/org/apache/xalan/internal/xsltc/compiler/EqualityExpr.java,Java,,273,42,42,357
/jdk1.6.0_45/com/sun/org/apache/xalan/internal/xsltc/compiler/Expression.java,Java,,121,26,73,220
/jdk1.6.0_45/com/sun/org/apache/xalan/internal/xsltc/compiler/Fallback.java,Java,,32,10,35,77
/jdk1.6.0_45/com/sun/org/apache/xalan/internal/xsltc/compiler/FilteredAbsoluteLocationPath.java,Java,,77,14,32,123
/jdk1.6.0_45/com/sun/org/apache/xalan/internal/xsltc/compiler/FilterExpr.java,Java,,117,26,61,204
/jdk1.6.0_45/com/sun/org/apache/xalan/internal/xsltc/compiler/FilterParentPath.java,Java,,100,19,45,164
/jdk1.6.0_45/com/sun/org/apache/xalan/internal/xsltc/compiler/FloorCall.java,Java,,17,5,22,44
/jdk1.6.0_45/com/sun/org/apache/xalan/internal/xsltc/compiler/FlowList.java,Java,,72,14,29,115
/jdk1.6.0_45/com/sun/org/apache/xalan/internal/xsltc/compiler/ForEach.java,Java,,114,28,52,194
/jdk1.6.0_45/com/sun/org/apache/xalan/internal/xsltc/compiler/FormatNumberCall.java,Java,,75,13,24,112
/jdk1.6.0_45/com/sun/org/apache/xalan/internal/xsltc/compiler/FunctionAvailableCall.java,Java,,111,25,56,192
/jdk1.6.0_45/com/sun/org/apache/xalan/internal/xsltc/compiler/FunctionCall.java,Java,,772,143,172,1087
/jdk1.6.0_45/com/sun/org/apache/xalan/internal/xsltc/compiler/GenerateIdCall.java,Java,,25,5,23,53
/jdk1.6.0_45/com/sun/org/apache/xalan/internal/xsltc/compiler/IdKeyPattern.java,Java,,73,21,32,126
/jdk1.6.0_45/com/sun/org/apache/xalan/internal/xsltc/compiler/IdPattern.java,Java,,6,5,22,33
/jdk1.6.0_45/com/sun/org/apache/xalan/internal/xsltc/compiler/If.java,Java,,53,11,44,108
/jdk1.6.0_45/com/sun/org/apache/xalan/internal/xsltc/compiler/IllegalCharException.java,Java,,7,2,22,31
/jdk1.6.0_45/com/sun/org/apache/xalan/internal/xsltc/compiler/Import.java,Java,,103,20,29,152
/jdk1.6.0_45/com/sun/org/apache/xalan/internal/xsltc/compiler/Include.java,Java,,102,20,30,152
/jdk1.6.0_45/com/sun/org/apache/xalan/internal/xsltc/compiler/Instruction.java,Java,,16,4,28,48
/jdk1.6.0_45/com/sun/org/apache/xalan/internal/xsltc/compiler/IntExpr.java,Java,,25,7,22,54
/jdk1.6.0_45/com/sun/org/apache/xalan/internal/xsltc/compiler/Key.java,Java,,169,51,79,299
/jdk1.6.0_45/com/sun/org/apache/xalan/internal/xsltc/compiler/KeyCall.java,Java,,111,26,97,234
/jdk1.6.0_45/com/sun/org/apache/xalan/internal/xsltc/compiler/KeyPattern.java,Java,,6,4,22,32
/jdk1.6.0_45/com/sun/org/apache/xalan/internal/xsltc/compiler/LangCall.java,Java,,45,9,35,89
/jdk1.6.0_45/com/sun/org/apache/xalan/internal/xsltc/compiler/LastCall.java,Java,,37,8,22,67
/jdk1.6.0_45/com/sun/org/apache/xalan/internal/xsltc/compiler/LiteralAttribute.java,Java,,84,21,50,155
/jdk1.6.0_45/com/sun/org/apache/xalan/internal/xsltc/compiler/LiteralElement.java,Java,,357,59,138,554
/jdk1.6.0_45/com/sun/org/apache/xalan/internal/xsltc/compiler/LiteralExpr.java,Java,,40,12,31,83
/jdk1.6.0_45/com/sun/org/apache/xalan/internal/xsltc/compiler/LocalNameCall.java,Java,,31,9,32,72
/jdk1.6.0_45/com/sun/org/apache/xalan/internal/xsltc/compiler/LocationPathPattern.java,Java,,58,15,32,105
/jdk1.6.0_45/com/sun/org/apache/xalan/internal/xsltc/compiler/LogicalExpr.java,Java,,115,33,83,231
/jdk1.6.0_45/com/sun/org/apache/xalan/internal/xsltc/compiler/Message.java,Java,,98,22,39,159
/jdk1.6.0_45/com/sun/org/apache/xalan/internal/xsltc/compiler/Mode.java,Java,,967,209,347,1523
/jdk1.6.0_45/com/sun/org/apache/xalan/internal/xsltc/compiler/NameBase.java,Java,,69,16,41,126
/jdk1.6.0_45/com/sun/org/apache/xalan/internal/xsltc/compiler/NameCall.java,Java,,24,8,32,64
/jdk1.6.0_45/com/sun/org/apache/xalan/internal/xsltc/compiler/NamespaceAlias.java,Java,,19,7,27,53
/jdk1.6.0_45/com/sun/org/apache/xalan/internal/xsltc/compiler/NamespaceUriCall.java,Java,,25,8,32,65
/jdk1.6.0_45/com/sun/org/apache/xalan/internal/xsltc/compiler/NodeTest.java,Java,,13,5,23,41
/jdk1.6.0_45/com/sun/org/apache/xalan/internal/xsltc/compiler/NotCall.java,Java,,28,6,22,56
/jdk1.6.0_45/com/sun/org/apache/xalan/internal/xsltc/compiler/Number.java,Java,,447,76,84,607
/jdk1.6.0_45/com/sun/org/apache/xalan/internal/xsltc/compiler/NumberCall.java,Java,,35,9,22,66
/jdk1.6.0_45/com/sun/org/apache/xalan/internal/xsltc/compiler/Otherwise.java,Java,,24,5,22,51
/jdk1.6.0_45/com/sun/org/apache/xalan/internal/xsltc/compiler/Output.java,Java,,289,53,75,417
/jdk1.6.0_45/com/sun/org/apache/xalan/internal/xsltc/compiler/Param.java,Java,,153,24,77,254
/jdk1.6.0_45/com/sun/org/apache/xalan/internal/xsltc/compiler/ParameterRef.java,Java,,64,12,33,109
/jdk1.6.0_45/com/sun/org/apache/xalan/internal/xsltc/compiler/ParentLocationPath.java,Java,,162,37,49,248
/jdk1.6.0_45/com/sun/org/apache/xalan/internal/xsltc/compiler/ParentPattern.java,Java,,95,23,26,144
/jdk1.6.0_45/com/sun/org/apache/xalan/internal/xsltc/compiler/Parser.java,Java,,1007,150,239,1396
/jdk1.6.0_45/com/sun/org/apache/xalan/internal/xsltc/compiler/Pattern.java,Java,,11,5,42,58
/jdk1.6.0_45/com/sun/org/apache/xalan/internal/xsltc/compiler/PositionCall.java,Java,,34,8,23,65
/jdk1.6.0_45/com/sun/org/apache/xalan/internal/xsltc/compiler/Predicate.java,Java,,356,78,185,619
/jdk1.6.0_45/com/sun/org/apache/xalan/internal/xsltc/compiler/ProcessingInstruction.java,Java,,85,19,33,137
/jdk1.6.0_45/com/sun/org/apache/xalan/internal/xsltc/compiler/ProcessingInstructionPattern.java,Java,,97,19,40,156
/jdk1.6.0_45/com/sun/org/apache/xalan/internal/xsltc/compiler/QName.java,Java,,45,14,23,82
/jdk1.6.0_45/com/sun/org/apache/xalan/internal/xsltc/compiler/RealExpr.java,Java,,25,7,22,54
/jdk1.6.0_45/com/sun/org/apache/xalan/internal/xsltc/compiler/RelationalExpr.java,Java,,203,36,40,279
/jdk1.6.0_45/com/sun/org/apache/xalan/internal/xsltc/compiler/RelativeLocationPath.java,Java,,5,2,22,29
/jdk1.6.0_45/com/sun/org/apache/xalan/internal/xsltc/compiler/RelativePathPattern.java,Java,,2,2,22,26
/jdk1.6.0_45/com/sun/org/apache/xalan/internal/xsltc/compiler/RoundCall.java,Java,,19,7,23,49
/jdk1.6.0_45/com/sun/org/apache/xalan/internal/xsltc/compiler/SimpleAttributeValue.java,Java,,28,9,36,73
/jdk1.6.0_45/com/sun/org/apache/xalan/internal/xsltc/compiler/Sort.java,Java,,509,109,133,751
/jdk1.6.0_45/com/sun/org/apache/xalan/internal/xsltc/compiler/SourceLoader.java,Java,,5,5,30,40
/jdk1.6.0_45/com/sun/org/apache/xalan/internal/xsltc/compiler/StartsWithCall.java,Java,,42,12,35,89
/jdk1.6.0_45/com/sun/org/apache/xalan/internal/xsltc/compiler/Step.java,Java,,327,54,147,528
/jdk1.6.0_45/com/sun/org/apache/xalan/internal/xsltc/compiler/StepPattern.java,Java,,374,78,71,523
/jdk1.6.0_45/com/sun/org/apache/xalan/internal/xsltc/compiler/StringCall.java,Java,,41,9,22,72
/jdk1.6.0_45/com/sun/org/apache/xalan/internal/xsltc/compiler/StringLengthCall.java,Java,,26,5,22,53
/jdk1.6.0_45/com/sun/org/apache/xalan/internal/xsltc/compiler/Stylesheet.java,Java,,874,202,334,1410
/jdk1.6.0_45/com/sun/org/apache/xalan/internal/xsltc/compiler/sym.java,Java,,57,4,6,67
/jdk1.6.0_45/com/sun/org/apache/xalan/internal/xsltc/compiler/SymbolTable.java,Java,,160,38,64,262
/jdk1.6.0_45/com/sun/org/apache/xalan/internal/xsltc/compiler/SyntaxTreeNode.java,Java,,458,96,358,912
/jdk1.6.0_45/com/sun/org/apache/xalan/internal/xsltc/compiler/Template.java,Java,,233,58,48,339
/jdk1.6.0_45/com/sun/org/apache/xalan/internal/xsltc/compiler/TestSeq.java,Java,,135,39,111,285
/jdk1.6.0_45/com/sun/org/apache/xalan/internal/xsltc/compiler/Text.java,Java,,148,27,68,243
/jdk1.6.0_45/com/sun/org/apache/xalan/internal/xsltc/compiler/TopLevelElement.java,Java,,44,12,40,96
/jdk1.6.0_45/com/sun/org/apache/xalan/internal/xsltc/compiler/TransletOutput.java,Java,,76,23,46,145
/jdk1.6.0_45/com/sun/org/apache/xalan/internal/xsltc/compiler/UnaryOpExpr.java,Java,,45,13,29,87
/jdk1.6.0_45/com/sun/org/apache/xalan/internal/xsltc/compiler/UnionPathExpr.java,Java,,97,17,30,144
/jdk1.6.0_45/com/sun/org/apache/xalan/internal/xsltc/compiler/UnparsedEntityUriCall.java,Java,,35,7,26,68
/jdk1.6.0_45/com/sun/org/apache/xalan/internal/xsltc/compiler/UnresolvedRef.java,Java,,62,14,24,100
/jdk1.6.0_45/com/sun/org/apache/xalan/internal/xsltc/compiler/UnsupportedElement.java,Java,,79,16,53,148
/jdk1.6.0_45/com/sun/org/apache/xalan/internal/xsltc/compiler/UseAttributeSets.java,Java,,58,12,44,114
/jdk1.6.0_45/com/sun/org/apache/xalan/internal/xsltc/compiler/util/AttributeSetMethodGenerator.java,Java,,44,10,21,75
/jdk1.6.0_45/com/sun/org/apache/xalan/internal/xsltc/compiler/util/BooleanType.java,Java,,137,22,62,221
/jdk1.6.0_45/com/sun/org/apache/xalan/internal/xsltc/compiler/util/ClassGenerator.java,Java,,74,16,43,133
/jdk1.6.0_45/com/sun/org/apache/xalan/internal/xsltc/compiler/util/CompareGenerator.java,Java,,76,17,23,116
/jdk1.6.0_45/com/sun/org/apache/xalan/internal/xsltc/compiler/util/ErrorMessages.java,Java,,258,115,579,952
/jdk1.6.0_45/com/sun/org/apache/xalan/internal/xsltc/compiler/util/ErrorMessages_ca.java,Java,,199,104,546,849
/jdk1.6.0_45/com/sun/org/apache/xalan/internal/xsltc/compiler/util/ErrorMessages_cs.java,Java,,199,104,546,849
/jdk1.6.0_45/com/sun/org/apache/xalan/internal/xsltc/compiler/util/ErrorMessages_de.java,Java,,199,104,546,849
/jdk1.6.0_45/com/sun/org/apache/xalan/internal/xsltc/compiler/util/ErrorMessages_es.java,Java,,199,104,546,849
/jdk1.6.0_45/com/sun/org/apache/xalan/internal/xsltc/compiler/util/ErrorMessages_fr.java,Java,,199,104,546,849
/jdk1.6.0_45/com/sun/org/apache/xalan/internal/xsltc/compiler/util/ErrorMessages_it.java,Java,,199,104,546,849
/jdk1.6.0_45/com/sun/org/apache/xalan/internal/xsltc/compiler/util/ErrorMessages_ja.java,Java,,199,104,546,849
/jdk1.6.0_45/com/sun/org/apache/xalan/internal/xsltc/compiler/util/ErrorMessages_ko.java,Java,,199,104,546,849
/jdk1.6.0_45/com/sun/org/apache/xalan/internal/xsltc/compiler/util/ErrorMessages_pt_BR.java,Java,,217,114,579,910
/jdk1.6.0_45/com/sun/org/apache/xalan/internal/xsltc/compiler/util/ErrorMessages_sk.java,Java,,199,104,546,849
/jdk1.6.0_45/com/sun/org/apache/xalan/internal/xsltc/compiler/util/ErrorMessages_zh_CN.java,Java,,199,104,546,849
/jdk1.6.0_45/com/sun/org/apache/xalan/internal/xsltc/compiler/util/ErrorMessages_zh_TW.java,Java,,199,104,546,849
/jdk1.6.0_45/com/sun/org/apache/xalan/internal/xsltc/compiler/util/ErrorMsg.java,Java,,232,33,47,312
/jdk1.6.0_45/com/sun/org/apache/xalan/internal/xsltc/compiler/util/FilterGenerator.java,Java,,22,7,33,62
/jdk1.6.0_45/com/sun/org/apache/xalan/internal/xsltc/compiler/util/IntType.java,Java,,196,29,73,298
/jdk1.6.0_45/com/sun/org/apache/xalan/internal/xsltc/compiler/util/MatchGenerator.java,Java,,51,15,34,100
/jdk1.6.0_45/com/sun/org/apache/xalan/internal/xsltc/compiler/util/MethodGenerator.java,Java,,232,59,45,336
/jdk1.6.0_45/com/sun/org/apache/xalan/internal/xsltc/compiler/util/MethodType.java,Java,,126,17,26,169
/jdk1.6.0_45/com/sun/org/apache/xalan/internal/xsltc/compiler/util/MultiHashtable.java,Java,,27,4,22,53
/jdk1.6.0_45/com/sun/org/apache/xalan/internal/xsltc/compiler/util/NamedMethodGenerator.java,Java,,30,8,25,63
/jdk1.6.0_45/com/sun/org/apache/xalan/internal/xsltc/compiler/util/NodeCounterGenerator.java,Java,,25,7,39,71
/jdk1.6.0_45/com/sun/org/apache/xalan/internal/xsltc/compiler/util/NodeSetType.java,Java,,194,30,103,327
/jdk1.6.0_45/com/sun/org/apache/xalan/internal/xsltc/compiler/util/NodeSortRecordFactGenerator.java,Java,,14,5,26,45
/jdk1.6.0_45/com/sun/org/apache/xalan/internal/xsltc/compiler/util/NodeSortRecordGenerator.java,Java,,22,7,32,61
/jdk1.6.0_45/com/sun/org/apache/xalan/internal/xsltc/compiler/util/NodeType.java,Java,,201,33,87,321
/jdk1.6.0_45/com/sun/org/apache/xalan/internal/xsltc/compiler/util/NumberType.java,Java,,9,5,22,36
/jdk1.6.0_45/com/sun/org/apache/xalan/internal/xsltc/compiler/util/ObjectType.java,Java,,101,22,52,175
/jdk1.6.0_45/com/sun/org/apache/xalan/internal/xsltc/compiler/util/RealType.java,Java,,225,34,81,340
/jdk1.6.0_45/com/sun/org/apache/xalan/internal/xsltc/compiler/util/ReferenceType.java,Java,,257,32,87,376
/jdk1.6.0_45/com/sun/org/apache/xalan/internal/xsltc/compiler/util/ResultTreeType.java,Java,,272,46,143,461
/jdk1.6.0_45/com/sun/org/apache/xalan/internal/xsltc/compiler/util/RtMethodGenerator.java,Java,,33,9,24,66
/jdk1.6.0_45/com/sun/org/apache/xalan/internal/xsltc/compiler/util/SlotAllocator.java,Java,,63,13,22,98
/jdk1.6.0_45/com/sun/org/apache/xalan/internal/xsltc/compiler/util/StringStack.java,Java,,14,5,22,41
/jdk1.6.0_45/com/sun/org/apache/xalan/internal/xsltc/compiler/util/StringType.java,Java,,129,23,75,227
/jdk1.6.0_45/com/sun/org/apache/xalan/internal/xsltc/compiler/util/TestGenerator.java,Java,,72,17,24,113
/jdk1.6.0_45/com/sun/org/apache/xalan/internal/xsltc/compiler/util/Type.java,Java,,164,38,92,294
/jdk1.6.0_45/com/sun/org/apache/xalan/internal/xsltc/compiler/util/TypeCheckError.java,Java,,41,12,22,75
/jdk1.6.0_45/com/sun/org/apache/xalan/internal/xsltc/compiler/util/Util.java,Java,,126,30,45,201
/jdk1.6.0_45/com/sun/org/apache/xalan/internal/xsltc/compiler/util/VoidType.java,Java,,47,11,38,96
/jdk1.6.0_45/com/sun/org/apache/xalan/internal/xsltc/compiler/ValueOf.java,Java,,81,14,41,136
/jdk1.6.0_45/com/sun/org/apache/xalan/internal/xsltc/compiler/Variable.java,Java,,115,18,54,187
/jdk1.6.0_45/com/sun/org/apache/xalan/internal/xsltc/compiler/VariableBase.java,Java,,159,33,100,292
/jdk1.6.0_45/com/sun/org/apache/xalan/internal/xsltc/compiler/VariableRef.java,Java,,59,10,26,95
/jdk1.6.0_45/com/sun/org/apache/xalan/internal/xsltc/compiler/VariableRefBase.java,Java,,75,21,60,156
/jdk1.6.0_45/com/sun/org/apache/xalan/internal/xsltc/compiler/When.java,Java,,50,14,39,103
/jdk1.6.0_45/com/sun/org/apache/xalan/internal/xsltc/compiler/Whitespace.java,Java,,346,65,128,539
/jdk1.6.0_45/com/sun/org/apache/xalan/internal/xsltc/compiler/WithParam.java,Java,,104,22,81,207
/jdk1.6.0_45/com/sun/org/apache/xalan/internal/xsltc/compiler/XPathLexer.java,Java,,1557,19,39,1615
/jdk1.6.0_45/com/sun/org/apache/xalan/internal/xsltc/compiler/XPathParser.java,Java,,2639,260,249,3148
/jdk1.6.0_45/com/sun/org/apache/xalan/internal/xsltc/compiler/XslAttribute.java,Java,,183,41,66,290
/jdk1.6.0_45/com/sun/org/apache/xalan/internal/xsltc/compiler/XslElement.java,Java,,188,40,62,290
/jdk1.6.0_45/com/sun/org/apache/xalan/internal/xsltc/compiler/XSLTC.java,Java,,525,107,279,911
/jdk1.6.0_45/com/sun/org/apache/xalan/internal/xsltc/dom/AbsoluteIterator.java,Java,,50,12,35,97
/jdk1.6.0_45/com/sun/org/apache/xalan/internal/xsltc/dom/AdaptiveResultTreeImpl.java,Java,,1108,153,80,1341
/jdk1.6.0_45/com/sun/org/apache/xalan/internal/xsltc/dom/AnyNodeCounter.java,Java,,82,9,36,127
/jdk1.6.0_45/com/sun/org/apache/xalan/internal/xsltc/dom/BitArray.java,Java,,159,33,72,264
/jdk1.6.0_45/com/sun/org/apache/xalan/internal/xsltc/dom/CachedNodeListIterator.java,Java,,66,16,29,111
/jdk1.6.0_45/com/sun/org/apache/xalan/internal/xsltc/dom/ClonedNodeListIterator.java,Java,,37,14,28,79
/jdk1.6.0_45/com/sun/org/apache/xalan/internal/xsltc/dom/CollatorFactoryBase.java,Java,,19,8,21,48
/jdk1.6.0_45/com/sun/org/apache/xalan/internal/xsltc/dom/CurrentNodeListFilter.java,Java,,7,3,23,33
/jdk1.6.0_45/com/sun/org/apache/xalan/internal/xsltc/dom/CurrentNodeListIterator.java,Java,,117,28,52,197
/jdk1.6.0_45/com/sun/org/apache/xalan/internal/xsltc/dom/DocumentCache.java,Java,,213,48,76,337
/jdk1.6.0_45/com/sun/org/apache/xalan/internal/xsltc/dom/DOMAdapter.java,Java,,357,71,36,464
/jdk1.6.0_45/com/sun/org/apache/xalan/internal/xsltc/dom/DOMBuilder.java,Java,,2,2,21,25
/jdk1.6.0_45/com/sun/org/apache/xalan/internal/xsltc/dom/DOMWSFilter.java,Java,,62,14,52,128
/jdk1.6.0_45/com/sun/org/apache/xalan/internal/xsltc/dom/DupFilterIterator.java,Java,,82,20,53,155
/jdk1.6.0_45/com/sun/org/apache/xalan/internal/xsltc/dom/EmptyFilter.java,Java,,6,2,22,30
/jdk1.6.0_45/com/sun/org/apache/xalan/internal/xsltc/dom/ExtendedSAX.java,Java,,9,2,21,32
/jdk1.6.0_45/com/sun/org/apache/xalan/internal/xsltc/dom/Filter.java,Java,,4,2,22,28
/jdk1.6.0_45/com/sun/org/apache/xalan/internal/xsltc/dom/FilteredStepIterator.java,Java,,20,7,25,52
/jdk1.6.0_45/com/sun/org/apache/xalan/internal/xsltc/dom/FilterIterator.java,Java,,62,18,36,116
/jdk1.6.0_45/com/sun/org/apache/xalan/internal/xsltc/dom/ForwardPositionIterator.java,Java,,41,11,53,105
/jdk1.6.0_45/com/sun/org/apache/xalan/internal/xsltc/dom/KeyIndex.java,Java,,381,116,400,897
/jdk1.6.0_45/com/sun/org/apache/xalan/internal/xsltc/dom/LoadDocument.java,Java,,186,34,71,291
/jdk1.6.0_45/com/sun/org/apache/xalan/internal/xsltc/dom/MatchingIterator.java,Java,,61,18,46,125
/jdk1.6.0_45/com/sun/org/apache/xalan/internal/xsltc/dom/MultiDOM.java,Java,,504,102,61,667
/jdk1.6.0_45/com/sun/org/apache/xalan/internal/xsltc/dom/MultipleNodeCounter.java,Java,,75,14,27,116
/jdk1.6.0_45/com/sun/org/apache/xalan/internal/xsltc/dom/MultiValuedNodeHeapIterator.java,Java,,165,35,92,292
/jdk1.6.0_45/com/sun/org/apache/xalan/internal/xsltc/dom/NodeCounter.java,Java,,232,47,82,361
/jdk1.6.0_45/com/sun/org/apache/xalan/internal/xsltc/dom/NodeIteratorBase.java,Java,,65,19,84,168
/jdk1.6.0_45/com/sun/org/apache/xalan/internal/xsltc/dom/NodeSortRecord.java,Java,,136,30,82,248
/jdk1.6.0_45/com/sun/org/apache/xalan/internal/xsltc/dom/NodeSortRecordFactory.java,Java,,92,21,49,162
/jdk1.6.0_45/com/sun/org/apache/xalan/internal/xsltc/dom/NthIterator.java,Java,,61,13,39,113
/jdk1.6.0_45/com/sun/org/apache/xalan/internal/xsltc/dom/SAXImpl.java,Java,,1182,238,483,1903
/jdk1.6.0_45/com/sun/org/apache/xalan/internal/xsltc/dom/SimpleResultTreeImpl.java,Java,,733,175,108,1016
/jdk1.6.0_45/com/sun/org/apache/xalan/internal/xsltc/dom/SingleNodeCounter.java,Java,,109,19,27,155
/jdk1.6.0_45/com/sun/org/apache/xalan/internal/xsltc/dom/SingletonIterator.java,Java,,53,11,26,90
/jdk1.6.0_45/com/sun/org/apache/xalan/internal/xsltc/dom/SortingIterator.java,Java,,99,18,30,147
/jdk1.6.0_45/com/sun/org/apache/xalan/internal/xsltc/dom/SortSettings.java,Java,,39,16,81,136
/jdk1.6.0_45/com/sun/org/apache/xalan/internal/xsltc/dom/StepIterator.java,Java,,68,16,52,136
/jdk1.6.0_45/com/sun/org/apache/xalan/internal/xsltc/dom/StripWhitespaceFilter.java,Java,,5,3,22,30
/jdk1.6.0_45/com/sun/org/apache/xalan/internal/xsltc/dom/UnionIterator.java,Java,,53,14,29,96
/jdk1.6.0_45/com/sun/org/apache/xalan/internal/xsltc/dom/XSLTCDTMManager.java,Java,,249,49,183,481
/jdk1.6.0_45/com/sun/org/apache/xalan/internal/xsltc/DOM.java,Java,,66,11,26,103
/jdk1.6.0_45/com/sun/org/apache/xalan/internal/xsltc/DOMCache.java,Java,,4,5,45,54
/jdk1.6.0_45/com/sun/org/apache/xalan/internal/xsltc/DOMEnhancedForDTM.java,Java,,12,1,30,43
/jdk1.6.0_45/com/sun/org/apache/xalan/internal/xsltc/NodeIterator.java,Java,,15,14,53,82
/jdk1.6.0_45/com/sun/org/apache/xalan/internal/xsltc/ProcessorVersion.java,Java,,10,4,33,47
/jdk1.6.0_45/com/sun/org/apache/xalan/internal/xsltc/runtime/AbstractTranslet.java,Java,,440,106,221,767
/jdk1.6.0_45/com/sun/org/apache/xalan/internal/xsltc/runtime/AttributeList.java,Java,,118,24,84,226
/jdk1.6.0_45/com/sun/org/apache/xalan/internal/xsltc/runtime/Attributes.java,Java,,29,10,22,61
/jdk1.6.0_45/com/sun/org/apache/xalan/internal/xsltc/runtime/BasisLibrary.java,Java,,1136,157,292,1585
/jdk1.6.0_45/com/sun/org/apache/xalan/internal/xsltc/runtime/Constants.java,Java,,19,6,24,49
/jdk1.6.0_45/com/sun/org/apache/xalan/internal/xsltc/runtime/ErrorMessages.java,Java,,57,32,194,283
/jdk1.6.0_45/com/sun/org/apache/xalan/internal/xsltc/runtime/ErrorMessages_ca.java,Java,,43,23,163,229
/jdk1.6.0_45/com/sun/org/apache/xalan/internal/xsltc/runtime/ErrorMessages_cs.java,Java,,43,23,163,229
/jdk1.6.0_45/com/sun/org/apache/xalan/internal/xsltc/runtime/ErrorMessages_de.java,Java,,43,23,163,229
/jdk1.6.0_45/com/sun/org/apache/xalan/internal/xsltc/runtime/ErrorMessages_es.java,Java,,43,23,163,229
/jdk1.6.0_45/com/sun/org/apache/xalan/internal/xsltc/runtime/ErrorMessages_fr.java,Java,,43,23,163,229
/jdk1.6.0_45/com/sun/org/apache/xalan/internal/xsltc/runtime/ErrorMessages_it.java,Java,,43,23,163,229
/jdk1.6.0_45/com/sun/org/apache/xalan/internal/xsltc/runtime/ErrorMessages_ja.java,Java,,43,23,163,229
/jdk1.6.0_45/com/sun/org/apache/xalan/internal/xsltc/runtime/ErrorMessages_ko.java,Java,,43,23,163,229
/jdk1.6.0_45/com/sun/org/apache/xalan/internal/xsltc/runtime/ErrorMessages_pt_BR.java,Java,,57,32,194,283
/jdk1.6.0_45/com/sun/org/apache/xalan/internal/xsltc/runtime/ErrorMessages_sk.java,Java,,43,23,163,229
/jdk1.6.0_45/com/sun/org/apache/xalan/internal/xsltc/runtime/ErrorMessages_zh_CN.java,Java,,43,23,163,229
/jdk1.6.0_45/com/sun/org/apache/xalan/internal/xsltc/runtime/ErrorMessages_zh_TW.java,Java,,43,23,163,229
/jdk1.6.0_45/com/sun/org/apache/xalan/internal/xsltc/runtime/Hashtable.java,Java,,198,42,101,341
/jdk1.6.0_45/com/sun/org/apache/xalan/internal/xsltc/runtime/MessageHandler.java,Java,,6,2,21,29
/jdk1.6.0_45/com/sun/org/apache/xalan/internal/xsltc/runtime/Node.java,Java,,9,3,24,36
/jdk1.6.0_45/com/sun/org/apache/xalan/internal/xsltc/runtime/Operators.java,Java,,26,7,23,56
/jdk1.6.0_45/com/sun/org/apache/xalan/internal/xsltc/runtime/output/OutputBuffer.java,Java,,7,6,21,34
/jdk1.6.0_45/com/sun/org/apache/xalan/internal/xsltc/runtime/output/StringOutputBuffer.java,Java,,22,9,21,52
/jdk1.6.0_45/com/sun/org/apache/xalan/internal/xsltc/runtime/output/TransletOutputHandlerFactory.java,Java,,199,46,23,268
/jdk1.6.0_45/com/sun/org/apache/xalan/internal/xsltc/runtime/output/WriterOutputBuffer.java,Java,,55,12,28,95
/jdk1.6.0_45/com/sun/org/apache/xalan/internal/xsltc/runtime/Parameter.java,Java,,16,5,23,44
/jdk1.6.0_45/com/sun/org/apache/xalan/internal/xsltc/runtime/StringValueHandler.java,Java,,76,18,29,123
/jdk1.6.0_45/com/sun/org/apache/xalan/internal/xsltc/StripFilter.java,Java,,4,3,22,29
/jdk1.6.0_45/com/sun/org/apache/xalan/internal/xsltc/Translet.java,Java,,24,7,22,53
/jdk1.6.0_45/com/sun/org/apache/xalan/internal/xsltc/TransletException.java,Java,,15,6,23,44
/jdk1.6.0_45/com/sun/org/apache/xalan/internal/xsltc/trax/DOM2SAX.java,Java,,307,56,118,481
/jdk1.6.0_45/com/sun/org/apache/xalan/internal/xsltc/trax/DOM2TO.java,Java,,260,58,114,432
/jdk1.6.0_45/com/sun/org/apache/xalan/internal/xsltc/trax/OutputSettings.java,Java,,17,7,21,45
/jdk1.6.0_45/com/sun/org/apache/xalan/internal/xsltc/trax/SAX2DOM.java,Java,,216,45,71,332
/jdk1.6.0_45/com/sun/org/apache/xalan/internal/xsltc/trax/SAX2StAXBaseWriter.java,Java,,155,51,45,251
/jdk1.6.0_45/com/sun/org/apache/xalan/internal/xsltc/trax/SAX2StAXEventWriter.java,Java,,223,152,47,422
/jdk1.6.0_45/com/sun/org/apache/xalan/internal/xsltc/trax/SAX2StAXStreamWriter.java,Java,,139,111,54,304
/jdk1.6.0_45/com/sun/org/apache/xalan/internal/xsltc/trax/SmartTransformerFactoryImpl.java,Java,,289,35,127,451
/jdk1.6.0_45/com/sun/org/apache/xalan/internal/xsltc/trax/StAXEvent2SAX.java,Java,,372,77,154,603
/jdk1.6.0_45/com/sun/org/apache/xalan/internal/xsltc/trax/StAXStream2SAX.java,Java,,325,79,148,552
/jdk1.6.0_45/com/sun/org/apache/xalan/internal/xsltc/trax/TemplatesHandlerImpl.java,Java,,159,46,127,332
/jdk1.6.0_45/com/sun/org/apache/xalan/internal/xsltc/trax/TemplatesImpl.java,Java,,225,55,167,447
/jdk1.6.0_45/com/sun/org/apache/xalan/internal/xsltc/trax/TransformerFactoryImpl.java,Java,,855,147,447,1449
/jdk1.6.0_45/com/sun/org/apache/xalan/internal/xsltc/trax/TransformerHandlerImpl.java,Java,,271,55,157,483
/jdk1.6.0_45/com/sun/org/apache/xalan/internal/xsltc/trax/TransformerImpl.java,Java,,851,132,412,1395
/jdk1.6.0_45/com/sun/org/apache/xalan/internal/xsltc/trax/TrAXFilter.java,Java,,99,20,25,144
/jdk1.6.0_45/com/sun/org/apache/xalan/internal/xsltc/trax/Util.java,Java,,146,34,41,221
/jdk1.6.0_45/com/sun/org/apache/xalan/internal/xsltc/trax/XSLTCSource.java,Java,,75,19,44,138
/jdk1.6.0_45/com/sun/org/apache/xalan/internal/xsltc/util/IntegerArray.java,Java,,158,33,33,224
/jdk1.6.0_45/com/sun/org/apache/xerces/internal/dom/AttributeMap.java,Java,,334,66,166,566
/jdk1.6.0_45/com/sun/org/apache/xerces/internal/dom/AttrImpl.java,Java,,573,159,503,1235
/jdk1.6.0_45/com/sun/org/apache/xerces/internal/dom/AttrNSImpl.java,Java,,182,34,132,348
/jdk1.6.0_45/com/sun/org/apache/xerces/internal/dom/CDATASectionImpl.java,Java,,17,11,58,86
/jdk1.6.0_45/com/sun/org/apache/xerces/internal/dom/CharacterDataImpl.java,Java,,163,75,184,422
/jdk1.6.0_45/com/sun/org/apache/xerces/internal/dom/ChildNode.java,Java,,35,24,88,147
/jdk1.6.0_45/com/sun/org/apache/xerces/internal/dom/CommentImpl.java,Java,,18,11,39,68
/jdk1.6.0_45/com/sun/org/apache/xerces/internal/dom/CoreDocumentImpl.java,Java,,1317,331,1114,2762
/jdk1.6.0_45/com/sun/org/apache/xerces/internal/dom/CoreDOMImplementationImpl.java,Java,,257,24,203,484
/jdk1.6.0_45/com/sun/org/apache/xerces/internal/dom/DeepNodeListImpl.java,Java,,113,31,100,244
/jdk1.6.0_45/com/sun/org/apache/xerces/internal/dom/DeferredAttrImpl.java,Java,,32,20,90,142
/jdk1.6.0_45/com/sun/org/apache/xerces/internal/dom/DeferredAttrNSImpl.java,Java,,40,24,63,127
/jdk1.6.0_45/com/sun/org/apache/xerces/internal/dom/DeferredCDATASectionImpl.java,Java,,21,18,67,106
/jdk1.6.0_45/com/sun/org/apache/xerces/internal/dom/DeferredCommentImpl.java,Java,,21,18,48,87
/jdk1.6.0_45/com/sun/org/apache/xerces/internal/dom/DeferredDocumentImpl.java,Java,,1295,371,478,2144
/jdk1.6.0_45/com/sun/org/apache/xerces/internal/dom/DeferredDocumentTypeImpl.java,Java,,75,34,75,184
/jdk1.6.0_45/com/sun/org/apache/xerces/internal/dom/DeferredDOMImplementationImpl.java,Java,,9,8,38,55
/jdk1.6.0_45/com/sun/org/apache/xerces/internal/dom/DeferredElementDefinitionImpl.java,Java,,39,26,58,123
/jdk1.6.0_45/com/sun/org/apache/xerces/internal/dom/DeferredElementImpl.java,Java,,40,25,70,135
/jdk1.6.0_45/com/sun/org/apache/xerces/internal/dom/DeferredElementNSImpl.java,Java,,51,28,65,144
/jdk1.6.0_45/com/sun/org/apache/xerces/internal/dom/DeferredEntityImpl.java,Java,,40,27,83,150
/jdk1.6.0_45/com/sun/org/apache/xerces/internal/dom/DeferredEntityReferenceImpl.java,Java,,31,22,99,152
/jdk1.6.0_45/com/sun/org/apache/xerces/internal/dom/DeferredNode.java,Java,,6,8,26,40
/jdk1.6.0_45/com/sun/org/apache/xerces/internal/dom/DeferredNotationImpl.java,Java,,27,20,67,114
/jdk1.6.0_45/com/sun/org/apache/xerces/internal/dom/DeferredProcessingInstructionImpl.java,Java,,23,18,50,91
/jdk1.6.0_45/com/sun/org/apache/xerces/internal/dom/DeferredTextImpl.java,Java,,22,20,62,104
/jdk1.6.0_45/com/sun/org/apache/xerces/internal/dom/DocumentFragmentImpl.java,Java,,48,17,87,152
/jdk1.6.0_45/com/sun/org/apache/xerces/internal/dom/DocumentImpl.java,Java,,643,124,534,1301
/jdk1.6.0_45/com/sun/org/apache/xerces/internal/dom/DocumentTypeImpl.java,Java,,231,73,178,482
/jdk1.6.0_45/com/sun/org/apache/xerces/internal/dom/DOMConfigurationImpl.java,Java,,632,135,305,1072
/jdk1.6.0_45/com/sun/org/apache/xerces/internal/dom/DOMErrorImpl.java,Java,,47,27,59,133
/jdk1.6.0_45/com/sun/org/apache/xerces/internal/dom/DOMImplementationImpl.java,Java,,51,19,78,148
/jdk1.6.0_45/com/sun/org/apache/xerces/internal/dom/DOMImplementationListImpl.java,Java,,23,8,40,71
/jdk1.6.0_45/com/sun/org/apache/xerces/internal/dom/DOMImplementationSourceImpl.java,Java,,73,10,50,133
/jdk1.6.0_45/com/sun/org/apache/xerces/internal/dom/DOMInputImpl.java,Java,,96,45,247,388
/jdk1.6.0_45/com/sun/org/apache/xerces/internal/dom/DOMLocatorImpl.java,Java,,57,29,73,159
/jdk1.6.0_45/com/sun/org/apache/xerces/internal/dom/DOMMessageFormatter.java,Java,,82,11,47,140
/jdk1.6.0_45/com/sun/org/apache/xerces/internal/dom/DOMNormalizer.java,Java,,1171,251,622,2044
/jdk1.6.0_45/com/sun/org/apache/xerces/internal/dom/DOMOutputImpl.java,Java,,35,24,110,169
/jdk1.6.0_45/com/sun/org/apache/xerces/internal/dom/DOMStringListImpl.java,Java,,28,12,46,86
/jdk1.6.0_45/com/sun/org/apache/xerces/internal/dom/DOMXSImplementationSourceImpl.java,Java,,39,9,49,97
/jdk1.6.0_45/com/sun/org/apache/xerces/internal/dom/ElementDefinitionImpl.java,Java,,35,20,63,118
/jdk1.6.0_45/com/sun/org/apache/xerces/internal/dom/ElementImpl.java,Java,,577,144,454,1175
/jdk1.6.0_45/com/sun/org/apache/xerces/internal/dom/ElementNSImpl.java,Java,,263,58,164,485
/jdk1.6.0_45/com/sun/org/apache/xerces/internal/dom/EntityImpl.java,Java,,136,66,163,365
/jdk1.6.0_45/com/sun/org/apache/xerces/internal/dom/EntityReferenceImpl.java,Java,,139,41,219,399
/jdk1.6.0_45/com/sun/org/apache/xerces/internal/dom/events/EventImpl.java,Java,,56,15,61,132
/jdk1.6.0_45/com/sun/org/apache/xerces/internal/dom/events/MutationEventImpl.java,Java,,49,12,48,109
/jdk1.6.0_45/com/sun/org/apache/xerces/internal/dom/LCount.java,Java,,13,4,37,54
/jdk1.6.0_45/com/sun/org/apache/xerces/internal/dom/NamedNodeMapImpl.java,Java,,298,82,219,599
/jdk1.6.0_45/com/sun/org/apache/xerces/internal/dom/NodeImpl.java,Java,,878,214,929,2021
/jdk1.6.0_45/com/sun/org/apache/xerces/internal/dom/NodeIteratorImpl.java,Java,,179,68,124,371
/jdk1.6.0_45/com/sun/org/apache/xerces/internal/dom/NodeListCache.java,Java,,13,11,32,56
/jdk1.6.0_45/com/sun/org/apache/xerces/internal/dom/NotationImpl.java,Java,,81,33,95,209
/jdk1.6.0_45/com/sun/org/apache/xerces/internal/dom/ParentNode.java,Java,,505,120,408,1033
/jdk1.6.0_45/com/sun/org/apache/xerces/internal/dom/ProcessingInstructionImpl.java,Java,,44,24,90,158
/jdk1.6.0_45/com/sun/org/apache/xerces/internal/dom/PSVIAttrNSImpl.java,Java,,91,38,121,250
/jdk1.6.0_45/com/sun/org/apache/xerces/internal/dom/PSVIDocumentImpl.java,Java,,55,21,71,147
/jdk1.6.0_45/com/sun/org/apache/xerces/internal/dom/PSVIDOMImplementationImpl.java,Java,,32,13,76,121
/jdk1.6.0_45/com/sun/org/apache/xerces/internal/dom/PSVIElementNSImpl.java,Java,,105,44,142,291
/jdk1.6.0_45/com/sun/org/apache/xerces/internal/dom/RangeExceptionImpl.java,Java,,8,5,21,34
/jdk1.6.0_45/com/sun/org/apache/xerces/internal/dom/RangeImpl.java,Java,,1273,181,628,2082
/jdk1.6.0_45/com/sun/org/apache/xerces/internal/dom/TextImpl.java,Java,,318,92,252,662
/jdk1.6.0_45/com/sun/org/apache/xerces/internal/dom/TreeWalkerImpl.java,Java,,279,93,132,504
/jdk1.6.0_45/com/sun/org/apache/xerces/internal/impl/Constants.java,Java,,280,184,287,751
/jdk1.6.0_45/com/sun/org/apache/xerces/internal/impl/dtd/DTDGrammar.java,Java,,1488,411,868,2767
/jdk1.6.0_45/com/sun/org/apache/xerces/internal/impl/dtd/DTDGrammarBucket.java,Java,,35,17,96,148
/jdk1.6.0_45/com/sun/org/apache/xerces/internal/impl/dtd/models/CMAny.java,Java,,63,26,101,190
/jdk1.6.0_45/com/sun/org/apache/xerces/internal/impl/dtd/models/CMBinOp.java,Java,,71,16,102,189
/jdk1.6.0_45/com/sun/org/apache/xerces/internal/impl/dtd/models/CMLeaf.java,Java,,66,27,92,185
/jdk1.6.0_45/com/sun/org/apache/xerces/internal/impl/dtd/models/CMNode.java,Java,,53,18,118,189
/jdk1.6.0_45/com/sun/org/apache/xerces/internal/impl/dtd/models/CMStateSet.java,Java,,189,27,124,340
/jdk1.6.0_45/com/sun/org/apache/xerces/internal/impl/dtd/models/CMUniOp.java,Java,,36,15,90,141
/jdk1.6.0_45/com/sun/org/apache/xerces/internal/impl/dtd/models/ContentModelValidator.java,Java,,5,6,74,85
/jdk1.6.0_45/com/sun/org/apache/xerces/internal/impl/dtd/models/DFAContentModel.java,Java,,370,117,543,1030
/jdk1.6.0_45/com/sun/org/apache/xerces/internal/impl/dtd/models/MixedContentModel.java,Java,,91,26,139,256
/jdk1.6.0_45/com/sun/org/apache/xerces/internal/impl/dtd/models/SimpleContentModel.java,Java,,92,35,191,318
/jdk1.6.0_45/com/sun/org/apache/xerces/internal/impl/dtd/XML11DTDProcessor.java,Java,,29,13,70,112
/jdk1.6.0_45/com/sun/org/apache/xerces/internal/impl/dtd/XML11DTDValidator.java,Java,,33,13,76,122
/jdk1.6.0_45/com/sun/org/apache/xerces/internal/impl/dtd/XML11NSDTDValidator.java,Java,,130,23,109,262
/jdk1.6.0_45/com/sun/org/apache/xerces/internal/impl/dtd/XMLAttributeDecl.java,Java,,17,11,79,107
/jdk1.6.0_45/com/sun/org/apache/xerces/internal/impl/dtd/XMLContentSpec.java,Java,,72,44,218,334
/jdk1.6.0_45/com/sun/org/apache/xerces/internal/impl/dtd/XMLDTDDescription.java,Java,,92,18,99,209
/jdk1.6.0_45/com/sun/org/apache/xerces/internal/impl/dtd/XMLDTDLoader.java,Java,,200,41,188,429
/jdk1.6.0_45/com/sun/org/apache/xerces/internal/impl/dtd/XMLDTDProcessor.java,Java,,737,226,734,1697
/jdk1.6.0_45/com/sun/org/apache/xerces/internal/impl/dtd/XMLDTDValidator.java,Java,,1090,287,715,2092
/jdk1.6.0_45/com/sun/org/apache/xerces/internal/impl/dtd/XMLDTDValidatorFilter.java,Java,,7,7,76,90
/jdk1.6.0_45/com/sun/org/apache/xerces/internal/impl/dtd/XMLElementDecl.java,Java,,29,19,90,138
/jdk1.6.0_45/com/sun/org/apache/xerces/internal/impl/dtd/XMLEntityDecl.java,Java,,38,17,100,155
/jdk1.6.0_45/com/sun/org/apache/xerces/internal/impl/dtd/XMLNotationDecl.java,Java,,19,11,79,109
/jdk1.6.0_45/com/sun/org/apache/xerces/internal/impl/dtd/XMLNSDTDValidator.java,Java,,133,29,110,272
/jdk1.6.0_45/com/sun/org/apache/xerces/internal/impl/dtd/XMLSimpleType.java,Java,,69,34,106,209
/jdk1.6.0_45/com/sun/org/apache/xerces/internal/impl/dv/DatatypeException.java,Java,,41,12,53,106
/jdk1.6.0_45/com/sun/org/apache/xerces/internal/impl/dv/DatatypeValidator.java,Java,,6,5,31,42
/jdk1.6.0_45/com/sun/org/apache/xerces/internal/impl/dv/dtd/DTDDVFactoryImpl.java,Java,,31,12,36,79
/jdk1.6.0_45/com/sun/org/apache/xerces/internal/impl/dv/dtd/ENTITYDatatypeValidator.java,Java,,10,8,47,65
/jdk1.6.0_45/com/sun/org/apache/xerces/internal/impl/dv/dtd/IDDatatypeValidator.java,Java,,23,9,49,81
/jdk1.6.0_45/com/sun/org/apache/xerces/internal/impl/dv/dtd/IDREFDatatypeValidator.java,Java,,20,9,46,75
/jdk1.6.0_45/com/sun/org/apache/xerces/internal/impl/dv/dtd/ListDatatypeValidator.java,Java,,19,9,38,66
/jdk1.6.0_45/com/sun/org/apache/xerces/internal/impl/dv/dtd/NMTOKENDatatypeValidator.java,Java,,12,6,36,54
/jdk1.6.0_45/com/sun/org/apache/xerces/internal/impl/dv/dtd/NOTATIONDatatypeValidator.java,Java,,8,6,38,52
/jdk1.6.0_45/com/sun/org/apache/xerces/internal/impl/dv/dtd/StringDatatypeValidator.java,Java,,8,6,43,57
/jdk1.6.0_45/com/sun/org/apache/xerces/internal/impl/dv/dtd/XML11DTDDVFactoryImpl.java,Java,,31,11,38,80
/jdk1.6.0_45/com/sun/org/apache/xerces/internal/impl/dv/dtd/XML11IDDatatypeValidator.java,Java,,24,10,50,84
/jdk1.6.0_45/com/sun/org/apache/xerces/internal/impl/dv/dtd/XML11IDREFDatatypeValidator.java,Java,,21,10,47,78
/jdk1.6.0_45/com/sun/org/apache/xerces/internal/impl/dv/dtd/XML11NMTOKENDatatypeValidator.java,Java,,13,7,37,57
/jdk1.6.0_45/com/sun/org/apache/xerces/internal/impl/dv/DTDDVFactory.java,Java,,20,11,54,85
/jdk1.6.0_45/com/sun/org/apache/xerces/internal/impl/dv/DVFactoryException.java,Java,,10,5,24,39
/jdk1.6.0_45/com/sun/org/apache/xerces/internal/impl/dv/InvalidDatatypeFacetException.java,Java,,7,5,33,45
/jdk1.6.0_45/com/sun/org/apache/xerces/internal/impl/dv/InvalidDatatypeValueException.java,Java,,7,5,73,85
/jdk1.6.0_45/com/sun/org/apache/xerces/internal/impl/dv/SchemaDVFactory.java,Java,,29,16,100,145
/jdk1.6.0_45/com/sun/org/apache/xerces/internal/impl/dv/util/Base64.java,Java,,198,52,54,304
/jdk1.6.0_45/com/sun/org/apache/xerces/internal/impl/dv/util/ByteListImpl.java,Java,,28,11,48,87
/jdk1.6.0_45/com/sun/org/apache/xerces/internal/impl/dv/util/HexBin.java,Java,,67,8,37,112
/jdk1.6.0_45/com/sun/org/apache/xerces/internal/impl/dv/ValidatedInfo.java,Java,,22,11,62,95
/jdk1.6.0_45/com/sun/org/apache/xerces/internal/impl/dv/ValidationContext.java,Java,,14,10,33,57
/jdk1.6.0_45/com/sun/org/apache/xerces/internal/impl/dv/xs/AbstractDateTimeDV.java,Java,,637,107,264,1008
/jdk1.6.0_45/com/sun/org/apache/xerces/internal/impl/dv/xs/AnyAtomicDV.java,Java,,11,6,24,41
/jdk1.6.0_45/com/sun/org/apache/xerces/internal/impl/dv/xs/AnySimpleDV.java,Java,,11,6,26,43
/jdk1.6.0_45/com/sun/org/apache/xerces/internal/impl/dv/xs/AnyURIDV.java,Java,,105,14,49,168
/jdk1.6.0_45/com/sun/org/apache/xerces/internal/impl/dv/xs/Base64BinaryDV.java,Java,,43,10,29,82
/jdk1.6.0_45/com/sun/org/apache/xerces/internal/impl/dv/xs/BaseDVFactory.java,Java,,138,30,78,246
/jdk1.6.0_45/com/sun/org/apache/xerces/internal/impl/dv/xs/BooleanDV.java,Java,,19,8,25,52
/jdk1.6.0_45/com/sun/org/apache/xerces/internal/impl/dv/xs/DateDV.java,Java,,40,13,36,89
/jdk1.6.0_45/com/sun/org/apache/xerces/internal/impl/dv/xs/DateTimeDV.java,Java,,37,15,38,90
/jdk1.6.0_45/com/sun/org/apache/xerces/internal/impl/dv/xs/DayDV.java,Java,,53,18,43,114
/jdk1.6.0_45/com/sun/org/apache/xerces/internal/impl/dv/xs/DayTimeDurationDV.java,Java,,29,6,24,59
/jdk1.6.0_45/com/sun/org/apache/xerces/internal/impl/dv/xs/DecimalDV.java,Java,,262,42,57,361
/jdk1.6.0_45/com/sun/org/apache/xerces/internal/impl/dv/xs/DoubleDV.java,Java,,152,24,71,247
/jdk1.6.0_45/com/sun/org/apache/xerces/internal/impl/dv/xs/DurationDV.java,Java,,247,55,80,382
/jdk1.6.0_45/com/sun/org/apache/xerces/internal/impl/dv/xs/EntityDV.java,Java,,20,8,25,53
/jdk1.6.0_45/com/sun/org/apache/xerces/internal/impl/dv/xs/FloatDV.java,Java,,141,25,66,232
/jdk1.6.0_45/com/sun/org/apache/xerces/internal/impl/dv/xs/FullDVFactory.java,Java,,94,25,46,165
/jdk1.6.0_45/com/sun/org/apache/xerces/internal/impl/dv/xs/HexBinaryDV.java,Java,,43,11,26,80
/jdk1.6.0_45/com/sun/org/apache/xerces/internal/impl/dv/xs/IDDV.java,Java,,21,6,25,52
/jdk1.6.0_45/com/sun/org/apache/xerces/internal/impl/dv/xs/IDREFDV.java,Java,,18,8,25,51
/jdk1.6.0_45/com/sun/org/apache/xerces/internal/impl/dv/xs/IntegerDV.java,Java,,12,5,24,41
/jdk1.6.0_45/com/sun/org/apache/xerces/internal/impl/dv/xs/ListDV.java,Java,,67,13,29,109
/jdk1.6.0_45/com/sun/org/apache/xerces/internal/impl/dv/xs/MonthDayDV.java,Java,,58,19,49,126
/jdk1.6.0_45/com/sun/org/apache/xerces/internal/impl/dv/xs/MonthDV.java,Java,,52,14,98,164
/jdk1.6.0_45/com/sun/org/apache/xerces/internal/impl/dv/xs/PrecisionDecimalDV.java,Java,,224,57,77,358
/jdk1.6.0_45/com/sun/org/apache/xerces/internal/impl/dv/xs/QNameDV.java,Java,,56,16,36,108
/jdk1.6.0_45/com/sun/org/apache/xerces/internal/impl/dv/xs/SchemaDateTimeException.java,Java,,10,5,21,36
/jdk1.6.0_45/com/sun/org/apache/xerces/internal/impl/dv/xs/SchemaDVFactoryImpl.java,Java,,244,55,78,377
/jdk1.6.0_45/com/sun/org/apache/xerces/internal/impl/dv/xs/StringDV.java,Java,,12,6,25,43
/jdk1.6.0_45/com/sun/org/apache/xerces/internal/impl/dv/xs/TimeDV.java,Java,,44,15,50,109
/jdk1.6.0_45/com/sun/org/apache/xerces/internal/impl/dv/xs/TypeValidator.java,Java,,35,16,56,107
/jdk1.6.0_45/com/sun/org/apache/xerces/internal/impl/dv/xs/UnionDV.java,Java,,11,6,27,44
/jdk1.6.0_45/com/sun/org/apache/xerces/internal/impl/dv/xs/XSSimpleTypeDecl.java,Java,,2270,341,647,3258
/jdk1.6.0_45/com/sun/org/apache/xerces/internal/impl/dv/xs/YearDV.java,Java,,49,16,49,114
/jdk1.6.0_45/com/sun/org/apache/xerces/internal/impl/dv/xs/YearMonthDurationDV.java,Java,,30,6,24,60
/jdk1.6.0_45/com/sun/org/apache/xerces/internal/impl/dv/xs/YearMonthDV.java,Java,,40,15,42,97
/jdk1.6.0_45/com/sun/org/apache/xerces/internal/impl/dv/XSFacets.java,Java,,46,21,66,133
/jdk1.6.0_45/com/sun/org/apache/xerces/internal/impl/dv/XSSimpleType.java,Java,,39,14,147,200
/jdk1.6.0_45/com/sun/org/apache/xerces/internal/impl/ExternalSubsetResolver.java,Java,,11,7,45,63
/jdk1.6.0_45/com/sun/org/apache/xerces/internal/impl/io/ASCIIReader.java,Java,,78,24,142,244
/jdk1.6.0_45/com/sun/org/apache/xerces/internal/impl/io/MalformedByteSequenceException.java,Java,,38,19,79,136
/jdk1.6.0_45/com/sun/org/apache/xerces/internal/impl/io/UCSReader.java,Java,,131,25,152,308
/jdk1.6.0_45/com/sun/org/apache/xerces/internal/impl/io/UTF8Reader.java,Java,,436,67,200,703
/jdk1.6.0_45/com/sun/org/apache/xerces/internal/impl/msg/XMLMessageFormatter.java,Java,,54,12,51,117
/jdk1.6.0_45/com/sun/org/apache/xerces/internal/impl/PropertyManager.java,Java,,92,25,56,173
/jdk1.6.0_45/com/sun/org/apache/xerces/internal/impl/RevalidationHandler.java,Java,,6,5,70,81
/jdk1.6.0_45/com/sun/org/apache/xerces/internal/impl/validation/EntityState.java,Java,,5,4,37,46
/jdk1.6.0_45/com/sun/org/apache/xerces/internal/impl/validation/ValidationManager.java,Java,,32,13,37,82
/jdk1.6.0_45/com/sun/org/apache/xerces/internal/impl/validation/ValidationState.java,Java,,108,28,55,191
/jdk1.6.0_45/com/sun/org/apache/xerces/internal/impl/Version.java,Java,,11,10,77,98
/jdk1.6.0_45/com/sun/org/apache/xerces/internal/impl/XML11DocumentScannerImpl.java,Java,,345,36,207,588
/jdk1.6.0_45/com/sun/org/apache/xerces/internal/impl/XML11DTDScannerImpl.java,Java,,115,26,163,304
/jdk1.6.0_45/com/sun/org/apache/xerces/internal/impl/XML11EntityScanner.java,Java,,1062,93,369,1524
/jdk1.6.0_45/com/sun/org/apache/xerces/internal/impl/XML11NamespaceBinder.java,Java,,8,10,85,103
/jdk1.6.0_45/com/sun/org/apache/xerces/internal/impl/XML11NSDocumentScannerImpl.java,Java,,530,106,287,923
/jdk1.6.0_45/com/sun/org/apache/xerces/internal/impl/XMLDocumentFragmentScannerImpl.java,Java,aa,1612,437,1216,3265
/jdk1.6.0_45/com/sun/org/apache/xerces/internal/impl/XMLDocumentScannerImpl.java,Java,,781,233,510,1524
/jdk1.6.0_45/com/sun/org/apache/xerces/internal/impl/XMLDTDScannerImpl.java,Java,,1309,205,642,2156
/jdk1.6.0_45/com/sun/org/apache/xerces/internal/impl/XMLEntityDescription.java,Java,,6,6,35,47
/jdk1.6.0_45/com/sun/org/apache/xerces/internal/impl/XMLEntityHandler.java,Java,,11,7,98,116
/jdk1.6.0_45/com/sun/org/apache/xerces/internal/impl/XMLEntityManager.java,Java,,1703,368,993,3064
/jdk1.6.0_45/com/sun/org/apache/xerces/internal/impl/XMLEntityScanner.java,Java,,1349,189,628,2166
/jdk1.6.0_45/com/sun/org/apache/xerces/internal/impl/XMLErrorReporter.java,Java,,196,72,337,605
/jdk1.6.0_45/com/sun/org/apache/xerces/internal/impl/XMLNamespaceBinder.java,Java,,355,108,427,890
/jdk1.6.0_45/com/sun/org/apache/xerces/internal/impl/XMLNSDocumentScannerImpl.java,Java,,345,93,223,661
/jdk1.6.0_45/com/sun/org/apache/xerces/internal/impl/XMLScanner.java,Java,,864,166,435,1465
/jdk1.6.0_45/com/sun/org/apache/xerces/internal/impl/XMLStreamFilterImpl.java,Java,,223,62,255,540
/jdk1.6.0_45/com/sun/org/apache/xerces/internal/impl/XMLStreamReaderImpl.java,Java,,799,141,429,1369
/jdk1.6.0_45/com/sun/org/apache/xerces/internal/impl/XMLVersionDetector.java,Java,,116,34,122,272
/jdk1.6.0_45/com/sun/org/apache/xerces/internal/impl/xpath/regex/BMPattern.java,Java,,170,13,52,235
/jdk1.6.0_45/com/sun/org/apache/xerces/internal/impl/xpath/regex/Match.java,Java,,98,14,71,183
/jdk1.6.0_45/com/sun/org/apache/xerces/internal/impl/xpath/regex/Op.java,Java,,211,11,29,251
/jdk1.6.0_45/com/sun/org/apache/xerces/internal/impl/xpath/regex/ParseException.java,Java,,12,6,34,52
/jdk1.6.0_45/com/sun/org/apache/xerces/internal/impl/xpath/regex/ParserForXMLSchema.java,Java,,409,27,49,485
/jdk1.6.0_45/com/sun/org/apache/xerces/internal/impl/xpath/regex/RangeToken.java,Java,,492,29,99,620
/jdk1.6.0_45/com/sun/org/apache/xerces/internal/impl/xpath/regex/RegexParser.java,Java,,925,70,96,1091
/jdk1.6.0_45/com/sun/org/apache/xerces/internal/impl/xpath/regex/RegularExpression.java,Java,,2127,244,782,3153
/jdk1.6.0_45/com/sun/org/apache/xerces/internal/impl/xpath/regex/REUtil.java,Java,,260,25,47,332
/jdk1.6.0_45/com/sun/org/apache/xerces/internal/impl/xpath/regex/Token.java,Java,,1280,157,113,1550
/jdk1.6.0_45/com/sun/org/apache/xerces/internal/impl/xpath/XPath.java,Java,,1355,157,507,2019
/jdk1.6.0_45/com/sun/org/apache/xerces/internal/impl/xpath/XPathException.java,Java,,17,9,32,58
/jdk1.6.0_45/com/sun/org/apache/xerces/internal/impl/xs/AttributePSVImpl.java,Java,,78,31,110,219
/jdk1.6.0_45/com/sun/org/apache/xerces/internal/impl/xs/ElementPSVImpl.java,Java,,98,39,137,274
/jdk1.6.0_45/com/sun/org/apache/xerces/internal/impl/xs/identity/Field.java,Java,,116,37,91,244
/jdk1.6.0_45/com/sun/org/apache/xerces/internal/impl/xs/identity/FieldActivator.java,Java,,9,10,66,85
/jdk1.6.0_45/com/sun/org/apache/xerces/internal/impl/xs/identity/IdentityConstraint.java,Java,,120,38,89,247
/jdk1.6.0_45/com/sun/org/apache/xerces/internal/impl/xs/identity/KeyRef.java,Java,,18,11,40,69
/jdk1.6.0_45/com/sun/org/apache/xerces/internal/impl/xs/identity/Selector.java,Java,,106,42,104,252
/jdk1.6.0_45/com/sun/org/apache/xerces/internal/impl/xs/identity/UniqueOrKey.java,Java,,9,6,33,48
/jdk1.6.0_45/com/sun/org/apache/xerces/internal/impl/xs/identity/ValueStore.java,Java,,6,9,52,67
/jdk1.6.0_45/com/sun/org/apache/xerces/internal/impl/xs/identity/XPathMatcher.java,Java,,275,59,185,519
/jdk1.6.0_45/com/sun/org/apache/xerces/internal/impl/xs/models/CMBuilder.java,Java,,180,31,111,322
/jdk1.6.0_45/com/sun/org/apache/xerces/internal/impl/xs/models/CMNodeFactory.java,Java,,73,27,54,154
/jdk1.6.0_45/com/sun/org/apache/xerces/internal/impl/xs/models/XSAllCM.java,Java,,98,37,86,221
/jdk1.6.0_45/com/sun/org/apache/xerces/internal/impl/xs/models/XSCMBinOp.java,Java,,60,16,63,139
/jdk1.6.0_45/com/sun/org/apache/xerces/internal/impl/xs/models/XSCMLeaf.java,Java,,54,27,53,134
/jdk1.6.0_45/com/sun/org/apache/xerces/internal/impl/xs/models/XSCMUniOp.java,Java,,36,16,57,109
/jdk1.6.0_45/com/sun/org/apache/xerces/internal/impl/xs/models/XSCMValidator.java,Java,,16,16,75,107
/jdk1.6.0_45/com/sun/org/apache/xerces/internal/impl/xs/models/XSDFACM.java,Java,,450,127,463,1040
/jdk1.6.0_45/com/sun/org/apache/xerces/internal/impl/xs/models/XSEmptyCM.java,Java,,38,24,75,137
/jdk1.6.0_45/com/sun/org/apache/xerces/internal/impl/xs/opti/AttrImpl.java,Java,,40,20,81,141
/jdk1.6.0_45/com/sun/org/apache/xerces/internal/impl/xs/opti/DefaultDocument.java,Java,,115,63,110,288
/jdk1.6.0_45/com/sun/org/apache/xerces/internal/impl/xs/opti/DefaultElement.java,Java,,75,45,28,148
/jdk1.6.0_45/com/sun/org/apache/xerces/internal/impl/xs/opti/DefaultNode.java,Java,,121,66,29,216
/jdk1.6.0_45/com/sun/org/apache/xerces/internal/impl/xs/opti/DefaultText.java,Java,,54,16,165,235
/jdk1.6.0_45/com/sun/org/apache/xerces/internal/impl/xs/opti/DefaultXMLDocumentHandler.java,Java,,174,69,625,868
/jdk1.6.0_45/com/sun/org/apache/xerces/internal/impl/xs/opti/ElementImpl.java,Java,,166,54,32,252
/jdk1.6.0_45/com/sun/org/apache/xerces/internal/impl/xs/opti/NamedNodeMapImpl.java,Java,,48,15,22,85
/jdk1.6.0_45/com/sun/org/apache/xerces/internal/impl/xs/opti/NodeImpl.java,Java,,39,22,23,84
/jdk1.6.0_45/com/sun/org/apache/xerces/internal/impl/xs/opti/SchemaDOM.java,Java,,304,56,89,449
/jdk1.6.0_45/com/sun/org/apache/xerces/internal/impl/xs/opti/SchemaDOMParser.java,Java,,275,69,255,599
/jdk1.6.0_45/com/sun/org/apache/xerces/internal/impl/xs/opti/SchemaParsingConfig.java,Java,,332,119,258,709
/jdk1.6.0_45/com/sun/org/apache/xerces/internal/impl/xs/opti/TextImpl.java,Java,,50,16,61,127
/jdk1.6.0_45/com/sun/org/apache/xerces/internal/impl/xs/SchemaGrammar.java,Java,,710,157,334,1201
/jdk1.6.0_45/com/sun/org/apache/xerces/internal/impl/xs/SchemaNamespaceSupport.java,Java,,50,8,51,109
/jdk1.6.0_45/com/sun/org/apache/xerces/internal/impl/xs/SchemaSymbols.java,Java,,164,14,36,214
/jdk1.6.0_45/com/sun/org/apache/xerces/internal/impl/xs/SubstitutionGroupHandler.java,Java,,174,37,114,325
/jdk1.6.0_45/com/sun/org/apache/xerces/internal/impl/xs/traversers/SchemaContentHandler.java,Java,,255,36,88,379
/jdk1.6.0_45/com/sun/org/apache/xerces/internal/impl/xs/traversers/XSAnnotationInfo.java,Java,,30,9,30,69
/jdk1.6.0_45/com/sun/org/apache/xerces/internal/impl/xs/traversers/XSAttributeChecker.java,Java,,1287,133,473,1893
/jdk1.6.0_45/com/sun/org/apache/xerces/internal/impl/xs/traversers/XSDAbstractIDConstraintTraverser.java,Java,,124,19,40,183
/jdk1.6.0_45/com/sun/org/apache/xerces/internal/impl/xs/traversers/XSDAbstractParticleTraverser.java,Java,,212,45,107,364
/jdk1.6.0_45/com/sun/org/apache/xerces/internal/impl/xs/traversers/XSDAbstractTraverser.java,Java,,638,56,113,807
/jdk1.6.0_45/com/sun/org/apache/xerces/internal/impl/xs/traversers/XSDAttributeGroupTraverser.java,Java,,88,33,47,168
/jdk1.6.0_45/com/sun/org/apache/xerces/internal/impl/xs/traversers/XSDAttributeTraverser.java,Java,,250,59,102,411
/jdk1.6.0_45/com/sun/org/apache/xerces/internal/impl/xs/traversers/XSDComplexTypeTraverser.java,Java,,867,141,211,1219
/jdk1.6.0_45/com/sun/org/apache/xerces/internal/impl/xs/traversers/XSDElementTraverser.java,Java,,304,62,135,501
/jdk1.6.0_45/com/sun/org/apache/xerces/internal/impl/xs/traversers/XSDGroupTraverser.java,Java,,136,28,48,212
/jdk1.6.0_45/com/sun/org/apache/xerces/internal/impl/xs/traversers/XSDHandler.java,Java,,1857,228,623,2708
/jdk1.6.0_45/com/sun/org/apache/xerces/internal/impl/xs/traversers/XSDKeyrefTraverser.java,Java,,53,14,35,102
/jdk1.6.0_45/com/sun/org/apache/xerces/internal/impl/xs/traversers/XSDNotationTraverser.java,Java,,53,13,36,102
/jdk1.6.0_45/com/sun/org/apache/xerces/internal/impl/xs/traversers/XSDocumentInfo.java,Java,,132,39,77,248
/jdk1.6.0_45/com/sun/org/apache/xerces/internal/impl/xs/traversers/XSDSimpleTypeTraverser.java,Java,,339,31,125,495
/jdk1.6.0_45/com/sun/org/apache/xerces/internal/impl/xs/traversers/XSDUniqueOrKeyTraverser.java,Java,,33,13,33,79
/jdk1.6.0_45/com/sun/org/apache/xerces/internal/impl/xs/traversers/XSDWildcardTraverser.java,Java,,84,22,82,188
/jdk1.6.0_45/com/sun/org/apache/xerces/internal/impl/xs/util/NSItemListImpl.java,Java,,28,10,38,76
/jdk1.6.0_45/com/sun/org/apache/xerces/internal/impl/xs/util/ShortListImpl.java,Java,,41,12,44,97
/jdk1.6.0_45/com/sun/org/apache/xerces/internal/impl/xs/util/SimpleLocator.java,Java,,73,24,47,144
/jdk1.6.0_45/com/sun/org/apache/xerces/internal/impl/xs/util/StringListImpl.java,Java,,55,12,49,116
/jdk1.6.0_45/com/sun/org/apache/xerces/internal/impl/xs/util/XInt.java,Java,,19,9,21,49
/jdk1.6.0_45/com/sun/org/apache/xerces/internal/impl/xs/util/XIntPool.java,Java,,15,4,21,40
/jdk1.6.0_45/com/sun/org/apache/xerces/internal/impl/xs/util/XSGrammarPool.java,Java,,24,7,29,60
/jdk1.6.0_45/com/sun/org/apache/xerces/internal/impl/xs/util/XSNamedMap4Types.java,Java,,58,10,70,138
/jdk1.6.0_45/com/sun/org/apache/xerces/internal/impl/xs/util/XSNamedMapImpl.java,Java,,84,12,88,184
/jdk1.6.0_45/com/sun/org/apache/xerces/internal/impl/xs/util/XSObjectListImpl.java,Java,,50,15,49,114
/jdk1.6.0_45/com/sun/org/apache/xerces/internal/impl/xs/XMLSchemaException.java,Java,,16,7,27,50
/jdk1.6.0_45/com/sun/org/apache/xerces/internal/impl/xs/XMLSchemaLoader.java,Java,,891,133,307,1331
/jdk1.6.0_45/com/sun/org/apache/xerces/internal/impl/xs/XMLSchemaValidator.java,Java,,2505,565,1199,4269
/jdk1.6.0_45/com/sun/org/apache/xerces/internal/impl/xs/XSAnnotationImpl.java,Java,,74,17,73,164
/jdk1.6.0_45/com/sun/org/apache/xerces/internal/impl/xs/XSAttributeDecl.java,Java,,89,21,76,186
/jdk1.6.0_45/com/sun/org/apache/xerces/internal/impl/xs/XSAttributeGroupDecl.java,Java,,204,48,108,360
/jdk1.6.0_45/com/sun/org/apache/xerces/internal/impl/xs/XSAttributeUseImpl.java,Java,,61,17,60,138
/jdk1.6.0_45/com/sun/org/apache/xerces/internal/impl/xs/XSComplexTypeDecl.java,Java,,371,97,230,698
/jdk1.6.0_45/com/sun/org/apache/xerces/internal/impl/xs/XSConstraints.java,Java,,967,199,278,1444
/jdk1.6.0_45/com/sun/org/apache/xerces/internal/impl/xs/XSDDescription.java,Java,,103,23,133,259
/jdk1.6.0_45/com/sun/org/apache/xerces/internal/impl/xs/XSDeclarationPool.java,Java,,213,52,43,308
/jdk1.6.0_45/com/sun/org/apache/xerces/internal/impl/xs/XSElementDecl.java,Java,,186,39,141,366
/jdk1.6.0_45/com/sun/org/apache/xerces/internal/impl/xs/XSGrammarBucket.java,Java,,72,15,77,164
/jdk1.6.0_45/com/sun/org/apache/xerces/internal/impl/xs/XSGroupDecl.java,Java,,26,11,50,87
/jdk1.6.0_45/com/sun/org/apache/xerces/internal/impl/xs/XSImplementationImpl.java,Java,,41,17,58,116
/jdk1.6.0_45/com/sun/org/apache/xerces/internal/impl/xs/XSLoaderImpl.java,Java,,181,32,112,325
/jdk1.6.0_45/com/sun/org/apache/xerces/internal/impl/xs/XSMessageFormatter.java,Java,,36,11,44,91
/jdk1.6.0_45/com/sun/org/apache/xerces/internal/impl/xs/XSModelGroupImpl.java,Java,,129,27,75,231
/jdk1.6.0_45/com/sun/org/apache/xerces/internal/impl/xs/XSModelImpl.java,Java,,293,41,146,480
/jdk1.6.0_45/com/sun/org/apache/xerces/internal/impl/xs/XSNotationDecl.java,Java,,33,13,54,100
/jdk1.6.0_45/com/sun/org/apache/xerces/internal/impl/xs/XSParticleDecl.java,Java,,127,25,79,231
/jdk1.6.0_45/com/sun/org/apache/xerces/internal/impl/xs/XSWildcardDecl.java,Java,,306,81,201,588
/jdk1.6.0_45/com/sun/org/apache/xerces/internal/jaxp/datatype/DatatypeFactoryImpl.java,Java,,133,34,481,648
/jdk1.6.0_45/com/sun/org/apache/xerces/internal/jaxp/datatype/DurationDayTimeImpl.java,Java,,69,19,81,169
/jdk1.6.0_45/com/sun/org/apache/xerces/internal/jaxp/datatype/DurationImpl.java,Java,,838,185,994,2017
/jdk1.6.0_45/com/sun/org/apache/xerces/internal/jaxp/datatype/DurationYearMonthImpl.java,Java,,51,19,107,177
/jdk1.6.0_45/com/sun/org/apache/xerces/internal/jaxp/datatype/XMLGregorianCalendarImpl.java,Java,,1342,268,1444,3054
/jdk1.6.0_45/com/sun/org/apache/xerces/internal/jaxp/DefaultValidationErrorHandler.java,Java,,28,6,21,55
/jdk1.6.0_45/com/sun/org/apache/xerces/internal/jaxp/DocumentBuilderFactoryImpl.java,Java,,136,21,55,212
/jdk1.6.0_45/com/sun/org/apache/xerces/internal/jaxp/DocumentBuilderImpl.java,Java,,241,43,72,356
/jdk1.6.0_45/com/sun/org/apache/xerces/internal/jaxp/JAXPConstants.java,Java,,9,4,25,38
/jdk1.6.0_45/com/sun/org/apache/xerces/internal/jaxp/JAXPValidatorComponent.java,Java,,364,85,147,596
/jdk1.6.0_45/com/sun/org/apache/xerces/internal/jaxp/SAXParserFactoryImpl.java,Java,,121,28,54,203
/jdk1.6.0_45/com/sun/org/apache/xerces/internal/jaxp/SAXParserImpl.java,Java,,420,59,133,612
/jdk1.6.0_45/com/sun/org/apache/xerces/internal/jaxp/SchemaValidatorConfiguration.java,Java,,66,20,65,151
/jdk1.6.0_45/com/sun/org/apache/xerces/internal/jaxp/TeeXMLDocumentFilterImpl.java,Java,,106,30,37,173
/jdk1.6.0_45/com/sun/org/apache/xerces/internal/jaxp/UnparsedEntityHandler.java,Java,,177,39,36,252
/jdk1.6.0_45/com/sun/org/apache/xerces/internal/jaxp/validation/AbstractXMLSchema.java,Java,,24,14,46,84
/jdk1.6.0_45/com/sun/org/apache/xerces/internal/jaxp/validation/DOMDocumentHandler.java,Java,,18,12,56,86
/jdk1.6.0_45/com/sun/org/apache/xerces/internal/jaxp/validation/DOMResultAugmentor.java,Java,,183,41,31,255
/jdk1.6.0_45/com/sun/org/apache/xerces/internal/jaxp/validation/DOMResultBuilder.java,Java,,274,49,47,370
/jdk1.6.0_45/com/sun/org/apache/xerces/internal/jaxp/validation/DOMValidatorHelper.java,Java,,413,70,127,610
/jdk1.6.0_45/com/sun/org/apache/xerces/internal/jaxp/validation/DraconianErrorHandler.java,Java,,20,10,29,59
/jdk1.6.0_45/com/sun/org/apache/xerces/internal/jaxp/validation/EmptyXMLSchema.java,Java,,24,16,30,70
/jdk1.6.0_45/com/sun/org/apache/xerces/internal/jaxp/validation/ErrorHandlerAdaptor.java,Java,,35,8,75,118
/jdk1.6.0_45/com/sun/org/apache/xerces/internal/jaxp/validation/JAXPValidationMessageFormatter.java,Java,,51,8,39,98
/jdk1.6.0_45/com/sun/org/apache/xerces/internal/jaxp/validation/ReadOnlyGrammarPool.java,Java,,24,12,26,62
/jdk1.6.0_45/com/sun/org/apache/xerces/internal/jaxp/validation/SimpleXMLSchema.java,Java,,32,17,29,78
/jdk1.6.0_45/com/sun/org/apache/xerces/internal/jaxp/validation/SoftReferenceGrammarPool.java,Java,,221,41,170,432
/jdk1.6.0_45/com/sun/org/apache/xerces/internal/jaxp/validation/StAXValidatorHelper.java,Java,,61,14,33,108
/jdk1.6.0_45/com/sun/org/apache/xerces/internal/jaxp/validation/StreamValidatorHelper.java,Java,,112,29,42,183
/jdk1.6.0_45/com/sun/org/apache/xerces/internal/jaxp/validation/Util.java,Java,,36,9,29,74
/jdk1.6.0_45/com/sun/org/apache/xerces/internal/jaxp/validation/ValidatorHandlerImpl.java,Java,,748,140,169,1057
/jdk1.6.0_45/com/sun/org/apache/xerces/internal/jaxp/validation/ValidatorHelper.java,Java,,9,6,22,37
/jdk1.6.0_45/com/sun/org/apache/xerces/internal/jaxp/validation/ValidatorImpl.java,Java,,189,31,47,267
/jdk1.6.0_45/com/sun/org/apache/xerces/internal/jaxp/validation/WeakReferenceXMLSchema.java,Java,,18,10,31,59
/jdk1.6.0_45/com/sun/org/apache/xerces/internal/jaxp/validation/WrappedSAXException.java,Java,,8,3,72,83
/jdk1.6.0_45/com/sun/org/apache/xerces/internal/jaxp/validation/XMLSchema.java,Java,,14,9,40,63
/jdk1.6.0_45/com/sun/org/apache/xerces/internal/jaxp/validation/XMLSchemaFactory.java,Java,,339,55,78,472
/jdk1.6.0_45/com/sun/org/apache/xerces/internal/jaxp/validation/XMLSchemaValidatorComponentManager.java,Java,,263,70,147,480
/jdk1.6.0_45/com/sun/org/apache/xerces/internal/jaxp/validation/XSGrammarPoolContainer.java,Java,,7,7,41,55
/jdk1.6.0_45/com/sun/org/apache/xerces/internal/parsers/AbstractDOMParser.java,Java,,1535,299,736,2570
/jdk1.6.0_45/com/sun/org/apache/xerces/internal/parsers/AbstractSAXParser.java,Java,,1118,284,1013,2415
/jdk1.6.0_45/com/sun/org/apache/xerces/internal/parsers/AbstractXMLDocumentParser.java,Java,,170,73,566,809
/jdk1.6.0_45/com/sun/org/apache/xerces/internal/parsers/BasicParserConfiguration.java,Java,,208,82,296,586
/jdk1.6.0_45/com/sun/org/apache/xerces/internal/parsers/CachingParserPool.java,Java,,117,56,254,427
/jdk1.6.0_45/com/sun/org/apache/xerces/internal/parsers/DOMParser.java,Java,,325,67,210,602
/jdk1.6.0_45/com/sun/org/apache/xerces/internal/parsers/DOMParserImpl.java,Java,,921,147,232,1300
/jdk1.6.0_45/com/sun/org/apache/xerces/internal/parsers/DTDConfiguration.java,Java,,414,124,310,848
/jdk1.6.0_45/com/sun/org/apache/xerces/internal/parsers/DTDParser.java,Java,,100,40,338,478
/jdk1.6.0_45/com/sun/org/apache/xerces/internal/parsers/IntegratedParserConfiguration.java,Java,,111,32,106,249
/jdk1.6.0_45/com/sun/org/apache/xerces/internal/parsers/NonValidatingConfiguration.java,Java,,370,122,283,775
/jdk1.6.0_45/com/sun/org/apache/xerces/internal/parsers/SAXParser.java,Java,,45,21,53,119
/jdk1.6.0_45/com/sun/org/apache/xerces/internal/parsers/SecurityConfiguration.java,Java,,27,13,71,111
/jdk1.6.0_45/com/sun/org/apache/xerces/internal/parsers/StandardParserConfiguration.java,Java,,134,59,168,361
/jdk1.6.0_45/com/sun/org/apache/xerces/internal/parsers/XIncludeAwareParserConfiguration.java,Java,,176,34,82,292
/jdk1.6.0_45/com/sun/org/apache/xerces/internal/parsers/XIncludeParserConfiguration.java,Java,,119,31,67,217
/jdk1.6.0_45/com/sun/org/apache/xerces/internal/parsers/XML11Configurable.java,Java,,2,3,23,28
/jdk1.6.0_45/com/sun/org/apache/xerces/internal/parsers/XML11Configuration.java,Java,,801,217,493,1511
/jdk1.6.0_45/com/sun/org/apache/xerces/internal/parsers/XML11DTDConfiguration.java,Java,,675,190,472,1337
/jdk1.6.0_45/com/sun/org/apache/xerces/internal/parsers/XML11NonValidatingConfiguration.java,Java,,611,185,436,1232
/jdk1.6.0_45/com/sun/org/apache/xerces/internal/parsers/XMLDocumentParser.java,Java,,24,9,42,75
/jdk1.6.0_45/com/sun/org/apache/xerces/internal/parsers/XMLGrammarCachingConfiguration.java,Java,,119,46,183,348
/jdk1.6.0_45/com/sun/org/apache/xerces/internal/parsers/XMLGrammarParser.java,Java,,12,8,30,50
/jdk1.6.0_45/com/sun/org/apache/xerces/internal/parsers/XMLGrammarPreparser.java,Java,,155,38,144,337
/jdk1.6.0_45/com/sun/org/apache/xerces/internal/parsers/XMLParser.java,Java,,34,26,73,133
/jdk1.6.0_45/com/sun/org/apache/xerces/internal/parsers/XPointerParserConfiguration.java,Java,,127,43,69,239
/jdk1.6.0_45/com/sun/org/apache/xerces/internal/util/AttributesProxy.java,Java,,110,33,46,189
/jdk1.6.0_45/com/sun/org/apache/xerces/internal/util/AugmentationsImpl.java,Java,,175,56,55,286
/jdk1.6.0_45/com/sun/org/apache/xerces/internal/util/DatatypeMessageFormatter.java,Java,,52,9,39,100
/jdk1.6.0_45/com/sun/org/apache/xerces/internal/util/DefaultErrorHandler.java,Java,,48,18,47,113
/jdk1.6.0_45/com/sun/org/apache/xerces/internal/util/DOMEntityResolverWrapper.java,Java,,79,25,63,167
/jdk1.6.0_45/com/sun/org/apache/xerces/internal/util/DOMErrorHandlerWrapper.java,Java,,254,49,114,417
/jdk1.6.0_45/com/sun/org/apache/xerces/internal/util/DOMInputSource.java,Java,,37,11,25,73
/jdk1.6.0_45/com/sun/org/apache/xerces/internal/util/DOMUtil.java,Java,,520,139,172,831
/jdk1.6.0_45/com/sun/org/apache/xerces/internal/util/DraconianErrorHandler.java,Java,,17,4,65,86
/jdk1.6.0_45/com/sun/org/apache/xerces/internal/util/EncodingMap.java,Java,,447,39,541,1027
/jdk1.6.0_45/com/sun/org/apache/xerces/internal/util/EntityResolver2Wrapper.java,Java,,91,32,89,212
/jdk1.6.0_45/com/sun/org/apache/xerces/internal/util/EntityResolverWrapper.java,Java,,59,20,59,138
/jdk1.6.0_45/com/sun/org/apache/xerces/internal/util/ErrorHandlerProxy.java,Java,,35,7,35,77
/jdk1.6.0_45/com/sun/org/apache/xerces/internal/util/ErrorHandlerWrapper.java,Java,,96,28,105,229
/jdk1.6.0_45/com/sun/org/apache/xerces/internal/util/HTTPInputSource.java,Java,,46,20,126,192
/jdk1.6.0_45/com/sun/org/apache/xerces/internal/util/IntStack.java,Java,,52,17,44,113
/jdk1.6.0_45/com/sun/org/apache/xerces/internal/util/LocatorProxy.java,Java,,28,16,41,85
/jdk1.6.0_45/com/sun/org/apache/xerces/internal/util/LocatorWrapper.java,Java,,20,8,78,106
/jdk1.6.0_45/com/sun/org/apache/xerces/internal/util/MessageFormatter.java,Java,,7,6,44,57
/jdk1.6.0_45/com/sun/org/apache/xerces/internal/util/NamespaceContextWrapper.java,Java,,35,11,46,92
/jdk1.6.0_45/com/sun/org/apache/xerces/internal/util/NamespaceSupport.java,Java,,216,71,194,481
/jdk1.6.0_45/com/sun/org/apache/xerces/internal/util/ParserConfigurationSettings.java,Java,,95,50,142,287
/jdk1.6.0_45/com/sun/org/apache/xerces/internal/util/SAX2XNI.java,Java,,138,33,81,252
/jdk1.6.0_45/com/sun/org/apache/xerces/internal/util/SAXInputSource.java,Java,,88,18,55,161
/jdk1.6.0_45/com/sun/org/apache/xerces/internal/util/SAXLocatorWrapper.java,Java,,63,19,26,108
/jdk1.6.0_45/com/sun/org/apache/xerces/internal/util/SAXMessageFormatter.java,Java,,51,7,40,98
/jdk1.6.0_45/com/sun/org/apache/xerces/internal/util/SecurityManager.java,Java,,75,23,125,223
/jdk1.6.0_45/com/sun/org/apache/xerces/internal/util/ShadowedSymbolTable.java,Java,,26,18,74,118
/jdk1.6.0_45/com/sun/org/apache/xerces/internal/util/SymbolHash.java,Java,,90,27,90,207
/jdk1.6.0_45/com/sun/org/apache/xerces/internal/util/SymbolTable.java,Java,,114,46,184,344
/jdk1.6.0_45/com/sun/org/apache/xerces/internal/util/SynchronizedSymbolTable.java,Java,,34,23,69,126
/jdk1.6.0_45/com/sun/org/apache/xerces/internal/util/TeeXMLDocumentFilterImpl.java,Java,,106,29,78,213
/jdk1.6.0_45/com/sun/org/apache/xerces/internal/util/TypeInfoImpl.java,Java,,42,11,77,130
/jdk1.6.0_45/com/sun/org/apache/xerces/internal/util/URI.java,Java,,1162,208,817,2187
/jdk1.6.0_45/com/sun/org/apache/xerces/internal/util/XML11Char.java,Java,,208,37,165,410
/jdk1.6.0_45/com/sun/org/apache/xerces/internal/util/XMLAttributesImpl.java,Java,,472,110,606,1188
/jdk1.6.0_45/com/sun/org/apache/xerces/internal/util/XMLAttributesIteratorImpl.java,Java,,33,15,56,104
/jdk1.6.0_45/com/sun/org/apache/xerces/internal/util/XMLCatalogResolver.java,Java,,228,59,296,583
/jdk1.6.0_45/com/sun/org/apache/xerces/internal/util/XMLChar.java,Java,,760,49,213,1022
/jdk1.6.0_45/com/sun/org/apache/xerces/internal/util/XMLDocumentFilterImpl.java,Java,,83,28,67,178
/jdk1.6.0_45/com/sun/org/apache/xerces/internal/util/XMLEntityDescriptionImpl.java,Java,,69,19,90,178
/jdk1.6.0_45/com/sun/org/apache/xerces/internal/util/XMLErrorCode.java,Java,,22,9,50,81
/jdk1.6.0_45/com/sun/org/apache/xerces/internal/util/XMLGrammarPoolImpl.java,Java,,157,32,174,363
/jdk1.6.0_45/com/sun/org/apache/xerces/internal/util/XMLInputSourceAdaptor.java,Java,,22,6,75,103
/jdk1.6.0_45/com/sun/org/apache/xerces/internal/util/XMLResourceIdentifierImpl.java,Java,,116,32,79,227
/jdk1.6.0_45/com/sun/org/apache/xerces/internal/util/XMLStringBuffer.java,Java,,77,23,127,227
/jdk1.6.0_45/com/sun/org/apache/xerces/internal/util/XMLSymbols.java,Java,,21,25,54,100
/jdk1.6.0_45/com/sun/org/apache/xerces/internal/utils/ConfigurationError.java,Java,,12,9,71,92
/jdk1.6.0_45/com/sun/org/apache/xerces/internal/utils/ObjectFactory.java,Java,,209,44,217,470
/jdk1.6.0_45/com/sun/org/apache/xerces/internal/utils/SecuritySupport.java,Java,,136,18,79,233
/jdk1.6.0_45/com/sun/org/apache/xerces/internal/xinclude/MultipleScopeNamespaceSupport.java,Java,,109,21,63,193
/jdk1.6.0_45/com/sun/org/apache/xerces/internal/xinclude/XInclude11TextReader.java,Java,,14,5,40,59
/jdk1.6.0_45/com/sun/org/apache/xerces/internal/xinclude/XIncludeHandler.java,Java,,1996,289,734,3019
/jdk1.6.0_45/com/sun/org/apache/xerces/internal/xinclude/XIncludeMessageFormatter.java,Java,,36,10,40,86
/jdk1.6.0_45/com/sun/org/apache/xerces/internal/xinclude/XIncludeNamespaceSupport.java,Java,,30,9,53,92
/jdk1.6.0_45/com/sun/org/apache/xerces/internal/xinclude/XIncludeTextReader.java,Java,,301,44,168,513
/jdk1.6.0_45/com/sun/org/apache/xerces/internal/xinclude/XPointerElementHandler.java,Java,,455,123,181,759
/jdk1.6.0_45/com/sun/org/apache/xerces/internal/xinclude/XPointerFramework.java,Java,,122,23,60,205
/jdk1.6.0_45/com/sun/org/apache/xerces/internal/xinclude/XPointerSchema.java,Java,,13,12,20,45
/jdk1.6.0_45/com/sun/org/apache/xerces/internal/xni/Augmentations.java,Java,,9,15,62,86
/jdk1.6.0_45/com/sun/org/apache/xerces/internal/xni/grammars/Grammar.java,Java,,4,5,44,53
/jdk1.6.0_45/com/sun/org/apache/xerces/internal/xni/grammars/XMLDTDDescription.java,Java,,4,4,26,34
/jdk1.6.0_45/com/sun/org/apache/xerces/internal/xni/grammars/XMLGrammarDescription.java,Java,,7,8,41,56
/jdk1.6.0_45/com/sun/org/apache/xerces/internal/xni/grammars/XMLGrammarLoader.java,Java,,28,19,98,145
/jdk1.6.0_45/com/sun/org/apache/xerces/internal/xni/grammars/XMLGrammarPool.java,Java,,9,10,84,103
/jdk1.6.0_45/com/sun/org/apache/xerces/internal/xni/grammars/XMLSchemaDescription.java,Java,,19,11,105,135
/jdk1.6.0_45/com/sun/org/apache/xerces/internal/xni/grammars/XSGrammar.java,Java,,6,6,40,52
/jdk1.6.0_45/com/sun/org/apache/xerces/internal/xni/NamespaceContext.java,Java,,16,20,140,176
/jdk1.6.0_45/com/sun/org/apache/xerces/internal/xni/parser/XMLComponent.java,Java,,13,11,99,123
/jdk1.6.0_45/com/sun/org/apache/xerces/internal/xni/parser/XMLComponentManager.java,Java,,7,6,47,60
/jdk1.6.0_45/com/sun/org/apache/xerces/internal/xni/parser/XMLConfigurationException.java,Java,,27,17,69,113
/jdk1.6.0_45/com/sun/org/apache/xerces/internal/xni/parser/XMLDocumentFilter.java,Java,,5,5,23,33
/jdk1.6.0_45/com/sun/org/apache/xerces/internal/xni/parser/XMLDocumentScanner.java,Java,,10,7,55,72
/jdk1.6.0_45/com/sun/org/apache/xerces/internal/xni/parser/XMLDocumentSource.java,Java,,6,7,33,46
/jdk1.6.0_45/com/sun/org/apache/xerces/internal/xni/parser/XMLDTDContentModelFilter.java,Java,,5,4,23,32
/jdk1.6.0_45/com/sun/org/apache/xerces/internal/xni/parser/XMLDTDContentModelSource.java,Java,,6,7,74,87
/jdk1.6.0_45/com/sun/org/apache/xerces/internal/xni/parser/XMLDTDFilter.java,Java,,5,4,23,32
/jdk1.6.0_45/com/sun/org/apache/xerces/internal/xni/parser/XMLDTDScanner.java,Java,,12,8,75,95
/jdk1.6.0_45/com/sun/org/apache/xerces/internal/xni/parser/XMLDTDSource.java,Java,,6,7,33,46
/jdk1.6.0_45/com/sun/org/apache/xerces/internal/xni/parser/XMLEntityResolver.java,Java,,8,7,43,58
/jdk1.6.0_45/com/sun/org/apache/xerces/internal/xni/parser/XMLErrorHandler.java,Java,,10,8,85,103
/jdk1.6.0_45/com/sun/org/apache/xerces/internal/xni/parser/XMLInputSource.java,Java,,77,31,143,251
/jdk1.6.0_45/com/sun/org/apache/xerces/internal/xni/parser/XMLParseException.java,Java,,96,28,54,178
/jdk1.6.0_45/com/sun/org/apache/xerces/internal/xni/parser/XMLParserConfiguration.java,Java,,34,29,187,250
/jdk1.6.0_45/com/sun/org/apache/xerces/internal/xni/parser/XMLPullParserConfiguration.java,Java,,10,10,74,94
/jdk1.6.0_45/com/sun/org/apache/xerces/internal/xni/QName.java,Java,,87,24,120,231
/jdk1.6.0_45/com/sun/org/apache/xerces/internal/xni/XMLAttributes.java,Java,,33,40,363,436
/jdk1.6.0_45/com/sun/org/apache/xerces/internal/xni/XMLDocumentFragmentHandler.java,Java,,35,18,203,256
/jdk1.6.0_45/com/sun/org/apache/xerces/internal/xni/XMLDocumentHandler.java,Java,,33,25,235,293
/jdk1.6.0_45/com/sun/org/apache/xerces/internal/xni/XMLDTDContentModelHandler.java,Java,,25,25,220,270
/jdk1.6.0_45/com/sun/org/apache/xerces/internal/xni/XMLDTDHandler.java,Java,,59,30,286,375
/jdk1.6.0_45/com/sun/org/apache/xerces/internal/xni/XMLLocator.java,Java,,12,14,50,76
/jdk1.6.0_45/com/sun/org/apache/xerces/internal/xni/XMLResourceIdentifier.java,Java,,13,14,34,61
/jdk1.6.0_45/com/sun/org/apache/xerces/internal/xni/XMLString.java,Java,,58,22,108,188
/jdk1.6.0_45/com/sun/org/apache/xerces/internal/xni/XNIException.java,Java,,20,12,57,89
/jdk1.6.0_45/com/sun/org/apache/xerces/internal/xpointer/ElementSchemePointer.java,Java,,430,131,314,875
/jdk1.6.0_45/com/sun/org/apache/xerces/internal/xpointer/ShortHandPointer.java,Java,,121,38,134,293
/jdk1.6.0_45/com/sun/org/apache/xerces/internal/xpointer/XPointerErrorHandler.java,Java,,47,17,48,112
/jdk1.6.0_45/com/sun/org/apache/xerces/internal/xpointer/XPointerHandler.java,Java,,656,152,437,1245
/jdk1.6.0_45/com/sun/org/apache/xerces/internal/xpointer/XPointerMessageFormatter.java,Java,,40,10,43,93
/jdk1.6.0_45/com/sun/org/apache/xerces/internal/xpointer/XPointerPart.java,Java,,19,14,96,129
/jdk1.6.0_45/com/sun/org/apache/xerces/internal/xpointer/XPointerProcessor.java,Java,,15,11,75,101
/jdk1.6.0_45/com/sun/org/apache/xerces/internal/xs/AttributePSVI.java,Java,,4,3,22,29
/jdk1.6.0_45/com/sun/org/apache/xerces/internal/xs/datatypes/ByteList.java,Java,,7,6,45,58
/jdk1.6.0_45/com/sun/org/apache/xerces/internal/xs/datatypes/ObjectList.java,Java,,6,5,45,56
/jdk1.6.0_45/com/sun/org/apache/xerces/internal/xs/datatypes/XSDateTime.java,Java,,19,16,255,290
/jdk1.6.0_45/com/sun/org/apache/xerces/internal/xs/datatypes/XSDecimal.java,Java,,11,8,45,64
/jdk1.6.0_45/com/sun/org/apache/xerces/internal/xs/datatypes/XSDouble.java,Java,,4,3,25,32
/jdk1.6.0_45/com/sun/org/apache/xerces/internal/xs/datatypes/XSFloat.java,Java,,4,3,25,32
/jdk1.6.0_45/com/sun/org/apache/xerces/internal/xs/datatypes/XSQName.java,Java,,5,4,26,35
/jdk1.6.0_45/com/sun/org/apache/xerces/internal/xs/ElementPSVI.java,Java,,7,6,33,46
/jdk1.6.0_45/com/sun/org/apache/xerces/internal/xs/ItemPSVI.java,Java,,24,14,147,185
/jdk1.6.0_45/com/sun/org/apache/xerces/internal/xs/LSInputList.java,Java,,6,5,33,44
/jdk1.6.0_45/com/sun/org/apache/xerces/internal/xs/PSVIProvider.java,Java,,7,5,77,89
/jdk1.6.0_45/com/sun/org/apache/xerces/internal/xs/ShortList.java,Java,,7,5,41,53
/jdk1.6.0_45/com/sun/org/apache/xerces/internal/xs/StringList.java,Java,,6,5,40,51
/jdk1.6.0_45/com/sun/org/apache/xerces/internal/xs/XSAnnotation.java,Java,,9,5,45,59
/jdk1.6.0_45/com/sun/org/apache/xerces/internal/xs/XSAttributeDeclaration.java,Java,,15,11,76,102
/jdk1.6.0_45/com/sun/org/apache/xerces/internal/xs/XSAttributeGroupDefinition.java,Java,,6,5,28,39
/jdk1.6.0_45/com/sun/org/apache/xerces/internal/xs/XSAttributeUse.java,Java,,13,9,69,91
/jdk1.6.0_45/com/sun/org/apache/xerces/internal/xs/XSComplexTypeDefinition.java,Java,,17,13,83,113
/jdk1.6.0_45/com/sun/org/apache/xerces/internal/xs/XSConstants.java,Java,,84,7,250,341
/jdk1.6.0_45/com/sun/org/apache/xerces/internal/xs/XSElementDeclaration.java,Java,,23,19,129,171
/jdk1.6.0_45/com/sun/org/apache/xerces/internal/xs/XSException.java,Java,,11,5,36,52
/jdk1.6.0_45/com/sun/org/apache/xerces/internal/xs/XSFacet.java,Java,,7,6,32,45
/jdk1.6.0_45/com/sun/org/apache/xerces/internal/xs/XSIDCDefinition.java,Java,,11,8,50,69
/jdk1.6.0_45/com/sun/org/apache/xerces/internal/xs/XSImplementation.java,Java,,6,5,36,47
/jdk1.6.0_45/com/sun/org/apache/xerces/internal/xs/XSLoader.java,Java,,10,8,71,89
/jdk1.6.0_45/com/sun/org/apache/xerces/internal/xs/XSModel.java,Java,,21,13,110,144
/jdk1.6.0_45/com/sun/org/apache/xerces/internal/xs/XSModelGroup.java,Java,,9,6,42,57
/jdk1.6.0_45/com/sun/org/apache/xerces/internal/xs/XSModelGroupDefinition.java,Java,,5,4,24,33
/jdk1.6.0_45/com/sun/org/apache/xerces/internal/xs/XSMultiValueFacet.java,Java,,6,5,29,40
/jdk1.6.0_45/com/sun/org/apache/xerces/internal/xs/XSNamedMap.java,Java,,7,5,51,63
/jdk1.6.0_45/com/sun/org/apache/xerces/internal/xs/XSNamespaceItem.java,Java,,13,12,81,106
/jdk1.6.0_45/com/sun/org/apache/xerces/internal/xs/XSNamespaceItemList.java,Java,,5,4,33,42
/jdk1.6.0_45/com/sun/org/apache/xerces/internal/xs/XSNotationDeclaration.java,Java,,6,5,29,40
/jdk1.6.0_45/com/sun/org/apache/xerces/internal/xs/XSObject.java,Java,,7,6,41,54
/jdk1.6.0_45/com/sun/org/apache/xerces/internal/xs/XSObjectList.java,Java,,5,4,33,42
/jdk1.6.0_45/com/sun/org/apache/xerces/internal/xs/XSParticle.java,Java,,7,6,34,47
/jdk1.6.0_45/com/sun/org/apache/xerces/internal/xs/XSSimpleTypeDefinition.java,Java,,42,23,174,239
/jdk1.6.0_45/com/sun/org/apache/xerces/internal/xs/XSTerm.java,Java,,3,2,21,26
/jdk1.6.0_45/com/sun/org/apache/xerces/internal/xs/XSTypeDefinition.java,Java,,15,9,77,101
/jdk1.6.0_45/com/sun/org/apache/xerces/internal/xs/XSWildcard.java,Java,,13,8,60,81
/jdk1.6.0_45/com/sun/org/apache/xml/internal/dtm/Axis.java,Java,,74,29,115,218
/jdk1.6.0_45/com/sun/org/apache/xml/internal/dtm/DTM.java,Java,,95,95,775,965
/jdk1.6.0_45/com/sun/org/apache/xml/internal/dtm/DTMAxisIterator.java,Java,,17,15,76,108
/jdk1.6.0_45/com/sun/org/apache/xml/internal/dtm/DTMAxisTraverser.java,Java,,14,5,95,114
/jdk1.6.0_45/com/sun/org/apache/xml/internal/dtm/DTMConfigurationException.java,Java,,26,8,63,97
/jdk1.6.0_45/com/sun/org/apache/xml/internal/dtm/DTMDOMException.java,Java,,13,2,37,52
/jdk1.6.0_45/com/sun/org/apache/xml/internal/dtm/DTMException.java,Java,,175,64,142,381
/jdk1.6.0_45/com/sun/org/apache/xml/internal/dtm/DTMFilter.java,Java,,21,20,145,186
/jdk1.6.0_45/com/sun/org/apache/xml/internal/dtm/DTMIterator.java,Java,,32,33,277,342
/jdk1.6.0_45/com/sun/org/apache/xml/internal/dtm/DTMManager.java,Java,,127,52,317,496
/jdk1.6.0_45/com/sun/org/apache/xml/internal/dtm/DTMWSFilter.java,Java,,8,5,41,54
/jdk1.6.0_45/com/sun/org/apache/xml/internal/dtm/ref/ChunkedIntArray.java,Java,,146,22,136,304
/jdk1.6.0_45/com/sun/org/apache/xml/internal/dtm/ref/CoroutineManager.java,Java,,91,23,228,342
/jdk1.6.0_45/com/sun/org/apache/xml/internal/dtm/ref/CoroutineParser.java,Java,,14,13,111,138
/jdk1.6.0_45/com/sun/org/apache/xml/internal/dtm/ref/CustomStringPool.java,Java,,32,6,48,86
/jdk1.6.0_45/com/sun/org/apache/xml/internal/dtm/ref/dom2dtm/DOM2DTM.java,Java,,904,192,667,1763
/jdk1.6.0_45/com/sun/org/apache/xml/internal/dtm/ref/dom2dtm/DOM2DTMdefaultNamespaceDeclarationNode.java,Java,,219,43,415,677
/jdk1.6.0_45/com/sun/org/apache/xml/internal/dtm/ref/DTMAxisIteratorBase.java,Java,,101,40,138,279
/jdk1.6.0_45/com/sun/org/apache/xml/internal/dtm/ref/DTMAxisIterNodeList.java,Java,,57,10,73,140
/jdk1.6.0_45/com/sun/org/apache/xml/internal/dtm/ref/DTMChildIterNodeList.java,Java,,32,8,77,117
/jdk1.6.0_45/com/sun/org/apache/xml/internal/dtm/ref/DTMDefaultBase.java,Java,,1028,291,1050,2369
/jdk1.6.0_45/com/sun/org/apache/xml/internal/dtm/ref/DTMDefaultBaseIterators.java,Java,,1140,326,724,2190
/jdk1.6.0_45/com/sun/org/apache/xml/internal/dtm/ref/DTMDefaultBaseTraversers.java,Java,,744,212,787,1743
/jdk1.6.0_45/com/sun/org/apache/xml/internal/dtm/ref/DTMDocumentImpl.java,Java,,728,238,1443,2409
/jdk1.6.0_45/com/sun/org/apache/xml/internal/dtm/ref/DTMManagerDefault.java,Java,,388,104,365,857
/jdk1.6.0_45/com/sun/org/apache/xml/internal/dtm/ref/DTMNamedNodeMap.java,Java,,101,26,171,298
/jdk1.6.0_45/com/sun/org/apache/xml/internal/dtm/ref/DTMNodeIterator.java,Java,,66,20,98,184
/jdk1.6.0_45/com/sun/org/apache/xml/internal/dtm/ref/DTMNodeList.java,Java,,40,8,77,125
/jdk1.6.0_45/com/sun/org/apache/xml/internal/dtm/ref/DTMNodeListBase.java,Java,,12,4,63,79
/jdk1.6.0_45/com/sun/org/apache/xml/internal/dtm/ref/DTMNodeProxy.java,Java,,834,204,1275,2313
/jdk1.6.0_45/com/sun/org/apache/xml/internal/dtm/ref/DTMSafeStringPool.java,Java,,60,14,34,108
/jdk1.6.0_45/com/sun/org/apache/xml/internal/dtm/ref/DTMStringPool.java,Java,,100,25,64,189
/jdk1.6.0_45/com/sun/org/apache/xml/internal/dtm/ref/DTMTreeWalker.java,Java,,237,56,109,402
/jdk1.6.0_45/com/sun/org/apache/xml/internal/dtm/ref/EmptyIterator.java,Java,,21,18,21,60
/jdk1.6.0_45/com/sun/org/apache/xml/internal/dtm/ref/ExpandedNameTable.java,Java,,168,50,171,389
/jdk1.6.0_45/com/sun/org/apache/xml/internal/dtm/ref/ExtendedType.java,Java,,65,11,67,143
/jdk1.6.0_45/com/sun/org/apache/xml/internal/dtm/ref/IncrementalSAXSource.java,Java,,12,11,64,87
/jdk1.6.0_45/com/sun/org/apache/xml/internal/dtm/ref/IncrementalSAXSource_Filter.java,Java,,428,63,318,809
/jdk1.6.0_45/com/sun/org/apache/xml/internal/dtm/ref/IncrementalSAXSource_Xerces.java,Java,,263,46,144,453
/jdk1.6.0_45/com/sun/org/apache/xml/internal/dtm/ref/NodeLocator.java,Java,,39,9,60,108
/jdk1.6.0_45/com/sun/org/apache/xml/internal/dtm/ref/sax2dtm/SAX2DTM.java,Java,,1110,358,1051,2519
/jdk1.6.0_45/com/sun/org/apache/xml/internal/dtm/ref/sax2dtm/SAX2DTM2.java,Java,,1937,494,950,3381
/jdk1.6.0_45/com/sun/org/apache/xml/internal/dtm/ref/sax2dtm/SAX2RTFDTM.java,Java,,135,41,184,360
/jdk1.6.0_45/com/sun/org/apache/xml/internal/res/XMLErrorResources.java,Java,,249,95,113,457
/jdk1.6.0_45/com/sun/org/apache/xml/internal/res/XMLErrorResources_ca.java,Java,,238,91,109,438
/jdk1.6.0_45/com/sun/org/apache/xml/internal/res/XMLErrorResources_cs.java,Java,,238,91,109,438
/jdk1.6.0_45/com/sun/org/apache/xml/internal/res/XMLErrorResources_de.java,Java,,238,91,109,438
/jdk1.6.0_45/com/sun/org/apache/xml/internal/res/XMLErrorResources_en.java,Java,,4,2,23,29
/jdk1.6.0_45/com/sun/org/apache/xml/internal/res/XMLErrorResources_es.java,Java,,238,91,109,438
/jdk1.6.0_45/com/sun/org/apache/xml/internal/res/XMLErrorResources_fr.java,Java,,238,91,109,438
/jdk1.6.0_45/com/sun/org/apache/xml/internal/res/XMLErrorResources_it.java,Java,,238,91,109,438
/jdk1.6.0_45/com/sun/org/apache/xml/internal/res/XMLErrorResources_ja.java,Java,,238,91,109,438
/jdk1.6.0_45/com/sun/org/apache/xml/internal/res/XMLErrorResources_ko.java,Java,,238,91,109,438
/jdk1.6.0_45/com/sun/org/apache/xml/internal/res/XMLErrorResources_pt_BR.java,Java,,249,95,113,457
/jdk1.6.0_45/com/sun/org/apache/xml/internal/res/XMLErrorResources_sk.java,Java,,238,91,109,438
/jdk1.6.0_45/com/sun/org/apache/xml/internal/res/XMLErrorResources_sv.java,Java,,202,256,166,624
/jdk1.6.0_45/com/sun/org/apache/xml/internal/res/XMLErrorResources_tr.java,Java,,238,91,109,438
/jdk1.6.0_45/com/sun/org/apache/xml/internal/res/XMLErrorResources_zh_CN.java,Java,,238,91,109,438
/jdk1.6.0_45/com/sun/org/apache/xml/internal/res/XMLErrorResources_zh_HK.java,Java,,4,3,66,73
/jdk1.6.0_45/com/sun/org/apache/xml/internal/res/XMLErrorResources_zh_TW.java,Java,,238,91,109,438
/jdk1.6.0_45/com/sun/org/apache/xml/internal/res/XMLMessages.java,Java,,72,22,61,155
/jdk1.6.0_45/com/sun/org/apache/xml/internal/resolver/Catalog.java,Java,,1119,289,804,2212
/jdk1.6.0_45/com/sun/org/apache/xml/internal/resolver/CatalogEntry.java,Java,,87,27,135,249
/jdk1.6.0_45/com/sun/org/apache/xml/internal/resolver/CatalogException.java,Java,,58,13,94,165
/jdk1.6.0_45/com/sun/org/apache/xml/internal/resolver/CatalogManager.java,Java,,388,111,346,845
/jdk1.6.0_45/com/sun/org/apache/xml/internal/resolver/helpers/BootstrapResolver.java,Java,,111,29,60,200
/jdk1.6.0_45/com/sun/org/apache/xml/internal/resolver/helpers/Debug.java,Java,,29,9,70,108
/jdk1.6.0_45/com/sun/org/apache/xml/internal/resolver/helpers/FileURL.java,Java,,11,5,73,89
/jdk1.6.0_45/com/sun/org/apache/xml/internal/resolver/helpers/Namespaces.java,Java,,39,13,59,111
/jdk1.6.0_45/com/sun/org/apache/xml/internal/resolver/helpers/PublicId.java,Java,,63,20,75,158
/jdk1.6.0_45/com/sun/org/apache/xml/internal/resolver/readers/CatalogReader.java,Java,,12,6,60,78
/jdk1.6.0_45/com/sun/org/apache/xml/internal/resolver/readers/DOMCatalogParser.java,Java,,6,4,40,50
/jdk1.6.0_45/com/sun/org/apache/xml/internal/resolver/readers/DOMCatalogReader.java,Java,,99,23,121,243
/jdk1.6.0_45/com/sun/org/apache/xml/internal/resolver/readers/ExtendedXMLCatalogReader.java,Java,,108,27,49,184
/jdk1.6.0_45/com/sun/org/apache/xml/internal/resolver/readers/OASISXMLCatalogReader.java,Java,,389,78,71,538
/jdk1.6.0_45/com/sun/org/apache/xml/internal/resolver/readers/SAXCatalogParser.java,Java,,6,4,32,42
/jdk1.6.0_45/com/sun/org/apache/xml/internal/resolver/readers/SAXCatalogReader.java,Java,,315,59,129,503
/jdk1.6.0_45/com/sun/org/apache/xml/internal/resolver/readers/SAXParserHandler.java,Java,,96,21,30,147
/jdk1.6.0_45/com/sun/org/apache/xml/internal/resolver/readers/TextCatalogReader.java,Java,,179,36,85,300
/jdk1.6.0_45/com/sun/org/apache/xml/internal/resolver/readers/TR9401CatalogReader.java,Java,,70,17,53,140
/jdk1.6.0_45/com/sun/org/apache/xml/internal/resolver/readers/XCatalogReader.java,Java,,102,26,57,185
/jdk1.6.0_45/com/sun/org/apache/xml/internal/resolver/Resolver.java,Java,,355,70,269,694
/jdk1.6.0_45/com/sun/org/apache/xml/internal/resolver/tools/CatalogResolver.java,Java,,172,37,130,339
/jdk1.6.0_45/com/sun/org/apache/xml/internal/resolver/tools/ResolvingParser.java,Java,,263,58,122,443
/jdk1.6.0_45/com/sun/org/apache/xml/internal/resolver/tools/ResolvingXMLFilter.java,Java,,188,43,119,350
/jdk1.6.0_45/com/sun/org/apache/xml/internal/resolver/tools/ResolvingXMLReader.java,Java,,35,10,49,94
/jdk1.6.0_45/com/sun/org/apache/xml/internal/security/algorithms/Algorithm.java,Java,,27,13,43,83
/jdk1.6.0_45/com/sun/org/apache/xml/internal/security/algorithms/implementations/IntegrityHmac.java,Java,,266,86,237,589
/jdk1.6.0_45/com/sun/org/apache/xml/internal/security/algorithms/implementations/SignatureBaseRSA.java,Java,,195,60,113,368
/jdk1.6.0_45/com/sun/org/apache/xml/internal/security/algorithms/implementations/SignatureDSA.java,Java,,199,70,107,376
/jdk1.6.0_45/com/sun/org/apache/xml/internal/security/algorithms/JCEMapper.java,Java,,62,28,71,161
/jdk1.6.0_45/com/sun/org/apache/xml/internal/security/algorithms/MessageDigestAlgorithm.java,Java,,93,32,127,252
/jdk1.6.0_45/com/sun/org/apache/xml/internal/security/algorithms/SignatureAlgorithm.java,Java,,178,58,168,404
/jdk1.6.0_45/com/sun/org/apache/xml/internal/security/algorithms/SignatureAlgorithmSpi.java,Java,,44,25,129,198
/jdk1.6.0_45/com/sun/org/apache/xml/internal/security/c14n/CanonicalizationException.java,Java,,21,12,52,85
/jdk1.6.0_45/com/sun/org/apache/xml/internal/security/c14n/Canonicalizer.java,Java,,125,48,177,350
/jdk1.6.0_45/com/sun/org/apache/xml/internal/security/c14n/CanonicalizerSpi.java,Java,,50,25,120,195
/jdk1.6.0_45/com/sun/org/apache/xml/internal/security/c14n/helper/AttrCompare.java,Java,,52,25,62,139
/jdk1.6.0_45/com/sun/org/apache/xml/internal/security/c14n/helper/C14nHelper.java,Java,,64,23,73,160
/jdk1.6.0_45/com/sun/org/apache/xml/internal/security/c14n/implementations/Canonicalizer20010315.java,Java,,187,46,130,363
/jdk1.6.0_45/com/sun/org/apache/xml/internal/security/c14n/implementations/Canonicalizer20010315Excl.java,Java,,183,26,112,321
/jdk1.6.0_45/com/sun/org/apache/xml/internal/security/c14n/implementations/Canonicalizer20010315ExclOmitComments.java,Java,,14,6,25,45
/jdk1.6.0_45/com/sun/org/apache/xml/internal/security/c14n/implementations/Canonicalizer20010315ExclWithComments.java,Java,,14,8,27,49
/jdk1.6.0_45/com/sun/org/apache/xml/internal/security/c14n/implementations/Canonicalizer20010315OmitComments.java,Java,,13,8,26,47
/jdk1.6.0_45/com/sun/org/apache/xml/internal/security/c14n/implementations/Canonicalizer20010315WithComments.java,Java,,13,6,26,45
/jdk1.6.0_45/com/sun/org/apache/xml/internal/security/c14n/implementations/CanonicalizerBase.java,Java,,605,83,187,875
/jdk1.6.0_45/com/sun/org/apache/xml/internal/security/c14n/implementations/NameSpaceSymbTable.java,Java,,261,36,120,417
/jdk1.6.0_45/com/sun/org/apache/xml/internal/security/c14n/InvalidCanonicalizerException.java,Java,,22,12,51,85
/jdk1.6.0_45/com/sun/org/apache/xml/internal/security/encryption/AgreementMethod.java,Java,,16,14,123,153
/jdk1.6.0_45/com/sun/org/apache/xml/internal/security/encryption/CipherData.java,Java,,11,8,71,90
/jdk1.6.0_45/com/sun/org/apache/xml/internal/security/encryption/CipherReference.java,Java,,8,7,75,90
/jdk1.6.0_45/com/sun/org/apache/xml/internal/security/encryption/CipherValue.java,Java,,5,3,35,43
/jdk1.6.0_45/com/sun/org/apache/xml/internal/security/encryption/EncryptedData.java,Java,,3,3,35,41
/jdk1.6.0_45/com/sun/org/apache/xml/internal/security/encryption/EncryptedKey.java,Java,,9,9,91,109
/jdk1.6.0_45/com/sun/org/apache/xml/internal/security/encryption/EncryptedType.java,Java,,19,19,154,192
/jdk1.6.0_45/com/sun/org/apache/xml/internal/security/encryption/EncryptionMethod.java,Java,,13,12,80,105
/jdk1.6.0_45/com/sun/org/apache/xml/internal/security/encryption/EncryptionProperties.java,Java,,9,9,64,82
/jdk1.6.0_45/com/sun/org/apache/xml/internal/security/encryption/EncryptionProperty.java,Java,,14,11,90,115
/jdk1.6.0_45/com/sun/org/apache/xml/internal/security/encryption/Reference.java,Java,,10,8,70,88
/jdk1.6.0_45/com/sun/org/apache/xml/internal/security/encryption/ReferenceList.java,Java,,13,11,79,103
/jdk1.6.0_45/com/sun/org/apache/xml/internal/security/encryption/Transforms.java,Java,,4,9,58,71
/jdk1.6.0_45/com/sun/org/apache/xml/internal/security/encryption/XMLCipher.java,Java,,2128,486,1420,4034
/jdk1.6.0_45/com/sun/org/apache/xml/internal/security/encryption/XMLCipherInput.java,Java,,90,38,61,189
/jdk1.6.0_45/com/sun/org/apache/xml/internal/security/encryption/XMLCipherParameters.java,Java,,41,22,38,101
/jdk1.6.0_45/com/sun/org/apache/xml/internal/security/encryption/XMLEncryptionException.java,Java,,22,2,46,70
/jdk1.6.0_45/com/sun/org/apache/xml/internal/security/exceptions/AlgorithmAlreadyRegisteredException.java,Java,,21,9,55,85
/jdk1.6.0_45/com/sun/org/apache/xml/internal/security/exceptions/Base64DecodingException.java,Java,,21,9,52,82
/jdk1.6.0_45/com/sun/org/apache/xml/internal/security/exceptions/XMLSecurityException.java,Java,,88,46,111,245
/jdk1.6.0_45/com/sun/org/apache/xml/internal/security/exceptions/XMLSecurityRuntimeException.java,Java,,89,40,95,224
/jdk1.6.0_45/com/sun/org/apache/xml/internal/security/Init.java,Java,,262,71,87,420
/jdk1.6.0_45/com/sun/org/apache/xml/internal/security/keys/content/KeyInfoContent.java,Java,,3,6,21,30
/jdk1.6.0_45/com/sun/org/apache/xml/internal/security/keys/content/KeyName.java,Java,,23,12,40,75
/jdk1.6.0_45/com/sun/org/apache/xml/internal/security/keys/content/KeyValue.java,Java,,69,36,64,169
/jdk1.6.0_45/com/sun/org/apache/xml/internal/security/keys/content/keyvalues/DSAKeyValue.java,Java,,77,20,46,143
/jdk1.6.0_45/com/sun/org/apache/xml/internal/security/keys/content/keyvalues/KeyValueContent.java,Java,,7,7,30,44
/jdk1.6.0_45/com/sun/org/apache/xml/internal/security/keys/content/keyvalues/RSAKeyValue.java,Java,,67,21,45,133
/jdk1.6.0_45/com/sun/org/apache/xml/internal/security/keys/content/MgmtData.java,Java,,24,12,40,76
/jdk1.6.0_45/com/sun/org/apache/xml/internal/security/keys/content/PGPData.java,Java,,15,8,30,53
/jdk1.6.0_45/com/sun/org/apache/xml/internal/security/keys/content/RetrievalMethod.java,Java,,64,21,65,150
/jdk1.6.0_45/com/sun/org/apache/xml/internal/security/keys/content/SPKIData.java,Java,,16,8,30,54
/jdk1.6.0_45/com/sun/org/apache/xml/internal/security/keys/content/x509/XMLX509Certificate.java,Java,,75,29,63,167
/jdk1.6.0_45/com/sun/org/apache/xml/internal/security/keys/content/x509/XMLX509CRL.java,Java,,25,12,45,82
/jdk1.6.0_45/com/sun/org/apache/xml/internal/security/keys/content/x509/XMLX509DataContent.java,Java,,3,6,21,30
/jdk1.6.0_45/com/sun/org/apache/xml/internal/security/keys/content/x509/XMLX509IssuerSerial.java,Java,,73,28,75,176
/jdk1.6.0_45/com/sun/org/apache/xml/internal/security/keys/content/x509/XMLX509SKI.java,Java,,102,34,87,223
/jdk1.6.0_45/com/sun/org/apache/xml/internal/security/keys/content/x509/XMLX509SubjectName.java,Java,,43,19,48,110
/jdk1.6.0_45/com/sun/org/apache/xml/internal/security/keys/content/X509Data.java,Java,,244,75,221,540
/jdk1.6.0_45/com/sun/org/apache/xml/internal/security/keys/ContentHandlerAlreadyRegisteredException.java,Java,,24,12,51,87
/jdk1.6.0_45/com/sun/org/apache/xml/internal/security/keys/KeyInfo.java,Java,,617,194,414,1225
/jdk1.6.0_45/com/sun/org/apache/xml/internal/security/keys/keyresolver/implementations/DSAKeyValueResolver.java,Java,,60,26,35,121
/jdk1.6.0_45/com/sun/org/apache/xml/internal/security/keys/keyresolver/implementations/EncryptedKeyResolver.java,Java,,63,23,51,137
/jdk1.6.0_45/com/sun/org/apache/xml/internal/security/keys/keyresolver/implementations/RetrievalMethodResolver.java,Java,,187,48,72,307
/jdk1.6.0_45/com/sun/org/apache/xml/internal/security/keys/keyresolver/implementations/RSAKeyValueResolver.java,Java,,65,26,28,119
/jdk1.6.0_45/com/sun/org/apache/xml/internal/security/keys/keyresolver/implementations/X509CertificateResolver.java,Java,,83,34,60,177
/jdk1.6.0_45/com/sun/org/apache/xml/internal/security/keys/keyresolver/implementations/X509IssuerSerialResolver.java,Java,,99,32,25,156
/jdk1.6.0_45/com/sun/org/apache/xml/internal/security/keys/keyresolver/implementations/X509SKIResolver.java,Java,,93,39,58,190
/jdk1.6.0_45/com/sun/org/apache/xml/internal/security/keys/keyresolver/implementations/X509SubjectNameResolver.java,Java,,99,42,57,198
/jdk1.6.0_45/com/sun/org/apache/xml/internal/security/keys/keyresolver/InvalidKeyResolverException.java,Java,,22,12,52,86
/jdk1.6.0_45/com/sun/org/apache/xml/internal/security/keys/keyresolver/KeyResolver.java,Java,,114,42,161,317
/jdk1.6.0_45/com/sun/org/apache/xml/internal/security/keys/keyresolver/KeyResolverException.java,Java,,21,12,55,88
/jdk1.6.0_45/com/sun/org/apache/xml/internal/security/keys/keyresolver/KeyResolverSpi.java,Java,,58,30,93,181
/jdk1.6.0_45/com/sun/org/apache/xml/internal/security/keys/KeyUtils.java,Java,,38,17,29,84
/jdk1.6.0_45/com/sun/org/apache/xml/internal/security/keys/storage/implementations/CertsInFilesystemDirectoryResolver.java,Java,,122,40,64,226
/jdk1.6.0_45/com/sun/org/apache/xml/internal/security/keys/storage/implementations/KeyStoreResolver.java,Java,,62,27,57,146
/jdk1.6.0_45/com/sun/org/apache/xml/internal/security/keys/storage/implementations/SingleCertificateResolver.java,Java,,33,20,49,102
/jdk1.6.0_45/com/sun/org/apache/xml/internal/security/keys/storage/StorageResolver.java,Java,,70,34,92,196
/jdk1.6.0_45/com/sun/org/apache/xml/internal/security/keys/storage/StorageResolverException.java,Java,,21,12,51,84
/jdk1.6.0_45/com/sun/org/apache/xml/internal/security/keys/storage/StorageResolverSpi.java,Java,,5,7,25,37
/jdk1.6.0_45/com/sun/org/apache/xml/internal/security/signature/InvalidDigestValueException.java,Java,,21,10,52,83
/jdk1.6.0_45/com/sun/org/apache/xml/internal/security/signature/InvalidSignatureValueException.java,Java,,21,10,53,84
/jdk1.6.0_45/com/sun/org/apache/xml/internal/security/signature/Manifest.java,Java,,267,90,202,559
/jdk1.6.0_45/com/sun/org/apache/xml/internal/security/signature/MissingResourceFailureException.java,Java,,32,21,74,127
/jdk1.6.0_45/com/sun/org/apache/xml/internal/security/signature/NodeFilter.java,Java,,5,3,26,34
/jdk1.6.0_45/com/sun/org/apache/xml/internal/security/signature/ObjectContainer.java,Java,,56,24,74,154
/jdk1.6.0_45/com/sun/org/apache/xml/internal/security/signature/Reference.java,Java,,382,116,252,750
/jdk1.6.0_45/com/sun/org/apache/xml/internal/security/signature/ReferenceNotInitializedException.java,Java,,21,12,53,86
/jdk1.6.0_45/com/sun/org/apache/xml/internal/security/signature/SignatureProperties.java,Java,,57,20,66,143
/jdk1.6.0_45/com/sun/org/apache/xml/internal/security/signature/SignatureProperty.java,Java,,48,16,70,134
/jdk1.6.0_45/com/sun/org/apache/xml/internal/security/signature/SignedInfo.java,Java,,202,55,127,384
/jdk1.6.0_45/com/sun/org/apache/xml/internal/security/signature/XMLSignature.java,Java,,323,108,322,753
/jdk1.6.0_45/com/sun/org/apache/xml/internal/security/signature/XMLSignatureException.java,Java,,21,12,53,86
/jdk1.6.0_45/com/sun/org/apache/xml/internal/security/signature/XMLSignatureInput.java,Java,,280,73,259,612
/jdk1.6.0_45/com/sun/org/apache/xml/internal/security/signature/XMLSignatureInputDebugger.java,Java,,435,149,130,714
/jdk1.6.0_45/com/sun/org/apache/xml/internal/security/transforms/implementations/FuncHere.java,Java,,67,30,60,157
/jdk1.6.0_45/com/sun/org/apache/xml/internal/security/transforms/implementations/FuncHereContext.java,Java,,42,16,81,139
/jdk1.6.0_45/com/sun/org/apache/xml/internal/security/transforms/implementations/TransformBase64Decode.java,Java,,98,20,60,178
/jdk1.6.0_45/com/sun/org/apache/xml/internal/security/transforms/implementations/TransformC14N.java,Java,,33,10,29,72
/jdk1.6.0_45/com/sun/org/apache/xml/internal/security/transforms/implementations/TransformC14NExclusive.java,Java,,55,14,35,104
/jdk1.6.0_45/com/sun/org/apache/xml/internal/security/transforms/implementations/TransformC14NExclusiveWithComments.java,Java,,52,14,31,97
/jdk1.6.0_45/com/sun/org/apache/xml/internal/security/transforms/implementations/TransformC14NWithComments.java,Java,,33,11,26,70
/jdk1.6.0_45/com/sun/org/apache/xml/internal/security/transforms/implementations/TransformEnvelopedSignature.java,Java,,57,23,57,137
/jdk1.6.0_45/com/sun/org/apache/xml/internal/security/transforms/implementations/TransformXPath.java,Java,,83,24,59,166
/jdk1.6.0_45/com/sun/org/apache/xml/internal/security/transforms/implementations/TransformXPath2Filter.java,Java,,133,34,53,220
/jdk1.6.0_45/com/sun/org/apache/xml/internal/security/transforms/implementations/TransformXPointer.java,Java,,18,14,31,63
/jdk1.6.0_45/com/sun/org/apache/xml/internal/security/transforms/implementations/TransformXSLT.java,Java,,85,26,54,165
/jdk1.6.0_45/com/sun/org/apache/xml/internal/security/transforms/InvalidTransformException.java,Java,,21,12,51,84
/jdk1.6.0_45/com/sun/org/apache/xml/internal/security/transforms/params/InclusiveNamespaces.java,Java,,70,29,79,178
/jdk1.6.0_45/com/sun/org/apache/xml/internal/security/transforms/params/XPath2FilterContainer.java,Java,,131,52,127,310
/jdk1.6.0_45/com/sun/org/apache/xml/internal/security/transforms/params/XPath2FilterContainer04.java,Java,,111,41,109,261
/jdk1.6.0_45/com/sun/org/apache/xml/internal/security/transforms/params/XPathContainer.java,Java,,28,12,39,79
/jdk1.6.0_45/com/sun/org/apache/xml/internal/security/transforms/params/XPathFilterCHGPContainer.java,Java,,134,48,135,317
/jdk1.6.0_45/com/sun/org/apache/xml/internal/security/transforms/Transform.java,Java,,177,64,135,376
/jdk1.6.0_45/com/sun/org/apache/xml/internal/security/transforms/TransformationException.java,Java,,21,12,51,84
/jdk1.6.0_45/com/sun/org/apache/xml/internal/security/transforms/TransformParam.java,Java,,3,4,20,27
/jdk1.6.0_45/com/sun/org/apache/xml/internal/security/transforms/Transforms.java,Java,,139,38,121,298
/jdk1.6.0_45/com/sun/org/apache/xml/internal/security/transforms/TransformSpi.java,Java,,31,12,53,96
/jdk1.6.0_45/com/sun/org/apache/xml/internal/security/utils/Base64.java,Java,,469,142,200,811
/jdk1.6.0_45/com/sun/org/apache/xml/internal/security/utils/CachedXPathAPIHolder.java,Java,,31,5,27,63
/jdk1.6.0_45/com/sun/org/apache/xml/internal/security/utils/CachedXPathFuncHereAPI.java,Java,,200,48,209,457
/jdk1.6.0_45/com/sun/org/apache/xml/internal/security/utils/Constants.java,Java,,81,19,133,233
/jdk1.6.0_45/com/sun/org/apache/xml/internal/security/utils/DigesterOutputStream.java,Java,,25,8,30,63
/jdk1.6.0_45/com/sun/org/apache/xml/internal/security/utils/ElementProxy.java,Java,,245,96,202,543
/jdk1.6.0_45/com/sun/org/apache/xml/internal/security/utils/EncryptionConstants.java,Java,,61,20,95,176
/jdk1.6.0_45/com/sun/org/apache/xml/internal/security/utils/EncryptionElementProxy.java,Java,,16,8,35,59
/jdk1.6.0_45/com/sun/org/apache/xml/internal/security/utils/HelperNodeList.java,Java,,37,19,51,107
/jdk1.6.0_45/com/sun/org/apache/xml/internal/security/utils/I18n.java,Java,,72,27,134,233
/jdk1.6.0_45/com/sun/org/apache/xml/internal/security/utils/IdResolver.java,Java,,134,33,72,239
/jdk1.6.0_45/com/sun/org/apache/xml/internal/security/utils/IgnoreAllErrorHandler.java,Java,,37,14,28,79
/jdk1.6.0_45/com/sun/org/apache/xml/internal/security/utils/JavaUtils.java,Java,,53,22,48,123
/jdk1.6.0_45/com/sun/org/apache/xml/internal/security/utils/resolver/implementations/ResolverAnonymous.java,Java,,32,12,34,78
/jdk1.6.0_45/com/sun/org/apache/xml/internal/security/utils/resolver/implementations/ResolverDirectHTTP.java,Java,,161,56,77,294
/jdk1.6.0_45/com/sun/org/apache/xml/internal/security/utils/resolver/implementations/ResolverFragment.java,Java,,57,21,56,134
/jdk1.6.0_45/com/sun/org/apache/xml/internal/security/utils/resolver/implementations/ResolverLocalFilesystem.java,Java,,77,27,38,142
/jdk1.6.0_45/com/sun/org/apache/xml/internal/security/utils/resolver/implementations/ResolverXPointer.java,Java,,90,34,64,188
/jdk1.6.0_45/com/sun/org/apache/xml/internal/security/utils/resolver/ResourceResolver.java,Java,,112,40,145,297
/jdk1.6.0_45/com/sun/org/apache/xml/internal/security/utils/resolver/ResourceResolverException.java,Java,,44,23,75,142
/jdk1.6.0_45/com/sun/org/apache/xml/internal/security/utils/resolver/ResourceResolverSpi.java,Java,,78,38,78,194
/jdk1.6.0_45/com/sun/org/apache/xml/internal/security/utils/RFC2253Parser.java,Java,,281,115,168,564
/jdk1.6.0_45/com/sun/org/apache/xml/internal/security/utils/SignatureElementProxy.java,Java,,16,9,37,62
/jdk1.6.0_45/com/sun/org/apache/xml/internal/security/utils/SignerOutputStream.java,Java,,35,9,27,71
/jdk1.6.0_45/com/sun/org/apache/xml/internal/security/utils/UnsyncBufferedOutputStream.java,Java,,46,11,30,87
/jdk1.6.0_45/com/sun/org/apache/xml/internal/security/utils/UnsyncByteArrayOutputStream.java,Java,,44,5,27,76
/jdk1.6.0_45/com/sun/org/apache/xml/internal/security/utils/XMLUtils.java,Java,,387,100,206,693
/jdk1.6.0_45/com/sun/org/apache/xml/internal/security/utils/XPathFuncHereAPI.java,Java,,85,36,182,303
/jdk1.6.0_45/com/sun/org/apache/xml/internal/serialize/BaseMarkupSerializer.java,Java,,1219,264,482,1965
/jdk1.6.0_45/com/sun/org/apache/xml/internal/serialize/DOMSerializer.java,Java,,14,18,47,79
/jdk1.6.0_45/com/sun/org/apache/xml/internal/serialize/DOMSerializerImpl.java,Java,,853,79,279,1211
/jdk1.6.0_45/com/sun/org/apache/xml/internal/serialize/ElementState.java,Java,,16,30,59,105
/jdk1.6.0_45/com/sun/org/apache/xml/internal/serialize/EncodingInfo.java,Java,,143,31,93,267
/jdk1.6.0_45/com/sun/org/apache/xml/internal/serialize/Encodings.java,Java,,66,14,41,121
/jdk1.6.0_45/com/sun/org/apache/xml/internal/serialize/HTMLdtd.java,Java,,269,88,198,555
/jdk1.6.0_45/com/sun/org/apache/xml/internal/serialize/HTMLSerializer.java,Java,,523,101,258,882
/jdk1.6.0_45/com/sun/org/apache/xml/internal/serialize/IndentPrinter.java,Java,,162,58,142,362
/jdk1.6.0_45/com/sun/org/apache/xml/internal/serialize/LineSeparator.java,Java,,8,16,32,56
/jdk1.6.0_45/com/sun/org/apache/xml/internal/serialize/Method.java,Java,,9,18,35,62
/jdk1.6.0_45/com/sun/org/apache/xml/internal/serialize/OutputFormat.java,Java,,332,160,467,959
/jdk1.6.0_45/com/sun/org/apache/xml/internal/serialize/Printer.java,Java,,198,64,99,361
/jdk1.6.0_45/com/sun/org/apache/xml/internal/serialize/Serializer.java,Java,,18,26,81,125
/jdk1.6.0_45/com/sun/org/apache/xml/internal/serialize/SerializerFactory.java,Java,,60,29,59,148
/jdk1.6.0_45/com/sun/org/apache/xml/internal/serialize/SerializerFactoryImpl.java,Java,,64,26,24,114
/jdk1.6.0_45/com/sun/org/apache/xml/internal/serialize/TextSerializer.java,Java,,189,76,124,389
/jdk1.6.0_45/com/sun/org/apache/xml/internal/serialize/XHTMLSerializer.java,Java,,29,18,54,101
/jdk1.6.0_45/com/sun/org/apache/xml/internal/serialize/XML11Serializer.java,Java,,311,68,159,538
/jdk1.6.0_45/com/sun/org/apache/xml/internal/serialize/XMLSerializer.java,Java,,890,177,403,1470
/jdk1.6.0_45/com/sun/org/apache/xml/internal/serializer/AttributesImplSerializer.java,Java,,103,22,110,235
/jdk1.6.0_45/com/sun/org/apache/xml/internal/serializer/CharInfo.java,Java,,320,95,328,743
/jdk1.6.0_45/com/sun/org/apache/xml/internal/serializer/DOMSerializer.java,Java,,7,3,54,64
/jdk1.6.0_45/com/sun/org/apache/xml/internal/serializer/ElemContext.java,Java,,57,18,142,217
/jdk1.6.0_45/com/sun/org/apache/xml/internal/serializer/ElemDesc.java,Java,,55,36,85,176
/jdk1.6.0_45/com/sun/org/apache/xml/internal/serializer/EmptySerializer.java,Java,,443,23,289,755
/jdk1.6.0_45/com/sun/org/apache/xml/internal/serializer/EncodingInfo.java,Java,,188,45,275,508
/jdk1.6.0_45/com/sun/org/apache/xml/internal/serializer/Encodings.java,Java,,248,43,172,463
/jdk1.6.0_45/com/sun/org/apache/xml/internal/serializer/ExtendedContentHandler.java,Java,,49,17,203,269
/jdk1.6.0_45/com/sun/org/apache/xml/internal/serializer/ExtendedLexicalHandler.java,Java,,6,2,29,37
/jdk1.6.0_45/com/sun/org/apache/xml/internal/serializer/Method.java,Java,,11,7,56,74
/jdk1.6.0_45/com/sun/org/apache/xml/internal/serializer/NamespaceMappings.java,Java,,158,34,133,325
/jdk1.6.0_45/com/sun/org/apache/xml/internal/serializer/OutputPropertiesFactory.java,Java,,260,49,206,515
/jdk1.6.0_45/com/sun/org/apache/xml/internal/serializer/OutputPropertyUtils.java,Java,,21,8,52,81
/jdk1.6.0_45/com/sun/org/apache/xml/internal/serializer/SerializationHandler.java,Java,,30,14,80,124
/jdk1.6.0_45/com/sun/org/apache/xml/internal/serializer/Serializer.java,Java,,17,12,191,220
/jdk1.6.0_45/com/sun/org/apache/xml/internal/serializer/SerializerBase.java,Java,,586,150,647,1383
/jdk1.6.0_45/com/sun/org/apache/xml/internal/serializer/SerializerConstants.java,Java,,19,7,31,57
/jdk1.6.0_45/com/sun/org/apache/xml/internal/serializer/SerializerFactory.java,Java,,75,23,84,182
/jdk1.6.0_45/com/sun/org/apache/xml/internal/serializer/SerializerTrace.java,Java,,22,24,105,151
/jdk1.6.0_45/com/sun/org/apache/xml/internal/serializer/SerializerTraceWriter.java,Java,,152,44,143,339
/jdk1.6.0_45/com/sun/org/apache/xml/internal/serializer/ToHTMLSAXHandler.java,Java,,284,65,394,743
/jdk1.6.0_45/com/sun/org/apache/xml/internal/serializer/ToHTMLStream.java,Java,,1384,240,692,2316
/jdk1.6.0_45/com/sun/org/apache/xml/internal/serializer/ToSAXHandler.java,Java,,204,48,184,436
/jdk1.6.0_45/com/sun/org/apache/xml/internal/serializer/ToStream.java,Java,,1760,335,1277,3372
/jdk1.6.0_45/com/sun/org/apache/xml/internal/serializer/ToTextSAXHandler.java,Java,,215,55,140,410
/jdk1.6.0_45/com/sun/org/apache/xml/internal/serializer/ToTextStream.java,Java,,247,54,331,632
/jdk1.6.0_45/com/sun/org/apache/xml/internal/serializer/ToUnknownStream.java,Java,,674,154,506,1334
/jdk1.6.0_45/com/sun/org/apache/xml/internal/serializer/ToXMLSAXHandler.java,Java,,407,102,265,774
/jdk1.6.0_45/com/sun/org/apache/xml/internal/serializer/ToXMLStream.java,Java,,354,70,202,626
/jdk1.6.0_45/com/sun/org/apache/xml/internal/serializer/TransformStateSetter.java,Java,,8,6,40,54
/jdk1.6.0_45/com/sun/org/apache/xml/internal/serializer/TreeWalker.java,Java,,328,71,127,526
/jdk1.6.0_45/com/sun/org/apache/xml/internal/serializer/utils/AttList.java,Java,,86,23,153,262
/jdk1.6.0_45/com/sun/org/apache/xml/internal/serializer/utils/BoolStack.java,Java,,67,27,108,202
/jdk1.6.0_45/com/sun/org/apache/xml/internal/serializer/utils/DOM2Helper.java,Java,,30,14,88,132
/jdk1.6.0_45/com/sun/org/apache/xml/internal/serializer/utils/Messages.java,Java,,104,22,157,283
/jdk1.6.0_45/com/sun/org/apache/xml/internal/serializer/utils/MsgKey.java,Java,,58,6,34,98
/jdk1.6.0_45/com/sun/org/apache/xml/internal/serializer/utils/SerializerMessages.java,Java,,82,41,81,204
/jdk1.6.0_45/com/sun/org/apache/xml/internal/serializer/utils/SerializerMessages_ca.java,Java,,73,35,18,126
/jdk1.6.0_45/com/sun/org/apache/xml/internal/serializer/utils/SerializerMessages_cs.java,Java,,65,31,22,118
/jdk1.6.0_45/com/sun/org/apache/xml/internal/serializer/utils/SerializerMessages_de.java,Java,,65,31,22,118
/jdk1.6.0_45/com/sun/org/apache/xml/internal/serializer/utils/SerializerMessages_en.java,Java,,4,2,22,28
/jdk1.6.0_45/com/sun/org/apache/xml/internal/serializer/utils/SerializerMessages_es.java,Java,,65,31,22,118
/jdk1.6.0_45/com/sun/org/apache/xml/internal/serializer/utils/SerializerMessages_fr.java,Java,,65,31,22,118
/jdk1.6.0_45/com/sun/org/apache/xml/internal/serializer/utils/SerializerMessages_it.java,Java,,65,31,22,118
/jdk1.6.0_45/com/sun/org/apache/xml/internal/serializer/utils/SerializerMessages_ja.java,Java,,65,31,22,118
/jdk1.6.0_45/com/sun/org/apache/xml/internal/serializer/utils/SerializerMessages_ko.java,Java,,65,31,22,118
/jdk1.6.0_45/com/sun/org/apache/xml/internal/serializer/utils/SerializerMessages_pt_BR.java,Java,,82,41,81,204
/jdk1.6.0_45/com/sun/org/apache/xml/internal/serializer/utils/SerializerMessages_sv.java,Java,,43,20,33,96
/jdk1.6.0_45/com/sun/org/apache/xml/internal/serializer/utils/SerializerMessages_zh_CN.java,Java,,65,31,22,118
/jdk1.6.0_45/com/sun/org/apache/xml/internal/serializer/utils/SerializerMessages_zh_TW.java,Java,,65,31,22,118
/jdk1.6.0_45/com/sun/org/apache/xml/internal/serializer/utils/StringToIntTable.java,Java,,82,35,84,201
/jdk1.6.0_45/com/sun/org/apache/xml/internal/serializer/utils/SystemIDResolver.java,Java,,154,27,119,300
/jdk1.6.0_45/com/sun/org/apache/xml/internal/serializer/utils/URI.java,Java,,899,219,534,1652
/jdk1.6.0_45/com/sun/org/apache/xml/internal/serializer/utils/Utils.java,Java,,8,2,31,41
/jdk1.6.0_45/com/sun/org/apache/xml/internal/serializer/utils/WrappedRuntimeException.java,Java,,20,9,50,79
/jdk1.6.0_45/com/sun/org/apache/xml/internal/serializer/Utils.java,Java,,27,4,45,76
/jdk1.6.0_45/com/sun/org/apache/xml/internal/serializer/Version.java,Java,,46,11,91,148
/jdk1.6.0_45/com/sun/org/apache/xml/internal/serializer/WriterChain.java,Java,,14,4,62,80
/jdk1.6.0_45/com/sun/org/apache/xml/internal/serializer/WriterToASCI.java,Java,,49,15,89,153
/jdk1.6.0_45/com/sun/org/apache/xml/internal/serializer/WriterToUTF8Buffered.java,Java,,225,53,223,501
/jdk1.6.0_45/com/sun/org/apache/xml/internal/serializer/XSLOutputAttributes.java,Java,,24,12,144,180
/jdk1.6.0_45/com/sun/org/apache/xml/internal/utils/AttList.java,Java,,86,23,144,253
/jdk1.6.0_45/com/sun/org/apache/xml/internal/utils/BoolStack.java,Java,,72,29,99,200
/jdk1.6.0_45/com/sun/org/apache/xml/internal/utils/CharKey.java,Java,,24,9,49,82
/jdk1.6.0_45/com/sun/org/apache/xml/internal/utils/Constants.java,Java,,32,9,69,110
/jdk1.6.0_45/com/sun/org/apache/xml/internal/utils/DefaultErrorHandler.java,Java,,143,31,166,340
/jdk1.6.0_45/com/sun/org/apache/xml/internal/utils/DOM2Helper.java,Java,,90,32,190,312
/jdk1.6.0_45/com/sun/org/apache/xml/internal/utils/DOMBuilder.java,Java,,263,87,436,786
/jdk1.6.0_45/com/sun/org/apache/xml/internal/utils/DOMHelper.java,Java,,620,172,540,1332
/jdk1.6.0_45/com/sun/org/apache/xml/internal/utils/DOMOrder.java,Java,,5,2,32,39
/jdk1.6.0_45/com/sun/org/apache/xml/internal/utils/ElemDesc.java,Java,,56,36,95,187
/jdk1.6.0_45/com/sun/org/apache/xml/internal/utils/FastStringBuffer.java,Java,,539,192,563,1294
/jdk1.6.0_45/com/sun/org/apache/xml/internal/utils/Hashtree2Node.java,Java,,69,12,58,139
/jdk1.6.0_45/com/sun/org/apache/xml/internal/utils/IntStack.java,Java,,86,25,98,209
/jdk1.6.0_45/com/sun/org/apache/xml/internal/utils/IntVector.java,Java,,177,70,170,417
/jdk1.6.0_45/com/sun/org/apache/xml/internal/utils/ListingErrorHandler.java,Java,,236,65,263,564
/jdk1.6.0_45/com/sun/org/apache/xml/internal/utils/LocaleUtility.java,Java,,45,17,24,86
/jdk1.6.0_45/com/sun/org/apache/xml/internal/utils/MutableAttrListImpl.java,Java,,51,18,68,137
/jdk1.6.0_45/com/sun/org/apache/xml/internal/utils/NameSpace.java,Java,,14,6,37,57
/jdk1.6.0_45/com/sun/org/apache/xml/internal/utils/NamespaceSupport2.java,Java,,276,85,386,747
/jdk1.6.0_45/com/sun/org/apache/xml/internal/utils/NodeConsumer.java,Java,,6,3,29,38
/jdk1.6.0_45/com/sun/org/apache/xml/internal/utils/NodeVector.java,Java,,338,133,266,737
/jdk1.6.0_45/com/sun/org/apache/xml/internal/utils/NSInfo.java,Java,,33,15,60,108
/jdk1.6.0_45/com/sun/org/apache/xml/internal/utils/ObjectPool.java,Java,,71,26,80,177
/jdk1.6.0_45/com/sun/org/apache/xml/internal/utils/ObjectStack.java,Java,,88,27,98,213
/jdk1.6.0_45/com/sun/org/apache/xml/internal/utils/ObjectVector.java,Java,,183,74,172,429
/jdk1.6.0_45/com/sun/org/apache/xml/internal/utils/PrefixResolver.java,Java,,8,5,57,70
/jdk1.6.0_45/com/sun/org/apache/xml/internal/utils/PrefixResolverDefault.java,Java,,65,17,61,143
/jdk1.6.0_45/com/sun/org/apache/xml/internal/utils/QName.java,Java,,343,94,270,707
/jdk1.6.0_45/com/sun/org/apache/xml/internal/utils/RawCharacterHandler.java,Java,,6,2,32,40
/jdk1.6.0_45/com/sun/org/apache/xml/internal/utils/res/CharArrayWrapper.java,Java,,13,4,23,40
/jdk1.6.0_45/com/sun/org/apache/xml/internal/utils/res/IntArrayWrapper.java,Java,,13,4,23,40
/jdk1.6.0_45/com/sun/org/apache/xml/internal/utils/res/LongArrayWrapper.java,Java,,13,4,23,40
/jdk1.6.0_45/com/sun/org/apache/xml/internal/utils/res/StringArrayWrapper.java,Java,,13,5,23,41
/jdk1.6.0_45/com/sun/org/apache/xml/internal/utils/res/XResourceBundle.java,Java,,37,7,30,74
/jdk1.6.0_45/com/sun/org/apache/xml/internal/utils/res/XResourceBundleBase.java,Java,,7,4,37,48
/jdk1.6.0_45/com/sun/org/apache/xml/internal/utils/res/XResources_de.java,Java,,21,6,44,71
/jdk1.6.0_45/com/sun/org/apache/xml/internal/utils/res/XResources_en.java,Java,,21,6,44,71
/jdk1.6.0_45/com/sun/org/apache/xml/internal/utils/res/XResources_es.java,Java,,21,6,44,71
/jdk1.6.0_45/com/sun/org/apache/xml/internal/utils/res/XResources_fr.java,Java,,21,6,44,71
/jdk1.6.0_45/com/sun/org/apache/xml/internal/utils/res/XResources_it.java,Java,,21,6,44,71
/jdk1.6.0_45/com/sun/org/apache/xml/internal/utils/res/XResources_ja_JP_A.java,Java,,37,8,39,84
/jdk1.6.0_45/com/sun/org/apache/xml/internal/utils/res/XResources_ja_JP_HA.java,Java,,37,8,39,84
/jdk1.6.0_45/com/sun/org/apache/xml/internal/utils/res/XResources_ja_JP_HI.java,Java,,37,8,40,85
/jdk1.6.0_45/com/sun/org/apache/xml/internal/utils/res/XResources_ja_JP_I.java,Java,,36,8,40,84
/jdk1.6.0_45/com/sun/org/apache/xml/internal/utils/res/XResources_ko.java,Java,,33,8,37,78
/jdk1.6.0_45/com/sun/org/apache/xml/internal/utils/res/XResources_pt_BR.java,Java,,21,5,44,70
/jdk1.6.0_45/com/sun/org/apache/xml/internal/utils/res/XResources_sv.java,Java,,21,6,44,71
/jdk1.6.0_45/com/sun/org/apache/xml/internal/utils/res/XResources_zh_CN.java,Java,,33,8,37,78
/jdk1.6.0_45/com/sun/org/apache/xml/internal/utils/res/XResources_zh_TW.java,Java,,33,8,37,78
/jdk1.6.0_45/com/sun/org/apache/xml/internal/utils/SAXSourceLocator.java,Java,,52,13,103,168
/jdk1.6.0_45/com/sun/org/apache/xml/internal/utils/SerializableLocatorImpl.java,Java,,52,33,139,224
/jdk1.6.0_45/com/sun/org/apache/xml/internal/utils/StopParseException.java,Java,,9,1,28,38
/jdk1.6.0_45/com/sun/org/apache/xml/internal/utils/StringBufferPool.java,Java,,15,4,39,58
/jdk1.6.0_45/com/sun/org/apache/xml/internal/utils/StringComparable.java,Java,,155,30,28,213
/jdk1.6.0_45/com/sun/org/apache/xml/internal/utils/StringToIntTable.java,Java,,82,35,77,194
/jdk1.6.0_45/com/sun/org/apache/xml/internal/utils/StringToStringTable.java,Java,,104,40,96,240
/jdk1.6.0_45/com/sun/org/apache/xml/internal/utils/StringToStringTableVector.java,Java,,80,32,85,197
/jdk1.6.0_45/com/sun/org/apache/xml/internal/utils/StringVector.java,Java,,92,41,88,221
/jdk1.6.0_45/com/sun/org/apache/xml/internal/utils/StylesheetPIHandler.java,Java,,206,33,99,338
/jdk1.6.0_45/com/sun/org/apache/xml/internal/utils/SuballocatedByteVector.java,Java,,267,37,192,496
/jdk1.6.0_45/com/sun/org/apache/xml/internal/utils/SuballocatedIntVector.java,Java,,290,47,218,555
/jdk1.6.0_45/com/sun/org/apache/xml/internal/utils/SystemIDResolver.java,Java,,154,27,112,293
/jdk1.6.0_45/com/sun/org/apache/xml/internal/utils/ThreadControllerWrapper.java,Java,,50,15,57,122
/jdk1.6.0_45/com/sun/org/apache/xml/internal/utils/TreeWalker.java,Java,,303,72,117,492
/jdk1.6.0_45/com/sun/org/apache/xml/internal/utils/Trie.java,Java,,93,24,86,203
/jdk1.6.0_45/com/sun/org/apache/xml/internal/utils/UnImplNode.java,Java,,634,274,1142,2050
/jdk1.6.0_45/com/sun/org/apache/xml/internal/utils/URI.java,Java,,909,220,543,1672
/jdk1.6.0_45/com/sun/org/apache/xml/internal/utils/WrappedRuntimeException.java,Java,,20,9,43,72
/jdk1.6.0_45/com/sun/org/apache/xml/internal/utils/WrongParserException.java,Java,,9,2,27,38
/jdk1.6.0_45/com/sun/org/apache/xml/internal/utils/XML11Char.java,Java,,222,42,166,430
/jdk1.6.0_45/com/sun/org/apache/xml/internal/utils/XMLChar.java,Java,,322,80,264,666
/jdk1.6.0_45/com/sun/org/apache/xml/internal/utils/XMLCharacterRecognizer.java,Java,,41,15,51,107
/jdk1.6.0_45/com/sun/org/apache/xml/internal/utils/XMLReaderManager.java,Java,,89,19,72,180
/jdk1.6.0_45/com/sun/org/apache/xml/internal/utils/XMLString.java,Java,,47,40,586,673
/jdk1.6.0_45/com/sun/org/apache/xml/internal/utils/XMLStringDefault.java,Java,,171,42,587,800
/jdk1.6.0_45/com/sun/org/apache/xml/internal/utils/XMLStringFactory.java,Java,,10,5,54,69
/jdk1.6.0_45/com/sun/org/apache/xml/internal/utils/XMLStringFactoryDefault.java,Java,,21,5,56,82
/jdk1.6.0_45/com/sun/org/apache/xpath/internal/Arg.java,Java,,97,27,132,256
/jdk1.6.0_45/com/sun/org/apache/xpath/internal/axes/AttributeIterator.java,Java,,23,8,42,73
/jdk1.6.0_45/com/sun/org/apache/xpath/internal/axes/AxesWalker.java,Java,,274,79,235,588
/jdk1.6.0_45/com/sun/org/apache/xpath/internal/axes/BasicTestIterator.java,Java,,110,28,85,223
/jdk1.6.0_45/com/sun/org/apache/xpath/internal/axes/ChildIterator.java,Java,,45,15,59,119
/jdk1.6.0_45/com/sun/org/apache/xpath/internal/axes/ChildTestIterator.java,Java,,54,22,100,176
/jdk1.6.0_45/com/sun/org/apache/xpath/internal/axes/ContextNodeList.java,Java,,18,14,102,134
/jdk1.6.0_45/com/sun/org/apache/xpath/internal/axes/DescendantIterator.java,Java,,224,48,105,377
/jdk1.6.0_45/com/sun/org/apache/xpath/internal/axes/FilterExprIterator.java,Java,,98,26,88,212
/jdk1.6.0_45/com/sun/org/apache/xpath/internal/axes/FilterExprIteratorSimple.java,Java,,159,39,115,313
/jdk1.6.0_45/com/sun/org/apache/xpath/internal/axes/FilterExprWalker.java,Java,,156,43,149,348
/jdk1.6.0_45/com/sun/org/apache/xpath/internal/axes/HasPositionalPredChecker.java,Java,,55,12,55,122
/jdk1.6.0_45/com/sun/org/apache/xpath/internal/axes/IteratorPool.java,Java,,53,15,53,121
/jdk1.6.0_45/com/sun/org/apache/xpath/internal/axes/LocPathIterator.java,Java,,363,123,545,1031
/jdk1.6.0_45/com/sun/org/apache/xpath/internal/axes/MatchPatternIterator.java,Java,,197,44,87,328
/jdk1.6.0_45/com/sun/org/apache/xpath/internal/axes/NodeSequence.java,Java,,390,70,189,649
/jdk1.6.0_45/com/sun/org/apache/xpath/internal/axes/OneStepIterator.java,Java,,162,52,128,342
/jdk1.6.0_45/com/sun/org/apache/xpath/internal/axes/OneStepIteratorForward.java,Java,,48,20,101,169
/jdk1.6.0_45/com/sun/org/apache/xpath/internal/axes/PathComponent.java,Java,,5,3,26,34
/jdk1.6.0_45/com/sun/org/apache/xpath/internal/axes/PredicatedNodeTest.java,Java,,333,76,236,645
/jdk1.6.0_45/com/sun/org/apache/xpath/internal/axes/ReverseAxesWalker.java,Java,,109,38,98,245
/jdk1.6.0_45/com/sun/org/apache/xpath/internal/axes/RTFIterator.java,Java,,9,5,27,41
/jdk1.6.0_45/com/sun/org/apache/xpath/internal/axes/SelfIteratorNoPredicate.java,Java,,47,15,64,126
/jdk1.6.0_45/com/sun/org/apache/xpath/internal/axes/SubContextList.java,Java,,7,4,39,50
/jdk1.6.0_45/com/sun/org/apache/xpath/internal/axes/UnionChildIterator.java,Java,,72,13,63,148
/jdk1.6.0_45/com/sun/org/apache/xpath/internal/axes/UnionPathIterator.java,Java,,322,77,182,581
/jdk1.6.0_45/com/sun/org/apache/xpath/internal/axes/WalkerFactory.java,Java,,1245,195,384,1824
/jdk1.6.0_45/com/sun/org/apache/xpath/internal/axes/WalkingIterator.java,Java,,166,52,142,360
/jdk1.6.0_45/com/sun/org/apache/xpath/internal/axes/WalkingIteratorSorted.java,Java,,73,18,121,212
/jdk1.6.0_45/com/sun/org/apache/xpath/internal/CachedXPathAPI.java,Java,,85,32,216,333
/jdk1.6.0_45/com/sun/org/apache/xpath/internal/compiler/Compiler.java,Java,,609,149,508,1266
/jdk1.6.0_45/com/sun/org/apache/xpath/internal/compiler/FuncLoader.java,Java,,40,12,53,105
/jdk1.6.0_45/com/sun/org/apache/xpath/internal/compiler/FunctionTable.java,Java,,232,58,116,406
/jdk1.6.0_45/com/sun/org/apache/xpath/internal/compiler/Keywords.java,Java,,136,67,81,284
/jdk1.6.0_45/com/sun/org/apache/xpath/internal/compiler/Lexer.java,Java,,422,88,150,660
/jdk1.6.0_45/com/sun/org/apache/xpath/internal/compiler/OpCodes.java,Java,,68,66,496,630
/jdk1.6.0_45/com/sun/org/apache/xpath/internal/compiler/OpMap.java,Java,,192,57,204,453
/jdk1.6.0_45/com/sun/org/apache/xpath/internal/compiler/OpMapVector.java,Java,,36,22,56,114
/jdk1.6.0_45/com/sun/org/apache/xpath/internal/compiler/PsuedoNames.java,Java,,10,7,40,57
/jdk1.6.0_45/com/sun/org/apache/xpath/internal/compiler/XPathDumper.java,Java,,4,3,22,29
/jdk1.6.0_45/com/sun/org/apache/xpath/internal/compiler/XPathParser.java,Java,,1264,395,740,2399
/jdk1.6.0_45/com/sun/org/apache/xpath/internal/domapi/XPathEvaluatorImpl.java,Java,,68,26,175,269
/jdk1.6.0_45/com/sun/org/apache/xpath/internal/domapi/XPathExpressionImpl.java,Java,,60,18,103,181
/jdk1.6.0_45/com/sun/org/apache/xpath/internal/domapi/XPathNamespaceImpl.java,Java,,131,49,140,320
/jdk1.6.0_45/com/sun/org/apache/xpath/internal/domapi/XPathNSResolverImpl.java,Java,,12,6,41,59
/jdk1.6.0_45/com/sun/org/apache/xpath/internal/domapi/XPathResultImpl.java,Java,,232,60,216,508
/jdk1.6.0_45/com/sun/org/apache/xpath/internal/domapi/XPathStylesheetDOM3Exception.java,Java,,9,3,22,34
/jdk1.6.0_45/com/sun/org/apache/xpath/internal/Expression.java,Java,,194,56,337,587
/jdk1.6.0_45/com/sun/org/apache/xpath/internal/ExpressionNode.java,Java,,10,6,34,50
/jdk1.6.0_45/com/sun/org/apache/xpath/internal/ExpressionOwner.java,Java,,6,5,32,43
/jdk1.6.0_45/com/sun/org/apache/xpath/internal/ExtensionsProvider.java,Java,,16,7,35,58
/jdk1.6.0_45/com/sun/org/apache/xpath/internal/FoundIndex.java,Java,,6,2,27,35
/jdk1.6.0_45/com/sun/org/apache/xpath/internal/functions/FuncBoolean.java,Java,,12,4,30,46
/jdk1.6.0_45/com/sun/org/apache/xpath/internal/functions/FuncCeiling.java,Java,,12,3,30,45
/jdk1.6.0_45/com/sun/org/apache/xpath/internal/functions/FuncConcat.java,Java,,33,10,45,88
/jdk1.6.0_45/com/sun/org/apache/xpath/internal/functions/FuncContains.java,Java,,17,7,31,55
/jdk1.6.0_45/com/sun/org/apache/xpath/internal/functions/FuncCount.java,Java,,16,6,40,62
/jdk1.6.0_45/com/sun/org/apache/xpath/internal/functions/FuncCurrent.java,Java,,37,8,35,80
/jdk1.6.0_45/com/sun/org/apache/xpath/internal/functions/FuncDoclocation.java,Java,,27,8,34,69
/jdk1.6.0_45/com/sun/org/apache/xpath/internal/functions/FuncExtElementAvailable.java,Java,,41,8,46,95
/jdk1.6.0_45/com/sun/org/apache/xpath/internal/functions/FuncExtFunction.java,Java,,146,43,149,338
/jdk1.6.0_45/com/sun/org/apache/xpath/internal/functions/FuncExtFunctionAvailable.java,Java,,55,9,38,102
/jdk1.6.0_45/com/sun/org/apache/xpath/internal/functions/FuncFalse.java,Java,,15,5,34,54
/jdk1.6.0_45/com/sun/org/apache/xpath/internal/functions/FuncFloor.java,Java,,12,3,30,45
/jdk1.6.0_45/com/sun/org/apache/xpath/internal/functions/FuncGenerateId.java,Java,,19,5,36,60
/jdk1.6.0_45/com/sun/org/apache/xpath/internal/functions/FuncId.java,Java,,82,22,45,149
/jdk1.6.0_45/com/sun/org/apache/xpath/internal/functions/FuncLang.java,Java,,39,10,31,80
/jdk1.6.0_45/com/sun/org/apache/xpath/internal/functions/FuncLast.java,Java,,40,12,52,104
/jdk1.6.0_45/com/sun/org/apache/xpath/internal/functions/FuncLocalPart.java,Java,,20,5,30,55
/jdk1.6.0_45/com/sun/org/apache/xpath/internal/functions/FuncNamespace.java,Java,,35,9,32,76
/jdk1.6.0_45/com/sun/org/apache/xpath/internal/functions/FuncNormalizeSpace.java,Java,,36,6,42,84
/jdk1.6.0_45/com/sun/org/apache/xpath/internal/functions/FuncNot.java,Java,,12,3,30,45
/jdk1.6.0_45/com/sun/org/apache/xpath/internal/functions/FuncNumber.java,Java,,12,3,30,45
/jdk1.6.0_45/com/sun/org/apache/xpath/internal/functions/FuncPosition.java,Java,,60,14,58,132
/jdk1.6.0_45/com/sun/org/apache/xpath/internal/functions/FuncQname.java,Java,,25,6,30,61
/jdk1.6.0_45/com/sun/org/apache/xpath/internal/functions/FuncRound.java,Java,,17,3,30,50
/jdk1.6.0_45/com/sun/org/apache/xpath/internal/functions/FuncStartsWith.java,Java,,13,3,30,46
/jdk1.6.0_45/com/sun/org/apache/xpath/internal/functions/FuncString.java,Java,,12,3,30,45
/jdk1.6.0_45/com/sun/org/apache/xpath/internal/functions/FuncStringLength.java,Java,,12,3,30,45
/jdk1.6.0_45/com/sun/org/apache/xpath/internal/functions/FuncSubstring.java,Java,,61,14,47,122
/jdk1.6.0_45/com/sun/org/apache/xpath/internal/functions/FuncSubstringAfter.java,Java,,18,5,30,53
/jdk1.6.0_45/com/sun/org/apache/xpath/internal/functions/FuncSubstringBefore.java,Java,,16,5,30,51
/jdk1.6.0_45/com/sun/org/apache/xpath/internal/functions/FuncSum.java,Java,,26,7,30,63
/jdk1.6.0_45/com/sun/org/apache/xpath/internal/functions/FuncSystemProperty.java,Java,,111,23,50,184
/jdk1.6.0_45/com/sun/org/apache/xpath/internal/functions/Function.java,Java,,49,14,79,142
/jdk1.6.0_45/com/sun/org/apache/xpath/internal/functions/Function2Args.java,Java,,79,21,82,182
/jdk1.6.0_45/com/sun/org/apache/xpath/internal/functions/Function3Args.java,Java,,79,21,81,181
/jdk1.6.0_45/com/sun/org/apache/xpath/internal/functions/FunctionDef1Arg.java,Java,,68,13,84,165
/jdk1.6.0_45/com/sun/org/apache/xpath/internal/functions/FunctionMultiArgs.java,Java,,121,29,84,234
/jdk1.6.0_45/com/sun/org/apache/xpath/internal/functions/FunctionOneArg.java,Java,,71,20,81,172
/jdk1.6.0_45/com/sun/org/apache/xpath/internal/functions/FuncTranslate.java,Java,,34,11,41,86
/jdk1.6.0_45/com/sun/org/apache/xpath/internal/functions/FuncTrue.java,Java,,15,5,34,54
/jdk1.6.0_45/com/sun/org/apache/xpath/internal/functions/FuncUnparsedEntityURI.java,Java,,18,6,29,53
/jdk1.6.0_45/com/sun/org/apache/xpath/internal/functions/WrongNumberArgsException.java,Java,,9,3,29,41
/jdk1.6.0_45/com/sun/org/apache/xpath/internal/jaxp/JAXPExtensionsProvider.java,Java,,125,30,51,206
/jdk1.6.0_45/com/sun/org/apache/xpath/internal/jaxp/JAXPPrefixResolver.java,Java,,55,25,45,125
/jdk1.6.0_45/com/sun/org/apache/xpath/internal/jaxp/JAXPVariableStack.java,Java,,36,10,24,70
/jdk1.6.0_45/com/sun/org/apache/xpath/internal/jaxp/XPathExpressionImpl.java,Java,,179,32,161,372
/jdk1.6.0_45/com/sun/org/apache/xpath/internal/jaxp/XPathFactoryImpl.java,Java,,107,42,141,290
/jdk1.6.0_45/com/sun/org/apache/xpath/internal/jaxp/XPathImpl.java,Java,,254,49,227,530
/jdk1.6.0_45/com/sun/org/apache/xpath/internal/NodeSet.java,Java,,598,234,536,1368
/jdk1.6.0_45/com/sun/org/apache/xpath/internal/NodeSetDTM.java,Java,,399,167,679,1245
/jdk1.6.0_45/com/sun/org/apache/xpath/internal/objects/DTMXRTreeFrag.java,Java,,27,7,22,56
/jdk1.6.0_45/com/sun/org/apache/xpath/internal/objects/XBoolean.java,Java,,58,21,87,166
/jdk1.6.0_45/com/sun/org/apache/xpath/internal/objects/XBooleanStatic.java,Java,,22,6,39,67
/jdk1.6.0_45/com/sun/org/apache/xpath/internal/objects/XMLStringFactoryImpl.java,Java,,29,8,62,99
/jdk1.6.0_45/com/sun/org/apache/xpath/internal/objects/XNodeSet.java,Java,,407,101,454,962
/jdk1.6.0_45/com/sun/org/apache/xpath/internal/objects/XNodeSetForDOM.java,Java,,56,15,55,126
/jdk1.6.0_45/com/sun/org/apache/xpath/internal/objects/XNull.java,Java,,39,12,77,128
/jdk1.6.0_45/com/sun/org/apache/xpath/internal/objects/XNumber.java,Java,,136,43,256,435
/jdk1.6.0_45/com/sun/org/apache/xpath/internal/objects/XObject.java,Java,,284,105,364,753
/jdk1.6.0_45/com/sun/org/apache/xpath/internal/objects/XObjectFactory.java,Java,,107,11,41,159
/jdk1.6.0_45/com/sun/org/apache/xpath/internal/objects/XRTreeFrag.java,Java,,143,33,123,299
/jdk1.6.0_45/com/sun/org/apache/xpath/internal/objects/XRTreeFragSelectWrapper.java,Java,,59,14,79,152
/jdk1.6.0_45/com/sun/org/apache/xpath/internal/objects/XString.java,Java,,349,95,657,1101
/jdk1.6.0_45/com/sun/org/apache/xpath/internal/objects/XStringForChars.java,Java,,70,23,121,214
/jdk1.6.0_45/com/sun/org/apache/xpath/internal/objects/XStringForFSB.java,Java,,402,122,460,984
/jdk1.6.0_45/com/sun/org/apache/xpath/internal/operations/And.java,Java,,24,8,41,73
/jdk1.6.0_45/com/sun/org/apache/xpath/internal/operations/Bool.java,Java,,20,6,40,66
/jdk1.6.0_45/com/sun/org/apache/xpath/internal/operations/Div.java,Java,,18,6,41,65
/jdk1.6.0_45/com/sun/org/apache/xpath/internal/operations/Equals.java,Java,,23,6,43,72
/jdk1.6.0_45/com/sun/org/apache/xpath/internal/operations/Gt.java,Java,,12,3,32,47
/jdk1.6.0_45/com/sun/org/apache/xpath/internal/operations/Gte.java,Java,,13,3,32,48
/jdk1.6.0_45/com/sun/org/apache/xpath/internal/operations/Lt.java,Java,,12,3,32,47
/jdk1.6.0_45/com/sun/org/apache/xpath/internal/operations/Lte.java,Java,,12,3,32,47
/jdk1.6.0_45/com/sun/org/apache/xpath/internal/operations/Minus.java,Java,,18,6,42,66
/jdk1.6.0_45/com/sun/org/apache/xpath/internal/operations/Mod.java,Java,,18,6,41,65
/jdk1.6.0_45/com/sun/org/apache/xpath/internal/operations/Mult.java,Java,,18,5,41,64
/jdk1.6.0_45/com/sun/org/apache/xpath/internal/operations/Neg.java,Java,,17,6,40,63
/jdk1.6.0_45/com/sun/org/apache/xpath/internal/operations/NotEquals.java,Java,,12,3,32,47
/jdk1.6.0_45/com/sun/org/apache/xpath/internal/operations/Number.java,Java,,20,7,40,67
/jdk1.6.0_45/com/sun/org/apache/xpath/internal/operations/Operation.java,Java,,92,26,92,210
/jdk1.6.0_45/com/sun/org/apache/xpath/internal/operations/Or.java,Java,,24,8,41,73
/jdk1.6.0_45/com/sun/org/apache/xpath/internal/operations/Plus.java,Java,,18,6,41,65
/jdk1.6.0_45/com/sun/org/apache/xpath/internal/operations/Quo.java,Java,,12,4,34,50
/jdk1.6.0_45/com/sun/org/apache/xpath/internal/operations/String.java,Java,,11,3,31,45
/jdk1.6.0_45/com/sun/org/apache/xpath/internal/operations/UnaryOperation.java,Java,,59,21,81,161
/jdk1.6.0_45/com/sun/org/apache/xpath/internal/operations/Variable.java,Java,,130,46,219,395
/jdk1.6.0_45/com/sun/org/apache/xpath/internal/operations/VariableSafeAbsRef.java,Java,,24,6,42,72
/jdk1.6.0_45/com/sun/org/apache/xpath/internal/patterns/ContextMatchStepPattern.java,Java,,95,24,58,177
/jdk1.6.0_45/com/sun/org/apache/xpath/internal/patterns/FunctionPattern.java,Java,,112,40,94,246
/jdk1.6.0_45/com/sun/org/apache/xpath/internal/patterns/NodeTest.java,Java,,297,102,291,690
/jdk1.6.0_45/com/sun/org/apache/xpath/internal/patterns/NodeTestFilter.java,Java,,5,2,30,37
/jdk1.6.0_45/com/sun/org/apache/xpath/internal/patterns/StepPattern.java,Java,,601,136,314,1051
/jdk1.6.0_45/com/sun/org/apache/xpath/internal/patterns/UnionPattern.java,Java,,116,29,71,216
/jdk1.6.0_45/com/sun/org/apache/xpath/internal/res/XPATHErrorResources.java,Java,,545,185,200,930
/jdk1.6.0_45/com/sun/org/apache/xpath/internal/res/XPATHErrorResources_de.java,Java,,484,306,471,1261
/jdk1.6.0_45/com/sun/org/apache/xpath/internal/res/XPATHErrorResources_en.java,Java,,4,2,23,29
/jdk1.6.0_45/com/sun/org/apache/xpath/internal/res/XPATHErrorResources_es.java,Java,,484,307,471,1262
/jdk1.6.0_45/com/sun/org/apache/xpath/internal/res/XPATHErrorResources_fr.java,Java,,484,306,471,1261
/jdk1.6.0_45/com/sun/org/apache/xpath/internal/res/XPATHErrorResources_it.java,Java,,484,307,471,1262
/jdk1.6.0_45/com/sun/org/apache/xpath/internal/res/XPATHErrorResources_ja.java,Java,,484,306,471,1261
/jdk1.6.0_45/com/sun/org/apache/xpath/internal/res/XPATHErrorResources_ko.java,Java,,484,307,471,1262
/jdk1.6.0_45/com/sun/org/apache/xpath/internal/res/XPATHErrorResources_pt_BR.java,Java,,545,185,200,930
/jdk1.6.0_45/com/sun/org/apache/xpath/internal/res/XPATHErrorResources_sv.java,Java,,395,522,332,1249
/jdk1.6.0_45/com/sun/org/apache/xpath/internal/res/XPATHErrorResources_zh_CN.java,Java,,484,307,471,1262
/jdk1.6.0_45/com/sun/org/apache/xpath/internal/res/XPATHErrorResources_zh_TW.java,Java,,484,307,471,1262
/jdk1.6.0_45/com/sun/org/apache/xpath/internal/res/XPATHMessages.java,Java,,65,17,63,145
/jdk1.6.0_45/com/sun/org/apache/xpath/internal/SourceTree.java,Java,,11,5,34,50
/jdk1.6.0_45/com/sun/org/apache/xpath/internal/SourceTreeManager.java,Java,,191,54,143,388
/jdk1.6.0_45/com/sun/org/apache/xpath/internal/VariableStack.java,Java,,152,67,297,516
/jdk1.6.0_45/com/sun/org/apache/xpath/internal/WhitespaceStrippingElementMatcher.java,Java,,9,4,39,52
/jdk1.6.0_45/com/sun/org/apache/xpath/internal/XPath.java,Java,,292,80,269,641
/jdk1.6.0_45/com/sun/org/apache/xpath/internal/XPathAPI.java,Java,,73,27,181,281
/jdk1.6.0_45/com/sun/org/apache/xpath/internal/XPathContext.java,Java,,580,157,614,1351
/jdk1.6.0_45/com/sun/org/apache/xpath/internal/XPathException.java,Java,,161,57,108,326
/jdk1.6.0_45/com/sun/org/apache/xpath/internal/XPathFactory.java,Java,,8,4,36,48
/jdk1.6.0_45/com/sun/org/apache/xpath/internal/XPathProcessorException.java,Java,,13,4,35,52
/jdk1.6.0_45/com/sun/org/apache/xpath/internal/XPathVisitable.java,Java,,5,2,33,40
/jdk1.6.0_45/com/sun/org/apache/xpath/internal/XPathVisitor.java,Java,,63,17,121,201
/jdk1.6.0_45/com/sun/security/auth/callback/DialogCallbackHandler.java,Java,,196,43,59,298
/jdk1.6.0_45/com/sun/security/auth/callback/TextCallbackHandler.java,Java,,175,29,35,239
/jdk1.6.0_45/com/sun/security/auth/LdapPrincipal.java,Java,,42,14,64,120
/jdk1.6.0_45/com/sun/security/auth/login/ConfigFile.java,Java,,428,72,121,621
/jdk1.6.0_45/com/sun/security/auth/module/Crypt.java,Java,,263,55,68,386
/jdk1.6.0_45/com/sun/security/auth/module/JndiLoginModule.java,Java,,380,75,296,751
/jdk1.6.0_45/com/sun/security/auth/module/KeyStoreLoginModule.java,Java,,607,86,203,896
/jdk1.6.0_45/com/sun/security/auth/module/Krb5LoginModule.java,Java,defUsername,608,75,459,1142
/jdk1.6.0_45/com/sun/security/auth/module/LdapLoginModule.java,Java,,473,107,423,1003
/jdk1.6.0_45/com/sun/security/auth/module/NTLoginModule.java,Java,,229,32,119,380
/jdk1.6.0_45/com/sun/security/auth/module/NTSystem.java,Java,,47,15,66,128
/jdk1.6.0_45/com/sun/security/auth/module/SolarisLoginModule.java,Java,,151,25,122,298
/jdk1.6.0_45/com/sun/security/auth/module/SolarisSystem.java,Java,,26,10,44,80
/jdk1.6.0_45/com/sun/security/auth/module/UnixLoginModule.java,Java,,149,25,117,291
/jdk1.6.0_45/com/sun/security/auth/module/UnixSystem.java,Java,,26,10,44,80
/jdk1.6.0_45/com/sun/security/auth/NTDomainPrincipal.java,Java,,43,13,75,131
/jdk1.6.0_45/com/sun/security/auth/NTNumericCredential.java,Java,,33,12,57,102
/jdk1.6.0_45/com/sun/security/auth/NTSid.java,Java,,50,13,78,141
/jdk1.6.0_45/com/sun/security/auth/NTSidDomainPrincipal.java,Java,,24,9,58,91
/jdk1.6.0_45/com/sun/security/auth/NTSidGroupPrincipal.java,Java,,24,10,53,87
/jdk1.6.0_45/com/sun/security/auth/NTSidPrimaryGroupPrincipal.java,Java,,24,10,56,90
/jdk1.6.0_45/com/sun/security/auth/NTSidUserPrincipal.java,Java,,24,9,52,85
/jdk1.6.0_45/com/sun/security/auth/NTUserPrincipal.java,Java,,43,13,69,125
/jdk1.6.0_45/com/sun/security/auth/PolicyFile.java,Java,,760,138,556,1454
/jdk1.6.0_45/com/sun/security/auth/PolicyParser.java,Java,,611,106,229,946
/jdk1.6.0_45/com/sun/security/auth/PrincipalComparator.java,Java,,4,2,41,47
/jdk1.6.0_45/com/sun/security/auth/SolarisNumericGroupPrincipal.java,Java,,60,19,120,199
/jdk1.6.0_45/com/sun/security/auth/SolarisNumericUserPrincipal.java,Java,,49,18,98,165
/jdk1.6.0_45/com/sun/security/auth/SolarisPrincipal.java,Java,,41,16,72,129
/jdk1.6.0_45/com/sun/security/auth/SubjectCodeSource.java,Java,,191,44,150,385
/jdk1.6.0_45/com/sun/security/auth/UnixNumericGroupPrincipal.java,Java,,67,19,116,202
/jdk1.6.0_45/com/sun/security/auth/UnixNumericUserPrincipal.java,Java,,51,15,95,161
/jdk1.6.0_45/com/sun/security/auth/UnixPrincipal.java,Java,,43,14,69,126
/jdk1.6.0_45/com/sun/security/auth/UserPrincipal.java,Java,,30,10,54,94
/jdk1.6.0_45/com/sun/security/auth/X500Principal.java,Java,,61,20,86,167
/jdk1.6.0_45/com/sun/security/jgss/GSSUtil.java,Java,,11,5,38,54
/jdk1.6.0_45/com/sun/source/tree/AnnotationTree.java,Java,,6,3,24,33
/jdk1.6.0_45/com/sun/source/tree/ArrayAccessTree.java,Java,,5,2,23,30
/jdk1.6.0_45/com/sun/source/tree/ArrayTypeTree.java,Java,,4,2,23,29
/jdk1.6.0_45/com/sun/source/tree/AssertTree.java,Java,,5,2,25,32
/jdk1.6.0_45/com/sun/source/tree/AssignmentTree.java,Java,,5,2,23,30
/jdk1.6.0_45/com/sun/source/tree/BinaryTree.java,Java,,5,2,24,31
/jdk1.6.0_45/com/sun/source/tree/BlockTree.java,Java,,6,3,27,36
/jdk1.6.0_45/com/sun/source/tree/BreakTree.java,Java,,5,3,25,33
/jdk1.6.0_45/com/sun/source/tree/CaseTree.java,Java,,6,3,30,39
/jdk1.6.0_45/com/sun/source/tree/CatchTree.java,Java,,5,2,24,31
/jdk1.6.0_45/com/sun/source/tree/ClassTree.java,Java,,11,3,30,44
/jdk1.6.0_45/com/sun/source/tree/CompilationUnitTree.java,Java,,12,4,23,39
/jdk1.6.0_45/com/sun/source/tree/CompoundAssignmentTree.java,Java,,5,2,24,31
/jdk1.6.0_45/com/sun/source/tree/ConditionalExpressionTree.java,Java,,6,2,23,31
/jdk1.6.0_45/com/sun/source/tree/ContinueTree.java,Java,,5,3,24,32
/jdk1.6.0_45/com/sun/source/tree/DoWhileLoopTree.java,Java,,5,2,25,32
/jdk1.6.0_45/com/sun/source/tree/EmptyStatementTree.java,Java,,2,2,23,27
/jdk1.6.0_45/com/sun/source/tree/EnhancedForLoopTree.java,Java,,6,2,24,32
/jdk1.6.0_45/com/sun/source/tree/ErroneousTree.java,Java,,5,3,16,24
/jdk1.6.0_45/com/sun/source/tree/ExpressionStatementTree.java,Java,,4,2,23,29
/jdk1.6.0_45/com/sun/source/tree/ExpressionTree.java,Java,,2,2,19,23
/jdk1.6.0_45/com/sun/source/tree/ForLoopTree.java,Java,,8,3,24,35
/jdk1.6.0_45/com/sun/source/tree/IdentifierTree.java,Java,,5,3,23,31
/jdk1.6.0_45/com/sun/source/tree/IfTree.java,Java,,6,2,32,40
/jdk1.6.0_45/com/sun/source/tree/ImportTree.java,Java,,5,2,29,36
/jdk1.6.0_45/com/sun/source/tree/InstanceOfTree.java,Java,,5,2,23,30
/jdk1.6.0_45/com/sun/source/tree/LabeledStatementTree.java,Java,,6,3,23,32
/jdk1.6.0_45/com/sun/source/tree/LineMap.java,Java,,7,6,50,63
/jdk1.6.0_45/com/sun/source/tree/LiteralTree.java,Java,,4,2,24,30
/jdk1.6.0_45/com/sun/source/tree/MemberSelectTree.java,Java,,6,3,24,33
/jdk1.6.0_45/com/sun/source/tree/MethodInvocationTree.java,Java,,7,3,25,35
/jdk1.6.0_45/com/sun/source/tree/MethodTree.java,Java,,13,3,28,44
/jdk1.6.0_45/com/sun/source/tree/ModifiersTree.java,Java,,8,3,26,37
/jdk1.6.0_45/com/sun/source/tree/NewArrayTree.java,Java,,7,3,25,35
/jdk1.6.0_45/com/sun/source/tree/NewClassTree.java,Java,,9,3,30,42
/jdk1.6.0_45/com/sun/source/tree/package-info.java,Java,,1,1,17,19
/jdk1.6.0_45/com/sun/source/tree/ParameterizedTypeTree.java,Java,,6,3,23,32
/jdk1.6.0_45/com/sun/source/tree/ParenthesizedTree.java,Java,,4,2,24,30
/jdk1.6.0_45/com/sun/source/tree/PrimitiveTypeTree.java,Java,,5,3,23,31
/jdk1.6.0_45/com/sun/source/tree/ReturnTree.java,Java,,4,2,24,30
/jdk1.6.0_45/com/sun/source/tree/Scope.java,Java,,12,6,40,58
/jdk1.6.0_45/com/sun/source/tree/StatementTree.java,Java,,2,2,19,23
/jdk1.6.0_45/com/sun/source/tree/SwitchTree.java,Java,,6,3,25,34
/jdk1.6.0_45/com/sun/source/tree/SynchronizedTree.java,Java,,5,2,24,31
/jdk1.6.0_45/com/sun/source/tree/ThrowTree.java,Java,,4,2,23,29
/jdk1.6.0_45/com/sun/source/tree/Tree.java,Java,,106,100,364,570
/jdk1.6.0_45/com/sun/source/tree/TreeVisitor.java,Java,,51,2,40,93
/jdk1.6.0_45/com/sun/source/tree/TryTree.java,Java,,7,3,27,37
/jdk1.6.0_45/com/sun/source/tree/TypeCastTree.java,Java,,5,2,23,30
/jdk1.6.0_45/com/sun/source/tree/TypeParameterTree.java,Java,,7,3,25,35
/jdk1.6.0_45/com/sun/source/tree/UnaryTree.java,Java,,4,2,26,32
/jdk1.6.0_45/com/sun/source/tree/VariableTree.java,Java,,8,3,23,34
/jdk1.6.0_45/com/sun/source/tree/WhileLoopTree.java,Java,,5,2,25,32
/jdk1.6.0_45/com/sun/source/tree/WildcardTree.java,Java,,4,2,28,34
/jdk1.6.0_45/com/sun/source/util/JavacTask.java,Java,,20,9,47,76
/jdk1.6.0_45/com/sun/source/util/package-info.java,Java,,1,1,16,18
/jdk1.6.0_45/com/sun/source/util/SimpleTreeVisitor.java,Java,,168,56,15,239
/jdk1.6.0_45/com/sun/source/util/SourcePositions.java,Java,,6,6,59,71
/jdk1.6.0_45/com/sun/source/util/TaskEvent.java,Java,,55,14,38,107
/jdk1.6.0_45/com/sun/source/util/TaskListener.java,Java,,6,4,15,25
/jdk1.6.0_45/com/sun/source/util/TreePath.java,Java,,73,15,39,127
/jdk1.6.0_45/com/sun/source/util/TreePathScanner.java,Java,,28,8,31,67
/jdk1.6.0_45/com/sun/source/util/Trees.java,Java,,54,21,90,165
/jdk1.6.0_45/com/sun/source/util/TreeScanner.java,Java,,246,58,62,366
/jdk1.6.0_45/java/applet/Applet.java,Java,,143,37,381,561
/jdk1.6.0_45/java/applet/AppletContext.java,Java,,21,12,144,177
/jdk1.6.0_45/java/applet/AppletStub.java,Java,,10,8,76,94
/jdk1.6.0_45/java/applet/AudioClip.java,Java,,6,4,26,36
/jdk1.6.0_45/java/awt/ActiveEvent.java,Java,,4,3,35,42
/jdk1.6.0_45/java/awt/Adjustable.java,Java,,22,23,97,142
/jdk1.6.0_45/java/awt/AlphaComposite.java,Java,,120,46,622,788
/jdk1.6.0_45/java/awt/AttributeValue.java,Java,,21,5,8,34
/jdk1.6.0_45/java/awt/AWTError.java,Java,,7,4,21,32
/jdk1.6.0_45/java/awt/AWTEvent.java,Java,,309,71,218,598
/jdk1.6.0_45/java/awt/AWTEventMulticaster.java,Java,,366,88,561,1015
/jdk1.6.0_45/java/awt/AWTException.java,Java,,7,4,23,34
/jdk1.6.0_45/java/awt/AWTKeyStroke.java,Java,,459,69,346,874
/jdk1.6.0_45/java/awt/AWTPermission.java,Java,,13,9,190,212
/jdk1.6.0_45/java/awt/BasicStroke.java,Java,,270,58,258,586
/jdk1.6.0_45/java/awt/BorderLayout.java,Java,,335,57,478,870
/jdk1.6.0_45/java/awt/BufferCapabilities.java,Java,,60,21,118,199
/jdk1.6.0_45/java/awt/Button.java,Java,[PENDING:  WDW -- need to provide a localized string,205,54,399,658
/jdk1.6.0_45/java/awt/Canvas.java,Java,,60,19,147,226
/jdk1.6.0_45/java/awt/CardLayout.java,Java,,318,48,226,592
/jdk1.6.0_45/java/awt/Checkbox.java,Java,,281,70,498,849
/jdk1.6.0_45/java/awt/CheckboxGroup.java,Java,,34,9,90,133
/jdk1.6.0_45/java/awt/CheckboxMenuItem.java,Java,,191,51,382,624
/jdk1.6.0_45/java/awt/Choice.java,Java,,255,65,474,794
/jdk1.6.0_45/java/awt/color/CMMException.java,Java,,6,7,29,42
/jdk1.6.0_45/java/awt/color/ColorSpace.java,Java,,187,76,330,593
/jdk1.6.0_45/java/awt/color/ICC_ColorSpace.java,Java,,200,36,353,589
/jdk1.6.0_45/java/awt/color/ICC_Profile.java,Java,,878,348,834,2060
/jdk1.6.0_45/java/awt/color/ICC_ProfileGray.java,Java,,25,18,88,131
/jdk1.6.0_45/java/awt/color/ICC_ProfileRGB.java,Java,,73,34,156,263
/jdk1.6.0_45/java/awt/color/ProfileDataException.java,Java,,6,4,14,24
/jdk1.6.0_45/java/awt/Color.java,Java,,467,81,677,1225
/jdk1.6.0_45/java/awt/ColorPaintContext.java,Java,,31,11,6,48
/jdk1.6.0_45/java/awt/Component.java,Java,,4509,766,4748,10023
/jdk1.6.0_45/java/awt/ComponentOrientation.java,Java,,54,16,114,184
/jdk1.6.0_45/java/awt/Composite.java,Java,,7,5,57,69
/jdk1.6.0_45/java/awt/CompositeContext.java,Java,,9,8,35,52
/jdk1.6.0_45/java/awt/Conditional.java,Java,,4,2,14,20
/jdk1.6.0_45/java/awt/Container.java,Java,,2388,353,1906,4647
/jdk1.6.0_45/java/awt/ContainerOrderFocusTraversalPolicy.java,Java,,294,36,153,483
/jdk1.6.0_45/java/awt/Cursor.java,Java,,240,70,142,452
/jdk1.6.0_45/java/awt/datatransfer/Clipboard.java,Java,,116,33,192,341
/jdk1.6.0_45/java/awt/datatransfer/ClipboardOwner.java,Java,,4,5,30,39
/jdk1.6.0_45/java/awt/datatransfer/DataFlavor.java,Java,,501,124,755,1380
/jdk1.6.0_45/java/awt/datatransfer/FlavorEvent.java,Java,,7,3,22,32
/jdk1.6.0_45/java/awt/datatransfer/FlavorListener.java,Java,,5,3,30,38
/jdk1.6.0_45/java/awt/datatransfer/FlavorMap.java,Java,,6,6,46,58
/jdk1.6.0_45/java/awt/datatransfer/FlavorTable.java,Java,,6,6,53,65
/jdk1.6.0_45/java/awt/datatransfer/MimeType.java,Java,,171,40,164,375
/jdk1.6.0_45/java/awt/datatransfer/MimeTypeParameterList.java,Java,,244,56,89,389
/jdk1.6.0_45/java/awt/datatransfer/MimeTypeParseException.java,Java,,10,6,21,37
/jdk1.6.0_45/java/awt/datatransfer/StringSelection.java,Java,,38,11,73,122
/jdk1.6.0_45/java/awt/datatransfer/SystemFlavorMap.java,Java,,707,113,462,1282
/jdk1.6.0_45/java/awt/datatransfer/Transferable.java,Java,,7,8,41,56
/jdk1.6.0_45/java/awt/datatransfer/UnsupportedFlavorException.java,Java,,7,4,22,33
/jdk1.6.0_45/java/awt/DefaultFocusTraversalPolicy.java,Java,,33,7,71,111
/jdk1.6.0_45/java/awt/DefaultKeyboardFocusManager.java,Java,,874,129,344,1347
/jdk1.6.0_45/java/awt/Desktop.java,Java,,154,31,281,466
/jdk1.6.0_45/java/awt/Dialog.java,Java,,680,120,918,1718
/jdk1.6.0_45/java/awt/Dimension.java,Java,,58,20,142,220
/jdk1.6.0_45/java/awt/DisplayMode.java,Java,,45,14,79,138
/jdk1.6.0_45/java/awt/dnd/Autoscroll.java,Java,,7,9,47,63
/jdk1.6.0_45/java/awt/dnd/DnDConstants.java,Java,,10,14,44,68
/jdk1.6.0_45/java/awt/dnd/DnDEventMulticaster.java,Java,,82,19,116,217
/jdk1.6.0_45/java/awt/dnd/DragGestureEvent.java,Java,,88,55,197,340
/jdk1.6.0_45/java/awt/dnd/DragGestureListener.java,Java,,5,8,28,41
/jdk1.6.0_45/java/awt/dnd/DragGestureRecognizer.java,Java,,94,57,295,446
/jdk1.6.0_45/java/awt/dnd/DragSource.java,Java,,264,75,560,899
/jdk1.6.0_45/java/awt/dnd/DragSourceAdapter.java,Java,,10,8,107,125
/jdk1.6.0_45/java/awt/dnd/DragSourceContext.java,Java,,214,81,303,598
/jdk1.6.0_45/java/awt/dnd/DragSourceDragEvent.java,Java,,97,26,188,311
/jdk1.6.0_45/java/awt/dnd/DragSourceDropEvent.java,Java,,23,19,109,151
/jdk1.6.0_45/java/awt/dnd/DragSourceEvent.java,Java,,37,18,113,168
/jdk1.6.0_45/java/awt/dnd/DragSourceListener.java,Java,,9,15,91,115
/jdk1.6.0_45/java/awt/dnd/DragSourceMotionListener.java,Java,,5,5,34,44
/jdk1.6.0_45/java/awt/dnd/DropTarget.java,Java,,303,140,399,842
/jdk1.6.0_45/java/awt/dnd/DropTargetAdapter.java,Java,,7,6,79,92
/jdk1.6.0_45/java/awt/dnd/DropTargetContext.java,Java,,131,65,207,403
/jdk1.6.0_45/java/awt/dnd/DropTargetDragEvent.java,Java,,47,31,148,226
/jdk1.6.0_45/java/awt/dnd/DropTargetDropEvent.java,Java,,59,43,181,283
/jdk1.6.0_45/java/awt/dnd/DropTargetEvent.java,Java,,18,14,36,68
/jdk1.6.0_45/java/awt/dnd/DropTargetListener.java,Java,,12,22,109,143
/jdk1.6.0_45/java/awt/dnd/InvalidDnDOperationException.java,Java,,6,12,23,41
/jdk1.6.0_45/java/awt/dnd/MouseDragGestureRecognizer.java,Java,,35,35,123,193
/jdk1.6.0_45/java/awt/dnd/peer/DragSourceContextPeer.java,Java,,19,15,29,63
/jdk1.6.0_45/java/awt/dnd/peer/DropTargetContextPeer.java,Java,,23,30,49,102
/jdk1.6.0_45/java/awt/dnd/peer/DropTargetPeer.java,Java,,6,8,28,42
/jdk1.6.0_45/java/awt/dnd/SerializationTester.java,Java,,33,6,17,56
/jdk1.6.0_45/java/awt/event/ActionEvent.java,Java,,50,22,172,244
/jdk1.6.0_45/java/awt/event/ActionListener.java,Java,,5,5,25,35
/jdk1.6.0_45/java/awt/event/AdjustmentEvent.java,Java,,75,26,140,241
/jdk1.6.0_45/java/awt/event/AdjustmentListener.java,Java,,5,5,16,26
/jdk1.6.0_45/java/awt/event/AWTEventListener.java,Java,,6,5,34,45
/jdk1.6.0_45/java/awt/event/AWTEventListenerProxy.java,Java,,19,7,36,62
/jdk1.6.0_45/java/awt/event/ComponentAdapter.java,Java,,7,5,43,55
/jdk1.6.0_45/java/awt/event/ComponentEvent.java,Java,,45,14,83,142
/jdk1.6.0_45/java/awt/event/ComponentListener.java,Java,,8,6,43,57
/jdk1.6.0_45/java/awt/event/ContainerAdapter.java,Java,,5,3,37,45
/jdk1.6.0_45/java/awt/event/ContainerEvent.java,Java,,36,13,86,135
/jdk1.6.0_45/java/awt/event/ContainerListener.java,Java,,6,5,38,49
/jdk1.6.0_45/java/awt/event/FocusAdapter.java,Java,,5,3,37,45
/jdk1.6.0_45/java/awt/event/FocusEvent.java,Java,,53,19,146,218
/jdk1.6.0_45/java/awt/event/FocusListener.java,Java,,6,5,33,44
/jdk1.6.0_45/java/awt/event/HierarchyBoundsAdapter.java,Java,,6,3,35,44
/jdk1.6.0_45/java/awt/event/HierarchyBoundsListener.java,Java,,6,4,35,45
/jdk1.6.0_45/java/awt/event/HierarchyEvent.java,Java,,86,19,186,291
/jdk1.6.0_45/java/awt/event/HierarchyListener.java,Java,,5,3,32,40
/jdk1.6.0_45/java/awt/event/InputEvent.java,Java,,128,44,215,387
/jdk1.6.0_45/java/awt/event/InputMethodEvent.java,Java,,129,32,239,400
/jdk1.6.0_45/java/awt/event/InputMethodListener.java,Java,,6,7,26,39
/jdk1.6.0_45/java/awt/event/InvocationEvent.java,Java,,72,22,178,272
/jdk1.6.0_45/java/awt/event/ItemEvent.java,Java,,51,18,101,170
/jdk1.6.0_45/java/awt/event/ItemListener.java,Java,,5,5,29,39
/jdk1.6.0_45/java/awt/event/KeyAdapter.java,Java,,6,4,42,52
/jdk1.6.0_45/java/awt/event/KeyEvent.java,Java,,694,165,738,1597
/jdk1.6.0_45/java/awt/event/KeyListener.java,Java,,7,6,43,56
/jdk1.6.0_45/java/awt/event/MouseAdapter.java,Java,,11,9,76,96
/jdk1.6.0_45/java/awt/event/MouseEvent.java,Java,,300,54,538,892
/jdk1.6.0_45/java/awt/event/MouseListener.java,Java,,9,8,50,67
/jdk1.6.0_45/java/awt/event/MouseMotionAdapter.java,Java,,5,3,46,54
/jdk1.6.0_45/java/awt/event/MouseMotionListener.java,Java,,6,6,46,58
/jdk1.6.0_45/java/awt/event/MouseWheelEvent.java,Java,,57,25,262,344
/jdk1.6.0_45/java/awt/event/MouseWheelListener.java,Java,,5,4,32,41
/jdk1.6.0_45/java/awt/event/NativeLibLoader.java,Java,,7,3,31,41
/jdk1.6.0_45/java/awt/event/PaintEvent.java,Java,,36,13,66,115
/jdk1.6.0_45/java/awt/event/TextEvent.java,Java,,23,13,57,93
/jdk1.6.0_45/java/awt/event/TextListener.java,Java,,5,5,29,39
/jdk1.6.0_45/java/awt/event/WindowAdapter.java,Java,,15,11,74,100
/jdk1.6.0_45/java/awt/event/WindowEvent.java,Java,,99,32,256,387
/jdk1.6.0_45/java/awt/event/WindowFocusListener.java,Java,,6,5,41,52
/jdk1.6.0_45/java/awt/event/WindowListener.java,Java,,11,9,66,86
/jdk1.6.0_45/java/awt/event/WindowStateListener.java,Java,,5,3,29,37
/jdk1.6.0_45/java/awt/Event.java,Java,,230,106,526,862
/jdk1.6.0_45/java/awt/EventDispatchThread.java,Java,,287,46,126,459
/jdk1.6.0_45/java/awt/EventFilter.java,Java,,9,3,31,43
/jdk1.6.0_45/java/awt/EventQueue.java,Java,,665,94,372,1131
/jdk1.6.0_45/java/awt/FileDialog.java,Java,,123,33,293,449
/jdk1.6.0_45/java/awt/FlowLayout.java,Java,,275,52,354,681
/jdk1.6.0_45/java/awt/FocusTraversalPolicy.java,Java,,20,7,131,158
/jdk1.6.0_45/java/awt/font/CharArrayIterator.java,Java,,84,26,58,168
/jdk1.6.0_45/java/awt/font/FontRenderContext.java,Java,,143,20,177,340
/jdk1.6.0_45/java/awt/font/GlyphJustificationInfo.java,Java,,60,23,111,194
/jdk1.6.0_45/java/awt/font/GlyphMetrics.java,Java,,69,30,208,307
/jdk1.6.0_45/java/awt/font/GlyphVector.java,Java,,82,41,471,594
/jdk1.6.0_45/java/awt/font/GraphicAttribute.java,Java,,52,23,128,203
/jdk1.6.0_45/java/awt/font/ImageGraphicAttribute.java,Java,,68,36,107,211
/jdk1.6.0_45/java/awt/font/LayoutPath.java,Java,,7,4,56,67
/jdk1.6.0_45/java/awt/font/LineBreakMeasurer.java,Java,,113,36,367,516
/jdk1.6.0_45/java/awt/font/LineMetrics.java,Java,,14,16,98,128
/jdk1.6.0_45/java/awt/font/MultipleMaster.java,Java,,15,10,64,89
/jdk1.6.0_45/java/awt/font/NumericShaper.java,Java,,663,81,213,957
/jdk1.6.0_45/java/awt/font/OpenType.java,Java,,61,64,291,416
/jdk1.6.0_45/java/awt/font/ShapeGraphicAttribute.java,Java,,87,36,115,238
/jdk1.6.0_45/java/awt/font/StyledParagraph.java,Java,,275,61,131,467
/jdk1.6.0_45/java/awt/font/TextAttribute.java,Java,,145,73,881,1099
/jdk1.6.0_45/java/awt/font/TextHitInfo.java,Java,,54,18,157,229
/jdk1.6.0_45/java/awt/font/TextJustifier.java,Java,,146,26,50,222
/jdk1.6.0_45/java/awt/font/TextLayout.java,Java,,1278,326,1131,2735
/jdk1.6.0_45/java/awt/font/TextLine.java,Java,,988,275,145,1408
/jdk1.6.0_45/java/awt/font/TextMeasurer.java,Java,,401,118,223,742
/jdk1.6.0_45/java/awt/font/TransformAttribute.java,Java,,51,14,72,137
/jdk1.6.0_45/java/awt/Font.java,Java,,952,186,1429,2567
/jdk1.6.0_45/java/awt/FontFormatException.java,Java,,8,3,23,34
/jdk1.6.0_45/java/awt/FontMetrics.java,Java,,150,39,436,625
/jdk1.6.0_45/java/awt/Frame.java,Java,,426,95,666,1187
/jdk1.6.0_45/java/awt/geom/AffineTransform.java,Java,,2117,150,1637,3904
/jdk1.6.0_45/java/awt/geom/Arc2D.java,Java,,552,102,803,1457
/jdk1.6.0_45/java/awt/geom/ArcIterator.java,Java,,143,10,142,295
/jdk1.6.0_45/java/awt/geom/Area.java,Java,,314,38,374,726
/jdk1.6.0_45/java/awt/geom/CubicCurve2D.java,Java,,669,115,895,1679
/jdk1.6.0_45/java/awt/geom/CubicIterator.java,Java,,66,9,64,139
/jdk1.6.0_45/java/awt/geom/Dimension2D.java,Java,,18,8,71,97
/jdk1.6.0_45/java/awt/geom/Ellipse2D.java,Java,,159,39,249,447
/jdk1.6.0_45/java/awt/geom/EllipseIterator.java,Java,,91,11,70,172
/jdk1.6.0_45/java/awt/geom/FlatteningPathIterator.java,Java,,184,36,158,378
/jdk1.6.0_45/java/awt/geom/GeneralPath.java,Java,,29,9,72,110
/jdk1.6.0_45/java/awt/geom/IllegalPathStateException.java,Java,,8,4,27,39
/jdk1.6.0_45/java/awt/geom/Line2D.java,Java,,306,74,731,1111
/jdk1.6.0_45/java/awt/geom/LineIterator.java,Java,,58,9,64,131
/jdk1.6.0_45/java/awt/geom/NoninvertibleTransformException.java,Java,,6,3,20,29
/jdk1.6.0_45/java/awt/geom/Path2D.java,Java,,1303,137,1138,2578
/jdk1.6.0_45/java/awt/geom/PathIterator.java,Java,,15,13,170,198
/jdk1.6.0_45/java/awt/geom/Point2D.java,Java,,117,36,258,411
/jdk1.6.0_45/java/awt/geom/QuadCurve2D.java,Java,,505,104,775,1384
/jdk1.6.0_45/java/awt/geom/QuadIterator.java,Java,,62,9,64,135
/jdk1.6.0_45/java/awt/geom/Rectangle2D.java,Java,,317,68,528,913
/jdk1.6.0_45/java/awt/geom/RectangularShape.java,Java,,101,29,248,378
/jdk1.6.0_45/java/awt/geom/RectIterator.java,Java,,66,9,64,139
/jdk1.6.0_45/java/awt/geom/RoundRectangle2D.java,Java,,250,55,359,664
/jdk1.6.0_45/java/awt/geom/RoundRectIterator.java,Java,,92,11,69,172
/jdk1.6.0_45/java/awt/GradientPaint.java,Java,,85,19,141,245
/jdk1.6.0_45/java/awt/GradientPaintContext.java,Java,,209,23,44,276
/jdk1.6.0_45/java/awt/Graphics.java,Java,,164,57,1018,1239
/jdk1.6.0_45/java/awt/Graphics2D.java,Java,,99,47,1071,1217
/jdk1.6.0_45/java/awt/GraphicsCallback.java,Java,,109,13,6,128
/jdk1.6.0_45/java/awt/GraphicsConfigTemplate.java,Java,,15,11,70,96
/jdk1.6.0_45/java/awt/GraphicsConfiguration.java,Java,,92,27,297,416
/jdk1.6.0_45/java/awt/GraphicsDevice.java,Java,,88,24,312,424
/jdk1.6.0_45/java/awt/GraphicsEnvironment.java,Java,,113,29,269,411
/jdk1.6.0_45/java/awt/GridBagConstraints.java,Java,,100,53,493,646
/jdk1.6.0_45/java/awt/GridBagLayout.java,Java,,1060,158,993,2211
/jdk1.6.0_45/java/awt/GridBagLayoutInfo.java,Java,,23,5,34,62
/jdk1.6.0_45/java/awt/GridLayout.java,Java,,155,24,276,455
/jdk1.6.0_45/java/awt/HeadlessException.java,Java,,19,3,17,39
/jdk1.6.0_45/java/awt/IllegalComponentStateException.java,Java,,10,4,26,40
/jdk1.6.0_45/java/awt/im/InputContext.java,Java,,39,18,263,320
/jdk1.6.0_45/java/awt/im/InputMethodHighlight.java,Java,,48,21,109,178
/jdk1.6.0_45/java/awt/im/InputMethodRequests.java,Java,,15,11,165,191
/jdk1.6.0_45/java/awt/im/InputSubset.java,Java,,24,15,58,97
/jdk1.6.0_45/java/awt/im/spi/InputMethod.java,Java,,23,22,320,365
/jdk1.6.0_45/java/awt/im/spi/InputMethodContext.java,Java,,15,8,100,123
/jdk1.6.0_45/java/awt/im/spi/InputMethodDescriptor.java,Java,,11,10,85,106
/jdk1.6.0_45/java/awt/image/AffineTransformOp.java,Java,,273,39,231,543
/jdk1.6.0_45/java/awt/image/AreaAveragingScaleFilter.java,Java,,164,11,89,264
/jdk1.6.0_45/java/awt/image/BandCombineOp.java,Java,,132,15,125,272
/jdk1.6.0_45/java/awt/image/BandedSampleModel.java,Java,,387,92,342,821
/jdk1.6.0_45/java/awt/image/BufferedImage.java,Java,,712,127,753,1592
/jdk1.6.0_45/java/awt/image/BufferedImageFilter.java,Java,,263,15,122,400
/jdk1.6.0_45/java/awt/image/BufferedImageOp.java,Java,,12,7,100,119
/jdk1.6.0_45/java/awt/image/BufferStrategy.java,Java,,13,10,162,185
/jdk1.6.0_45/java/awt/image/ByteLookupTable.java,Java,,79,13,101,193
/jdk1.6.0_45/java/awt/image/ColorConvertOp.java,Java,,730,82,273,1085
/jdk1.6.0_45/java/awt/image/ColorModel.java,Java,,702,89,1145,1936
/jdk1.6.0_45/java/awt/image/ComponentColorModel.java,Java,,1824,80,1028,2932
/jdk1.6.0_45/java/awt/image/ComponentSampleModel.java,Java,,596,112,476,1184
/jdk1.6.0_45/java/awt/image/ConvolveOp.java,Java,,134,31,149,314
/jdk1.6.0_45/java/awt/image/CropImageFilter.java,Java,,86,11,79,176
/jdk1.6.0_45/java/awt/image/DataBuffer.java,Java,,127,40,240,407
/jdk1.6.0_45/java/awt/image/DataBufferByte.java,Java,,63,18,130,211
/jdk1.6.0_45/java/awt/image/DataBufferDouble.java,Java,,86,26,210,322
/jdk1.6.0_45/java/awt/image/DataBufferFloat.java,Java,,86,26,213,325
/jdk1.6.0_45/java/awt/image/DataBufferInt.java,Java,,63,19,128,210
/jdk1.6.0_45/java/awt/image/DataBufferShort.java,Java,,63,19,127,209
/jdk1.6.0_45/java/awt/image/DataBufferUShort.java,Java,,94,21,129,244
/jdk1.6.0_45/java/awt/image/DirectColorModel.java,Java,,715,56,629,1400
/jdk1.6.0_45/java/awt/image/FilteredImageSource.java,Java,,60,10,122,192
/jdk1.6.0_45/java/awt/image/ImageConsumer.java,Java,,22,18,169,209
/jdk1.6.0_45/java/awt/image/ImageFilter.java,Java,,52,13,176,241
/jdk1.6.0_45/java/awt/image/ImageObserver.java,Java,,14,11,128,153
/jdk1.6.0_45/java/awt/image/ImageProducer.java,Java,,8,6,81,95
/jdk1.6.0_45/java/awt/image/ImagingOpException.java,Java,,6,4,18,28
/jdk1.6.0_45/java/awt/image/IndexColorModel.java,Java,,684,79,754,1517
/jdk1.6.0_45/java/awt/image/Kernel.java,Java,,59,19,64,142
/jdk1.6.0_45/java/awt/image/LookupOp.java,Java,,331,52,169,552
/jdk1.6.0_45/java/awt/image/LookupTable.java,Java,,25,10,57,92
/jdk1.6.0_45/java/awt/image/MemoryImageSource.java,Java,,220,24,310,554
/jdk1.6.0_45/java/awt/image/MultiPixelPackedSampleModel.java,Java,,291,60,330,681
/jdk1.6.0_45/java/awt/image/PackedColorModel.java,Java,,208,35,221,464
/jdk1.6.0_45/java/awt/image/PixelGrabber.java,Java,,308,28,319,655
/jdk1.6.0_45/java/awt/image/PixelInterleavedSampleModel.java,Java,,67,6,80,153
/jdk1.6.0_45/java/awt/image/Raster.java,Java,,649,138,990,1777
/jdk1.6.0_45/java/awt/image/RasterFormatException.java,Java,,6,4,17,27
/jdk1.6.0_45/java/awt/image/RasterOp.java,Java,,11,7,72,90
/jdk1.6.0_45/java/awt/image/renderable/ContextualRenderedImageFactory.java,Java,,15,9,101,125
/jdk1.6.0_45/java/awt/image/renderable/ParameterBlock.java,Java,,191,50,466,707
/jdk1.6.0_45/java/awt/image/renderable/RenderableImage.java,Java,,18,15,147,180
/jdk1.6.0_45/java/awt/image/renderable/RenderableImageOp.java,Java,,121,29,182,332
/jdk1.6.0_45/java/awt/image/renderable/RenderableImageProducer.java,Java,,93,19,89,201
/jdk1.6.0_45/java/awt/image/renderable/RenderContext.java,Java,,63,22,169,254
/jdk1.6.0_45/java/awt/image/renderable/RenderedImageFactory.java,Java,,7,4,49,60
/jdk1.6.0_45/java/awt/image/RenderedImage.java,Java,,27,25,147,199
/jdk1.6.0_45/java/awt/image/ReplicateScaleFilter.java,Java,,115,16,107,238
/jdk1.6.0_45/java/awt/image/RescaleOp.java,Java,,348,63,238,649
/jdk1.6.0_45/java/awt/image/RGBImageFilter.java,Java,,101,13,161,275
/jdk1.6.0_45/java/awt/image/SampleModel.java,Java,,464,152,759,1375
/jdk1.6.0_45/java/awt/image/ShortLookupTable.java,Java,,79,13,95,187
/jdk1.6.0_45/java/awt/image/SinglePixelPackedSampleModel.java,Java,,380,75,332,787
/jdk1.6.0_45/java/awt/image/TileObserver.java,Java,,6,4,27,37
/jdk1.6.0_45/java/awt/image/VolatileImage.java,Java,,33,23,269,325
/jdk1.6.0_45/java/awt/image/WritableRaster.java,Java,,223,37,466,726
/jdk1.6.0_45/java/awt/image/WritableRenderedImage.java,Java,,13,13,107,133
/jdk1.6.0_45/java/awt/Image.java,Java,,70,23,243,336
/jdk1.6.0_45/java/awt/ImageCapabilities.java,Java,,20,8,35,63
/jdk1.6.0_45/java/awt/Insets.java,Java,,53,15,103,171
/jdk1.6.0_45/java/awt/ItemSelectable.java,Java,,7,7,34,48
/jdk1.6.0_45/java/awt/JobAttributes.java,Java,,443,68,537,1048
/jdk1.6.0_45/java/awt/KeyboardFocusManager.java,Java,,1487,252,1337,3076
/jdk1.6.0_45/java/awt/KeyEventDispatcher.java,Java,,5,4,64,73
/jdk1.6.0_45/java/awt/KeyEventPostProcessor.java,Java,,5,4,67,76
/jdk1.6.0_45/java/awt/Label.java,Java,,123,33,187,343
/jdk1.6.0_45/java/awt/LayoutManager.java,Java,,8,5,53,66
/jdk1.6.0_45/java/awt/LayoutManager2.java,Java,,8,7,55,70
/jdk1.6.0_45/java/awt/LinearGradientPaint.java,Java,,97,16,221,334
/jdk1.6.0_45/java/awt/LinearGradientPaintContext.java,Java,,54,20,73,147
/jdk1.6.0_45/java/awt/List.java,Java,[FIXME,623,154,1153,1930
/jdk1.6.0_45/java/awt/MediaTracker.java,Java,,390,56,487,933
/jdk1.6.0_45/java/awt/Menu.java,Java,,251,60,302,613
/jdk1.6.0_45/java/awt/MenuBar.java,Java,,216,43,235,494
/jdk1.6.0_45/java/awt/MenuComponent.java,Java,,350,102,604,1056
/jdk1.6.0_45/java/awt/MenuContainer.java,Java,,7,3,16,26
/jdk1.6.0_45/java/awt/MenuItem.java,Java,[PENDING:  WDW -- need to provide a localized string,323,76,524,923
/jdk1.6.0_45/java/awt/MenuShortcut.java,Java,,52,13,112,177
/jdk1.6.0_45/java/awt/ModalEventFilter.java,Java,,156,23,19,198
/jdk1.6.0_45/java/awt/MouseInfo.java,Java,,53,12,53,118
/jdk1.6.0_45/java/awt/MultipleGradientPaint.java,Java,,124,38,125,287
/jdk1.6.0_45/java/awt/MultipleGradientPaintContext.java,Java,,357,94,253,704
/jdk1.6.0_45/java/awt/PageAttributes.java,Java,,521,52,788,1361
/jdk1.6.0_45/java/awt/Paint.java,Java,,12,6,59,77
/jdk1.6.0_45/java/awt/PaintContext.java,Java,,12,7,46,65
/jdk1.6.0_45/java/awt/Panel.java,Java,,38,14,65,117
/jdk1.6.0_45/java/awt/peer/ButtonPeer.java,Java,,5,3,13,21
/jdk1.6.0_45/java/awt/peer/CanvasPeer.java,Java,,4,2,13,19
/jdk1.6.0_45/java/awt/peer/CheckboxMenuItemPeer.java,Java,,4,1,13,18
/jdk1.6.0_45/java/awt/peer/CheckboxPeer.java,Java,,7,2,13,22
/jdk1.6.0_45/java/awt/peer/ChoicePeer.java,Java,,9,3,16,28
/jdk1.6.0_45/java/awt/peer/ComponentPeer.java,Java,,71,18,53,142
/jdk1.6.0_45/java/awt/peer/ContainerPeer.java,Java,,13,4,28,45
/jdk1.6.0_45/java/awt/peer/DesktopPeer.java,Java,,13,9,66,88
/jdk1.6.0_45/java/awt/peer/DialogPeer.java,Java,,7,5,13,25
/jdk1.6.0_45/java/awt/peer/FileDialogPeer.java,Java,,8,3,13,24
/jdk1.6.0_45/java/awt/peer/FontPeer.java,Java,,3,2,13,18
/jdk1.6.0_45/java/awt/peer/FramePeer.java,Java,,12,3,13,28
/jdk1.6.0_45/java/awt/peer/KeyboardFocusManagerPeer.java,Java,,10,5,6,21
/jdk1.6.0_45/java/awt/peer/LabelPeer.java,Java,,7,2,13,22
/jdk1.6.0_45/java/awt/peer/LightweightPeer.java,Java,,3,3,21,27
/jdk1.6.0_45/java/awt/peer/ListPeer.java,Java,,19,7,28,54
/jdk1.6.0_45/java/awt/peer/MenuBarPeer.java,Java,,7,2,13,22
/jdk1.6.0_45/java/awt/peer/MenuComponentPeer.java,Java,,6,2,13,21
/jdk1.6.0_45/java/awt/peer/MenuItemPeer.java,Java,,7,4,19,30
/jdk1.6.0_45/java/awt/peer/MenuPeer.java,Java,,7,2,13,22
/jdk1.6.0_45/java/awt/peer/MouseInfoPeer.java,Java,,7,6,35,48
/jdk1.6.0_45/java/awt/peer/PanelPeer.java,Java,,4,2,13,19
/jdk1.6.0_45/java/awt/peer/PopupMenuPeer.java,Java,,5,2,13,20
/jdk1.6.0_45/java/awt/peer/RobotPeer.java,Java,,14,7,17,38
/jdk1.6.0_45/java/awt/peer/ScrollbarPeer.java,Java,,6,1,13,20
/jdk1.6.0_45/java/awt/peer/ScrollPanePeer.java,Java,,11,2,13,26
/jdk1.6.0_45/java/awt/peer/SystemTrayPeer.java,Java,,6,3,4,13
/jdk1.6.0_45/java/awt/peer/TextAreaPeer.java,Java,,12,6,25,43
/jdk1.6.0_45/java/awt/peer/TextComponentPeer.java,Java,,18,2,13,33
/jdk1.6.0_45/java/awt/peer/TextFieldPeer.java,Java,,10,5,22,37
/jdk1.6.0_45/java/awt/peer/TrayIconPeer.java,Java,,11,3,4,18
/jdk1.6.0_45/java/awt/peer/WindowPeer.java,Java,,18,6,13,37
/jdk1.6.0_45/java/awt/Point.java,Java,,54,18,143,215
/jdk1.6.0_45/java/awt/PointerInfo.java,Java,,15,8,44,67
/jdk1.6.0_45/java/awt/Polygon.java,Java,,268,52,340,660
/jdk1.6.0_45/java/awt/PopupMenu.java,Java,,97,21,105,223
/jdk1.6.0_45/java/awt/print/Book.java,Java,,66,27,110,203
/jdk1.6.0_45/java/awt/print/Pageable.java,Java,,9,7,50,66
/jdk1.6.0_45/java/awt/print/PageFormat.java,Java,,141,58,146,345
/jdk1.6.0_45/java/awt/print/Paper.java,Java,,53,25,113,191
/jdk1.6.0_45/java/awt/print/Printable.java,Java,,8,7,110,125
/jdk1.6.0_45/java/awt/print/PrinterAbortException.java,Java,,9,6,22,37
/jdk1.6.0_45/java/awt/print/PrinterException.java,Java,,8,6,21,35
/jdk1.6.0_45/java/awt/print/PrinterGraphics.java,Java,,4,5,20,29
/jdk1.6.0_45/java/awt/print/PrinterIOException.java,Java,,16,6,48,70
/jdk1.6.0_45/java/awt/print/PrinterJob.java,Java,,165,47,386,598
/jdk1.6.0_45/java/awt/PrintGraphics.java,Java,,4,4,16,24
/jdk1.6.0_45/java/awt/PrintJob.java,Java,,11,9,43,63
/jdk1.6.0_45/java/awt/RadialGradientPaint.java,Java,,156,25,398,579
/jdk1.6.0_45/java/awt/RadialGradientPaintContext.java,Java,,176,65,190,431
/jdk1.6.0_45/java/awt/Rectangle.java,Java,,434,62,701,1197
/jdk1.6.0_45/java/awt/RenderingHints.java,Java,,222,76,984,1282
/jdk1.6.0_45/java/awt/Robot.java,Java,,210,48,220,478
/jdk1.6.0_45/java/awt/Scrollbar.java,Java,,355,91,870,1316
/jdk1.6.0_45/java/awt/ScrollPane.java,Java,,356,79,393,828
/jdk1.6.0_45/java/awt/ScrollPaneAdjustable.java,Java,,147,45,244,436
/jdk1.6.0_45/java/awt/SentEvent.java,Java,,51,7,18,76
/jdk1.6.0_45/java/awt/SequencedEvent.java,Java,,113,18,67,198
/jdk1.6.0_45/java/awt/Shape.java,Java,,17,12,312,341
/jdk1.6.0_45/java/awt/SplashScreen.java,Java,,147,21,163,331
/jdk1.6.0_45/java/awt/Stroke.java,Java,,4,6,45,55
/jdk1.6.0_45/java/awt/SystemColor.java,Java,,111,65,296,472
/jdk1.6.0_45/java/awt/SystemTray.java,Java,,145,29,286,460
/jdk1.6.0_45/java/awt/TextArea.java,Java,,245,60,392,697
/jdk1.6.0_45/java/awt/TextComponent.java,Java,,484,93,627,1204
/jdk1.6.0_45/java/awt/TextField.java,Java,,225,55,458,738
/jdk1.6.0_45/java/awt/TexturePaint.java,Java,,47,13,63,123
/jdk1.6.0_45/java/awt/TexturePaintContext.java,Java,,702,47,57,806
/jdk1.6.0_45/java/awt/Toolkit.java,Java,,861,162,1488,2511
/jdk1.6.0_45/java/awt/Transparency.java,Java,,7,6,29,42
/jdk1.6.0_45/java/awt/TrayIcon.java,Java,,294,55,432,781
/jdk1.6.0_45/java/awt/Window.java,Java,,1565,276,1710,3551
/jdk1.6.0_45/java/beans/AppletInitializer.java,Java,,7,10,57,74
/jdk1.6.0_45/java/beans/beancontext/BeanContext.java,Java,,16,13,87,116
/jdk1.6.0_45/java/beans/beancontext/BeanContextChild.java,Java,,13,12,96,121
/jdk1.6.0_45/java/beans/beancontext/BeanContextChildComponentProxy.java,Java,,5,6,26,37
/jdk1.6.0_45/java/beans/beancontext/BeanContextChildSupport.java,Java,,100,57,199,356
/jdk1.6.0_45/java/beans/beancontext/BeanContextContainerProxy.java,Java,,5,5,25,35
/jdk1.6.0_45/java/beans/beancontext/BeanContextEvent.java,Java,,19,19,55,93
/jdk1.6.0_45/java/beans/beancontext/BeanContextMembershipEvent.java,Java,,28,24,66,118
/jdk1.6.0_45/java/beans/beancontext/BeanContextMembershipListener.java,Java,,7,7,30,44
/jdk1.6.0_45/java/beans/beancontext/BeanContextProxy.java,Java,,4,4,60,68
/jdk1.6.0_45/java/beans/beancontext/BeanContextServiceAvailableEvent.java,Java,,19,17,35,71
/jdk1.6.0_45/java/beans/beancontext/BeanContextServiceProvider.java,Java,,7,9,72,88
/jdk1.6.0_45/java/beans/beancontext/BeanContextServiceProviderBeanInfo.java,Java,,5,5,19,29
/jdk1.6.0_45/java/beans/beancontext/BeanContextServiceRevokedEvent.java,Java,,20,18,48,86
/jdk1.6.0_45/java/beans/beancontext/BeanContextServiceRevokedListener.java,Java,,6,7,18,31
/jdk1.6.0_45/java/beans/beancontext/BeanContextServices.java,Java,,17,17,107,141
/jdk1.6.0_45/java/beans/beancontext/BeanContextServicesListener.java,Java,,7,4,17,28
/jdk1.6.0_45/java/beans/beancontext/BeanContextServicesSupport.java,Java,,623,314,282,1219
/jdk1.6.0_45/java/beans/beancontext/BeanContextSupport.java,Java,,590,258,528,1376
/jdk1.6.0_45/java/beans/BeanDescriptor.java,Java,,29,11,42,82
/jdk1.6.0_45/java/beans/BeanInfo.java,Java,,15,15,123,153
/jdk1.6.0_45/java/beans/Beans.java,Java,,310,92,248,650
/jdk1.6.0_45/java/beans/ConstructorProperties.java,Java,,8,3,47,58
/jdk1.6.0_45/java/beans/Customizer.java,Java,,6,8,34,48
/jdk1.6.0_45/java/beans/DefaultPersistenceDelegate.java,Java,,184,26,188,398
/jdk1.6.0_45/java/beans/DesignMode.java,Java,,6,9,57,72
/jdk1.6.0_45/java/beans/Encoder.java,Java,,108,65,172,345
/jdk1.6.0_45/java/beans/EventHandler.java,Java,,173,22,486,681
/jdk1.6.0_45/java/beans/EventSetDescriptor.java,Java,,256,44,200,500
/jdk1.6.0_45/java/beans/ExceptionListener.java,Java,,4,48,21,73
/jdk1.6.0_45/java/beans/Expression.java,Java,,27,10,90,127
/jdk1.6.0_45/java/beans/FeatureDescriptor.java,Java,,143,33,138,314
/jdk1.6.0_45/java/beans/IndexedPropertyChangeEvent.java,Java,,13,6,39,58
/jdk1.6.0_45/java/beans/IndexedPropertyDescriptor.java,Java,,267,51,161,479
/jdk1.6.0_45/java/beans/IntrospectionException.java,Java,,7,4,20,31
/jdk1.6.0_45/java/beans/Introspector.java,Java,,1012,163,403,1578
/jdk1.6.0_45/java/beans/MetaData.java,Java,,1048,171,255,1474
/jdk1.6.0_45/java/beans/MethodDescriptor.java,Java,,119,31,68,218
/jdk1.6.0_45/java/beans/NameGenerator.java,Java,,52,11,36,99
/jdk1.6.0_45/java/beans/ParameterDescriptor.java,Java,,8,6,21,35
/jdk1.6.0_45/java/beans/PersistenceDelegate.java,Java,,26,6,160,192
/jdk1.6.0_45/java/beans/PropertyChangeEvent.java,Java,,29,13,82,124
/jdk1.6.0_45/java/beans/PropertyChangeListener.java,Java,,4,6,16,26
/jdk1.6.0_45/java/beans/PropertyChangeListenerProxy.java,Java,,16,6,39,61
/jdk1.6.0_45/java/beans/PropertyChangeSupport.java,Java,,223,42,243,508
/jdk1.6.0_45/java/beans/PropertyDescriptor.java,Java,,368,69,232,669
/jdk1.6.0_45/java/beans/PropertyEditor.java,Java,,15,25,166,206
/jdk1.6.0_45/java/beans/PropertyEditorManager.java,Java,,92,19,81,192
/jdk1.6.0_45/java/beans/PropertyEditorSupport.java,Java,,87,32,152,271
/jdk1.6.0_45/java/beans/PropertyVetoException.java,Java,,12,8,26,46
/jdk1.6.0_45/java/beans/ReflectionUtils.java,Java,,261,33,122,416
/jdk1.6.0_45/java/beans/SimpleBeanInfo.java,Java,,54,14,60,128
/jdk1.6.0_45/java/beans/Statement.java,Java,,166,20,113,299
/jdk1.6.0_45/java/beans/VetoableChangeListener.java,Java,,5,2,19,26
/jdk1.6.0_45/java/beans/VetoableChangeListenerProxy.java,Java,,18,7,39,64
/jdk1.6.0_45/java/beans/VetoableChangeSupport.java,Java,,229,43,180,452
/jdk1.6.0_45/java/beans/Visibility.java,Java,,7,8,34,49
/jdk1.6.0_45/java/beans/XMLDecoder.java,Java,,110,21,138,269
/jdk1.6.0_45/java/beans/XMLEncoder.java,Java,,342,53,298,693
/jdk1.6.0_45/java/io/Bits.java,Java,,93,18,18,129
/jdk1.6.0_45/java/io/BufferedInputStream.java,Java,,157,27,273,457
/jdk1.6.0_45/java/io/BufferedOutputStream.java,Java,,44,9,73,126
/jdk1.6.0_45/java/io/BufferedReader.java,Java,,263,36,203,502
/jdk1.6.0_45/java/io/BufferedWriter.java,Java,,109,23,122,254
/jdk1.6.0_45/java/io/ByteArrayInputStream.java,Java,,65,17,182,264
/jdk1.6.0_45/java/io/ByteArrayOutputStream.java,Java,,64,19,144,227
/jdk1.6.0_45/java/io/CharArrayReader.java,Java,,95,17,103,215
/jdk1.6.0_45/java/io/CharArrayWriter.java,Java,,90,20,153,263
/jdk1.6.0_45/java/io/CharConversionException.java,Java,,10,1,21,32
/jdk1.6.0_45/java/io/Closeable.java,Java,,5,6,21,32
/jdk1.6.0_45/java/io/Console.java,Java,,246,22,279,547
/jdk1.6.0_45/java/io/DataInput.java,Java,,19,16,583,618
/jdk1.6.0_45/java/io/DataInputStream.java,Java,,212,35,399,646
/jdk1.6.0_45/java/io/DataOutput.java,Java,,18,15,304,337
/jdk1.6.0_45/java/io/DataOutputStream.java,Java,,145,29,225,399
/jdk1.6.0_45/java/io/DeleteOnExitHook.java,Java,,33,12,13,58
/jdk1.6.0_45/java/io/EOFException.java,Java,,10,3,33,46
/jdk1.6.0_45/java/io/ExpiringCache.java,Java,,84,15,9,108
/jdk1.6.0_45/java/io/Externalizable.java,Java,,7,4,69,80
/jdk1.6.0_45/java/io/File.java,Java,,509,101,1349,1959
/jdk1.6.0_45/java/io/FileDescriptor.java,Java,,40,21,88,149
/jdk1.6.0_45/java/io/FileFilter.java,Java,,4,5,23,32
/jdk1.6.0_45/java/io/FileInputStream.java,Java,,101,33,254,388
/jdk1.6.0_45/java/io/FilenameFilter.java,Java,,5,2,29,36
/jdk1.6.0_45/java/io/FileNotFoundException.java,Java,,14,8,42,64
/jdk1.6.0_45/java/io/FileOutputStream.java,Java,,120,36,260,416
/jdk1.6.0_45/java/io/FilePermission.java,Java,,328,95,380,803
/jdk1.6.0_45/java/io/FileReader.java,Java,,12,8,49,69
/jdk1.6.0_45/java/io/FileSystem.java,Java,,59,47,132,238
/jdk1.6.0_45/java/io/FileWriter.java,Java,,18,10,74,102
/jdk1.6.0_45/java/io/FilterInputStream.java,Java,,35,12,172,219
/jdk1.6.0_45/java/io/FilterOutputStream.java,Java,,31,9,105,145
/jdk1.6.0_45/java/io/FilterReader.java,Java,,32,15,60,107
/jdk1.6.0_45/java/io/FilterWriter.java,Java,,23,12,55,90
/jdk1.6.0_45/java/io/Flushable.java,Java,,5,5,20,30
/jdk1.6.0_45/java/io/InputStream.java,Java,,62,21,266,349
/jdk1.6.0_45/java/io/InputStreamReader.java,Java,,50,15,119,184
/jdk1.6.0_45/java/io/InterruptedIOException.java,Java,,11,4,40,55
/jdk1.6.0_45/java/io/InvalidClassException.java,Java,,18,7,39,64
/jdk1.6.0_45/java/io/InvalidObjectException.java,Java,,7,4,23,34
/jdk1.6.0_45/java/io/IOError.java,Java,,7,3,23,33
/jdk1.6.0_45/java/io/IOException.java,Java,,17,6,61,84
/jdk1.6.0_45/java/io/LineNumberInputStream.java,Java,,97,19,159,275
/jdk1.6.0_45/java/io/LineNumberReader.java,Java,,100,23,141,264
/jdk1.6.0_45/java/io/NotActiveException.java,Java,,10,5,21,36
/jdk1.6.0_45/java/io/NotSerializableException.java,Java,,10,5,23,38
/jdk1.6.0_45/java/io/ObjectInput.java,Java,,11,8,71,90
/jdk1.6.0_45/java/io/ObjectInputStream.java,Java,,1930,295,1287,3512
/jdk1.6.0_45/java/io/ObjectInputValidation.java,Java,,4,2,22,28
/jdk1.6.0_45/java/io/ObjectOutput.java,Java,,10,7,56,73
/jdk1.6.0_45/java/io/ObjectOutputStream.java,Java,,1257,192,995,2444
/jdk1.6.0_45/java/io/ObjectStreamClass.java,Java,,1506,192,590,2288
/jdk1.6.0_45/java/io/ObjectStreamConstants.java,Java,,34,36,148,218
/jdk1.6.0_45/java/io/ObjectStreamException.java,Java,,10,5,21,36
/jdk1.6.0_45/java/io/ObjectStreamField.java,Java,,97,21,142,260
/jdk1.6.0_45/java/io/OptionalDataException.java,Java,,14,6,46,66
/jdk1.6.0_45/java/io/OutputStream.java,Java,,24,7,106,137
/jdk1.6.0_45/java/io/OutputStreamWriter.java,Java,,56,17,145,218
/jdk1.6.0_45/java/io/PipedInputStream.java,Java,,191,31,211,433
/jdk1.6.0_45/java/io/PipedOutputStream.java,Java,,53,11,98,162
/jdk1.6.0_45/java/io/PipedReader.java,Java,,158,27,161,346
/jdk1.6.0_45/java/io/PipedWriter.java,Java,,53,14,100,167
/jdk1.6.0_45/java/io/PrintStream.java,Java,,335,62,682,1079
/jdk1.6.0_45/java/io/PrintWriter.java,Java,,306,57,659,1022
/jdk1.6.0_45/java/io/PushbackInputStream.java,Java,,111,19,232,362
/jdk1.6.0_45/java/io/PushbackReader.java,Java,,120,20,124,264
/jdk1.6.0_45/java/io/RandomAccessFile.java,Java,,283,67,759,1109
/jdk1.6.0_45/java/io/Reader.java,Java,,64,20,161,245
/jdk1.6.0_45/java/io/SequenceInputStream.java,Java,,78,14,126,218
/jdk1.6.0_45/java/io/SerialCallbackContext.java,Java,,28,7,21,56
/jdk1.6.0_45/java/io/Serializable.java,Java,,3,2,148,153
/jdk1.6.0_45/java/io/SerializablePermission.java,Java,,17,10,88,115
/jdk1.6.0_45/java/io/StreamCorruptedException.java,Java,,10,5,22,37
/jdk1.6.0_45/java/io/StreamTokenizer.java,Java,,365,52,400,817
/jdk1.6.0_45/java/io/StringBufferInputStream.java,Java,,54,11,90,155
/jdk1.6.0_45/java/io/StringReader.java,Java,,78,15,91,184
/jdk1.6.0_45/java/io/StringWriter.java,Java,,59,19,141,219
/jdk1.6.0_45/java/io/SyncFailedException.java,Java,,6,2,21,29
/jdk1.6.0_45/java/io/UnsupportedEncodingException.java,Java,,11,2,20,33
/jdk1.6.0_45/java/io/UTFDataFormatException.java,Java,,10,3,37,50
/jdk1.6.0_45/java/io/Win32FileSystem.java,Java,,422,64,105,591
/jdk1.6.0_45/java/io/WinNTFileSystem.java,Java,,33,12,16,61
/jdk1.6.0_45/java/io/WriteAbortedException.java,Java,,19,6,51,76
/jdk1.6.0_45/java/io/Writer.java,Java,,64,20,224,308
/jdk1.6.0_45/java/lang/AbstractMethodError.java,Java,,10,3,26,39
/jdk1.6.0_45/java/lang/AbstractStringBuilder.java,Java,,463,65,893,1421
/jdk1.6.0_45/java/lang/annotation/Annotation.java,Java,,7,5,98,110
/jdk1.6.0_45/java/lang/annotation/AnnotationFormatError.java,Java,,12,5,38,55
/jdk1.6.0_45/java/lang/annotation/AnnotationTypeMismatchException.java,Java,,18,6,43,67
/jdk1.6.0_45/java/lang/annotation/Documented.java,Java,,6,2,18,26
/jdk1.6.0_45/java/lang/annotation/ElementType.java,Java,,11,9,25,45
/jdk1.6.0_45/java/lang/annotation/IncompleteAnnotationException.java,Java,,18,6,28,52
/jdk1.6.0_45/java/lang/annotation/Inherited.java,Java,,6,2,26,34
/jdk1.6.0_45/java/lang/annotation/Retention.java,Java,,7,2,19,28
/jdk1.6.0_45/java/lang/annotation/RetentionPolicy.java,Java,,6,4,29,39
/jdk1.6.0_45/java/lang/annotation/Target.java,Java,,7,2,41,50
/jdk1.6.0_45/java/lang/Appendable.java,Java,,7,6,91,104
/jdk1.6.0_45/java/lang/ApplicationShutdownHooks.java,Java,,45,15,24,84
/jdk1.6.0_45/java/lang/ArithmeticException.java,Java,,10,3,25,38
/jdk1.6.0_45/java/lang/ArrayIndexOutOfBoundsException.java,Java,,13,4,31,48
/jdk1.6.0_45/java/lang/ArrayStoreException.java,Java,,10,4,28,42
/jdk1.6.0_45/java/lang/AssertionError.java,Java,,31,10,92,133
/jdk1.6.0_45/java/lang/AssertionStatusDirectives.java,Java,,8,6,62,76
/jdk1.6.0_45/java/lang/Boolean.java,Java,,58,19,170,247
/jdk1.6.0_45/java/lang/Byte.java,Java,,112,35,295,442
/jdk1.6.0_45/java/lang/Character.java,Java,,2132,340,2997,5469
/jdk1.6.0_45/java/lang/CharacterData00.java,Java,,1001,50,94,1145
/jdk1.6.0_45/java/lang/CharacterData01.java,Java,,379,43,69,491
/jdk1.6.0_45/java/lang/CharacterData02.java,Java,,285,42,68,395
/jdk1.6.0_45/java/lang/CharacterData0E.java,Java,,290,41,68,399
/jdk1.6.0_45/java/lang/CharacterDataLatin1.java,Java,,225,44,52,321
/jdk1.6.0_45/java/lang/CharacterDataPrivateUse.java,Java,,87,33,13,133
/jdk1.6.0_45/java/lang/CharacterDataUndefined.java,Java,,72,30,13,115
/jdk1.6.0_45/java/lang/CharSequence.java,Java,,7,9,78,94
/jdk1.6.0_45/java/lang/Class.java,Java,,1120,235,1752,3107
/jdk1.6.0_45/java/lang/ClassCastException.java,Java,,10,3,28,41
/jdk1.6.0_45/java/lang/ClassCircularityError.java,Java,,9,3,22,34
/jdk1.6.0_45/java/lang/ClassFormatError.java,Java,,10,3,24,37
/jdk1.6.0_45/java/lang/ClassLoader.java,Java,,871,142,1064,2077
/jdk1.6.0_45/java/lang/ClassNotFoundException.java,Java,,21,8,79,108
/jdk1.6.0_45/java/lang/Cloneable.java,Java,,3,2,32,37
/jdk1.6.0_45/java/lang/CloneNotSupportedException.java,Java,,10,4,32,46
/jdk1.6.0_45/java/lang/Comparable.java,Java,,5,3,112,120
/jdk1.6.0_45/java/lang/Compiler.java,Java,,40,10,67,117
/jdk1.6.0_45/java/lang/ConditionalSpecialCasing.java,Java,,273,61,115,449
/jdk1.6.0_45/java/lang/Deprecated.java,Java,,6,3,16,25
/jdk1.6.0_45/java/lang/Double.java,Java,,131,49,771,951
/jdk1.6.0_45/java/lang/Enum.java,Java,,64,17,135,216
/jdk1.6.0_45/java/lang/EnumConstantNotPresentException.java,Java,,13,6,36,55
/jdk1.6.0_45/java/lang/Error.java,Java,,16,6,64,86
/jdk1.6.0_45/java/lang/Exception.java,Java,,16,6,57,79
/jdk1.6.0_45/java/lang/ExceptionInInitializerError.java,Java,,22,8,79,109
/jdk1.6.0_45/java/lang/Float.java,Java,,115,42,694,851
/jdk1.6.0_45/java/lang/IllegalAccessError.java,Java,,9,3,27,39
/jdk1.6.0_45/java/lang/IllegalAccessException.java,Java,,9,3,47,59
/jdk1.6.0_45/java/lang/IllegalArgumentException.java,Java,,17,6,55,78
/jdk1.6.0_45/java/lang/IllegalMonitorStateException.java,Java,,10,3,30,43
/jdk1.6.0_45/java/lang/IllegalStateException.java,Java,,17,6,57,80
/jdk1.6.0_45/java/lang/IllegalThreadStateException.java,Java,,9,3,28,40
/jdk1.6.0_45/java/lang/IncompatibleClassChangeError.java,Java,,10,3,25,38
/jdk1.6.0_45/java/lang/IndexOutOfBoundsException.java,Java,,10,3,26,39
/jdk1.6.0_45/java/lang/InheritableThreadLocal.java,Java,,13,5,49,67
/jdk1.6.0_45/java/lang/InstantiationError.java,Java,,10,5,27,42
/jdk1.6.0_45/java/lang/InstantiationException.java,Java,,10,3,33,46
/jdk1.6.0_45/java/lang/instrument/ClassDefinition.java,Java,,22,7,40,69
/jdk1.6.0_45/java/lang/instrument/ClassFileTransformer.java,Java,,11,6,153,170
/jdk1.6.0_45/java/lang/instrument/IllegalClassFormatException.java,Java,,11,4,28,43
/jdk1.6.0_45/java/lang/instrument/Instrumentation.java,Java,,37,20,576,633
/jdk1.6.0_45/java/lang/instrument/UnmodifiableClassException.java,Java,,11,3,23,37
/jdk1.6.0_45/java/lang/Integer.java,Java,,392,82,728,1202
/jdk1.6.0_45/java/lang/InternalError.java,Java,,10,3,23,36
/jdk1.6.0_45/java/lang/InterruptedException.java,Java,,10,3,37,50
/jdk1.6.0_45/java/lang/Iterable.java,Java,,5,4,15,24
/jdk1.6.0_45/java/lang/LinkageError.java,Java,,10,3,25,38
/jdk1.6.0_45/java/lang/Long.java,Java,,362,67,723,1152
/jdk1.6.0_45/java/lang/management/ClassLoadingMXBean.java,Java,,8,9,77,94
/jdk1.6.0_45/java/lang/management/CompilationMXBean.java,Java,,6,5,70,81
/jdk1.6.0_45/java/lang/management/GarbageCollectorMXBean.java,Java,,5,6,63,74
/jdk1.6.0_45/java/lang/management/LockInfo.java,Java,,29,10,66,105
/jdk1.6.0_45/java/lang/management/ManagementFactory.java,Java,,115,29,501,645
/jdk1.6.0_45/java/lang/management/ManagementPermission.java,Java,,19,5,81,105
/jdk1.6.0_45/java/lang/management/MemoryManagerMXBean.java,Java,,6,5,57,68
/jdk1.6.0_45/java/lang/management/MemoryMXBean.java,Java,,10,9,264,283
/jdk1.6.0_45/java/lang/management/MemoryNotificationInfo.java,Java,,50,13,176,239
/jdk1.6.0_45/java/lang/management/MemoryPoolMXBean.java,Java,,21,19,582,622
/jdk1.6.0_45/java/lang/management/MemoryType.java,Java,,13,8,35,56
/jdk1.6.0_45/java/lang/management/MemoryUsage.java,Java,,80,15,191,286
/jdk1.6.0_45/java/lang/management/MonitorInfo.java,Java,,47,10,85,142
/jdk1.6.0_45/java/lang/management/OperatingSystemMXBean.java,Java,,8,7,107,122
/jdk1.6.0_45/java/lang/management/RuntimeMXBean.java,Java,,19,19,281,319
/jdk1.6.0_45/java/lang/management/ThreadInfo.java,Java,,281,36,507,824
/jdk1.6.0_45/java/lang/management/ThreadMXBean.java,Java,,31,30,724,785
/jdk1.6.0_45/java/lang/Math.java,Java,,197,66,1250,1513
/jdk1.6.0_45/java/lang/NegativeArraySizeException.java,Java,,10,3,23,36
/jdk1.6.0_45/java/lang/NoClassDefFoundError.java,Java,,10,3,29,42
/jdk1.6.0_45/java/lang/NoSuchFieldError.java,Java,,10,3,27,40
/jdk1.6.0_45/java/lang/NoSuchFieldException.java,Java,,9,3,21,33
/jdk1.6.0_45/java/lang/NoSuchMethodError.java,Java,,10,3,28,41
/jdk1.6.0_45/java/lang/NoSuchMethodException.java,Java,,10,3,21,34
/jdk1.6.0_45/java/lang/NullPointerException.java,Java,,10,3,35,48
/jdk1.6.0_45/java/lang/Number.java,Java,,14,8,73,95
/jdk1.6.0_45/java/lang/NumberFormatException.java,Java,,14,5,31,50
/jdk1.6.0_45/java/lang/Object.java,Java,,36,17,483,536
/jdk1.6.0_45/java/lang/OutOfMemoryError.java,Java,,10,3,24,37
/jdk1.6.0_45/java/lang/Override.java,Java,,6,3,15,24
/jdk1.6.0_45/java/lang/Package.java,Java,,307,41,248,596
/jdk1.6.0_45/java/lang/Process.java,Java,,11,8,112,131
/jdk1.6.0_45/java/lang/ProcessBuilder.java,Java,,113,25,339,477
/jdk1.6.0_45/java/lang/ProcessEnvironment.java,Java,,199,36,69,304
/jdk1.6.0_45/java/lang/ProcessImpl.java,Java,,135,31,58,224
/jdk1.6.0_45/java/lang/Readable.java,Java,,5,6,27,38
/jdk1.6.0_45/java/lang/ref/Finalizer.java,Java,,141,19,31,191
/jdk1.6.0_45/java/lang/ref/FinalReference.java,Java,,6,6,7,19
/jdk1.6.0_45/java/lang/ref/PhantomReference.java,Java,,9,7,50,66
/jdk1.6.0_45/java/lang/ref/Reference.java,Java,,71,33,117,221
/jdk1.6.0_45/java/lang/ref/ReferenceQueue.java,Java,,72,13,52,137
/jdk1.6.0_45/java/lang/ref/SoftReference.java,Java,,19,10,70,99
/jdk1.6.0_45/java/lang/ref/WeakReference.java,Java,,9,7,39,55
/jdk1.6.0_45/java/lang/reflect/AccessibleObject.java,Java,,54,15,115,184
/jdk1.6.0_45/java/lang/reflect/AnnotatedElement.java,Java,,8,6,75,89
/jdk1.6.0_45/java/lang/reflect/Array.java,Java,,56,29,382,467
/jdk1.6.0_45/java/lang/reflect/Constructor.java,Java,,305,44,319,668
/jdk1.6.0_45/java/lang/reflect/Field.java,Java,,295,55,671,1021
/jdk1.6.0_45/java/lang/reflect/GenericArrayType.java,Java,,4,3,28,35
/jdk1.6.0_45/java/lang/reflect/GenericDeclaration.java,Java,,4,2,25,31
/jdk1.6.0_45/java/lang/reflect/GenericSignatureFormatError.java,Java,,2,3,13,18
/jdk1.6.0_45/java/lang/reflect/InvocationHandler.java,Java,,5,3,70,78
/jdk1.6.0_45/java/lang/reflect/InvocationTargetException.java,Java,,22,8,63,93
/jdk1.6.0_45/java/lang/reflect/MalformedParameterizedTypeException.java,Java,,2,3,14,19
/jdk1.6.0_45/java/lang/reflect/Member.java,Java,,10,8,57,75
/jdk1.6.0_45/java/lang/reflect/Method.java,Java,,330,45,386,761
/jdk1.6.0_45/java/lang/reflect/Modifier.java,Java,,89,34,216,339
/jdk1.6.0_45/java/lang/reflect/ParameterizedType.java,Java,,6,6,66,78
/jdk1.6.0_45/java/lang/reflect/Proxy.java,Java,,271,46,461,778
/jdk1.6.0_45/java/lang/reflect/ReflectAccess.java,Java,,98,17,13,128
/jdk1.6.0_45/java/lang/reflect/ReflectPermission.java,Java,,11,6,66,83
/jdk1.6.0_45/java/lang/reflect/Type.java,Java,,3,3,13,19
/jdk1.6.0_45/java/lang/reflect/TypeVariable.java,Java,,6,5,61,72
/jdk1.6.0_45/java/lang/reflect/UndeclaredThrowableException.java,Java,,21,7,74,102
/jdk1.6.0_45/java/lang/reflect/WildcardType.java,Java,,5,4,57,66
/jdk1.6.0_45/java/lang/Runnable.java,Java,,5,2,45,52
/jdk1.6.0_45/java/lang/Runtime.java,Java,,126,35,719,880
/jdk1.6.0_45/java/lang/RuntimeException.java,Java,,16,6,57,79
/jdk1.6.0_45/java/lang/RuntimePermission.java,Java,,16,9,329,354
/jdk1.6.0_45/java/lang/SecurityException.java,Java,,16,6,45,67
/jdk1.6.0_45/java/lang/SecurityManager.java,Java,,374,66,1278,1718
/jdk1.6.0_45/java/lang/Short.java,Java,,121,35,302,458
/jdk1.6.0_45/java/lang/Shutdown.java,Java,,102,26,66,194
/jdk1.6.0_45/java/lang/StackOverflowError.java,Java,,10,3,23,36
/jdk1.6.0_45/java/lang/StackTraceElement.java,Java,,59,14,139,212
/jdk1.6.0_45/java/lang/StrictMath.java,Java,,188,71,1193,1452
/jdk1.6.0_45/java/lang/String.java,Java,,925,131,1946,3002
/jdk1.6.0_45/java/lang/StringBuffer.java,Java,,239,63,327,629
/jdk1.6.0_45/java/lang/StringBuilder.java,Java,,189,47,226,462
/jdk1.6.0_45/java/lang/StringCoding.java,Java,,231,36,34,301
/jdk1.6.0_45/java/lang/StringIndexOutOfBoundsException.java,Java,,13,4,35,52
/jdk1.6.0_45/java/lang/StringValue.java,Java,,8,5,13,26
/jdk1.6.0_45/java/lang/SuppressWarnings.java,Java,,9,3,35,47
/jdk1.6.0_45/java/lang/System.java,Java,,254,66,843,1163
/jdk1.6.0_45/java/lang/Terminator.java,Java,,22,10,23,55
/jdk1.6.0_45/java/lang/Thread.java,Java,,508,138,1237,1883
/jdk1.6.0_45/java/lang/ThreadDeath.java,Java,,2,3,30,35
/jdk1.6.0_45/java/lang/ThreadGroup.java,Java,,455,48,515,1018
/jdk1.6.0_45/java/lang/ThreadLocal.java,Java,,285,59,321,665
/jdk1.6.0_45/java/lang/Throwable.java,Java,,138,36,480,654
/jdk1.6.0_45/java/lang/TypeNotPresentException.java,Java,,9,4,33,46
/jdk1.6.0_45/java/lang/UnknownError.java,Java,,10,3,23,36
/jdk1.6.0_45/java/lang/UnsatisfiedLinkError.java,Java,,10,3,24,37
/jdk1.6.0_45/java/lang/UnsupportedClassVersionError.java,Java,,10,3,23,36
/jdk1.6.0_45/java/lang/UnsupportedOperationException.java,Java,,15,6,56,77
/jdk1.6.0_45/java/lang/VerifyError.java,Java,,10,3,23,36
/jdk1.6.0_45/java/lang/VirtualMachineError.java,Java,,10,3,24,37
/jdk1.6.0_45/java/lang/Void.java,Java,,6,4,22,32
/jdk1.6.0_45/java/math/BigDecimal.java,Java,,1489,218,2140,3847
/jdk1.6.0_45/java/math/BigInteger.java,Java,,1605,383,1162,3150
/jdk1.6.0_45/java/math/BitSieve.java,Java,,84,21,92,197
/jdk1.6.0_45/java/math/MathContext.java,Java,,87,29,198,314
/jdk1.6.0_45/java/math/MutableBigInteger.java,Java,,900,175,381,1456
/jdk1.6.0_45/java/math/RoundingMode.java,Java,,37,22,280,339
/jdk1.6.0_45/java/math/SignedMutableBigInteger.java,Java,,42,19,59,120
/jdk1.6.0_45/java/net/Authenticator.java,Java,,152,34,228,414
/jdk1.6.0_45/java/net/BindException.java,Java,,7,5,23,35
/jdk1.6.0_45/java/net/CacheRequest.java,Java,,7,5,34,46
/jdk1.6.0_45/java/net/CacheResponse.java,Java,,9,5,33,47
/jdk1.6.0_45/java/net/ConnectException.java,Java,,7,3,24,34
/jdk1.6.0_45/java/net/ContentHandler.java,Java,,14,6,73,93
/jdk1.6.0_45/java/net/ContentHandlerFactory.java,Java,,4,2,31,37
/jdk1.6.0_45/java/net/CookieHandler.java,Java,,28,7,88,123
/jdk1.6.0_45/java/net/CookieManager.java,Java,,206,45,167,418
/jdk1.6.0_45/java/net/CookiePolicy.java,Java,,19,7,34,60
/jdk1.6.0_45/java/net/CookieStore.java,Java,,11,14,86,111
/jdk1.6.0_45/java/net/DatagramPacket.java,Java,,105,26,238,369
/jdk1.6.0_45/java/net/DatagramSocket.java,Java,,453,60,679,1192
/jdk1.6.0_45/java/net/DatagramSocketImpl.java,Java,,37,24,165,226
/jdk1.6.0_45/java/net/DatagramSocketImplFactory.java,Java,,5,2,22,29
/jdk1.6.0_45/java/net/FileNameMap.java,Java,,4,3,20,27
/jdk1.6.0_45/java/net/HttpCookie.java,Java,,450,190,549,1189
/jdk1.6.0_45/java/net/HttpRetryException.java,Java,,25,9,47,81
/jdk1.6.0_45/java/net/HttpURLConnection.java,Java,,187,82,435,704
/jdk1.6.0_45/java/net/IDN.java,Java,,197,59,195,451
/jdk1.6.0_45/java/net/Inet4Address.java,Java,,117,29,217,363
/jdk1.6.0_45/java/net/Inet4AddressImpl.java,Java,,38,5,14,57
/jdk1.6.0_45/java/net/Inet6Address.java,Java,,311,62,376,749
/jdk1.6.0_45/java/net/Inet6AddressImpl.java,Java,,60,7,24,91
/jdk1.6.0_45/java/net/InetAddress.java,Java,,689,150,713,1552
/jdk1.6.0_45/java/net/InetAddressImpl.java,Java,,12,4,15,31
/jdk1.6.0_45/java/net/InetSocketAddress.java,Java,,191,35,167,393
/jdk1.6.0_45/java/net/InterfaceAddress.java,Java,,36,10,70,116
/jdk1.6.0_45/java/net/JarURLConnection.java,Java,,57,25,219,301
/jdk1.6.0_45/java/net/MalformedURLException.java,Java,,9,4,24,37
/jdk1.6.0_45/java/net/MulticastSocket.java,Java,,219,46,395,660
/jdk1.6.0_45/java/net/NetPermission.java,Java,,16,8,151,175
/jdk1.6.0_45/java/net/NetworkInterface.java,Java,,247,53,217,517
/jdk1.6.0_45/java/net/NoRouteToHostException.java,Java,,7,3,24,34
/jdk1.6.0_45/java/net/PasswordAuthentication.java,Java,,15,9,41,65
/jdk1.6.0_45/java/net/PlainDatagramSocketImpl.java,Java,,208,45,119,372
/jdk1.6.0_45/java/net/PlainSocketImpl.java,Java,,466,61,190,717
/jdk1.6.0_45/java/net/PortUnreachableException.java,Java,,7,5,21,33
/jdk1.6.0_45/java/net/ProtocolException.java,Java,,10,4,23,37
/jdk1.6.0_45/java/net/Proxy.java,Java,,49,12,93,154
/jdk1.6.0_45/java/net/ProxySelector.java,Java,,33,9,104,146
/jdk1.6.0_45/java/net/ResponseCache.java,Java,,26,8,112,146
/jdk1.6.0_45/java/net/SdpSocketImpl.java,Java,,20,5,10,35
/jdk1.6.0_45/java/net/SecureCacheResponse.java,Java,,14,7,69,90
/jdk1.6.0_45/java/net/ServerSocket.java,Java,,276,40,510,826
/jdk1.6.0_45/java/net/Socket.java,Java,,550,82,944,1576
/jdk1.6.0_45/java/net/SocketAddress.java,Java,,3,2,19,24
/jdk1.6.0_45/java/net/SocketException.java,Java,,10,4,23,37
/jdk1.6.0_45/java/net/SocketImpl.java,Java,,72,33,235,340
/jdk1.6.0_45/java/net/SocketImplFactory.java,Java,,5,2,24,31
/jdk1.6.0_45/java/net/SocketInputStream.java,Java,,129,25,97,251
/jdk1.6.0_45/java/net/SocketOptions.java,Java,,20,34,264,318
/jdk1.6.0_45/java/net/SocketOutputStream.java,Java,,72,17,77,166
/jdk1.6.0_45/java/net/SocketPermission.java,Java,,718,177,503,1398
/jdk1.6.0_45/java/net/SocketTimeoutException.java,Java,,7,5,19,31
/jdk1.6.0_45/java/net/SocksConsts.java,Java,,25,6,9,40
/jdk1.6.0_45/java/net/SocksSocketImpl.java,Java,,817,33,194,1044
/jdk1.6.0_45/java/net/UnknownHostException.java,Java,,10,4,23,37
/jdk1.6.0_45/java/net/UnknownServiceException.java,Java,,9,4,26,39
/jdk1.6.0_45/java/net/URI.java,Java,,1524,282,1701,3507
/jdk1.6.0_45/java/net/URISyntaxException.java,Java,,39,11,66,116
/jdk1.6.0_45/java/net/URL.java,Java,,459,108,742,1309
/jdk1.6.0_45/java/net/URLClassLoader.java,Java,,372,39,218,629
/jdk1.6.0_45/java/net/URLConnection.java,Java,,550,144,1014,1708
/jdk1.6.0_45/java/net/URLDecoder.java,Java,,65,20,103,188
/jdk1.6.0_45/java/net/URLEncoder.java,Java,,110,19,147,276
/jdk1.6.0_45/java/net/URLStreamHandler.java,Java,,303,42,228,573
/jdk1.6.0_45/java/net/URLStreamHandlerFactory.java,Java,,4,2,28,34
/jdk1.6.0_45/java/nio/Bits.java,Java,,552,140,64,756
/jdk1.6.0_45/java/nio/Buffer.java,Java,,130,36,372,538
/jdk1.6.0_45/java/nio/BufferOverflowException.java,Java,,6,7,19,32
/jdk1.6.0_45/java/nio/BufferUnderflowException.java,Java,,6,7,19,32
/jdk1.6.0_45/java/nio/ByteBuffer.java,Java,,196,491,1307,1994
/jdk1.6.0_45/java/nio/ByteBufferAsCharBufferB.java,Java,,123,68,9,200
/jdk1.6.0_45/java/nio/ByteBufferAsCharBufferL.java,Java,,123,68,9,200
/jdk1.6.0_45/java/nio/ByteBufferAsCharBufferRB.java,Java,,83,109,8,200
/jdk1.6.0_45/java/nio/ByteBufferAsCharBufferRL.java,Java,,83,109,8,200
/jdk1.6.0_45/java/nio/ByteBufferAsDoubleBufferB.java,Java,,92,100,8,200
/jdk1.6.0_45/java/nio/ByteBufferAsDoubleBufferL.java,Java,,92,100,8,200
/jdk1.6.0_45/java/nio/ByteBufferAsDoubleBufferRB.java,Java,,52,141,7,200
/jdk1.6.0_45/java/nio/ByteBufferAsDoubleBufferRL.java,Java,,52,141,7,200
/jdk1.6.0_45/java/nio/ByteBufferAsFloatBufferB.java,Java,,92,100,8,200
/jdk1.6.0_45/java/nio/ByteBufferAsFloatBufferL.java,Java,,92,100,8,200
/jdk1.6.0_45/java/nio/ByteBufferAsFloatBufferRB.java,Java,,52,141,7,200
/jdk1.6.0_45/java/nio/ByteBufferAsFloatBufferRL.java,Java,,52,141,7,200
/jdk1.6.0_45/java/nio/ByteBufferAsIntBufferB.java,Java,,92,100,8,200
/jdk1.6.0_45/java/nio/ByteBufferAsIntBufferL.java,Java,,92,100,8,200
/jdk1.6.0_45/java/nio/ByteBufferAsIntBufferRB.java,Java,,52,141,7,200
/jdk1.6.0_45/java/nio/ByteBufferAsIntBufferRL.java,Java,,52,141,7,200
/jdk1.6.0_45/java/nio/ByteBufferAsLongBufferB.java,Java,,92,100,8,200
/jdk1.6.0_45/java/nio/ByteBufferAsLongBufferL.java,Java,,92,100,8,200
/jdk1.6.0_45/java/nio/ByteBufferAsLongBufferRB.java,Java,,52,141,7,200
/jdk1.6.0_45/java/nio/ByteBufferAsLongBufferRL.java,Java,,52,141,7,200
/jdk1.6.0_45/java/nio/ByteBufferAsShortBufferB.java,Java,,92,100,8,200
/jdk1.6.0_45/java/nio/ByteBufferAsShortBufferL.java,Java,,92,100,8,200
/jdk1.6.0_45/java/nio/ByteBufferAsShortBufferRB.java,Java,,52,141,7,200
/jdk1.6.0_45/java/nio/ByteBufferAsShortBufferRL.java,Java,,52,141,7,200
/jdk1.6.0_45/java/nio/ByteOrder.java,Java,,17,11,44,72
/jdk1.6.0_45/java/nio/channels/AlreadyConnectedException.java,Java,,6,7,19,32
/jdk1.6.0_45/java/nio/channels/AsynchronousCloseException.java,Java,,6,7,20,33
/jdk1.6.0_45/java/nio/channels/ByteChannel.java,Java,,6,6,16,28
/jdk1.6.0_45/java/nio/channels/CancelledKeyException.java,Java,,6,7,19,32
/jdk1.6.0_45/java/nio/channels/Channel.java,Java,,7,8,52,67
/jdk1.6.0_45/java/nio/channels/Channels.java,Java,,212,44,196,452
/jdk1.6.0_45/java/nio/channels/ClosedByInterruptException.java,Java,,6,7,21,34
/jdk1.6.0_45/java/nio/channels/ClosedChannelException.java,Java,,6,7,22,35
/jdk1.6.0_45/java/nio/channels/ClosedSelectorException.java,Java,,6,7,19,32
/jdk1.6.0_45/java/nio/channels/ConnectionPendingException.java,Java,,6,7,20,33
/jdk1.6.0_45/java/nio/channels/DatagramChannel.java,Java,,41,25,355,421
/jdk1.6.0_45/java/nio/channels/FileChannel.java,Java,,64,43,858,965
/jdk1.6.0_45/java/nio/channels/FileLock.java,Java,,51,16,177,244
/jdk1.6.0_45/java/nio/channels/FileLockInterruptionException.java,Java,,6,7,20,33
/jdk1.6.0_45/java/nio/channels/GatheringByteChannel.java,Java,,10,9,130,149
/jdk1.6.0_45/java/nio/channels/IllegalBlockingModeException.java,Java,,6,7,19,32
/jdk1.6.0_45/java/nio/channels/IllegalSelectorException.java,Java,,6,7,20,33
/jdk1.6.0_45/java/nio/channels/InterruptibleChannel.java,Java,,7,8,49,64
/jdk1.6.0_45/java/nio/channels/NoConnectionPendingException.java,Java,,6,7,20,33
/jdk1.6.0_45/java/nio/channels/NonReadableChannelException.java,Java,,6,7,19,32
/jdk1.6.0_45/java/nio/channels/NonWritableChannelException.java,Java,,6,7,19,32
/jdk1.6.0_45/java/nio/channels/NotYetBoundException.java,Java,,6,7,19,32
/jdk1.6.0_45/java/nio/channels/NotYetConnectedException.java,Java,,6,7,19,32
/jdk1.6.0_45/java/nio/channels/OverlappingFileLockException.java,Java,,6,7,21,34
/jdk1.6.0_45/java/nio/channels/Pipe.java,Java,,33,16,87,136
/jdk1.6.0_45/java/nio/channels/ReadableByteChannel.java,Java,,6,7,78,91
/jdk1.6.0_45/java/nio/channels/ScatteringByteChannel.java,Java,,10,8,127,145
/jdk1.6.0_45/java/nio/channels/SelectableChannel.java,Java,,25,17,277,319
/jdk1.6.0_45/java/nio/channels/SelectionKey.java,Java,,37,33,310,380
/jdk1.6.0_45/java/nio/channels/Selector.java,Java,,20,17,341,378
/jdk1.6.0_45/java/nio/channels/ServerSocketChannel.java,Java,,20,13,121,154
/jdk1.6.0_45/java/nio/channels/SocketChannel.java,Java,,46,25,292,363
/jdk1.6.0_45/java/nio/channels/spi/AbstractInterruptibleChannel.java,Java,,63,18,113,194
/jdk1.6.0_45/java/nio/channels/spi/AbstractSelectableChannel.java,Java,,139,34,105,278
/jdk1.6.0_45/java/nio/channels/spi/AbstractSelectionKey.java,Java,,22,10,28,60
/jdk1.6.0_45/java/nio/channels/spi/AbstractSelector.java,Java,,59,23,131,213
/jdk1.6.0_45/java/nio/channels/spi/SelectorProvider.java,Java,,87,17,162,266
/jdk1.6.0_45/java/nio/channels/UnresolvedAddressException.java,Java,,6,7,19,32
/jdk1.6.0_45/java/nio/channels/UnsupportedAddressTypeException.java,Java,,6,7,19,32
/jdk1.6.0_45/java/nio/channels/WritableByteChannel.java,Java,,8,7,73,88
/jdk1.6.0_45/java/nio/CharBuffer.java,Java,,198,179,1030,1407
/jdk1.6.0_45/java/nio/charset/CharacterCodingException.java,Java,,6,7,19,32
/jdk1.6.0_45/java/nio/charset/Charset.java,Java,,304,60,520,884
/jdk1.6.0_45/java/nio/charset/CharsetDecoder.java,Java,,218,187,550,955
/jdk1.6.0_45/java/nio/charset/CharsetEncoder.java,Java,,263,141,551,955
/jdk1.6.0_45/java/nio/charset/CoderMalfunctionError.java,Java,,8,6,21,35
/jdk1.6.0_45/java/nio/charset/CoderResult.java,Java,,97,29,141,267
/jdk1.6.0_45/java/nio/charset/CodingErrorAction.java,Java,,16,11,40,67
/jdk1.6.0_45/java/nio/charset/IllegalCharsetNameException.java,Java,,13,9,27,49
/jdk1.6.0_45/java/nio/charset/MalformedInputException.java,Java,,15,9,13,37
/jdk1.6.0_45/java/nio/charset/spi/CharsetProvider.java,Java,,12,9,72,93
/jdk1.6.0_45/java/nio/charset/UnmappableCharacterException.java,Java,,15,9,13,37
/jdk1.6.0_45/java/nio/charset/UnsupportedCharsetException.java,Java,,13,9,27,49
/jdk1.6.0_45/java/nio/DirectByteBuffer.java,Java,,614,351,27,992
/jdk1.6.0_45/java/nio/DirectByteBufferR.java,Java,,339,642,11,992
/jdk1.6.0_45/java/nio/DirectCharBufferRS.java,Java,,92,353,8,453
/jdk1.6.0_45/java/nio/DirectCharBufferRU.java,Java,,92,353,8,453
/jdk1.6.0_45/java/nio/DirectCharBufferS.java,Java,,196,240,17,453
/jdk1.6.0_45/java/nio/DirectCharBufferU.java,Java,,196,240,17,453
/jdk1.6.0_45/java/nio/DirectDoubleBufferRS.java,Java,,61,385,7,453
/jdk1.6.0_45/java/nio/DirectDoubleBufferRU.java,Java,,61,385,7,453
/jdk1.6.0_45/java/nio/DirectDoubleBufferS.java,Java,,165,272,16,453
/jdk1.6.0_45/java/nio/DirectDoubleBufferU.java,Java,,165,272,16,453
/jdk1.6.0_45/java/nio/DirectFloatBufferRS.java,Java,,61,385,7,453
/jdk1.6.0_45/java/nio/DirectFloatBufferRU.java,Java,,61,385,7,453
/jdk1.6.0_45/java/nio/DirectFloatBufferS.java,Java,,165,272,16,453
/jdk1.6.0_45/java/nio/DirectFloatBufferU.java,Java,,165,272,16,453
/jdk1.6.0_45/java/nio/DirectIntBufferRS.java,Java,,61,385,7,453
/jdk1.6.0_45/java/nio/DirectIntBufferRU.java,Java,,61,385,7,453
/jdk1.6.0_45/java/nio/DirectIntBufferS.java,Java,,165,272,16,453
/jdk1.6.0_45/java/nio/DirectIntBufferU.java,Java,,165,272,16,453
/jdk1.6.0_45/java/nio/DirectLongBufferRS.java,Java,,61,385,7,453
/jdk1.6.0_45/java/nio/DirectLongBufferRU.java,Java,,61,385,7,453
/jdk1.6.0_45/java/nio/DirectLongBufferS.java,Java,,165,272,16,453
/jdk1.6.0_45/java/nio/DirectLongBufferU.java,Java,,165,272,16,453
/jdk1.6.0_45/java/nio/DirectShortBufferRS.java,Java,,61,385,7,453
/jdk1.6.0_45/java/nio/DirectShortBufferRU.java,Java,,61,385,7,453
/jdk1.6.0_45/java/nio/DirectShortBufferS.java,Java,,165,272,16,453
/jdk1.6.0_45/java/nio/DirectShortBufferU.java,Java,,165,272,16,453
/jdk1.6.0_45/java/nio/DoubleBuffer.java,Java,,149,504,754,1407
/jdk1.6.0_45/java/nio/FloatBuffer.java,Java,,149,504,754,1407
/jdk1.6.0_45/java/nio/HeapByteBuffer.java,Java,,301,232,43,576
/jdk1.6.0_45/java/nio/HeapByteBufferR.java,Java,,201,344,31,576
/jdk1.6.0_45/java/nio/HeapCharBuffer.java,Java,,132,406,38,576
/jdk1.6.0_45/java/nio/HeapCharBufferR.java,Java,,80,470,26,576
/jdk1.6.0_45/java/nio/HeapDoubleBuffer.java,Java,,112,427,37,576
/jdk1.6.0_45/java/nio/HeapDoubleBufferR.java,Java,,60,491,25,576
/jdk1.6.0_45/java/nio/HeapFloatBuffer.java,Java,,112,427,37,576
/jdk1.6.0_45/java/nio/HeapFloatBufferR.java,Java,,60,491,25,576
/jdk1.6.0_45/java/nio/HeapIntBuffer.java,Java,,112,427,37,576
/jdk1.6.0_45/java/nio/HeapIntBufferR.java,Java,,60,491,25,576
/jdk1.6.0_45/java/nio/HeapLongBuffer.java,Java,,112,427,37,576
/jdk1.6.0_45/java/nio/HeapLongBufferR.java,Java,,60,491,25,576
/jdk1.6.0_45/java/nio/HeapShortBuffer.java,Java,,112,427,37,576
/jdk1.6.0_45/java/nio/HeapShortBufferR.java,Java,,60,491,25,576
/jdk1.6.0_45/java/nio/IntBuffer.java,Java,,149,504,754,1407
/jdk1.6.0_45/java/nio/InvalidMarkException.java,Java,,6,7,19,32
/jdk1.6.0_45/java/nio/LongBuffer.java,Java,,149,504,754,1407
/jdk1.6.0_45/java/nio/MappedByteBuffer.java,Java,,52,15,95,162
/jdk1.6.0_45/java/nio/ReadOnlyBufferException.java,Java,,6,7,19,32
/jdk1.6.0_45/java/nio/ShortBuffer.java,Java,,149,504,754,1407
/jdk1.6.0_45/java/nio/StringCharBuffer.java,Java,,77,21,8,106
/jdk1.6.0_45/java/rmi/AccessException.java,Java,,10,5,38,53
/jdk1.6.0_45/java/rmi/activation/Activatable.java,Java,,134,22,382,538
/jdk1.6.0_45/java/rmi/activation/ActivateFailedException.java,Java,,10,5,30,45
/jdk1.6.0_45/java/rmi/activation/ActivationDesc.java,Java,,98,22,202,322
/jdk1.6.0_45/java/rmi/activation/ActivationException.java,Java,,28,9,64,101
/jdk1.6.0_45/java/rmi/activation/ActivationGroup.java,Java,,175,31,305,511
/jdk1.6.0_45/java/rmi/activation/ActivationGroupDesc.java,Java,,122,31,200,353
/jdk1.6.0_45/java/rmi/activation/ActivationGroupID.java,Java,,26,9,63,98
/jdk1.6.0_45/java/rmi/activation/ActivationID.java,Java,,94,16,163,273
/jdk1.6.0_45/java/rmi/activation/ActivationInstantiator.java,Java,,9,4,46,59
/jdk1.6.0_45/java/rmi/activation/ActivationMonitor.java,Java,,16,9,68,93
/jdk1.6.0_45/java/rmi/activation/ActivationSystem.java,Java,,32,14,166,212
/jdk1.6.0_45/java/rmi/activation/Activator.java,Java,,10,4,83,97
/jdk1.6.0_45/java/rmi/activation/UnknownGroupException.java,Java,,7,4,32,43
/jdk1.6.0_45/java/rmi/activation/UnknownObjectException.java,Java,,7,4,34,45
/jdk1.6.0_45/java/rmi/AlreadyBoundException.java,Java,,10,4,31,45
/jdk1.6.0_45/java/rmi/ConnectException.java,Java,,10,5,30,45
/jdk1.6.0_45/java/rmi/ConnectIOException.java,Java,,10,6,31,47
/jdk1.6.0_45/java/rmi/dgc/DGC.java,Java,,9,4,84,97
/jdk1.6.0_45/java/rmi/dgc/Lease.java,Java,,19,6,34,59
/jdk1.6.0_45/java/rmi/dgc/VMID.java,Java,,84,18,58,160
/jdk1.6.0_45/java/rmi/MarshalException.java,Java,,10,5,39,54
/jdk1.6.0_45/java/rmi/MarshalledObject.java,Java,,111,28,160,299
/jdk1.6.0_45/java/rmi/Naming.java,Java,,171,22,146,339
/jdk1.6.0_45/java/rmi/NoSuchObjectException.java,Java,,7,4,34,45
/jdk1.6.0_45/java/rmi/NotBoundException.java,Java,,10,4,33,47
/jdk1.6.0_45/java/rmi/registry/LocateRegistry.java,Java,,68,15,141,224
/jdk1.6.0_45/java/rmi/registry/Registry.java,Java,,18,8,149,175
/jdk1.6.0_45/java/rmi/registry/RegistryHandler.java,Java,,11,5,40,56
/jdk1.6.0_45/java/rmi/Remote.java,Java,,2,2,29,33
/jdk1.6.0_45/java/rmi/RemoteException.java,Java,,28,9,68,105
/jdk1.6.0_45/java/rmi/RMISecurityException.java,Java,,13,4,33,50
/jdk1.6.0_45/java/rmi/RMISecurityManager.java,Java,,6,4,37,47
/jdk1.6.0_45/java/rmi/server/ExportException.java,Java,,10,6,35,51
/jdk1.6.0_45/java/rmi/server/LoaderHandler.java,Java,,15,7,56,78
/jdk1.6.0_45/java/rmi/server/LogStream.java,Java,,123,27,103,253
/jdk1.6.0_45/java/rmi/server/ObjID.java,Java,,68,18,145,231
/jdk1.6.0_45/java/rmi/server/Operation.java,Java,,17,5,34,56
/jdk1.6.0_45/java/rmi/server/RemoteCall.java,Java,,24,10,81,115
/jdk1.6.0_45/java/rmi/server/RemoteObject.java,Java,,89,15,337,441
/jdk1.6.0_45/java/rmi/server/RemoteObjectInvocationHandler.java,Java,,129,16,122,267
/jdk1.6.0_45/java/rmi/server/RemoteRef.java,Java,,22,14,142,178
/jdk1.6.0_45/java/rmi/server/RemoteServer.java,Java,,27,8,63,98
/jdk1.6.0_45/java/rmi/server/RemoteStub.java,Java,,14,5,38,57
/jdk1.6.0_45/java/rmi/server/RMIClassLoader.java,Java,,129,27,546,702
/jdk1.6.0_45/java/rmi/server/RMIClassLoaderSpi.java,Java,,15,7,153,175
/jdk1.6.0_45/java/rmi/server/RMIClientSocketFactory.java,Java,,7,4,46,57
/jdk1.6.0_45/java/rmi/server/RMIFailureHandler.java,Java,,4,5,35,44
/jdk1.6.0_45/java/rmi/server/RMIServerSocketFactory.java,Java,,7,4,46,57
/jdk1.6.0_45/java/rmi/server/RMISocketFactory.java,Java,,52,12,107,171
/jdk1.6.0_45/java/rmi/server/ServerCloneException.java,Java,,25,8,62,95
/jdk1.6.0_45/java/rmi/server/ServerNotActiveException.java,Java,,9,5,30,44
/jdk1.6.0_45/java/rmi/server/ServerRef.java,Java,,8,6,35,49
/jdk1.6.0_45/java/rmi/server/Skeleton.java,Java,,10,3,40,53
/jdk1.6.0_45/java/rmi/server/SkeletonMismatchException.java,Java,,10,6,29,45
/jdk1.6.0_45/java/rmi/server/SkeletonNotFoundException.java,Java,,12,6,33,51
/jdk1.6.0_45/java/rmi/server/SocketSecurityException.java,Java,,10,6,29,45
/jdk1.6.0_45/java/rmi/server/UID.java,Java,,88,17,144,249
/jdk1.6.0_45/java/rmi/server/UnicastRemoteObject.java,Java,,83,18,194,295
/jdk1.6.0_45/java/rmi/server/Unreferenced.java,Java,,4,2,22,28
/jdk1.6.0_45/java/rmi/ServerError.java,Java,,7,4,28,39
/jdk1.6.0_45/java/rmi/ServerException.java,Java,,10,5,35,50
/jdk1.6.0_45/java/rmi/ServerRuntimeException.java,Java,,9,4,35,48
/jdk1.6.0_45/java/rmi/StubNotFoundException.java,Java,,10,5,35,50
/jdk1.6.0_45/java/rmi/UnexpectedException.java,Java,,10,5,32,47
/jdk1.6.0_45/java/rmi/UnknownHostException.java,Java,,10,5,30,45
/jdk1.6.0_45/java/rmi/UnmarshalException.java,Java,,10,5,44,59
/jdk1.6.0_45/java/security/AccessControlContext.java,Java,,313,78,215,606
/jdk1.6.0_45/java/security/AccessControlException.java,Java,,15,9,42,66
/jdk1.6.0_45/java/security/AccessController.java,Java,,89,34,428,551
/jdk1.6.0_45/java/security/acl/Acl.java,Java,,16,28,196,240
/jdk1.6.0_45/java/security/acl/AclEntry.java,Java,,15,15,108,138
/jdk1.6.0_45/java/security/acl/AclNotFoundException.java,Java,,6,5,15,26
/jdk1.6.0_45/java/security/acl/Group.java,Java,,9,9,51,69
/jdk1.6.0_45/java/security/acl/LastOwnerException.java,Java,,6,4,17,27
/jdk1.6.0_45/java/security/acl/NotOwnerException.java,Java,,6,4,16,26
/jdk1.6.0_45/java/security/acl/Owner.java,Java,,9,7,61,77
/jdk1.6.0_45/java/security/acl/Permission.java,Java,,5,6,25,36
/jdk1.6.0_45/java/security/AlgorithmParameterGenerator.java,Java,,78,18,216,312
/jdk1.6.0_45/java/security/AlgorithmParameterGeneratorSpi.java,Java,,9,7,53,69
/jdk1.6.0_45/java/security/AlgorithmParameters.java,Java,,108,21,236,365
/jdk1.6.0_45/java/security/AlgorithmParametersSpi.java,Java,,20,11,103,134
/jdk1.6.0_45/java/security/AllPermission.java,Java,,69,32,121,222
/jdk1.6.0_45/java/security/AuthProvider.java,Java,,13,7,89,109
/jdk1.6.0_45/java/security/BasicPermission.java,Java,,209,77,272,558
/jdk1.6.0_45/java/security/cert/Certificate.java,Java,,90,24,143,257
/jdk1.6.0_45/java/security/cert/CertificateEncodingException.java,Java,,16,7,48,71
/jdk1.6.0_45/java/security/cert/CertificateException.java,Java,,17,8,46,71
/jdk1.6.0_45/java/security/cert/CertificateExpiredException.java,Java,,10,5,27,42
/jdk1.6.0_45/java/security/cert/CertificateFactory.java,Java,,102,22,378,502
/jdk1.6.0_45/java/security/cert/CertificateFactorySpi.java,Java,,38,12,248,298
/jdk1.6.0_45/java/security/cert/CertificateNotYetValidException.java,Java,,10,5,27,42
/jdk1.6.0_45/java/security/cert/CertificateParsingException.java,Java,,16,7,49,72
/jdk1.6.0_45/java/security/cert/CertPath.java,Java,,91,25,196,312
/jdk1.6.0_45/java/security/cert/CertPathBuilder.java,Java,,69,13,192,274
/jdk1.6.0_45/java/security/cert/CertPathBuilderException.java,Java,,17,9,61,87
/jdk1.6.0_45/java/security/cert/CertPathBuilderResult.java,Java,,5,4,42,51
/jdk1.6.0_45/java/security/cert/CertPathBuilderSpi.java,Java,,7,5,46,58
/jdk1.6.0_45/java/security/cert/CertPathHelperImpl.java,Java,,42,18,20,80
/jdk1.6.0_45/java/security/cert/CertPathParameters.java,Java,,4,3,25,32
/jdk1.6.0_45/java/security/cert/CertPathValidator.java,Java,,71,13,202,286
/jdk1.6.0_45/java/security/cert/CertPathValidatorException.java,Java,,38,14,108,160
/jdk1.6.0_45/java/security/cert/CertPathValidatorResult.java,Java,,4,3,26,33
/jdk1.6.0_45/java/security/cert/CertPathValidatorSpi.java,Java,,8,5,55,68
/jdk1.6.0_45/java/security/cert/CertSelector.java,Java,,5,4,41,50
/jdk1.6.0_45/java/security/cert/CertStore.java,Java,,100,15,282,397
/jdk1.6.0_45/java/security/cert/CertStoreException.java,Java,,17,9,60,86
/jdk1.6.0_45/java/security/cert/CertStoreParameters.java,Java,,4,3,56,63
/jdk1.6.0_45/java/security/cert/CertStoreSpi.java,Java,,11,6,91,108
/jdk1.6.0_45/java/security/cert/CollectionCertStoreParameters.java,Java,,33,9,82,124
/jdk1.6.0_45/java/security/cert/CRL.java,Java,,12,8,51,71
/jdk1.6.0_45/java/security/cert/CRLException.java,Java,,17,8,46,71
/jdk1.6.0_45/java/security/cert/CRLSelector.java,Java,,5,4,40,49
/jdk1.6.0_45/java/security/cert/LDAPCertStoreParameters.java,Java,,39,13,80,132
/jdk1.6.0_45/java/security/cert/PKIXBuilderParameters.java,Java,,40,9,133,182
/jdk1.6.0_45/java/security/cert/PKIXCertPathBuilderResult.java,Java,,28,7,67,102
/jdk1.6.0_45/java/security/cert/PKIXCertPathChecker.java,Java,,20,9,135,164
/jdk1.6.0_45/java/security/cert/PKIXCertPathValidatorResult.java,Java,,43,10,89,142
/jdk1.6.0_45/java/security/cert/PKIXParameters.java,Java,,250,42,426,718
/jdk1.6.0_45/java/security/cert/PolicyNode.java,Java,,12,10,94,116
/jdk1.6.0_45/java/security/cert/PolicyQualifierInfo.java,Java,,46,12,98,156
/jdk1.6.0_45/java/security/cert/TrustAnchor.java,Java,,101,17,201,319
/jdk1.6.0_45/java/security/cert/X509Certificate.java,Java,,60,30,536,626
/jdk1.6.0_45/java/security/cert/X509CertSelector.java,Java,,1264,106,1251,2621
/jdk1.6.0_45/java/security/cert/X509CRL.java,Java,,82,27,309,418
/jdk1.6.0_45/java/security/cert/X509CRLEntry.java,Java,,44,15,99,158
/jdk1.6.0_45/java/security/cert/X509CRLSelector.java,Java,,271,38,386,695
/jdk1.6.0_45/java/security/cert/X509Extension.java,Java,,8,8,153,169
/jdk1.6.0_45/java/security/Certificate.java,Java,,15,11,113,139
/jdk1.6.0_45/java/security/CodeSigner.java,Java,,63,15,71,149
/jdk1.6.0_45/java/security/CodeSource.java,Java,,266,61,294,621
/jdk1.6.0_45/java/security/DigestException.java,Java,,16,7,46,69
/jdk1.6.0_45/java/security/DigestInputStream.java,Java,,41,18,116,175
/jdk1.6.0_45/java/security/DigestOutputStream.java,Java,,39,16,103,158
/jdk1.6.0_45/java/security/DomainCombiner.java,Java,,5,3,87,95
/jdk1.6.0_45/java/security/GeneralSecurityException.java,Java,,16,8,47,71
/jdk1.6.0_45/java/security/Guard.java,Java,,4,4,31,39
/jdk1.6.0_45/java/security/GuardedObject.java,Java,,25,11,49,85
/jdk1.6.0_45/java/security/Identity.java,Java,,179,41,259,479
/jdk1.6.0_45/java/security/IdentityScope.java,Java,,67,26,146,239
/jdk1.6.0_45/java/security/interfaces/DSAKey.java,Java,,4,3,26,33
/jdk1.6.0_45/java/security/interfaces/DSAKeyPairGenerator.java,Java,,8,5,84,97
/jdk1.6.0_45/java/security/interfaces/DSAParams.java,Java,,7,6,34,47
/jdk1.6.0_45/java/security/interfaces/DSAPrivateKey.java,Java,,6,8,29,43
/jdk1.6.0_45/java/security/interfaces/DSAPublicKey.java,Java,,6,8,29,43
/jdk1.6.0_45/java/security/interfaces/ECKey.java,Java,,5,2,21,28
/jdk1.6.0_45/java/security/interfaces/ECPrivateKey.java,Java,,7,3,26,36
/jdk1.6.0_45/java/security/interfaces/ECPublicKey.java,Java,,7,4,27,38
/jdk1.6.0_45/java/security/interfaces/RSAKey.java,Java,,5,5,22,32
/jdk1.6.0_45/java/security/interfaces/RSAMultiPrimePrivateCrtKey.java,Java,,13,12,58,83
/jdk1.6.0_45/java/security/interfaces/RSAPrivateCrtKey.java,Java,,11,11,46,68
/jdk1.6.0_45/java/security/interfaces/RSAPrivateKey.java,Java,,7,6,20,33
/jdk1.6.0_45/java/security/interfaces/RSAPublicKey.java,Java,,7,5,18,30
/jdk1.6.0_45/java/security/InvalidAlgorithmParameterException.java,Java,,17,8,55,80
/jdk1.6.0_45/java/security/InvalidKeyException.java,Java,,16,9,47,72
/jdk1.6.0_45/java/security/InvalidParameterException.java,Java,,10,6,26,42
/jdk1.6.0_45/java/security/Key.java,Java,,7,8,121,136
/jdk1.6.0_45/java/security/KeyException.java,Java,,16,8,49,73
/jdk1.6.0_45/java/security/KeyFactory.java,Java,,188,25,231,444
/jdk1.6.0_45/java/security/KeyFactorySpi.java,Java,,14,9,100,123
/jdk1.6.0_45/java/security/KeyManagementException.java,Java,,16,8,58,82
/jdk1.6.0_45/java/security/KeyPair.java,Java,,17,9,38,64
/jdk1.6.0_45/java/security/KeyPairGenerator.java,Java,,235,41,393,669
/jdk1.6.0_45/java/security/KeyPairGeneratorSpi.java,Java,,11,7,71,89
/jdk1.6.0_45/java/security/KeyRep.java,Java,,60,21,97,178
/jdk1.6.0_45/java/security/KeyStore.java,Java,,637,103,1001,1741
/jdk1.6.0_45/java/security/KeyStoreException.java,Java,,16,8,49,73
/jdk1.6.0_45/java/security/KeyStoreSpi.java,Java,,181,39,356,576
/jdk1.6.0_45/java/security/MessageDigest.java,Java,,217,42,299,558
/jdk1.6.0_45/java/security/MessageDigestSpi.java,Java,,56,15,118,189
/jdk1.6.0_45/java/security/NoSuchAlgorithmException.java,Java,,16,8,48,72
/jdk1.6.0_45/java/security/NoSuchProviderException.java,Java,,10,6,25,41
/jdk1.6.0_45/java/security/Permission.java,Java,,31,23,161,215
/jdk1.6.0_45/java/security/PermissionCollection.java,Java,,30,12,134,176
/jdk1.6.0_45/java/security/Permissions.java,Java,,238,80,262,580
/jdk1.6.0_45/java/security/Policy.java,Java,,344,68,432,844
/jdk1.6.0_45/java/security/PolicySpi.java,Java,,14,8,79,101
/jdk1.6.0_45/java/security/Principal.java,Java,,7,6,42,55
/jdk1.6.0_45/java/security/PrivateKey.java,Java,,4,3,32,39
/jdk1.6.0_45/java/security/PrivilegedAction.java,Java,,4,4,30,38
/jdk1.6.0_45/java/security/PrivilegedActionException.java,Java,,19,7,61,87
/jdk1.6.0_45/java/security/PrivilegedExceptionAction.java,Java,,4,5,35,44
/jdk1.6.0_45/java/security/ProtectionDomain.java,Java,,212,42,166,420
/jdk1.6.0_45/java/security/Provider.java,Java,,817,102,544,1463
/jdk1.6.0_45/java/security/ProviderException.java,Java,,16,7,49,72
/jdk1.6.0_45/java/security/PublicKey.java,Java,,4,3,29,36
/jdk1.6.0_45/java/security/SecureClassLoader.java,Java,,111,17,130,258
/jdk1.6.0_45/java/security/SecureRandom.java,Java,,140,36,386,562
/jdk1.6.0_45/java/security/SecureRandomSpi.java,Java,,7,7,43,57
/jdk1.6.0_45/java/security/Security.java,Java,,494,96,479,1069
/jdk1.6.0_45/java/security/SecurityPermission.java,Java,,16,9,274,299
/jdk1.6.0_45/java/security/Signature.java,Java,,626,96,540,1262
/jdk1.6.0_45/java/security/SignatureException.java,Java,,16,8,46,70
/jdk1.6.0_45/java/security/SignatureSpi.java,Java,,92,30,259,381
/jdk1.6.0_45/java/security/SignedObject.java,Java,,59,16,168,243
/jdk1.6.0_45/java/security/Signer.java,Java,,60,18,88,166
/jdk1.6.0_45/java/security/spec/AlgorithmParameterSpec.java,Java,,2,3,22,27
/jdk1.6.0_45/java/security/spec/DSAParameterSpec.java,Java,,22,9,41,72
/jdk1.6.0_45/java/security/spec/DSAPrivateKeySpec.java,Java,,27,10,52,89
/jdk1.6.0_45/java/security/spec/DSAPublicKeySpec.java,Java,,27,10,52,89
/jdk1.6.0_45/java/security/spec/ECField.java,Java,,6,2,24,32
/jdk1.6.0_45/java/security/spec/ECFieldF2m.java,Java,,91,12,121,224
/jdk1.6.0_45/java/security/spec/ECFieldFp.java,Java,,28,8,45,81
/jdk1.6.0_45/java/security/spec/ECGenParameterSpec.java,Java,,13,4,34,51
/jdk1.6.0_45/java/security/spec/ECParameterSpec.java,Java,,42,8,46,96
/jdk1.6.0_45/java/security/spec/ECPoint.java,Java,,37,10,50,97
/jdk1.6.0_45/java/security/spec/ECPrivateKeySpec.java,Java,,22,6,36,64
/jdk1.6.0_45/java/security/spec/ECPublicKeySpec.java,Java,,24,5,39,68
/jdk1.6.0_45/java/security/spec/EllipticCurve.java,Java,,83,13,82,178
/jdk1.6.0_45/java/security/spec/EncodedKeySpec.java,Java,,11,7,50,68
/jdk1.6.0_45/java/security/spec/InvalidKeySpecException.java,Java,,17,9,51,77
/jdk1.6.0_45/java/security/spec/InvalidParameterSpecException.java,Java,,11,7,31,49
/jdk1.6.0_45/java/security/spec/KeySpec.java,Java,,2,3,40,45
/jdk1.6.0_45/java/security/spec/MGF1ParameterSpec.java,Java,,22,7,61,90
/jdk1.6.0_45/java/security/spec/PKCS8EncodedKeySpec.java,Java,,12,6,61,79
/jdk1.6.0_45/java/security/spec/PSSParameterSpec.java,Java,,59,14,121,194
/jdk1.6.0_45/java/security/spec/RSAKeyGenParameterSpec.java,Java,,19,10,40,69
/jdk1.6.0_45/java/security/spec/RSAMultiPrimePrivateCrtKeySpec.java,Java,,90,13,92,195
/jdk1.6.0_45/java/security/spec/RSAOtherPrimeInfo.java,Java,,35,10,58,103
/jdk1.6.0_45/java/security/spec/RSAPrivateCrtKeySpec.java,Java,,44,14,68,126
/jdk1.6.0_45/java/security/spec/RSAPrivateKeySpec.java,Java,,16,8,36,60
/jdk1.6.0_45/java/security/spec/RSAPublicKeySpec.java,Java,,16,8,36,60
/jdk1.6.0_45/java/security/spec/X509EncodedKeySpec.java,Java,,12,6,51,69
/jdk1.6.0_45/java/security/Timestamp.java,Java,,49,15,68,132
/jdk1.6.0_45/java/security/UnrecoverableEntryException.java,Java,,10,6,23,39
/jdk1.6.0_45/java/security/UnrecoverableKeyException.java,Java,,10,6,23,39
/jdk1.6.0_45/java/security/UnresolvedPermission.java,Java,,296,47,246,589
/jdk1.6.0_45/java/security/UnresolvedPermissionCollection.java,Java,,90,29,82,201
/jdk1.6.0_45/java/security/URIParameter.java,Java,,14,6,25,45
/jdk1.6.0_45/java/sql/Array.java,Java,,17,16,317,350
/jdk1.6.0_45/java/sql/BatchUpdateException.java,Java,,52,16,260,328
/jdk1.6.0_45/java/sql/Blob.java,Java,,15,18,255,288
/jdk1.6.0_45/java/sql/CallableStatement.java,Java,,162,122,2142,2426
/jdk1.6.0_45/java/sql/ClientInfoStatus.java,Java,,8,8,28,44
/jdk1.6.0_45/java/sql/Clob.java,Java,,17,20,294,331
/jdk1.6.0_45/java/sql/Connection.java,Java,,75,61,1123,1259
/jdk1.6.0_45/java/sql/DatabaseMetaData.java,Java,,272,248,3036,3556
/jdk1.6.0_45/java/sql/DataTruncation.java,Java,,44,18,108,170
/jdk1.6.0_45/java/sql/Date.java,Java,,97,21,128,246
/jdk1.6.0_45/java/sql/Driver.java,Java,,11,12,113,136
/jdk1.6.0_45/java/sql/DriverManager.java,Java,,285,99,299,683
/jdk1.6.0_45/java/sql/DriverPropertyInfo.java,Java,,12,9,45,66
/jdk1.6.0_45/java/sql/NClob.java,Java,,3,4,30,37
/jdk1.6.0_45/java/sql/ParameterMetaData.java,Java,,19,20,139,178
/jdk1.6.0_45/java/sql/PreparedStatement.java,Java,,89,56,1048,1193
/jdk1.6.0_45/java/sql/Ref.java,Java,,7,10,94,111
/jdk1.6.0_45/java/sql/ResultSet.java,Java,,250,220,3597,4067
/jdk1.6.0_45/java/sql/ResultSetMetaData.java,Java,,27,28,204,259
/jdk1.6.0_45/java/sql/RowId.java,Java,,7,9,88,104
/jdk1.6.0_45/java/sql/RowIdLifetime.java,Java,,9,9,31,49
/jdk1.6.0_45/java/sql/Savepoint.java,Java,,5,7,32,44
/jdk1.6.0_45/java/sql/SQLClientInfoException.java,Java,,63,27,213,303
/jdk1.6.0_45/java/sql/SQLData.java,Java,,6,6,108,120
/jdk1.6.0_45/java/sql/SQLDataException.java,Java,,28,11,113,152
/jdk1.6.0_45/java/sql/SQLException.java,Java,,152,35,170,357
/jdk1.6.0_45/java/sql/SQLFeatureNotSupportedException.java,Java,,28,11,122,161
/jdk1.6.0_45/java/sql/SQLInput.java,Java,,30,36,340,406
/jdk1.6.0_45/java/sql/SQLIntegrityConstraintViolationException.java,Java,,28,11,113,152
/jdk1.6.0_45/java/sql/SQLInvalidAuthorizationSpecException.java,Java,,28,11,113,152
/jdk1.6.0_45/java/sql/SQLNonTransientConnectionException.java,Java,,28,12,116,156
/jdk1.6.0_45/java/sql/SQLNonTransientException.java,Java,,28,12,117,157
/jdk1.6.0_45/java/sql/SQLOutput.java,Java,,30,39,351,420
/jdk1.6.0_45/java/sql/SQLPermission.java,Java,,11,11,89,111
/jdk1.6.0_45/java/sql/SQLRecoverableException.java,Java,,28,11,118,157
/jdk1.6.0_45/java/sql/SQLSyntaxErrorException.java,Java,,28,11,113,152
/jdk1.6.0_45/java/sql/SQLTimeoutException.java,Java,,28,12,114,154
/jdk1.6.0_45/java/sql/SQLTransactionRollbackException.java,Java,,28,10,114,152
/jdk1.6.0_45/java/sql/SQLTransientConnectionException.java,Java,,28,11,116,155
/jdk1.6.0_45/java/sql/SQLTransientException.java,Java,,28,11,115,154
/jdk1.6.0_45/java/sql/SQLWarning.java,Java,,52,14,133,199
/jdk1.6.0_45/java/sql/SQLXML.java,Java,,19,13,375,407
/jdk1.6.0_45/java/sql/Statement.java,Java,,52,56,828,936
/jdk1.6.0_45/java/sql/Struct.java,Java,,7,8,75,90
/jdk1.6.0_45/java/sql/Time.java,Java,,86,23,124,233
/jdk1.6.0_45/java/sql/Timestamp.java,Java,,253,42,225,520
/jdk1.6.0_45/java/sql/Types.java,Java,,40,47,211,298
/jdk1.6.0_45/java/sql/Wrapper.java,Java,,5,8,51,64
/jdk1.6.0_45/java/text/Annotation.java,Java,,13,8,45,66
/jdk1.6.0_45/java/text/AttributedCharacterIterator.java,Java,,54,29,139,222
/jdk1.6.0_45/java/text/AttributedString.java,Java,,716,132,255,1103
/jdk1.6.0_45/java/text/Bidi.java,Java,,370,69,200,639
/jdk1.6.0_45/java/text/BreakDictionary.java,Java,,142,37,146,325
/jdk1.6.0_45/java/text/BreakIterator.java,Java,,231,49,411,691
/jdk1.6.0_45/java/text/CharacterIterator.java,Java,,15,17,143,175
/jdk1.6.0_45/java/text/CharacterIteratorFieldDelegate.java,Java,,60,11,36,107
/jdk1.6.0_45/java/text/ChoiceFormat.java,Java,,263,40,300,603
/jdk1.6.0_45/java/text/CollationElementIterator.java,Java,,410,57,285,752
/jdk1.6.0_45/java/text/CollationKey.java,Java,,15,11,103,129
/jdk1.6.0_45/java/text/CollationRules.java,Java,,204,11,42,257
/jdk1.6.0_45/java/text/Collator.java,Java,,147,33,356,536
/jdk1.6.0_45/java/text/DateFormat.java,Java,,303,73,589,965
/jdk1.6.0_45/java/text/DateFormatSymbols.java,Java,,279,64,409,752
/jdk1.6.0_45/java/text/DecimalFormat.java,Java,,1527,237,1496,3260
/jdk1.6.0_45/java/text/DecimalFormatSymbols.java,Java,,305,81,427,813
/jdk1.6.0_45/java/text/DictionaryBasedBreakIterator.java,Java,,216,49,232,497
/jdk1.6.0_45/java/text/DigitList.java,Java,,385,63,250,698
/jdk1.6.0_45/java/text/DontCareFieldPosition.java,Java,,18,5,12,35
/jdk1.6.0_45/java/text/EntryPair.java,Java,,15,4,23,42
/jdk1.6.0_45/java/text/FieldPosition.java,Java,,96,27,163,286
/jdk1.6.0_45/java/text/Format.java,Java,,68,28,293,389
/jdk1.6.0_45/java/text/MergeCollation.java,Java,,187,32,107,326
/jdk1.6.0_45/java/text/MessageFormat.java,Java,,622,70,809,1501
/jdk1.6.0_45/java/text/Normalizer.java,Java,,18,12,135,165
/jdk1.6.0_45/java/text/NumberFormat.java,Java,,333,94,718,1145
/jdk1.6.0_45/java/text/ParseException.java,Java,,12,6,43,61
/jdk1.6.0_45/java/text/ParsePosition.java,Java,,38,12,72,122
/jdk1.6.0_45/java/text/PatternEntry.java,Java,,206,29,54,289
/jdk1.6.0_45/java/text/RBCollationTables.java,Java,,129,31,125,285
/jdk1.6.0_45/java/text/RBTableBuilder.java,Java,,338,55,207,600
/jdk1.6.0_45/java/text/RuleBasedBreakIterator.java,Java,,494,121,519,1134
/jdk1.6.0_45/java/text/RuleBasedCollationKey.java,Java,,38,13,57,108
/jdk1.6.0_45/java/text/RuleBasedCollator.java,Java,,273,44,417,734
/jdk1.6.0_45/java/text/SimpleDateFormat.java,Java,,1158,170,863,2191
/jdk1.6.0_45/java/text/spi/BreakIteratorProvider.java,Java,,12,8,70,90
/jdk1.6.0_45/java/text/spi/CollatorProvider.java,Java,,9,5,30,44
/jdk1.6.0_45/java/text/spi/DateFormatProvider.java,Java,,12,7,78,97
/jdk1.6.0_45/java/text/spi/DateFormatSymbolsProvider.java,Java,,9,5,31,45
/jdk1.6.0_45/java/text/spi/DecimalFormatSymbolsProvider.java,Java,,9,5,31,45
/jdk1.6.0_45/java/text/spi/NumberFormatProvider.java,Java,,12,8,76,96
/jdk1.6.0_45/java/text/StringCharacterIterator.java,Java,,129,26,106,261
/jdk1.6.0_45/java/util/AbstractCollection.java,Java,,149,27,253,429
/jdk1.6.0_45/java/util/AbstractList.java,Java,,335,74,355,764
/jdk1.6.0_45/java/util/AbstractMap.java,Java,,292,70,427,789
/jdk1.6.0_45/java/util/AbstractQueue.java,Java,,44,9,114,167
/jdk1.6.0_45/java/util/AbstractSequentialList.java,Java,,57,14,165,236
/jdk1.6.0_45/java/util/AbstractSet.java,Java,,46,10,110,166
/jdk1.6.0_45/java/util/ArrayDeque.java,Java,,361,72,406,839
/jdk1.6.0_45/java/util/ArrayList.java,Java,,218,51,326,595
/jdk1.6.0_45/java/util/Arrays.java,Java,...,1590,311,2271,4172
/jdk1.6.0_45/java/util/BitSet.java,Java,,388,125,433,946
/jdk1.6.0_45/java/util/Calendar.java,Java,,870,201,1616,2687
/jdk1.6.0_45/java/util/Collection.java,Java,,18,23,382,423
/jdk1.6.0_45/java/util/Collections.java,Java,,1825,370,1455,3650
/jdk1.6.0_45/java/util/Comparator.java,Java,,5,4,137,146
/jdk1.6.0_45/java/util/concurrent/AbstractExecutorService.java,Java,,176,22,73,271
/jdk1.6.0_45/java/util/concurrent/ArrayBlockingQueue.java,Java,,443,45,275,763
/jdk1.6.0_45/java/util/concurrent/atomic/AtomicBoolean.java,Java,,49,14,73,136
/jdk1.6.0_45/java/util/concurrent/atomic/AtomicInteger.java,Java,,104,26,107,237
/jdk1.6.0_45/java/util/concurrent/atomic/AtomicIntegerArray.java,Java,,111,21,126,258
/jdk1.6.0_45/java/util/concurrent/atomic/AtomicIntegerFieldUpdater.java,Java,,140,28,150,318
/jdk1.6.0_45/java/util/concurrent/atomic/AtomicLong.java,Java,,106,28,117,251
/jdk1.6.0_45/java/util/concurrent/atomic/AtomicLongArray.java,Java,,111,22,125,258
/jdk1.6.0_45/java/util/concurrent/atomic/AtomicLongFieldUpdater.java,Java,,221,40,147,408
/jdk1.6.0_45/java/util/concurrent/atomic/AtomicMarkableReference.java,Java,,62,12,90,164
/jdk1.6.0_45/java/util/concurrent/atomic/AtomicReference.java,Java,,44,15,68,127
/jdk1.6.0_45/java/util/concurrent/atomic/AtomicReferenceArray.java,Java,,95,24,91,210
/jdk1.6.0_45/java/util/concurrent/atomic/AtomicReferenceFieldUpdater.java,Java,,123,24,130,277
/jdk1.6.0_45/java/util/concurrent/atomic/AtomicStampedReference.java,Java,,65,13,90,168
/jdk1.6.0_45/java/util/concurrent/BlockingDeque.java,Java,,39,33,542,614
/jdk1.6.0_45/java/util/concurrent/BlockingQueue.java,Java,,18,13,314,345
/jdk1.6.0_45/java/util/concurrent/BrokenBarrierException.java,Java,,8,4,27,39
/jdk1.6.0_45/java/util/concurrent/Callable.java,Java,,4,2,31,37
/jdk1.6.0_45/java/util/concurrent/CancellationException.java,Java,,8,4,23,35
/jdk1.6.0_45/java/util/concurrent/CompletionService.java,Java,,8,7,83,98
/jdk1.6.0_45/java/util/concurrent/ConcurrentHashMap.java,Java,,652,113,516,1281
/jdk1.6.0_45/java/util/concurrent/ConcurrentLinkedQueue.java,Java,,318,58,328,704
/jdk1.6.0_45/java/util/concurrent/ConcurrentMap.java,Java,,8,5,122,135
/jdk1.6.0_45/java/util/concurrent/ConcurrentNavigableMap.java,Java,,17,12,120,149
/jdk1.6.0_45/java/util/concurrent/ConcurrentSkipListMap.java,Java,,1735,249,1133,3117
/jdk1.6.0_45/java/util/concurrent/ConcurrentSkipListSet.java,Java,,147,46,264,457
/jdk1.6.0_45/java/util/concurrent/CopyOnWriteArrayList.java,Java,,704,98,492,1294
/jdk1.6.0_45/java/util/concurrent/CopyOnWriteArraySet.java,Java,,81,22,262,365
/jdk1.6.0_45/java/util/concurrent/CountDownLatch.java,Java,,48,13,230,291
/jdk1.6.0_45/java/util/concurrent/CyclicBarrier.java,Java,,131,22,302,455
/jdk1.6.0_45/java/util/concurrent/Delayed.java,Java,,5,4,25,34
/jdk1.6.0_45/java/util/concurrent/DelayQueue.java,Java,,255,30,202,487
/jdk1.6.0_45/java/util/concurrent/Exchanger.java,Java,,192,29,435,656
/jdk1.6.0_45/java/util/concurrent/ExecutionException.java,Java,,14,6,46,66
/jdk1.6.0_45/java/util/concurrent/Executor.java,Java,,4,3,106,113
/jdk1.6.0_45/java/util/concurrent/ExecutorCompletionService.java,Java,,64,13,98,175
/jdk1.6.0_45/java/util/concurrent/Executors.java,Java,,305,41,320,666
/jdk1.6.0_45/java/util/concurrent/ExecutorService.java,Java,,26,16,292,334
/jdk1.6.0_45/java/util/concurrent/Future.java,Java,,9,7,127,143
/jdk1.6.0_45/java/util/concurrent/FutureTask.java,Java,,167,31,128,326
/jdk1.6.0_45/java/util/concurrent/LinkedBlockingDeque.java,Java,,603,91,426,1120
/jdk1.6.0_45/java/util/concurrent/LinkedBlockingQueue.java,Java,,447,62,321,830
/jdk1.6.0_45/java/util/concurrent/locks/AbstractOwnableSynchronizer.java,Java,,13,7,38,58
/jdk1.6.0_45/java/util/concurrent/locks/AbstractQueuedLongSynchronizer.java,Java,,850,126,1069,2045
/jdk1.6.0_45/java/util/concurrent/locks/AbstractQueuedSynchronizer.java,Java,,850,126,1294,2270
/jdk1.6.0_45/java/util/concurrent/locks/Condition.java,Java,,12,9,415,436
/jdk1.6.0_45/java/util/concurrent/locks/Lock.java,Java,,10,8,310,328
/jdk1.6.0_45/java/util/concurrent/locks/LockSupport.java,Java,,56,15,282,353
/jdk1.6.0_45/java/util/concurrent/locks/ReadWriteLock.java,Java,,5,3,97,105
/jdk1.6.0_45/java/util/concurrent/locks/ReentrantLock.java,Java,,177,42,522,741
/jdk1.6.0_45/java/util/concurrent/locks/ReentrantReadWriteLock.java,Java,,348,77,922,1347
/jdk1.6.0_45/java/util/concurrent/PriorityBlockingQueue.java,Java,,258,36,270,564
/jdk1.6.0_45/java/util/concurrent/RejectedExecutionException.java,Java,,14,6,43,63
/jdk1.6.0_45/java/util/concurrent/RejectedExecutionHandler.java,Java,,4,3,27,34
/jdk1.6.0_45/java/util/concurrent/RunnableFuture.java,Java,,4,2,20,26
/jdk1.6.0_45/java/util/concurrent/RunnableScheduledFuture.java,Java,,4,3,23,30
/jdk1.6.0_45/java/util/concurrent/ScheduledExecutorService.java,Java,,17,7,136,160
/jdk1.6.0_45/java/util/concurrent/ScheduledFuture.java,Java,,3,2,15,20
/jdk1.6.0_45/java/util/concurrent/ScheduledThreadPoolExecutor.java,Java,,302,54,295,651
/jdk1.6.0_45/java/util/concurrent/Semaphore.java,Java,,144,36,502,682
/jdk1.6.0_45/java/util/concurrent/SynchronousQueue.java,Java,,519,92,516,1127
/jdk1.6.0_45/java/util/concurrent/ThreadFactory.java,Java,,4,3,35,42
/jdk1.6.0_45/java/util/concurrent/ThreadPoolExecutor.java,Java,,609,107,1107,1823
/jdk1.6.0_45/java/util/concurrent/TimeoutException.java,Java,,8,4,27,39
/jdk1.6.0_45/java/util/concurrent/TimeUnit.java,Java,,141,19,172,332
/jdk1.6.0_45/java/util/ConcurrentModificationException.java,Java,,8,3,58,69
/jdk1.6.0_45/java/util/Currency.java,Java,,182,35,176,393
/jdk1.6.0_45/java/util/CurrencyData.java,Java,,37,12,0,49
/jdk1.6.0_45/java/util/Date.java,Java,,533,59,722,1314
/jdk1.6.0_45/java/util/Deque.java,Java,,30,35,483,548
/jdk1.6.0_45/java/util/Dictionary.java,Java,,13,9,116,138
/jdk1.6.0_45/java/util/DuplicateFormatFlagsException.java,Java,,16,7,28,51
/jdk1.6.0_45/java/util/EmptyStackException.java,Java,,6,2,19,27
/jdk1.6.0_45/java/util/Enumeration.java,Java,,5,3,54,62
/jdk1.6.0_45/java/util/EnumMap.java,Java,,386,75,259,720
/jdk1.6.0_45/java/util/EnumSet.java,Java,,139,31,249,419
/jdk1.6.0_45/java/util/EventListener.java,Java,,3,2,10,15
/jdk1.6.0_45/java/util/EventListenerProxy.java,Java,,10,4,39,53
/jdk1.6.0_45/java/util/EventObject.java,Java,,16,9,35,60
/jdk1.6.0_45/java/util/FormatFlagsConversionMismatchException.java,Java,,23,8,36,67
/jdk1.6.0_45/java/util/Formattable.java,Java,,5,4,138,147
/jdk1.6.0_45/java/util/FormattableFlags.java,Java,,7,6,45,58
/jdk1.6.0_45/java/util/Formatter.java,Java,,1730,248,2417,4395
/jdk1.6.0_45/java/util/FormatterClosedException.java,Java,,5,4,19,28
/jdk1.6.0_45/java/util/GregorianCalendar.java,Java,,1522,185,1192,2899
/jdk1.6.0_45/java/util/HashMap.java,Java,,512,100,426,1038
/jdk1.6.0_45/java/util/HashSet.java,Java,,78,26,191,295
/jdk1.6.0_45/java/util/Hashtable.java,Java,,547,114,450,1111
/jdk1.6.0_45/java/util/IdentityHashMap.java,Java,,588,100,527,1215
/jdk1.6.0_45/java/util/IllegalFormatCodePointException.java,Java,,14,7,31,52
/jdk1.6.0_45/java/util/IllegalFormatConversionException.java,Java,,21,8,38,67
/jdk1.6.0_45/java/util/IllegalFormatException.java,Java,,5,4,16,25
/jdk1.6.0_45/java/util/IllegalFormatFlagsException.java,Java,,16,7,27,50
/jdk1.6.0_45/java/util/IllegalFormatPrecisionException.java,Java,,14,7,25,46
/jdk1.6.0_45/java/util/IllegalFormatWidthException.java,Java,,14,7,24,45
/jdk1.6.0_45/java/util/InputMismatchException.java,Java,,10,3,27,40
/jdk1.6.0_45/java/util/InvalidPropertiesFormatException.java,Java,,22,8,43,73
/jdk1.6.0_45/java/util/Iterator.java,Java,,6,4,56,66
/jdk1.6.0_45/java/util/JapaneseImperialCalendar.java,Java,,1574,163,628,2365
/jdk1.6.0_45/java/util/jar/Attributes.java,Java,,264,62,320,646
/jdk1.6.0_45/java/util/jar/JarEntry.java,Java,,32,9,69,110
/jdk1.6.0_45/java/util/jar/JarException.java,Java,,9,3,21,33
/jdk1.6.0_45/java/util/jar/JarFile.java,Java,,464,54,195,713
/jdk1.6.0_45/java/util/jar/JarInputStream.java,Java,,104,17,100,221
/jdk1.6.0_45/java/util/jar/JarOutputStream.java,Java,,60,10,62,132
/jdk1.6.0_45/java/util/jar/JarVerifier.java,Java,,594,111,149,854
/jdk1.6.0_45/java/util/jar/JavaUtilJarAccessImpl.java,Java,,32,9,6,47
/jdk1.6.0_45/java/util/jar/Manifest.java,Java,,263,34,131,428
/jdk1.6.0_45/java/util/jar/Pack200.java,Java,,91,55,589,735
/jdk1.6.0_45/java/util/JumboEnumSet.java,Java,,182,47,123,352
/jdk1.6.0_45/java/util/LinkedHashMap.java,Java,,152,38,284,474
/jdk1.6.0_45/java/util/LinkedHashSet.java,Java,,19,8,127,154
/jdk1.6.0_45/java/util/LinkedList.java,Java,,417,87,462,966
/jdk1.6.0_45/java/util/List.java,Java,,28,41,500,569
/jdk1.6.0_45/java/util/ListIterator.java,Java,,12,13,156,181
/jdk1.6.0_45/java/util/ListResourceBundle.java,Java,,46,13,127,186
/jdk1.6.0_45/java/util/Locale.java,Java,,435,109,581,1125
/jdk1.6.0_45/java/util/LocaleISOData.java,Java,,447,4,10,461
/jdk1.6.0_45/java/util/logging/ConsoleHandler.java,Java,,33,10,58,101
/jdk1.6.0_45/java/util/logging/ErrorManager.java,Java,,24,7,50,81
/jdk1.6.0_45/java/util/logging/FileHandler.java,Java,,323,37,247,607
/jdk1.6.0_45/java/util/logging/Filter.java,Java,,4,6,23,33
/jdk1.6.0_45/java/util/logging/Formatter.java,Java,,36,15,91,142
/jdk1.6.0_45/java/util/logging/Handler.java,Java,,94,22,169,285
/jdk1.6.0_45/java/util/logging/Level.java,Java,,215,54,273,542
/jdk1.6.0_45/java/util/logging/Logger.java,Java,,575,109,866,1550
/jdk1.6.0_45/java/util/logging/Logging.java,Java,,60,17,25,102
/jdk1.6.0_45/java/util/logging/LoggingMXBean.java,Java,,7,6,101,114
/jdk1.6.0_45/java/util/logging/LoggingPermission.java,Java,,14,7,40,61
/jdk1.6.0_45/java/util/logging/LogManager.java,Java,,727,107,537,1371
/jdk1.6.0_45/java/util/logging/LogRecord.java,Java,,190,47,273,510
/jdk1.6.0_45/java/util/logging/MemoryHandler.java,Java,,102,16,133,251
/jdk1.6.0_45/java/util/logging/SimpleFormatter.java,Java,,50,9,21,80
/jdk1.6.0_45/java/util/logging/SocketHandler.java,Java,,74,15,85,174
/jdk1.6.0_45/java/util/logging/StreamHandler.java,Java,,123,18,128,269
/jdk1.6.0_45/java/util/logging/XMLFormatter.java,Java,,166,27,53,246
/jdk1.6.0_45/java/util/Map.java,Java,,24,27,401,452
/jdk1.6.0_45/java/util/MissingFormatArgumentException.java,Java,,16,7,30,53
/jdk1.6.0_45/java/util/MissingFormatWidthException.java,Java,,16,7,28,51
/jdk1.6.0_45/java/util/MissingResourceException.java,Java,,23,11,73,107
/jdk1.6.0_45/java/util/NavigableMap.java,Java,,25,22,349,396
/jdk1.6.0_45/java/util/NavigableSet.java,Java,,19,16,256,291
/jdk1.6.0_45/java/util/NoSuchElementException.java,Java,,10,3,28,41
/jdk1.6.0_45/java/util/Observable.java,Java,,47,15,134,196
/jdk1.6.0_45/java/util/Observer.java,Java,,4,1,25,30
/jdk1.6.0_45/java/util/prefs/AbstractPreferences.java,Java,,536,105,957,1598
/jdk1.6.0_45/java/util/prefs/BackingStoreException.java,Java,,11,5,25,41
/jdk1.6.0_45/java/util/prefs/Base64.java,Java,,145,20,79,244
/jdk1.6.0_45/java/util/prefs/InvalidPreferencesFormatException.java,Java,,14,6,40,60
/jdk1.6.0_45/java/util/prefs/NodeChangeEvent.java,Java,,24,11,53,88
/jdk1.6.0_45/java/util/prefs/NodeChangeListener.java,Java,,5,4,28,37
/jdk1.6.0_45/java/util/prefs/PreferenceChangeEvent.java,Java,,30,12,66,108
/jdk1.6.0_45/java/util/prefs/PreferenceChangeListener.java,Java,,4,2,23,29
/jdk1.6.0_45/java/util/prefs/Preferences.java,Java,,162,57,1019,1238
/jdk1.6.0_45/java/util/prefs/PreferencesFactory.java,Java,,6,3,31,40
/jdk1.6.0_45/java/util/prefs/WindowsPreferences.java,Java,,700,67,327,1094
/jdk1.6.0_45/java/util/prefs/WindowsPreferencesFactory.java,Java,,9,3,22,34
/jdk1.6.0_45/java/util/prefs/XmlSupport.java,Java,,245,33,126,404
/jdk1.6.0_45/java/util/PriorityQueue.java,Java,,304,54,362,720
/jdk1.6.0_45/java/util/Properties.java,Java,,474,42,579,1095
/jdk1.6.0_45/java/util/PropertyPermission.java,Java,,268,94,289,651
/jdk1.6.0_45/java/util/PropertyResourceBundle.java,Java,,32,10,129,171
/jdk1.6.0_45/java/util/Queue.java,Java,,9,7,174,190
/jdk1.6.0_45/java/util/Random.java,Java,,121,29,381,531
/jdk1.6.0_45/java/util/RandomAccess.java,Java,,3,2,45,50
/jdk1.6.0_45/java/util/regex/ASCII.java,Java,,205,40,11,256
/jdk1.6.0_45/java/util/regex/Matcher.java,Java,,317,70,776,1163
/jdk1.6.0_45/java/util/regex/MatchResult.java,Java,,10,10,151,171
/jdk1.6.0_45/java/util/regex/Pattern.java,Java,,3320,275,1651,5246
/jdk1.6.0_45/java/util/regex/PatternSyntaxException.java,Java,,42,13,51,106
/jdk1.6.0_45/java/util/RegularEnumSet.java,Java,,133,38,113,284
/jdk1.6.0_45/java/util/ResourceBundle.java,Java,,838,135,1650,2623
/jdk1.6.0_45/java/util/Scanner.java,Java,,1079,164,1349,2592
/jdk1.6.0_45/java/util/ServiceConfigurationError.java,Java,,12,8,50,70
/jdk1.6.0_45/java/util/ServiceLoader.java,Java,,204,35,289,528
/jdk1.6.0_45/java/util/Set.java,Java,,18,25,314,357
/jdk1.6.0_45/java/util/SimpleTimeZone.java,Java,,629,109,940,1678
/jdk1.6.0_45/java/util/SortedMap.java,Java,,12,11,243,266
/jdk1.6.0_45/java/util/SortedSet.java,Java,,9,8,188,205
/jdk1.6.0_45/java/util/spi/CurrencyNameProvider.java,Java,,8,5,43,56
/jdk1.6.0_45/java/util/spi/LocaleNameProvider.java,Java,,9,7,78,94
/jdk1.6.0_45/java/util/spi/LocaleServiceProvider.java,Java,,7,5,103,115
/jdk1.6.0_45/java/util/spi/TimeZoneNameProvider.java,Java,,7,5,51,63
/jdk1.6.0_45/java/util/Stack.java,Java,,34,13,77,124
/jdk1.6.0_45/java/util/StringTokenizer.java,Java,,153,27,234,414
/jdk1.6.0_45/java/util/Timer.java,Java,,228,48,401,677
/jdk1.6.0_45/java/util/TimerTask.java,Java,,27,14,100,141
/jdk1.6.0_45/java/util/TimeZone.java,Java,,350,60,413,823
/jdk1.6.0_45/java/util/TooManyListenersException.java,Java,,9,8,37,54
/jdk1.6.0_45/java/util/TreeMap.java,Java,,1455,255,710,2420
/jdk1.6.0_45/java/util/TreeSet.java,Java,,147,47,328,522
/jdk1.6.0_45/java/util/UnknownFormatConversionException.java,Java,,16,7,28,51
/jdk1.6.0_45/java/util/UnknownFormatFlagsException.java,Java,,16,7,28,51
/jdk1.6.0_45/java/util/UUID.java,Java,,175,41,270,486
/jdk1.6.0_45/java/util/Vector.java,Java,,319,71,624,1014
/jdk1.6.0_45/java/util/WeakHashMap.java,Java,,470,99,381,950
/jdk1.6.0_45/java/util/XMLUtils.java,Java,,153,17,17,187
/jdk1.6.0_45/java/util/zip/Adler32.java,Java,,31,10,35,76
/jdk1.6.0_45/java/util/zip/CheckedInputStream.java,Java,,42,8,49,99
/jdk1.6.0_45/java/util/zip/CheckedOutputStream.java,Java,,23,7,37,67
/jdk1.6.0_45/java/util/zip/Checksum.java,Java,,8,5,30,43
/jdk1.6.0_45/java/util/zip/CRC32.java,Java,,30,10,33,73
/jdk1.6.0_45/java/util/zip/DataFormatException.java,Java,,10,3,20,33
/jdk1.6.0_45/java/util/zip/Deflater.java,Java,,179,36,225,440
/jdk1.6.0_45/java/util/zip/DeflaterInputStream.java,Java,,117,30,130,277
/jdk1.6.0_45/java/util/zip/DeflaterOutputStream.java,Java,,73,16,69,158
/jdk1.6.0_45/java/util/zip/GZIPInputStream.java,Java,,146,28,98,272
/jdk1.6.0_45/java/util/zip/GZIPOutputStream.java,Java,,70,15,67,152
/jdk1.6.0_45/java/util/zip/Inflater.java,Java,,151,26,201,378
/jdk1.6.0_45/java/util/zip/InflaterInputStream.java,Java,,121,23,127,271
/jdk1.6.0_45/java/util/zip/InflaterOutputStream.java,Java,,120,29,110,259
/jdk1.6.0_45/java/util/zip/ZipConstants.java,Java,,43,7,31,81
/jdk1.6.0_45/java/util/zip/ZipEntry.java,Java,,147,33,153,333
/jdk1.6.0_45/java/util/zip/ZipError.java,Java,,7,3,17,27
/jdk1.6.0_45/java/util/zip/ZipException.java,Java,,11,6,24,41
/jdk1.6.0_45/java/util/zip/ZipFile.java,Java,,312,59,154,525
/jdk1.6.0_45/java/util/zip/ZipInputStream.java,Java,,324,27,124,475
/jdk1.6.0_45/java/util/zip/ZipOutputStream.java,Java,,362,28,125,515
/jdk1.6.0_45/java/util/zip/ZStreamRef.java,Java,,13,6,9,28
/jdk1.6.0_45/javax/accessibility/Accessible.java,Java,,4,3,26,33
/jdk1.6.0_45/javax/accessibility/AccessibleAction.java,Java,,14,11,71,96
/jdk1.6.0_45/javax/accessibility/AccessibleAttributeSequence.java,Java,,12,9,41,62
/jdk1.6.0_45/javax/accessibility/AccessibleBundle.java,Java,,56,19,63,138
/jdk1.6.0_45/javax/accessibility/AccessibleComponent.java,Java,,32,30,236,298
/jdk1.6.0_45/javax/accessibility/AccessibleContext.java,Java,,130,55,547,732
/jdk1.6.0_45/javax/accessibility/AccessibleEditableText.java,Java,,15,14,87,116
/jdk1.6.0_45/javax/accessibility/AccessibleExtendedComponent.java,Java,,6,5,46,57
/jdk1.6.0_45/javax/accessibility/AccessibleExtendedTable.java,Java,,6,5,47,58
/jdk1.6.0_45/javax/accessibility/AccessibleExtendedText.java,Java,,13,13,101,127
/jdk1.6.0_45/javax/accessibility/AccessibleHyperlink.java,Java,,14,13,96,123
/jdk1.6.0_45/javax/accessibility/AccessibleHypertext.java,Java,,9,8,46,63
/jdk1.6.0_45/javax/accessibility/AccessibleIcon.java,Java,,7,7,51,65
/jdk1.6.0_45/javax/accessibility/AccessibleKeyBinding.java,Java,,5,4,56,65
/jdk1.6.0_45/javax/accessibility/AccessibleRelation.java,Java,,65,35,252,352
/jdk1.6.0_45/javax/accessibility/AccessibleRelationSet.java,Java,,115,16,95,226
/jdk1.6.0_45/javax/accessibility/AccessibleResourceBundle.java,Java,,89,4,41,134
/jdk1.6.0_45/javax/accessibility/AccessibleRole.java,Java,,135,85,425,645
/jdk1.6.0_45/javax/accessibility/AccessibleSelection.java,Java,,10,9,78,97
/jdk1.6.0_45/javax/accessibility/AccessibleState.java,Java,,68,35,255,358
/jdk1.6.0_45/javax/accessibility/AccessibleStateSet.java,Java,,86,14,82,182
/jdk1.6.0_45/javax/accessibility/AccessibleStreamable.java,Java,,7,4,37,48
/jdk1.6.0_45/javax/accessibility/AccessibleTable.java,Java,,25,26,152,203
/jdk1.6.0_45/javax/accessibility/AccessibleTableModelChange.java,Java,,11,10,63,84
/jdk1.6.0_45/javax/accessibility/AccessibleText.java,Java,,20,19,132,171
/jdk1.6.0_45/javax/accessibility/AccessibleTextSequence.java,Java,,11,8,41,60
/jdk1.6.0_45/javax/accessibility/AccessibleValue.java,Java,,7,7,61,75
/jdk1.6.0_45/javax/annotation/Generated.java,Java,,13,6,29,48
/jdk1.6.0_45/javax/annotation/PostConstruct.java,Java,,9,3,27,39
/jdk1.6.0_45/javax/annotation/PreDestroy.java,Java,,9,4,26,39
/jdk1.6.0_45/javax/annotation/processing/AbstractProcessor.java,Java,,72,14,92,178
/jdk1.6.0_45/javax/annotation/processing/Completion.java,Java,,5,4,25,34
/jdk1.6.0_45/javax/annotation/processing/Completions.java,Java,,31,11,30,72
/jdk1.6.0_45/javax/annotation/processing/Filer.java,Java,,18,6,220,244
/jdk1.6.0_45/javax/annotation/processing/FilerException.java,Java,,9,3,24,36
/jdk1.6.0_45/javax/annotation/processing/Messager.java,Java,,14,6,64,84
/jdk1.6.0_45/javax/annotation/processing/package-info.java,Java,,1,1,24,26
/jdk1.6.0_45/javax/annotation/processing/ProcessingEnvironment.java,Java,,17,9,93,119
/jdk1.6.0_45/javax/annotation/processing/Processor.java,Java,,16,9,368,393
/jdk1.6.0_45/javax/annotation/processing/RoundEnvironment.java,Java,,12,7,77,96
/jdk1.6.0_45/javax/annotation/processing/SupportedAnnotationTypes.java,Java,,10,3,21,34
/jdk1.6.0_45/javax/annotation/processing/SupportedOptions.java,Java,,10,3,20,33
/jdk1.6.0_45/javax/annotation/processing/SupportedSourceVersion.java,Java,,11,4,19,34
/jdk1.6.0_45/javax/annotation/Resource.java,Java,,18,9,73,100
/jdk1.6.0_45/javax/annotation/Resources.java,Java,,10,3,10,23
/jdk1.6.0_45/javax/imageio/event/IIOReadProgressListener.java,Java,,16,12,126,154
/jdk1.6.0_45/javax/imageio/event/IIOReadUpdateListener.java,Java,,34,9,189,232
/jdk1.6.0_45/javax/imageio/event/IIOReadWarningListener.java,Java,,6,4,31,41
/jdk1.6.0_45/javax/imageio/event/IIOWriteProgressListener.java,Java,,14,10,99,123
/jdk1.6.0_45/javax/imageio/event/IIOWriteWarningListener.java,Java,,8,4,33,45
/jdk1.6.0_45/javax/imageio/IIOException.java,Java,,11,5,40,56
/jdk1.6.0_45/javax/imageio/IIOImage.java,Java,,88,20,197,305
/jdk1.6.0_45/javax/imageio/IIOParam.java,Java,,152,38,469,659
/jdk1.6.0_45/javax/imageio/IIOParamController.java,Java,,4,3,94,101
/jdk1.6.0_45/javax/imageio/ImageIO.java,Java,,804,134,633,1571
/jdk1.6.0_45/javax/imageio/ImageReader.java,Java,,850,147,1884,2881
/jdk1.6.0_45/javax/imageio/ImageReadParam.java,Java,,98,24,369,491
/jdk1.6.0_45/javax/imageio/ImageTranscoder.java,Java,,9,5,121,135
/jdk1.6.0_45/javax/imageio/ImageTypeSpecifier.java,Java,,722,100,402,1224
/jdk1.6.0_45/javax/imageio/ImageWriteParam.java,Java,,398,59,1000,1457
/jdk1.6.0_45/javax/imageio/ImageWriter.java,Java,,441,92,1487,2020
/jdk1.6.0_45/javax/imageio/metadata/IIOInvalidTreeException.java,Java,,18,7,55,80
/jdk1.6.0_45/javax/imageio/metadata/IIOMetadata.java,Java,,222,44,617,883
/jdk1.6.0_45/javax/imageio/metadata/IIOMetadataController.java,Java,,4,3,62,69
/jdk1.6.0_45/javax/imageio/metadata/IIOMetadataFormat.java,Java,,59,57,702,818
/jdk1.6.0_45/javax/imageio/metadata/IIOMetadataFormatImpl.java,Java,,621,118,514,1253
/jdk1.6.0_45/javax/imageio/metadata/IIOMetadataNode.java,Java,,545,158,307,1010
/jdk1.6.0_45/javax/imageio/plugins/bmp/BMPImageWriteParam.java,Java,,23,11,64,98
/jdk1.6.0_45/javax/imageio/plugins/jpeg/JPEGHuffmanTable.java,Java,,156,27,102,285
/jdk1.6.0_45/javax/imageio/plugins/jpeg/JPEGImageReadParam.java,Java,,48,11,123,182
/jdk1.6.0_45/javax/imageio/plugins/jpeg/JPEGImageWriteParam.java,Java,,105,17,181,303
/jdk1.6.0_45/javax/imageio/plugins/jpeg/JPEGQTable.java,Java,,81,19,105,205
/jdk1.6.0_45/javax/imageio/spi/DigraphNode.java,Java,,62,20,62,144
/jdk1.6.0_45/javax/imageio/spi/IIORegistry.java,Java,,111,14,109,234
/jdk1.6.0_45/javax/imageio/spi/IIOServiceProvider.java,Java,,32,12,111,155
/jdk1.6.0_45/javax/imageio/spi/ImageInputStreamSpi.java,Java,,32,11,141,184
/jdk1.6.0_45/javax/imageio/spi/ImageOutputStreamSpi.java,Java,,33,11,139,183
/jdk1.6.0_45/javax/imageio/spi/ImageReaderSpi.java,Java,,78,18,297,393
/jdk1.6.0_45/javax/imageio/spi/ImageReaderWriterSpi.java,Java,,181,35,368,584
/jdk1.6.0_45/javax/imageio/spi/ImageTranscoderSpi.java,Java,,13,8,57,78
/jdk1.6.0_45/javax/imageio/spi/ImageWriterSpi.java,Java,,86,20,314,420
/jdk1.6.0_45/javax/imageio/spi/PartiallyOrderedSet.java,Java,,97,31,69,197
/jdk1.6.0_45/javax/imageio/spi/RegisterableService.java,Java,,5,4,38,47
/jdk1.6.0_45/javax/imageio/spi/ServiceRegistry.java,Java,,324,59,435,818
/jdk1.6.0_45/javax/imageio/stream/FileCacheImageInputStream.java,Java,,143,35,96,274
/jdk1.6.0_45/javax/imageio/stream/FileCacheImageOutputStream.java,Java,,127,29,86,242
/jdk1.6.0_45/javax/imageio/stream/FileImageInputStream.java,Java,,73,15,60,148
/jdk1.6.0_45/javax/imageio/stream/FileImageOutputStream.java,Java,,83,17,56,156
/jdk1.6.0_45/javax/imageio/stream/IIOByteBuffer.java,Java,,29,12,85,126
/jdk1.6.0_45/javax/imageio/stream/ImageInputStream.java,Java,,53,48,883,984
/jdk1.6.0_45/javax/imageio/stream/ImageInputStreamImpl.java,Java,,548,109,209,866
/jdk1.6.0_45/javax/imageio/stream/ImageOutputStream.java,Java,,29,26,592,647
/jdk1.6.0_45/javax/imageio/stream/ImageOutputStreamImpl.java,Java,,386,53,55,494
/jdk1.6.0_45/javax/imageio/stream/MemoryCache.java,Java,,185,37,124,346
/jdk1.6.0_45/javax/imageio/stream/MemoryCacheImageInputStream.java,Java,,93,26,68,187
/jdk1.6.0_45/javax/imageio/stream/MemoryCacheImageOutputStream.java,Java,,88,24,67,179
/jdk1.6.0_45/javax/lang/model/element/AnnotationMirror.java,Java,,7,5,45,57
/jdk1.6.0_45/javax/lang/model/element/AnnotationValue.java,Java,,8,7,45,60
/jdk1.6.0_45/javax/lang/model/element/AnnotationValueVisitor.java,Java,,21,21,143,185
/jdk1.6.0_45/javax/lang/model/element/Element.java,Java,,22,17,202,241
/jdk1.6.0_45/javax/lang/model/element/ElementKind.java,Java,,28,12,66,106
/jdk1.6.0_45/javax/lang/model/element/ElementVisitor.java,Java,,12,10,96,118
/jdk1.6.0_45/javax/lang/model/element/ExecutableElement.java,Java,,12,8,63,83
/jdk1.6.0_45/javax/lang/model/element/Modifier.java,Java,,21,9,29,59
/jdk1.6.0_45/javax/lang/model/element/Name.java,Java,,6,4,62,72
/jdk1.6.0_45/javax/lang/model/element/NestingKind.java,Java,,10,3,69,82
/jdk1.6.0_45/javax/lang/model/element/package-info.java,Java,,1,1,67,69
/jdk1.6.0_45/javax/lang/model/element/PackageElement.java,Java,,5,6,33,44
/jdk1.6.0_45/javax/lang/model/element/TypeElement.java,Java,,11,8,83,102
/jdk1.6.0_45/javax/lang/model/element/TypeParameterElement.java,Java,,8,5,35,48
/jdk1.6.0_45/javax/lang/model/element/UnknownAnnotationValueException.java,Java,,17,7,44,68
/jdk1.6.0_45/javax/lang/model/element/UnknownElementException.java,Java,,17,7,42,66
/jdk1.6.0_45/javax/lang/model/element/VariableElement.java,Java,,6,6,38,50
/jdk1.6.0_45/javax/lang/model/package-info.java,Java,,1,2,40,43
/jdk1.6.0_45/javax/lang/model/SourceVersion.java,Java,,70,19,128,217
/jdk1.6.0_45/javax/lang/model/type/ArrayType.java,Java,,4,4,22,30
/jdk1.6.0_45/javax/lang/model/type/DeclaredType.java,Java,,10,9,61,80
/jdk1.6.0_45/javax/lang/model/type/ErrorType.java,Java,,4,5,20,29
/jdk1.6.0_45/javax/lang/model/type/ExecutableType.java,Java,,9,10,53,72
/jdk1.6.0_45/javax/lang/model/type/MirroredTypeException.java,Java,,14,9,30,53
/jdk1.6.0_45/javax/lang/model/type/MirroredTypesException.java,Java,,17,10,31,58
/jdk1.6.0_45/javax/lang/model/type/NoType.java,Java,,4,5,24,33
/jdk1.6.0_45/javax/lang/model/type/NullType.java,Java,,3,4,16,23
/jdk1.6.0_45/javax/lang/model/type/package-info.java,Java,,1,1,22,24
/jdk1.6.0_45/javax/lang/model/type/PrimitiveType.java,Java,,3,3,17,23
/jdk1.6.0_45/javax/lang/model/type/ReferenceType.java,Java,,3,3,17,23
/jdk1.6.0_45/javax/lang/model/type/TypeKind.java,Java,,37,23,86,146
/jdk1.6.0_45/javax/lang/model/type/TypeMirror.java,Java,,10,8,73,91
/jdk1.6.0_45/javax/lang/model/type/TypeVariable.java,Java,,9,8,50,67
/jdk1.6.0_45/javax/lang/model/type/TypeVisitor.java,Java,,16,14,118,148
/jdk1.6.0_45/javax/lang/model/type/UnknownTypeException.java,Java,,17,7,42,66
/jdk1.6.0_45/javax/lang/model/type/WildcardType.java,Java,,5,5,38,48
/jdk1.6.0_45/javax/lang/model/util/AbstractAnnotationValueVisitor6.java,Java,,21,9,66,96
/jdk1.6.0_45/javax/lang/model/util/AbstractElementVisitor6.java,Java,,20,8,77,105
/jdk1.6.0_45/javax/lang/model/util/AbstractTypeVisitor6.java,Java,,14,6,74,94
/jdk1.6.0_45/javax/lang/model/util/ElementFilter.java,Java,,89,20,88,197
/jdk1.6.0_45/javax/lang/model/util/ElementKindVisitor6.java,Java,,115,38,214,367
/jdk1.6.0_45/javax/lang/model/util/Elements.java,Java,,23,21,175,219
/jdk1.6.0_45/javax/lang/model/util/ElementScanner6.java,Java,,43,14,130,187
/jdk1.6.0_45/javax/lang/model/util/package-info.java,Java,,1,1,24,26
/jdk1.6.0_45/javax/lang/model/util/SimpleAnnotationValueVisitor6.java,Java,,62,22,159,243
/jdk1.6.0_45/javax/lang/model/util/SimpleElementVisitor6.java,Java,,34,11,107,152
/jdk1.6.0_45/javax/lang/model/util/SimpleTypeVisitor6.java,Java,,45,16,131,192
/jdk1.6.0_45/javax/lang/model/util/TypeKindVisitor6.java,Java,,86,30,167,283
/jdk1.6.0_45/javax/lang/model/util/Types.java,Java,,27,22,235,284
/jdk1.6.0_45/javax/management/AndQueryExp.java,Java,,25,16,49,90
/jdk1.6.0_45/javax/management/Attribute.java,Java,,41,22,54,117
/jdk1.6.0_45/javax/management/AttributeChangeNotification.java,Java,,29,22,79,130
/jdk1.6.0_45/javax/management/AttributeChangeNotificationFilter.java,Java,,35,18,57,110
/jdk1.6.0_45/javax/management/AttributeList.java,Java,,138,27,170,335
/jdk1.6.0_45/javax/management/AttributeNotFoundException.java,Java,,10,7,20,37
/jdk1.6.0_45/javax/management/AttributeValueExp.java,Java,,41,20,69,130
/jdk1.6.0_45/javax/management/BadAttributeValueExpException.java,Java,,11,10,26,47
/jdk1.6.0_45/javax/management/BadBinaryOpValueExpException.java,Java,,14,12,31,57
/jdk1.6.0_45/javax/management/BadStringOperationException.java,Java,,11,9,25,45
/jdk1.6.0_45/javax/management/BetweenQueryExp.java,Java,,60,20,54,134
/jdk1.6.0_45/javax/management/BinaryOpValueExp.java,Java,,94,25,54,173
/jdk1.6.0_45/javax/management/BinaryRelQueryExp.java,Java,,120,27,54,201
/jdk1.6.0_45/javax/management/BooleanValueExp.java,Java,,21,13,35,69
/jdk1.6.0_45/javax/management/ClassAttributeValueExp.java,Java,,48,14,62,124
/jdk1.6.0_45/javax/management/DefaultLoaderRepository.java,Java,,14,6,53,73
/jdk1.6.0_45/javax/management/Descriptor.java,Java,,27,20,429,476
/jdk1.6.0_45/javax/management/DescriptorAccess.java,Java,,5,4,45,54
/jdk1.6.0_45/javax/management/DescriptorKey.java,Java,,8,4,143,155
/jdk1.6.0_45/javax/management/DescriptorRead.java,Java,,4,2,17,23
/jdk1.6.0_45/javax/management/DynamicMBean.java,Java,,12,12,80,104
/jdk1.6.0_45/javax/management/ImmutableDescriptor.java,Java,,315,35,199,549
/jdk1.6.0_45/javax/management/InQueryExp.java,Java,,53,21,48,122
/jdk1.6.0_45/javax/management/InstanceAlreadyExistsException.java,Java,,10,7,20,37
/jdk1.6.0_45/javax/management/InstanceNotFoundException.java,Java,,10,6,20,36
/jdk1.6.0_45/javax/management/InstanceOfQueryExp.java,Java,,37,13,53,103
/jdk1.6.0_45/javax/management/IntrospectionException.java,Java,,10,6,20,36
/jdk1.6.0_45/javax/management/InvalidApplicationException.java,Java,,8,8,24,40
/jdk1.6.0_45/javax/management/InvalidAttributeValueException.java,Java,,10,6,20,36
/jdk1.6.0_45/javax/management/JMException.java,Java,,10,7,21,38
/jdk1.6.0_45/javax/management/JMRuntimeException.java,Java,,20,8,33,61
/jdk1.6.0_45/javax/management/JMX.java,Java,,68,18,291,377
/jdk1.6.0_45/javax/management/ListenerNotFoundException.java,Java,,10,7,20,37
/jdk1.6.0_45/javax/management/loading/ClassLoaderRepository.java,Java,,12,7,116,135
/jdk1.6.0_45/javax/management/loading/DefaultLoaderRepository.java,Java,,55,20,61,136
/jdk1.6.0_45/javax/management/loading/MLet.java,Java,,633,104,601,1338
/jdk1.6.0_45/javax/management/loading/MLetContent.java,Java,,75,28,118,221
/jdk1.6.0_45/javax/management/loading/MLetMBean.java,Java,,21,18,129,168
/jdk1.6.0_45/javax/management/loading/MLetObjectInputStream.java,Java,,60,21,22,103
/jdk1.6.0_45/javax/management/loading/MLetParser.java,Java,,208,34,70,312
/jdk1.6.0_45/javax/management/loading/PrivateClassLoader.java,Java,,4,3,16,23
/jdk1.6.0_45/javax/management/loading/PrivateMLet.java,Java,,18,6,58,82
/jdk1.6.0_45/javax/management/MalformedObjectNameException.java,Java,,10,10,20,40
/jdk1.6.0_45/javax/management/MatchQueryExp.java,Java,,94,19,55,168
/jdk1.6.0_45/javax/management/MBeanAttributeInfo.java,Java,,163,32,139,334
/jdk1.6.0_45/javax/management/MBeanConstructorInfo.java,Java,,87,19,94,200
/jdk1.6.0_45/javax/management/MBeanException.java,Java,,19,12,40,71
/jdk1.6.0_45/javax/management/MBeanFeatureInfo.java,Java,,84,31,135,250
/jdk1.6.0_45/javax/management/MBeanInfo.java,Java,,289,71,339,699
/jdk1.6.0_45/javax/management/MBeanNotificationInfo.java,Java,,72,20,96,188
/jdk1.6.0_45/javax/management/MBeanOperationInfo.java,Java,,131,31,149,311
/jdk1.6.0_45/javax/management/MBeanParameterInfo.java,Java,,51,16,63,130
/jdk1.6.0_45/javax/management/MBeanPermission.java,Java,,666,95,381,1142
/jdk1.6.0_45/javax/management/MBeanRegistration.java,Java,,8,9,57,74
/jdk1.6.0_45/javax/management/MBeanRegistrationException.java,Java,,10,6,27,43
/jdk1.6.0_45/javax/management/MBeanServer.java,Java,,115,46,525,686
/jdk1.6.0_45/javax/management/MBeanServerBuilder.java,Java,,15,5,76,96
/jdk1.6.0_45/javax/management/MBeanServerConnection.java,Java,,97,42,704,843
/jdk1.6.0_45/javax/management/MBeanServerDelegate.java,Java,,114,25,86,225
/jdk1.6.0_45/javax/management/MBeanServerDelegateMBean.java,Java,,10,11,49,70
/jdk1.6.0_45/javax/management/MBeanServerFactory.java,Java,,172,37,327,536
/jdk1.6.0_45/javax/management/MBeanServerInvocationHandler.java,Java,,239,46,192,477
/jdk1.6.0_45/javax/management/MBeanServerNotification.java,Java,,14,13,48,75
/jdk1.6.0_45/javax/management/MBeanServerPermission.java,Java,,165,43,146,354
/jdk1.6.0_45/javax/management/MBeanTrustPermission.java,Java,,19,7,46,72
/jdk1.6.0_45/javax/management/modelmbean/DescriptorSupport.java,Java,,764,143,417,1324
/jdk1.6.0_45/javax/management/modelmbean/InvalidTargetObjectTypeException.java,Java,,88,21,89,198
/jdk1.6.0_45/javax/management/modelmbean/ModelMBean.java,Java,,14,10,94,118
/jdk1.6.0_45/javax/management/modelmbean/ModelMBeanAttributeInfo.java,Java,,276,46,228,550
/jdk1.6.0_45/javax/management/modelmbean/ModelMBeanConstructorInfo.java,Java,,298,44,208,550
/jdk1.6.0_45/javax/management/modelmbean/ModelMBeanInfo.java,Java,,34,33,272,339
/jdk1.6.0_45/javax/management/modelmbean/ModelMBeanInfoSupport.java,Java,,703,110,267,1080
/jdk1.6.0_45/javax/management/modelmbean/ModelMBeanNotificationBroadcaster.java,Java,,21,18,145,184
/jdk1.6.0_45/javax/management/modelmbean/ModelMBeanNotificationInfo.java,Java,,192,42,206,440
/jdk1.6.0_45/javax/management/modelmbean/ModelMBeanOperationInfo.java,Java,,311,48,219,578
/jdk1.6.0_45/javax/management/modelmbean/RequiredModelMBean.java,Java,,1615,343,824,2782
/jdk1.6.0_45/javax/management/modelmbean/XMLParseException.java,Java,,66,15,77,158
/jdk1.6.0_45/javax/management/monitor/CounterMonitor.java,Java,,471,87,417,975
/jdk1.6.0_45/javax/management/monitor/CounterMonitorMBean.java,Java,,25,21,159,205
/jdk1.6.0_45/javax/management/monitor/GaugeMonitor.java,Java,,437,75,368,880
/jdk1.6.0_45/javax/management/monitor/GaugeMonitorMBean.java,Java,,19,17,112,148
/jdk1.6.0_45/javax/management/monitor/Monitor.java,Java,,948,169,593,1710
/jdk1.6.0_45/javax/management/monitor/MonitorMBean.java,Java,,19,17,109,145
/jdk1.6.0_45/javax/management/monitor/MonitorNotification.java,Java,,39,34,170,243
/jdk1.6.0_45/javax/management/monitor/MonitorSettingException.java,Java,,10,6,26,42
/jdk1.6.0_45/javax/management/monitor/StringMonitor.java,Java,,205,46,205,456
/jdk1.6.0_45/javax/management/monitor/StringMonitorMBean.java,Java,,16,14,94,124
/jdk1.6.0_45/javax/management/MXBean.java,Java,,31,5,1124,1160
/jdk1.6.0_45/javax/management/NotCompliantMBeanException.java,Java,,10,8,20,38
/jdk1.6.0_45/javax/management/Notification.java,Java,,138,32,209,379
/jdk1.6.0_45/javax/management/NotificationBroadcaster.java,Java,,11,7,91,109
/jdk1.6.0_45/javax/management/NotificationBroadcasterSupport.java,Java,,142,37,158,337
/jdk1.6.0_45/javax/management/NotificationEmitter.java,Java,,8,3,70,81
/jdk1.6.0_45/javax/management/NotificationFilter.java,Java,,4,4,18,26
/jdk1.6.0_45/javax/management/NotificationFilterSupport.java,Java,,42,17,89,148
/jdk1.6.0_45/javax/management/NotificationListener.java,Java,,5,7,23,35
/jdk1.6.0_45/javax/management/NotQueryExp.java,Java,,20,14,41,75
/jdk1.6.0_45/javax/management/NumericValueExp.java,Java,,128,19,81,228
/jdk1.6.0_45/javax/management/ObjectInstance.java,Java,,45,17,74,136
/jdk1.6.0_45/javax/management/ObjectName.java,Java,,920,178,1043,2141
/jdk1.6.0_45/javax/management/openmbean/ArrayType.java,Java,,347,72,592,1011
/jdk1.6.0_45/javax/management/openmbean/CompositeData.java,Java,,14,18,128,160
/jdk1.6.0_45/javax/management/openmbean/CompositeDataInvocationHandler.java,Java,,77,11,139,227
/jdk1.6.0_45/javax/management/openmbean/CompositeDataSupport.java,Java,,179,54,226,459
/jdk1.6.0_45/javax/management/openmbean/CompositeDataView.java,Java,,4,2,104,110
/jdk1.6.0_45/javax/management/openmbean/CompositeType.java,Java,,163,53,250,466
/jdk1.6.0_45/javax/management/openmbean/InvalidKeyException.java,Java,,10,6,24,40
/jdk1.6.0_45/javax/management/openmbean/InvalidOpenTypeException.java,Java,,10,6,22,38
/jdk1.6.0_45/javax/management/openmbean/KeyAlreadyExistsException.java,Java,,10,6,24,40
/jdk1.6.0_45/javax/management/openmbean/OpenDataException.java,Java,,11,7,26,44
/jdk1.6.0_45/javax/management/openmbean/OpenMBeanAttributeInfo.java,Java,,9,21,93,123
/jdk1.6.0_45/javax/management/openmbean/OpenMBeanAttributeInfoSupport.java,Java,,537,95,454,1086
/jdk1.6.0_45/javax/management/openmbean/OpenMBeanConstructorInfo.java,Java,,10,18,94,122
/jdk1.6.0_45/javax/management/openmbean/OpenMBeanConstructorInfoSupport.java,Java,,84,32,173,289
/jdk1.6.0_45/javax/management/openmbean/OpenMBeanInfo.java,Java,,16,22,135,173
/jdk1.6.0_45/javax/management/openmbean/OpenMBeanInfoSupport.java,Java,,127,42,229,398
/jdk1.6.0_45/javax/management/openmbean/OpenMBeanOperationInfo.java,Java,,14,23,130,167
/jdk1.6.0_45/javax/management/openmbean/OpenMBeanOperationInfoSupport.java,Java,,136,47,228,411
/jdk1.6.0_45/javax/management/openmbean/OpenMBeanParameterInfo.java,Java,,20,29,148,197
/jdk1.6.0_45/javax/management/openmbean/OpenMBeanParameterInfoSupport.java,Java,,146,68,391,605
/jdk1.6.0_45/javax/management/openmbean/OpenType.java,Java,,175,41,188,404
/jdk1.6.0_45/javax/management/openmbean/SimpleType.java,Java,,89,49,168,306
/jdk1.6.0_45/javax/management/openmbean/TabularData.java,Java,,21,52,217,290
/jdk1.6.0_45/javax/management/openmbean/TabularDataSupport.java,Java,,234,139,516,889
/jdk1.6.0_45/javax/management/openmbean/TabularType.java,Java,,130,51,189,370
/jdk1.6.0_45/javax/management/OperationsException.java,Java,,10,8,21,39
/jdk1.6.0_45/javax/management/OrQueryExp.java,Java,,26,15,47,88
/jdk1.6.0_45/javax/management/PersistentMBean.java,Java,,10,9,70,89
/jdk1.6.0_45/javax/management/QualifiedAttributeValueExp.java,Java,,35,16,47,98
/jdk1.6.0_45/javax/management/Query.java,Java,,113,47,465,625
/jdk1.6.0_45/javax/management/QueryEval.java,Java,,14,10,42,66
/jdk1.6.0_45/javax/management/QueryExp.java,Java,,7,8,37,52
/jdk1.6.0_45/javax/management/ReflectionException.java,Java,,19,11,39,69
/jdk1.6.0_45/javax/management/relation/InvalidRelationIdException.java,Java,,10,5,21,36
/jdk1.6.0_45/javax/management/relation/InvalidRelationServiceException.java,Java,,10,5,20,35
/jdk1.6.0_45/javax/management/relation/InvalidRelationTypeException.java,Java,,10,5,24,39
/jdk1.6.0_45/javax/management/relation/InvalidRoleInfoException.java,Java,,10,5,21,36
/jdk1.6.0_45/javax/management/relation/InvalidRoleValueException.java,Java,,10,5,26,41
/jdk1.6.0_45/javax/management/relation/MBeanServerNotificationFilter.java,Java,,233,67,192,492
/jdk1.6.0_45/javax/management/relation/Relation.java,Java,,45,16,187,248
/jdk1.6.0_45/javax/management/relation/RelationException.java,Java,,11,6,21,38
/jdk1.6.0_45/javax/management/relation/RelationNotFoundException.java,Java,,10,5,21,36
/jdk1.6.0_45/javax/management/relation/RelationNotification.java,Java,,297,49,261,607
/jdk1.6.0_45/javax/management/relation/RelationService.java,Java,,2056,507,1414,3977
/jdk1.6.0_45/javax/management/relation/RelationServiceMBean.java,Java,,143,41,596,780
/jdk1.6.0_45/javax/management/relation/RelationServiceNotRegisteredException.java,Java,,10,5,21,36
/jdk1.6.0_45/javax/management/relation/RelationSupport.java,Java,,816,218,776,1810
/jdk1.6.0_45/javax/management/relation/RelationSupportMBean.java,Java,,7,4,47,58
/jdk1.6.0_45/javax/management/relation/RelationType.java,Java,,11,8,38,57
/jdk1.6.0_45/javax/management/relation/RelationTypeNotFoundException.java,Java,,10,5,21,36
/jdk1.6.0_45/javax/management/relation/RelationTypeSupport.java,Java,,246,73,196,515
/jdk1.6.0_45/javax/management/relation/Role.java,Java,,151,35,133,319
/jdk1.6.0_45/javax/management/relation/RoleInfo.java,Java,,296,52,245,593
/jdk1.6.0_45/javax/management/relation/RoleInfoNotFoundException.java,Java,,10,5,21,36
/jdk1.6.0_45/javax/management/relation/RoleList.java,Java,,147,37,170,354
/jdk1.6.0_45/javax/management/relation/RoleNotFoundException.java,Java,,10,5,21,36
/jdk1.6.0_45/javax/management/relation/RoleResult.java,Java,,118,25,100,243
/jdk1.6.0_45/javax/management/relation/RoleStatus.java,Java,,22,5,48,75
/jdk1.6.0_45/javax/management/relation/RoleUnresolved.java,Java,,163,32,144,339
/jdk1.6.0_45/javax/management/relation/RoleUnresolvedList.java,Java,,148,37,166,351
/jdk1.6.0_45/javax/management/remote/JMXAddressable.java,Java,,4,3,27,34
/jdk1.6.0_45/javax/management/remote/JMXAuthenticator.java,Java,,6,4,43,53
/jdk1.6.0_45/javax/management/remote/JMXConnectionNotification.java,Java,,39,13,128,180
/jdk1.6.0_45/javax/management/remote/JMXConnector.java,Java,,33,12,237,282
/jdk1.6.0_45/javax/management/remote/JMXConnectorFactory.java,Java,,245,49,234,528
/jdk1.6.0_45/javax/management/remote/JMXConnectorProvider.java,Java,,8,4,44,56
/jdk1.6.0_45/javax/management/remote/JMXConnectorServer.java,Java,,143,38,218,399
/jdk1.6.0_45/javax/management/remote/JMXConnectorServerFactory.java,Java,,128,20,190,338
/jdk1.6.0_45/javax/management/remote/JMXConnectorServerMBean.java,Java,,15,12,151,178
/jdk1.6.0_45/javax/management/remote/JMXConnectorServerProvider.java,Java,,10,4,51,65
/jdk1.6.0_45/javax/management/remote/JMXPrincipal.java,Java,,31,15,70,116
/jdk1.6.0_45/javax/management/remote/JMXProviderException.java,Java,,19,10,38,67
/jdk1.6.0_45/javax/management/remote/JMXServerErrorException.java,Java,,14,9,31,54
/jdk1.6.0_45/javax/management/remote/JMXServiceURL.java,Java,...,322,65,293,680
/jdk1.6.0_45/javax/management/remote/MBeanServerForwarder.java,Java,,6,5,37,48
/jdk1.6.0_45/javax/management/remote/NotificationResult.java,Java,,37,13,80,130
/jdk1.6.0_45/javax/management/remote/rmi/NoCallStackClassLoader.java,Java,,65,13,133,211
/jdk1.6.0_45/javax/management/remote/rmi/RMIConnection.java,Java,,195,30,849,1074
/jdk1.6.0_45/javax/management/remote/rmi/RMIConnectionImpl.java,Java,,1452,246,102,1800
/jdk1.6.0_45/javax/management/remote/rmi/RMIConnectionImpl_Stub.java,Java,,540,33,31,604
/jdk1.6.0_45/javax/management/remote/rmi/RMIConnector.java,Java,,1705,287,544,2536
/jdk1.6.0_45/javax/management/remote/rmi/RMIConnectorServer.java,Java,,415,93,321,829
/jdk1.6.0_45/javax/management/remote/rmi/RMIIIOPServerImpl.java,Java,,66,16,64,146
/jdk1.6.0_45/javax/management/remote/rmi/RMIJRMPServerImpl.java,Java,,74,18,72,164
/jdk1.6.0_45/javax/management/remote/rmi/RMIServer.java,Java,,8,4,62,74
/jdk1.6.0_45/javax/management/remote/rmi/RMIServerImpl.java,Java,,230,56,226,512
/jdk1.6.0_45/javax/management/remote/rmi/RMIServerImpl_Stub.java,Java,,49,8,6,63
/jdk1.6.0_45/javax/management/remote/SubjectDelegationPermission.java,Java,,13,7,59,79
/jdk1.6.0_45/javax/management/remote/TargetedNotification.java,Java,,26,12,78,116
/jdk1.6.0_45/javax/management/RuntimeErrorException.java,Java,,19,10,37,66
/jdk1.6.0_45/javax/management/RuntimeMBeanException.java,Java,,19,10,40,69
/jdk1.6.0_45/javax/management/RuntimeOperationsException.java,Java,,19,11,38,68
/jdk1.6.0_45/javax/management/ServiceNotFoundException.java,Java,,11,8,21,40
/jdk1.6.0_45/javax/management/StandardEmitterMBean.java,Java,,71,13,196,280
/jdk1.6.0_45/javax/management/StandardMBean.java,Java,,532,80,639,1251
/jdk1.6.0_45/javax/management/StringValueExp.java,Java,,21,13,54,88
/jdk1.6.0_45/javax/management/timer/Timer.java,Java,,504,173,619,1296
/jdk1.6.0_45/javax/management/timer/TimerAlarmClockNotification.java,Java,,8,5,21,34
/jdk1.6.0_45/javax/management/timer/TimerMBean.java,Java,,37,33,292,362
/jdk1.6.0_45/javax/management/timer/TimerNotification.java,Java,,18,16,66,100
/jdk1.6.0_45/javax/management/ValueExp.java,Java,,8,5,72,85
/jdk1.6.0_45/javax/naming/AuthenticationException.java,Java,,10,5,43,58
/jdk1.6.0_45/javax/naming/AuthenticationNotSupportedException.java,Java,,10,5,48,63
/jdk1.6.0_45/javax/naming/BinaryRefAddr.java,Java,,50,13,103,166
/jdk1.6.0_45/javax/naming/Binding.java,Java,,40,15,128,183
/jdk1.6.0_45/javax/naming/CannotProceedException.java,Java,,42,21,206,269
/jdk1.6.0_45/javax/naming/CommunicationException.java,Java,,10,4,35,49
/jdk1.6.0_45/javax/naming/CompositeName.java,Java,,125,32,456,613
/jdk1.6.0_45/javax/naming/CompoundName.java,Java,,127,30,451,608
/jdk1.6.0_45/javax/naming/ConfigurationException.java,Java,,10,4,41,55
/jdk1.6.0_45/javax/naming/Context.java,Java,,56,49,977,1082
/jdk1.6.0_45/javax/naming/ContextNotEmptyException.java,Java,,10,4,41,55
/jdk1.6.0_45/javax/naming/directory/Attribute.java,Java,,26,22,275,323
/jdk1.6.0_45/javax/naming/directory/AttributeInUseException.java,Java,,11,5,34,50
/jdk1.6.0_45/javax/naming/directory/AttributeModificationException.java,Java,,26,12,85,123
/jdk1.6.0_45/javax/naming/directory/Attributes.java,Java,,16,15,135,166
/jdk1.6.0_45/javax/naming/directory/BasicAttribute.java,Java,,269,51,219,539
/jdk1.6.0_45/javax/naming/directory/BasicAttributes.java,Java,,169,45,145,359
/jdk1.6.0_45/javax/naming/directory/DirContext.java,Java,,77,35,910,1022
/jdk1.6.0_45/javax/naming/directory/InitialDirContext.java,Java,,181,38,62,281
/jdk1.6.0_45/javax/naming/directory/InvalidAttributeIdentifierException.java,Java,,11,6,32,49
/jdk1.6.0_45/javax/naming/directory/InvalidAttributesException.java,Java,,11,6,38,55
/jdk1.6.0_45/javax/naming/directory/InvalidAttributeValueException.java,Java,,11,6,36,53
/jdk1.6.0_45/javax/naming/directory/InvalidSearchControlsException.java,Java,,11,6,33,50
/jdk1.6.0_45/javax/naming/directory/InvalidSearchFilterException.java,Java,,11,6,33,50
/jdk1.6.0_45/javax/naming/directory/ModificationItem.java,Java,,37,14,66,117
/jdk1.6.0_45/javax/naming/directory/NoSuchAttributeException.java,Java,,11,7,31,49
/jdk1.6.0_45/javax/naming/directory/SchemaViolationException.java,Java,,11,6,43,60
/jdk1.6.0_45/javax/naming/directory/SearchControls.java,Java,,70,26,223,319
/jdk1.6.0_45/javax/naming/directory/SearchResult.java,Java,,34,14,124,172
/jdk1.6.0_45/javax/naming/event/EventContext.java,Java,,15,12,205,232
/jdk1.6.0_45/javax/naming/event/EventDirContext.java,Java,,15,6,121,142
/jdk1.6.0_45/javax/naming/event/NamespaceChangeListener.java,Java,,6,5,63,74
/jdk1.6.0_45/javax/naming/event/NamingEvent.java,Java,,52,20,211,283
/jdk1.6.0_45/javax/naming/event/NamingExceptionEvent.java,Java,,19,9,49,77
/jdk1.6.0_45/javax/naming/event/NamingListener.java,Java,,4,2,42,48
/jdk1.6.0_45/javax/naming/event/ObjectChangeListener.java,Java,,4,3,49,56
/jdk1.6.0_45/javax/naming/InitialContext.java,Java,,195,50,295,540
/jdk1.6.0_45/javax/naming/InsufficientResourcesException.java,Java,,10,5,40,55
/jdk1.6.0_45/javax/naming/InterruptedNamingException.java,Java,,10,5,44,59
/jdk1.6.0_45/javax/naming/InvalidNameException.java,Java,,10,5,40,55
/jdk1.6.0_45/javax/naming/ldap/BasicControl.java,Java,,24,11,65,100
/jdk1.6.0_45/javax/naming/ldap/Control.java,Java,,8,7,64,79
/jdk1.6.0_45/javax/naming/ldap/ControlFactory.java,Java,,27,13,100,140
/jdk1.6.0_45/javax/naming/ldap/ExtendedRequest.java,Java,,8,7,116,131
/jdk1.6.0_45/javax/naming/ldap/ExtendedResponse.java,Java,,5,6,71,82
/jdk1.6.0_45/javax/naming/ldap/HasControls.java,Java,,5,5,43,53
/jdk1.6.0_45/javax/naming/ldap/InitialLdapContext.java,Java,,62,20,110,192
/jdk1.6.0_45/javax/naming/ldap/LdapContext.java,Java,,17,11,306,334
/jdk1.6.0_45/javax/naming/ldap/LdapName.java,Java,,295,55,424,774
/jdk1.6.0_45/javax/naming/ldap/LdapReferralException.java,Java,,22,9,114,145
/jdk1.6.0_45/javax/naming/ldap/ManageReferralControl.java,Java,,11,6,32,49
/jdk1.6.0_45/javax/naming/ldap/PagedResultsControl.java,Java,,31,14,135,180
/jdk1.6.0_45/javax/naming/ldap/PagedResultsResponseControl.java,Java,,28,13,74,115
/jdk1.6.0_45/javax/naming/ldap/Rdn.java,Java,,369,71,311,751
/jdk1.6.0_45/javax/naming/ldap/Rfc2253Parser.java,Java,,153,33,42,228
/jdk1.6.0_45/javax/naming/ldap/SortControl.java,Java,,44,17,143,204
/jdk1.6.0_45/javax/naming/ldap/SortKey.java,Java,,24,11,65,100
/jdk1.6.0_45/javax/naming/ldap/SortResponseControl.java,Java,,35,16,100,151
/jdk1.6.0_45/javax/naming/ldap/StartTlsRequest.java,Java,,74,29,128,231
/jdk1.6.0_45/javax/naming/ldap/StartTlsResponse.java,Java,,23,19,146,188
/jdk1.6.0_45/javax/naming/ldap/UnsolicitedNotification.java,Java,,6,5,36,47
/jdk1.6.0_45/javax/naming/ldap/UnsolicitedNotificationEvent.java,Java,,16,8,43,67
/jdk1.6.0_45/javax/naming/ldap/UnsolicitedNotificationListener.java,Java,,5,4,42,51
/jdk1.6.0_45/javax/naming/LimitExceededException.java,Java,,11,7,39,57
/jdk1.6.0_45/javax/naming/LinkException.java,Java,,63,23,201,287
/jdk1.6.0_45/javax/naming/LinkLoopException.java,Java,,10,5,35,50
/jdk1.6.0_45/javax/naming/LinkRef.java,Java,,21,7,71,99
/jdk1.6.0_45/javax/naming/MalformedLinkException.java,Java,,10,6,34,50
/jdk1.6.0_45/javax/naming/Name.java,Java,,22,20,218,260
/jdk1.6.0_45/javax/naming/NameAlreadyBoundException.java,Java,,10,5,41,56
/jdk1.6.0_45/javax/naming/NameClassPair.java,Java,,48,21,212,281
/jdk1.6.0_45/javax/naming/NameImpl.java,Java,,530,81,103,714
/jdk1.6.0_45/javax/naming/NameNotFoundException.java,Java,,10,5,33,48
/jdk1.6.0_45/javax/naming/NameParser.java,Java,,4,3,33,40
/jdk1.6.0_45/javax/naming/NamingEnumeration.java,Java,,7,5,118,130
/jdk1.6.0_45/javax/naming/NamingException.java,Java,,104,24,290,418
/jdk1.6.0_45/javax/naming/NamingSecurityException.java,Java,,10,5,39,54
/jdk1.6.0_45/javax/naming/NoInitialContextException.java,Java,,10,4,44,58
/jdk1.6.0_45/javax/naming/NoPermissionException.java,Java,,10,4,33,47
/jdk1.6.0_45/javax/naming/NotContextException.java,Java,,10,5,41,56
/jdk1.6.0_45/javax/naming/OperationNotSupportedException.java,Java,,10,5,35,50
/jdk1.6.0_45/javax/naming/PartialResultException.java,Java,,10,5,34,49
/jdk1.6.0_45/javax/naming/RefAddr.java,Java,,36,12,86,134
/jdk1.6.0_45/javax/naming/Reference.java,Java,,109,29,240,378
/jdk1.6.0_45/javax/naming/Referenceable.java,Java,,4,2,35,41
/jdk1.6.0_45/javax/naming/ReferralException.java,Java,,18,11,158,187
/jdk1.6.0_45/javax/naming/ServiceUnavailableException.java,Java,,10,5,36,51
/jdk1.6.0_45/javax/naming/SizeLimitExceededException.java,Java,,11,6,35,52
/jdk1.6.0_45/javax/naming/spi/ContinuationContext.java,Java,,181,34,14,229
/jdk1.6.0_45/javax/naming/spi/ContinuationDirContext.java,Java,,244,52,20,316
/jdk1.6.0_45/javax/naming/spi/DirectoryManager.java,Java,,121,30,169,320
/jdk1.6.0_45/javax/naming/spi/DirObjectFactory.java,Java,,10,4,101,115
/jdk1.6.0_45/javax/naming/spi/DirStateFactory.java,Java,,20,10,141,171
/jdk1.6.0_45/javax/naming/spi/InitialContextFactory.java,Java,,7,4,44,55
/jdk1.6.0_45/javax/naming/spi/InitialContextFactoryBuilder.java,Java,,8,3,43,54
/jdk1.6.0_45/javax/naming/spi/NamingManager.java,Java,,302,83,472,857
/jdk1.6.0_45/javax/naming/spi/ObjectFactory.java,Java,,8,5,144,157
/jdk1.6.0_45/javax/naming/spi/ObjectFactoryBuilder.java,Java,,8,3,47,58
/jdk1.6.0_45/javax/naming/spi/Resolver.java,Java,,12,7,60,79
/jdk1.6.0_45/javax/naming/spi/ResolveResult.java,Java,,63,13,108,184
/jdk1.6.0_45/javax/naming/spi/StateFactory.java,Java,,8,2,111,121
/jdk1.6.0_45/javax/naming/StringRefAddr.java,Java,,12,5,52,69
/jdk1.6.0_45/javax/naming/TimeLimitExceededException.java,Java,,11,6,35,52
/jdk1.6.0_45/javax/print/attribute/Attribute.java,Java,,6,6,33,45
/jdk1.6.0_45/javax/print/attribute/AttributeSet.java,Java,,16,19,257,292
/jdk1.6.0_45/javax/print/attribute/AttributeSetUtilities.java,Java,,259,73,228,560
/jdk1.6.0_45/javax/print/attribute/DateTimeSyntax.java,Java,,27,17,84,128
/jdk1.6.0_45/javax/print/attribute/DocAttribute.java,Java,,3,4,23,30
/jdk1.6.0_45/javax/print/attribute/DocAttributeSet.java,Java,,5,6,82,93
/jdk1.6.0_45/javax/print/attribute/EnumSyntax.java,Java,,60,23,180,263
/jdk1.6.0_45/javax/print/attribute/HashAttributeSet.java,Java,,163,37,310,510
/jdk1.6.0_45/javax/print/attribute/HashDocAttributeSet.java,Java,,18,10,56,84
/jdk1.6.0_45/javax/print/attribute/HashPrintJobAttributeSet.java,Java,,18,9,55,82
/jdk1.6.0_45/javax/print/attribute/HashPrintRequestAttributeSet.java,Java,,19,12,55,86
/jdk1.6.0_45/javax/print/attribute/HashPrintServiceAttributeSet.java,Java,,19,10,55,84
/jdk1.6.0_45/javax/print/attribute/IntegerSyntax.java,Java,,30,12,74,116
/jdk1.6.0_45/javax/print/attribute/PrintJobAttribute.java,Java,,3,2,22,27
/jdk1.6.0_45/javax/print/attribute/PrintJobAttributeSet.java,Java,,5,5,81,91
/jdk1.6.0_45/javax/print/attribute/PrintRequestAttribute.java,Java,,3,4,26,33
/jdk1.6.0_45/javax/print/attribute/PrintRequestAttributeSet.java,Java,,5,6,82,93
/jdk1.6.0_45/javax/print/attribute/PrintServiceAttribute.java,Java,,3,2,18,23
/jdk1.6.0_45/javax/print/attribute/PrintServiceAttributeSet.java,Java,,5,7,84,96
/jdk1.6.0_45/javax/print/attribute/ResolutionSyntax.java,Java,,82,29,229,340
/jdk1.6.0_45/javax/print/attribute/SetOfIntegerSyntax.java,Java,,265,41,234,540
/jdk1.6.0_45/javax/print/attribute/Size2DSyntax.java,Java,,85,23,220,328
/jdk1.6.0_45/javax/print/attribute/standard/Chromaticity.java,Java,,31,15,95,141
/jdk1.6.0_45/javax/print/attribute/standard/ColorSupported.java,Java,,29,13,70,112
/jdk1.6.0_45/javax/print/attribute/standard/Compression.java,Java,,34,16,66,116
/jdk1.6.0_45/javax/print/attribute/standard/Copies.java,Java,,21,8,89,118
/jdk1.6.0_45/javax/print/attribute/standard/CopiesSupported.java,Java,,31,10,82,123
/jdk1.6.0_45/javax/print/attribute/standard/DateTimeAtCompleted.java,Java,,22,9,76,107
/jdk1.6.0_45/javax/print/attribute/standard/DateTimeAtCreation.java,Java,,22,8,75,105
/jdk1.6.0_45/javax/print/attribute/standard/DateTimeAtProcessing.java,Java,,22,8,76,106
/jdk1.6.0_45/javax/print/attribute/standard/Destination.java,Java,,23,9,73,105
/jdk1.6.0_45/javax/print/attribute/standard/DocumentName.java,Java,,20,9,74,103
/jdk1.6.0_45/javax/print/attribute/standard/Fidelity.java,Java,,35,13,63,111
/jdk1.6.0_45/javax/print/attribute/standard/Finishings.java,Java,,122,30,307,459
/jdk1.6.0_45/javax/print/attribute/standard/JobHoldUntil.java,Java,,22,10,103,135
/jdk1.6.0_45/javax/print/attribute/standard/JobImpressions.java,Java,,21,9,96,126
/jdk1.6.0_45/javax/print/attribute/standard/JobImpressionsCompleted.java,Java,,21,8,81,110
/jdk1.6.0_45/javax/print/attribute/standard/JobImpressionsSupported.java,Java,,27,10,75,112
/jdk1.6.0_45/javax/print/attribute/standard/JobKOctets.java,Java,,21,8,147,176
/jdk1.6.0_45/javax/print/attribute/standard/JobKOctetsProcessed.java,Java,,21,8,93,122
/jdk1.6.0_45/javax/print/attribute/standard/JobKOctetsSupported.java,Java,,27,8,75,110
/jdk1.6.0_45/javax/print/attribute/standard/JobMediaSheets.java,Java,,21,9,90,120
/jdk1.6.0_45/javax/print/attribute/standard/JobMediaSheetsCompleted.java,Java,,21,8,81,110
/jdk1.6.0_45/javax/print/attribute/standard/JobMediaSheetsSupported.java,Java,,27,8,75,110
/jdk1.6.0_45/javax/print/attribute/standard/JobMessageFromOperator.java,Java,,22,9,80,111
/jdk1.6.0_45/javax/print/attribute/standard/JobName.java,Java,,22,9,76,107
/jdk1.6.0_45/javax/print/attribute/standard/JobOriginatingUserName.java,Java,,22,9,80,111
/jdk1.6.0_45/javax/print/attribute/standard/JobPriority.java,Java,,21,8,80,109
/jdk1.6.0_45/javax/print/attribute/standard/JobPrioritySupported.java,Java,,21,11,74,106
/jdk1.6.0_45/javax/print/attribute/standard/JobSheets.java,Java,,35,14,67,116
/jdk1.6.0_45/javax/print/attribute/standard/JobState.java,Java,,52,22,145,219
/jdk1.6.0_45/javax/print/attribute/standard/JobStateReason.java,Java,,138,41,264,443
/jdk1.6.0_45/javax/print/attribute/standard/JobStateReasons.java,Java,,33,12,118,163
/jdk1.6.0_45/javax/print/attribute/standard/Media.java,Java,,24,8,73,105
/jdk1.6.0_45/javax/print/attribute/standard/MediaName.java,Java,,33,15,47,95
/jdk1.6.0_45/javax/print/attribute/standard/MediaPrintableArea.java,Java,,85,24,208,317
/jdk1.6.0_45/javax/print/attribute/standard/MediaSize.java,Java,,319,35,483,837
/jdk1.6.0_45/javax/print/attribute/standard/MediaSizeName.java,Java,,260,35,252,547
/jdk1.6.0_45/javax/print/attribute/standard/MediaTray.java,Java,,45,20,57,122
/jdk1.6.0_45/javax/print/attribute/standard/MultipleDocumentHandling.java,Java,,44,17,189,250
/jdk1.6.0_45/javax/print/attribute/standard/NumberOfDocuments.java,Java,,21,9,66,96
/jdk1.6.0_45/javax/print/attribute/standard/NumberOfInterveningJobs.java,Java,,21,8,66,95
/jdk1.6.0_45/javax/print/attribute/standard/NumberUp.java,Java,,22,9,143,174
/jdk1.6.0_45/javax/print/attribute/standard/NumberUpSupported.java,Java,,51,11,99,161
/jdk1.6.0_45/javax/print/attribute/standard/OrientationRequested.java,Java,,48,16,106,170
/jdk1.6.0_45/javax/print/attribute/standard/OutputDeviceAssigned.java,Java,,22,11,77,110
/jdk1.6.0_45/javax/print/attribute/standard/PageRanges.java,Java,,60,13,174,247
/jdk1.6.0_45/javax/print/attribute/standard/PagesPerMinute.java,Java,,21,8,67,96
/jdk1.6.0_45/javax/print/attribute/standard/PagesPerMinuteColor.java,Java,,21,8,79,108
/jdk1.6.0_45/javax/print/attribute/standard/PDLOverrideSupported.java,Java,,35,14,61,110
/jdk1.6.0_45/javax/print/attribute/standard/PresentationDirection.java,Java,,60,19,89,168
/jdk1.6.0_45/javax/print/attribute/standard/PrinterInfo.java,Java,,21,9,73,103
/jdk1.6.0_45/javax/print/attribute/standard/PrinterIsAcceptingJobs.java,Java,,35,13,62,110
/jdk1.6.0_45/javax/print/attribute/standard/PrinterLocation.java,Java,,21,9,71,101
/jdk1.6.0_45/javax/print/attribute/standard/PrinterMakeAndModel.java,Java,,22,8,70,100
/jdk1.6.0_45/javax/print/attribute/standard/PrinterMessageFromOperator.java,Java,,22,9,85,116
/jdk1.6.0_45/javax/print/attribute/standard/PrinterMoreInfo.java,Java,,22,9,74,105
/jdk1.6.0_45/javax/print/attribute/standard/PrinterMoreInfoManufacturer.java,Java,,22,9,78,109
/jdk1.6.0_45/javax/print/attribute/standard/PrinterName.java,Java,,21,9,73,103
/jdk1.6.0_45/javax/print/attribute/standard/PrinterResolution.java,Java,,24,8,101,133
/jdk1.6.0_45/javax/print/attribute/standard/PrinterState.java,Java,,43,15,66,124
/jdk1.6.0_45/javax/print/attribute/standard/PrinterStateReason.java,Java,,156,45,225,426
/jdk1.6.0_45/javax/print/attribute/standard/PrinterStateReasons.java,Java,,108,23,160,291
/jdk1.6.0_45/javax/print/attribute/standard/PrinterURI.java,Java,,22,10,66,98
/jdk1.6.0_45/javax/print/attribute/standard/PrintQuality.java,Java,,41,14,62,117
/jdk1.6.0_45/javax/print/attribute/standard/QueuedJobCount.java,Java,,21,8,64,93
/jdk1.6.0_45/javax/print/attribute/standard/ReferenceUriSchemesSupported.java,Java,,51,19,95,165
/jdk1.6.0_45/javax/print/attribute/standard/RequestingUserName.java,Java,,22,9,81,112
/jdk1.6.0_45/javax/print/attribute/standard/Severity.java,Java,,34,15,91,140
/jdk1.6.0_45/javax/print/attribute/standard/SheetCollate.java,Java,,35,13,168,216
/jdk1.6.0_45/javax/print/attribute/standard/Sides.java,Java,,40,17,147,204
/jdk1.6.0_45/javax/print/attribute/SupportedValuesAttribute.java,Java,,3,3,20,26
/jdk1.6.0_45/javax/print/attribute/TextSyntax.java,Java,,42,16,76,134
/jdk1.6.0_45/javax/print/attribute/UnmodifiableSetException.java,Java,,8,3,22,33
/jdk1.6.0_45/javax/print/attribute/URISyntax.java,Java,,31,13,60,104
/jdk1.6.0_45/javax/print/AttributeException.java,Java,,6,8,34,48
/jdk1.6.0_45/javax/print/CancelablePrintJob.java,Java,,4,5,50,59
/jdk1.6.0_45/javax/print/Doc.java,Java,,14,11,165,190
/jdk1.6.0_45/javax/print/DocFlavor.java,Java,,226,123,1067,1416
/jdk1.6.0_45/javax/print/DocPrintJob.java,Java,,20,12,127,159
/jdk1.6.0_45/javax/print/event/PrintEvent.java,Java,,10,7,19,36
/jdk1.6.0_45/javax/print/event/PrintJobAdapter.java,Java,,15,13,59,87
/jdk1.6.0_45/javax/print/event/PrintJobAttributeEvent.java,Java,,19,16,29,64
/jdk1.6.0_45/javax/print/event/PrintJobAttributeListener.java,Java,,4,4,20,28
/jdk1.6.0_45/javax/print/event/PrintJobEvent.java,Java,,22,20,65,107
/jdk1.6.0_45/javax/print/event/PrintJobListener.java,Java,,9,15,53,77
/jdk1.6.0_45/javax/print/event/PrintServiceAttributeEvent.java,Java,,20,15,32,67
/jdk1.6.0_45/javax/print/event/PrintServiceAttributeListener.java,Java,,4,5,21,30
/jdk1.6.0_45/javax/print/FlavorException.java,Java,,5,5,19,29
/jdk1.6.0_45/javax/print/MimeType.java,Java,,389,43,197,629
/jdk1.6.0_45/javax/print/MultiDoc.java,Java,,6,8,104,118
/jdk1.6.0_45/javax/print/MultiDocPrintJob.java,Java,,6,6,37,49
/jdk1.6.0_45/javax/print/MultiDocPrintService.java,Java,,7,7,15,29
/jdk1.6.0_45/javax/print/PrintException.java,Java,,15,8,32,55
/jdk1.6.0_45/javax/print/PrintService.java,Java,,37,25,408,470
/jdk1.6.0_45/javax/print/PrintServiceLookup.java,Java,,250,42,174,466
/jdk1.6.0_45/javax/print/ServiceUI.java,Java,,132,27,159,318
/jdk1.6.0_45/javax/print/ServiceUIFactory.java,Java,,13,15,96,124
/jdk1.6.0_45/javax/print/SimpleDoc.java,Java,,76,22,135,233
/jdk1.6.0_45/javax/print/StreamPrintService.java,Java,,21,12,63,96
/jdk1.6.0_45/javax/print/StreamPrintServiceFactory.java,Java,,98,26,87,211
/jdk1.6.0_45/javax/print/URIException.java,Java,,9,10,36,55
/jdk1.6.0_45/javax/rmi/CORBA/ClassDesc.java,Java,,5,4,23,32
/jdk1.6.0_45/javax/rmi/CORBA/GetORBPropertiesFileAction.java,Java,,54,18,18,90
/jdk1.6.0_45/javax/rmi/CORBA/PortableRemoteObjectDelegate.java,Java,,17,9,42,68
/jdk1.6.0_45/javax/rmi/CORBA/Stub.java,Java,,135,44,68,247
/jdk1.6.0_45/javax/rmi/CORBA/StubDelegate.java,Java,,17,10,50,77
/jdk1.6.0_45/javax/rmi/CORBA/Tie.java,Java,,18,9,42,69
/jdk1.6.0_45/javax/rmi/CORBA/Util.java,Java,,171,51,158,380
/jdk1.6.0_45/javax/rmi/CORBA/UtilDelegate.java,Java,,28,20,72,120
/jdk1.6.0_45/javax/rmi/CORBA/ValueHandler.java,Java,,14,9,57,80
/jdk1.6.0_45/javax/rmi/CORBA/ValueHandlerMultiFormat.java,Java,,7,4,41,52
/jdk1.6.0_45/javax/rmi/PortableRemoteObject.java,Java,,152,45,85,282
/jdk1.6.0_45/javax/rmi/ssl/SslRMIClientSocketFactory.java,Java,,67,10,120,197
/jdk1.6.0_45/javax/rmi/ssl/SslRMIServerSocketFactory.java,Java,,128,23,243,394
/jdk1.6.0_45/javax/script/AbstractScriptEngine.java,Java,,88,42,164,294
/jdk1.6.0_45/javax/script/Bindings.java,Java,,9,6,93,108
/jdk1.6.0_45/javax/script/Compilable.java,Java,,9,5,41,55
/jdk1.6.0_45/javax/script/CompiledScript.java,Java,,23,13,64,100
/jdk1.6.0_45/javax/script/Invocable.java,Java,,9,7,78,94
/jdk1.6.0_45/javax/script/ScriptContext.java,Java,,22,24,143,189
/jdk1.6.0_45/javax/script/ScriptEngine.java,Java,,27,33,246,306
/jdk1.6.0_45/javax/script/ScriptEngineFactory.java,Java,,16,18,178,212
/jdk1.6.0_45/javax/script/ScriptEngineManager.java,Java,,253,32,156,441
/jdk1.6.0_45/javax/script/ScriptException.java,Java,,55,13,67,135
/jdk1.6.0_45/javax/script/SimpleBindings.java,Java,,75,19,112,206
/jdk1.6.0_45/javax/script/SimpleScriptContext.java,Java,,129,42,134,305
/jdk1.6.0_45/javax/security/auth/AuthPermission.java,Java,,13,5,137,155
/jdk1.6.0_45/javax/security/auth/callback/Callback.java,Java,,2,3,30,35
/jdk1.6.0_45/javax/security/auth/callback/CallbackHandler.java,Java,,5,3,128,136
/jdk1.6.0_45/javax/security/auth/callback/ChoiceCallback.java,Java,,48,15,131,194
/jdk1.6.0_45/javax/security/auth/callback/ConfirmationCallback.java,Java,,122,37,325,484
/jdk1.6.0_45/javax/security/auth/callback/LanguageCallback.java,Java,,13,8,41,62
/jdk1.6.0_45/javax/security/auth/callback/NameCallback.java,Java,,31,11,85,127
/jdk1.6.0_45/javax/security/auth/callback/PasswordCallback.java,Java,,33,11,83,127
/jdk1.6.0_45/javax/security/auth/callback/TextInputCallback.java,Java,,31,11,86,128
/jdk1.6.0_45/javax/security/auth/callback/TextOutputCallback.java,Java,,23,9,58,90
/jdk1.6.0_45/javax/security/auth/callback/UnsupportedCallbackException.java,Java,,16,7,41,64
/jdk1.6.0_45/javax/security/auth/Destroyable.java,Java,,5,4,36,45
/jdk1.6.0_45/javax/security/auth/DestroyFailedException.java,Java,,10,5,28,43
/jdk1.6.0_45/javax/security/auth/kerberos/DelegationPermission.java,Java,,133,49,193,375
/jdk1.6.0_45/javax/security/auth/kerberos/KerberosKey.java,Java,,112,30,143,285
/jdk1.6.0_45/javax/security/auth/kerberos/KerberosPrincipal.java,Java,,103,43,139,285
/jdk1.6.0_45/javax/security/auth/kerberos/KerberosTicket.java,Java,,336,85,310,731
/jdk1.6.0_45/javax/security/auth/kerberos/KeyImpl.java,Java,,142,37,49,228
/jdk1.6.0_45/javax/security/auth/kerberos/ServicePermission.java,Java,,218,92,270,580
/jdk1.6.0_45/javax/security/auth/login/AccountException.java,Java,,10,6,25,41
/jdk1.6.0_45/javax/security/auth/login/AccountExpiredException.java,Java,,10,5,31,46
/jdk1.6.0_45/javax/security/auth/login/AccountLockedException.java,Java,,10,5,29,44
/jdk1.6.0_45/javax/security/auth/login/AccountNotFoundException.java,Java,,10,5,28,43
/jdk1.6.0_45/javax/security/auth/login/AppConfigurationEntry.java,Java,,50,17,89,156
/jdk1.6.0_45/javax/security/auth/login/Configuration.java,Java,,198,37,369,604
/jdk1.6.0_45/javax/security/auth/login/ConfigurationSpi.java,Java,,6,5,47,58
/jdk1.6.0_45/javax/security/auth/login/CredentialException.java,Java,,10,5,25,40
/jdk1.6.0_45/javax/security/auth/login/CredentialExpiredException.java,Java,,10,5,33,48
/jdk1.6.0_45/javax/security/auth/login/CredentialNotFoundException.java,Java,,10,5,28,43
/jdk1.6.0_45/javax/security/auth/login/FailedLoginException.java,Java,,10,5,28,43
/jdk1.6.0_45/javax/security/auth/login/LoginContext.java,Java,,422,88,472,982
/jdk1.6.0_45/javax/security/auth/login/LoginException.java,Java,,10,6,25,41
/jdk1.6.0_45/javax/security/auth/Policy.java,Java,,70,14,214,298
/jdk1.6.0_45/javax/security/auth/PrivateCredentialPermission.java,Java,,230,80,236,546
/jdk1.6.0_45/javax/security/auth/Refreshable.java,Java,,5,4,36,45
/jdk1.6.0_45/javax/security/auth/RefreshFailedException.java,Java,,10,5,28,43
/jdk1.6.0_45/javax/security/auth/spi/LoginModule.java,Java,,15,8,200,223
/jdk1.6.0_45/javax/security/auth/Subject.java,Java,,658,133,598,1389
/jdk1.6.0_45/javax/security/auth/SubjectDomainCombiner.java,Java,,357,69,150,576
/jdk1.6.0_45/javax/security/auth/x500/X500Principal.java,Java,,140,23,317,480
/jdk1.6.0_45/javax/security/auth/x500/X500PrivateCredential.java,Java,,41,14,62,117
/jdk1.6.0_45/javax/security/sasl/AuthenticationException.java,Java,,13,5,47,65
/jdk1.6.0_45/javax/security/sasl/AuthorizeCallback.java,Java,,34,14,79,127
/jdk1.6.0_45/javax/security/sasl/RealmCallback.java,Java,,11,6,32,49
/jdk1.6.0_45/javax/security/sasl/RealmChoiceCallback.java,Java,,9,5,30,44
/jdk1.6.0_45/javax/security/sasl/Sasl.java,Java,,179,37,372,588
/jdk1.6.0_45/javax/security/sasl/SaslClient.java,Java,,14,11,182,207
/jdk1.6.0_45/javax/security/sasl/SaslClientFactory.java,Java,,13,4,77,94
/jdk1.6.0_45/javax/security/sasl/SaslException.java,Java,,33,11,67,111
/jdk1.6.0_45/javax/security/sasl/SaslServer.java,Java,,14,11,173,198
/jdk1.6.0_45/javax/security/sasl/SaslServerFactory.java,Java,,12,4,75,91
/jdk1.6.0_45/javax/sound/midi/ControllerEventListener.java,Java,,5,5,37,47
/jdk1.6.0_45/javax/sound/midi/Instrument.java,Java,,12,15,46,73
/jdk1.6.0_45/javax/sound/midi/InvalidMidiDataException.java,Java,,9,8,29,46
/jdk1.6.0_45/javax/sound/midi/MetaEventListener.java,Java,,5,5,23,33
/jdk1.6.0_45/javax/sound/midi/MetaMessage.java,Java,,74,36,106,216
/jdk1.6.0_45/javax/sound/midi/MidiChannel.java,Java,,29,30,461,520
/jdk1.6.0_45/javax/sound/midi/MidiDevice.java,Java,,48,52,262,362
/jdk1.6.0_45/javax/sound/midi/MidiEvent.java,Java,,18,15,46,79
/jdk1.6.0_45/javax/sound/midi/MidiFileFormat.java,Java,,59,35,193,287
/jdk1.6.0_45/javax/sound/midi/MidiMessage.java,Java,,36,20,115,171
/jdk1.6.0_45/javax/sound/midi/MidiSystem.java,Java,,590,158,698,1446
/jdk1.6.0_45/javax/sound/midi/MidiUnavailableException.java,Java,,9,8,29,46
/jdk1.6.0_45/javax/sound/midi/Patch.java,Java,,15,18,62,95
/jdk1.6.0_45/javax/sound/midi/Receiver.java,Java,,5,6,46,57
/jdk1.6.0_45/javax/sound/midi/Sequence.java,Java,,81,51,191,323
/jdk1.6.0_45/javax/sound/midi/Sequencer.java,Java,,68,114,669,851
/jdk1.6.0_45/javax/sound/midi/ShortMessage.java,Java,,129,57,215,401
/jdk1.6.0_45/javax/sound/midi/Soundbank.java,Java,,11,17,88,116
/jdk1.6.0_45/javax/sound/midi/SoundbankResource.java,Java,,21,27,113,161
/jdk1.6.0_45/javax/sound/midi/spi/MidiDeviceProvider.java,Java,,16,11,35,62
/jdk1.6.0_45/javax/sound/midi/spi/MidiFileReader.java,Java,,16,15,94,125
/jdk1.6.0_45/javax/sound/midi/spi/MidiFileWriter.java,Java,,30,18,70,118
/jdk1.6.0_45/javax/sound/midi/spi/SoundbankReader.java,Java,,12,15,40,67
/jdk1.6.0_45/javax/sound/midi/Synthesizer.java,Java,,19,48,309,376
/jdk1.6.0_45/javax/sound/midi/SysexMessage.java,Java,,47,26,113,186
/jdk1.6.0_45/javax/sound/midi/Track.java,Java,,110,30,117,257
/jdk1.6.0_45/javax/sound/midi/Transmitter.java,Java,,6,9,44,59
/jdk1.6.0_45/javax/sound/midi/VoiceStatus.java,Java,,9,16,118,143
/jdk1.6.0_45/javax/sound/sampled/AudioFileFormat.java,Java,,106,61,233,400
/jdk1.6.0_45/javax/sound/sampled/AudioFormat.java,Java,,183,75,387,645
/jdk1.6.0_45/javax/sound/sampled/AudioInputStream.java,Java,,199,81,218,498
/jdk1.6.0_45/javax/sound/sampled/AudioPermission.java,Java,,10,11,201,222
/jdk1.6.0_45/javax/sound/sampled/AudioSystem.java,Java,,627,203,784,1614
/jdk1.6.0_45/javax/sound/sampled/BooleanControl.java,Java,,34,41,101,176
/jdk1.6.0_45/javax/sound/sampled/Clip.java,Java,,14,13,179,206
/jdk1.6.0_45/javax/sound/sampled/CompoundControl.java,Java,,33,38,53,124
/jdk1.6.0_45/javax/sound/sampled/Control.java,Java,,28,29,72,129
/jdk1.6.0_45/javax/sound/sampled/DataLine.java,Java,,107,56,317,480
/jdk1.6.0_45/javax/sound/sampled/EnumControl.java,Java,,43,51,104,198
/jdk1.6.0_45/javax/sound/sampled/FloatControl.java,Java,,87,91,300,478
/jdk1.6.0_45/javax/sound/sampled/Line.java,Java,,46,47,250,343
/jdk1.6.0_45/javax/sound/sampled/LineEvent.java,Java,,49,44,171,264
/jdk1.6.0_45/javax/sound/sampled/LineListener.java,Java,,4,6,42,52
/jdk1.6.0_45/javax/sound/sampled/LineUnavailableException.java,Java,,9,9,35,53
/jdk1.6.0_45/javax/sound/sampled/Mixer.java,Java,,49,38,249,336
/jdk1.6.0_45/javax/sound/sampled/Port.java,Java,,45,45,102,192
/jdk1.6.0_45/javax/sound/sampled/ReverbType.java,Java,,48,32,202,282
/jdk1.6.0_45/javax/sound/sampled/SourceDataLine.java,Java,,6,10,170,186
/jdk1.6.0_45/javax/sound/sampled/spi/AudioFileReader.java,Java,,16,10,94,120
/jdk1.6.0_45/javax/sound/sampled/spi/AudioFileWriter.java,Java,,31,22,77,130
/jdk1.6.0_45/javax/sound/sampled/spi/FormatConversionProvider.java,Java,,48,34,96,178
/jdk1.6.0_45/javax/sound/sampled/spi/MixerProvider.java,Java,,15,11,35,61
/jdk1.6.0_45/javax/sound/sampled/TargetDataLine.java,Java,,6,9,160,175
/jdk1.6.0_45/javax/sound/sampled/UnsupportedAudioFileException.java,Java,,9,9,33,51
/jdk1.6.0_45/javax/sql/CommonDataSource.java,Java,,9,8,78,95
/jdk1.6.0_45/javax/sql/ConnectionEvent.java,Java,,14,15,53,82
/jdk1.6.0_45/javax/sql/ConnectionEventListener.java,Java,,5,11,47,63
/jdk1.6.0_45/javax/sql/ConnectionPoolDataSource.java,Java,,7,12,41,60
/jdk1.6.0_45/javax/sql/DataSource.java,Java,,9,12,65,86
/jdk1.6.0_45/javax/sql/PooledConnection.java,Java,,11,11,138,160
/jdk1.6.0_45/javax/sql/rowset/BaseRowSet.java,Java,,756,285,3454,4495
/jdk1.6.0_45/javax/sql/rowset/CachedRowSet.java,Java,,52,52,1501,1605
/jdk1.6.0_45/javax/sql/rowset/FilteredRowSet.java,Java,,10,7,126,143
/jdk1.6.0_45/javax/sql/rowset/JdbcRowSet.java,Java,,17,17,236,270
/jdk1.6.0_45/javax/sql/rowset/Joinable.java,Java,,14,13,246,273
/jdk1.6.0_45/javax/sql/rowset/JoinRowSet.java,Java,,34,29,457,520
/jdk1.6.0_45/javax/sql/rowset/Predicate.java,Java,,8,8,130,146
/jdk1.6.0_45/javax/sql/rowset/RowSetMetaDataImpl.java,Java,,320,96,661,1077
/jdk1.6.0_45/javax/sql/rowset/RowSetWarning.java,Java,,24,11,93,128
/jdk1.6.0_45/javax/sql/rowset/serial/SerialArray.java,Java,,145,42,330,517
/jdk1.6.0_45/javax/sql/rowset/serial/SerialBlob.java,Java,,130,41,267,438
/jdk1.6.0_45/javax/sql/rowset/serial/SerialClob.java,Java,,165,49,281,495
/jdk1.6.0_45/javax/sql/rowset/serial/SerialDatalink.java,Java,,25,13,53,91
/jdk1.6.0_45/javax/sql/rowset/serial/SerialException.java,Java,,10,6,23,39
/jdk1.6.0_45/javax/sql/rowset/serial/SerialJavaObject.java,Java,,60,21,77,158
/jdk1.6.0_45/javax/sql/rowset/serial/SerialRef.java,Java,,58,22,77,157
/jdk1.6.0_45/javax/sql/rowset/serial/SerialStruct.java,Java,,70,28,138,236
/jdk1.6.0_45/javax/sql/rowset/serial/SQLInputImpl.java,Java,,279,68,465,812
/jdk1.6.0_45/javax/sql/rowset/serial/SQLOutputImpl.java,Java,,166,56,383,605
/jdk1.6.0_45/javax/sql/rowset/spi/SyncFactory.java,Java,,343,118,455,916
/jdk1.6.0_45/javax/sql/rowset/spi/SyncFactoryException.java,Java,,10,8,25,43
/jdk1.6.0_45/javax/sql/rowset/spi/SyncProvider.java,Java,,28,26,358,412
/jdk1.6.0_45/javax/sql/rowset/spi/SyncProviderException.java,Java,,40,13,95,148
/jdk1.6.0_45/javax/sql/rowset/spi/SyncResolver.java,Java,,16,15,323,354
/jdk1.6.0_45/javax/sql/rowset/spi/TransactionalWriter.java,Java,,11,7,47,65
/jdk1.6.0_45/javax/sql/rowset/spi/XmlReader.java,Java,,9,6,41,56
/jdk1.6.0_45/javax/sql/rowset/spi/XmlWriter.java,Java,,9,8,39,56
/jdk1.6.0_45/javax/sql/rowset/WebRowSet.java,Java,,18,12,451,481
/jdk1.6.0_45/javax/sql/RowSet.java,Java,,166,141,1870,2177
/jdk1.6.0_45/javax/sql/RowSetEvent.java,Java,,6,9,33,48
/jdk1.6.0_45/javax/sql/RowSetInternal.java,Java,,9,15,66,90
/jdk1.6.0_45/javax/sql/RowSetListener.java,Java,,6,6,47,59
/jdk1.6.0_45/javax/sql/RowSetMetaData.java,Java,,21,27,174,222
/jdk1.6.0_45/javax/sql/RowSetReader.java,Java,,5,6,44,55
/jdk1.6.0_45/javax/sql/RowSetWriter.java,Java,,5,6,35,46
/jdk1.6.0_45/javax/sql/StatementEvent.java,Java,,27,13,52,92
/jdk1.6.0_45/javax/sql/StatementEventListener.java,Java,,5,3,53,61
/jdk1.6.0_45/javax/sql/XAConnection.java,Java,,5,13,30,48
/jdk1.6.0_45/javax/sql/XADataSource.java,Java,,7,11,42,60
/jdk1.6.0_45/javax/swing/AbstractAction.java,Java,,150,36,159,345
/jdk1.6.0_45/javax/swing/AbstractButton.java,Java,,1429,232,1417,3078
/jdk1.6.0_45/javax/swing/AbstractCellEditor.java,Java,,51,15,85,151
/jdk1.6.0_45/javax/swing/AbstractListModel.java,Java,,60,19,125,204
/jdk1.6.0_45/javax/swing/AbstractSpinnerModel.java,Java,,33,18,73,124
/jdk1.6.0_45/javax/swing/Action.java,Java,,24,12,336,372
/jdk1.6.0_45/javax/swing/ActionMap.java,Java,,107,22,77,206
/jdk1.6.0_45/javax/swing/ActionPropertyChangeListener.java,Java,,81,16,43,140
/jdk1.6.0_45/javax/swing/AncestorNotifier.java,Java,,148,31,43,222
/jdk1.6.0_45/javax/swing/ArrayTable.java,Java,,219,21,78,318
/jdk1.6.0_45/javax/swing/Autoscroller.java,Java,,84,20,58,162
/jdk1.6.0_45/javax/swing/border/AbstractBorder.java,Java,,50,12,118,180
/jdk1.6.0_45/javax/swing/border/BevelBorder.java,Java,,123,38,130,291
/jdk1.6.0_45/javax/swing/border/Border.java,Java,,11,4,58,73
/jdk1.6.0_45/javax/swing/border/CompoundBorder.java,Java,,66,16,75,157
/jdk1.6.0_45/javax/swing/border/EmptyBorder.java,Java,,38,10,54,102
/jdk1.6.0_45/javax/swing/border/EtchedBorder.java,Java,,65,22,107,194
/jdk1.6.0_45/javax/swing/border/LineBorder.java,Java,,68,17,77,162
/jdk1.6.0_45/javax/swing/border/MatteBorder.java,Java,,126,26,96,248
/jdk1.6.0_45/javax/swing/border/SoftBevelBorder.java,Java,,68,20,67,155
/jdk1.6.0_45/javax/swing/border/TitledBorder.java,Java,,487,68,209,764
/jdk1.6.0_45/javax/swing/BorderFactory.java,Java,,127,30,348,505
/jdk1.6.0_45/javax/swing/BoundedRangeModel.java,Java,,18,30,203,251
/jdk1.6.0_45/javax/swing/Box.java,Java,,96,27,296,419
/jdk1.6.0_45/javax/swing/BoxLayout.java,Java,,192,43,285,520
/jdk1.6.0_45/javax/swing/BufferStrategyPaintManager.java,Java,,616,60,263,939
/jdk1.6.0_45/javax/swing/ButtonGroup.java,Java,,67,16,90,173
/jdk1.6.0_45/javax/swing/ButtonModel.java,Java,,27,25,173,225
/jdk1.6.0_45/javax/swing/CellEditor.java,Java,,12,10,95,117
/jdk1.6.0_45/javax/swing/CellRendererPane.java,Java,,83,32,97,212
/jdk1.6.0_45/javax/swing/colorchooser/AbstractColorChooserPanel.java,Java,,70,22,130,222
/jdk1.6.0_45/javax/swing/colorchooser/CenterLayout.java,Java,,41,9,12,62
/jdk1.6.0_45/javax/swing/colorchooser/ColorChooserComponentFactory.java,Java,,14,10,23,47
/jdk1.6.0_45/javax/swing/colorchooser/ColorSelectionModel.java,Java,,10,6,40,56
/jdk1.6.0_45/javax/swing/colorchooser/DefaultColorSelectionModel.java,Java,,47,16,75,138
/jdk1.6.0_45/javax/swing/colorchooser/DefaultHSBChooserPanel.java,Java,,555,125,101,781
/jdk1.6.0_45/javax/swing/colorchooser/DefaultPreviewPanel.java,Java,,161,45,22,228
/jdk1.6.0_45/javax/swing/colorchooser/DefaultRGBChooserPanel.java,Java,,157,41,79,277
/jdk1.6.0_45/javax/swing/colorchooser/DefaultSwatchChooserPanel.java,Java,,495,69,68,632
/jdk1.6.0_45/javax/swing/colorchooser/SmartGridLayout.java,Java,,108,49,16,173
/jdk1.6.0_45/javax/swing/colorchooser/SyntheticImage.java,Java,,106,10,33,149
/jdk1.6.0_45/javax/swing/ComboBoxEditor.java,Java,,11,8,20,39
/jdk1.6.0_45/javax/swing/ComboBoxModel.java,Java,,5,4,30,39
/jdk1.6.0_45/javax/swing/ComponentInputMap.java,Java,,43,7,51,101
/jdk1.6.0_45/javax/swing/DebugGraphics.java,Java,,1037,180,236,1453
/jdk1.6.0_45/javax/swing/DebugGraphicsFilter.java,Java,,13,5,11,29
/jdk1.6.0_45/javax/swing/DebugGraphicsInfo.java,Java,,35,9,12,56
/jdk1.6.0_45/javax/swing/DebugGraphicsObserver.java,Java,,19,6,11,36
/jdk1.6.0_45/javax/swing/DefaultBoundedRangeModel.java,Java,,142,50,216,408
/jdk1.6.0_45/javax/swing/DefaultButtonModel.java,Java,,209,62,247,518
/jdk1.6.0_45/javax/swing/DefaultCellEditor.java,Java,,163,42,175,380
/jdk1.6.0_45/javax/swing/DefaultComboBoxModel.java,Java,,98,25,51,174
/jdk1.6.0_45/javax/swing/DefaultDesktopManager.java,Java,,500,114,190,804
/jdk1.6.0_45/javax/swing/DefaultFocusManager.java,Java,,99,26,31,156
/jdk1.6.0_45/javax/swing/DefaultListCellRenderer.java,Java,,139,36,156,331
/jdk1.6.0_45/javax/swing/DefaultListModel.java,Java,,144,42,340,526
/jdk1.6.0_45/javax/swing/DefaultListSelectionModel.java,Java,,373,97,361,831
/jdk1.6.0_45/javax/swing/DefaultRowSorter.java,Java,,678,119,565,1362
/jdk1.6.0_45/javax/swing/DefaultSingleSelectionModel.java,Java,,52,15,94,161
/jdk1.6.0_45/javax/swing/DelegatingDefaultFocusManager.java,Java,,109,9,26,144
/jdk1.6.0_45/javax/swing/DesktopManager.java,Java,,19,11,72,102
/jdk1.6.0_45/javax/swing/DropMode.java,Java,,11,9,66,86
/jdk1.6.0_45/javax/swing/event/AncestorEvent.java,Java,,25,7,54,86
/jdk1.6.0_45/javax/swing/event/AncestorListener.java,Java,,10,8,36,54
/jdk1.6.0_45/javax/swing/event/CaretEvent.java,Java,,9,7,39,55
/jdk1.6.0_45/javax/swing/event/CaretListener.java,Java,,5,5,18,28
/jdk1.6.0_45/javax/swing/event/CellEditorListener.java,Java,,7,7,15,29
/jdk1.6.0_45/javax/swing/event/ChangeEvent.java,Java,,7,4,28,39
/jdk1.6.0_45/javax/swing/event/ChangeListener.java,Java,,5,5,17,27
/jdk1.6.0_45/javax/swing/event/DocumentEvent.java,Java,,28,20,118,166
/jdk1.6.0_45/javax/swing/event/DocumentListener.java,Java,,7,5,49,61
/jdk1.6.0_45/javax/swing/event/EventListenerList.java,Java,,115,18,140,273
/jdk1.6.0_45/javax/swing/event/HyperlinkEvent.java,Java,,48,20,103,171
/jdk1.6.0_45/javax/swing/event/HyperlinkListener.java,Java,,5,5,17,27
/jdk1.6.0_45/javax/swing/event/InternalFrameAdapter.java,Java,,10,8,45,63
/jdk1.6.0_45/javax/swing/event/InternalFrameEvent.java,Java,,49,18,108,175
/jdk1.6.0_45/javax/swing/event/InternalFrameListener.java,Java,,11,9,50,70
/jdk1.6.0_45/javax/swing/event/ListDataEvent.java,Java,,26,12,68,106
/jdk1.6.0_45/javax/swing/event/ListDataListener.java,Java,,7,9,37,53
/jdk1.6.0_45/javax/swing/event/ListSelectionEvent.java,Java,,29,10,68,107
/jdk1.6.0_45/javax/swing/event/ListSelectionListener.java,Java,,6,8,19,33
/jdk1.6.0_45/javax/swing/event/MenuDragMouseEvent.java,Java,,34,8,86,128
/jdk1.6.0_45/javax/swing/event/MenuDragMouseListener.java,Java,,8,5,36,49
/jdk1.6.0_45/javax/swing/event/MenuEvent.java,Java,,7,4,30,41
/jdk1.6.0_45/javax/swing/event/MenuKeyEvent.java,Java,,23,7,50,80
/jdk1.6.0_45/javax/swing/event/MenuKeyListener.java,Java,,7,7,22,36
/jdk1.6.0_45/javax/swing/event/MenuListener.java,Java,,7,5,27,39
/jdk1.6.0_45/javax/swing/event/MouseInputAdapter.java,Java,,5,3,17,25
/jdk1.6.0_45/javax/swing/event/MouseInputListener.java,Java,,5,5,14,24
/jdk1.6.0_45/javax/swing/event/PopupMenuEvent.java,Java,,7,2,28,37
/jdk1.6.0_45/javax/swing/event/PopupMenuListener.java,Java,,7,6,22,35
/jdk1.6.0_45/javax/swing/event/RowSorterEvent.java,Java,,38,10,79,127
/jdk1.6.0_45/javax/swing/event/RowSorterListener.java,Java,,4,1,20,25
/jdk1.6.0_45/javax/swing/event/SwingPropertyChangeSupport.java,Java,,34,11,62,107
/jdk1.6.0_45/javax/swing/event/TableColumnModelEvent.java,Java,,15,10,48,73
/jdk1.6.0_45/javax/swing/event/TableColumnModelListener.java,Java,,12,9,22,43
/jdk1.6.0_45/javax/swing/event/TableModelEvent.java,Java,,38,18,105,161
/jdk1.6.0_45/javax/swing/event/TableModelListener.java,Java,,6,5,18,29
/jdk1.6.0_45/javax/swing/event/TreeExpansionEvent.java,Java,,12,5,41,58
/jdk1.6.0_45/javax/swing/event/TreeExpansionListener.java,Java,,7,5,22,34
/jdk1.6.0_45/javax/swing/event/TreeModelEvent.java,Java,,75,16,206,297
/jdk1.6.0_45/javax/swing/event/TreeModelListener.java,Java,,8,8,65,81
/jdk1.6.0_45/javax/swing/event/TreeSelectionEvent.java,Java,,71,14,86,171
/jdk1.6.0_45/javax/swing/event/TreeSelectionListener.java,Java,,6,3,24,33
/jdk1.6.0_45/javax/swing/event/TreeWillExpandListener.java,Java,,7,5,22,34
/jdk1.6.0_45/javax/swing/event/UndoableEditEvent.java,Java,,12,5,33,50
/jdk1.6.0_45/javax/swing/event/UndoableEditListener.java,Java,,5,5,16,26
/jdk1.6.0_45/javax/swing/filechooser/FileFilter.java,Java,,6,4,35,45
/jdk1.6.0_45/javax/swing/filechooser/FileNameExtensionFilter.java,Java,,56,8,77,141
/jdk1.6.0_45/javax/swing/filechooser/FileSystemView.java,Java,,424,110,259,793
/jdk1.6.0_45/javax/swing/filechooser/FileView.java,Java,,20,8,66,94
/jdk1.6.0_45/javax/swing/FocusManager.java,Java,,38,10,87,135
/jdk1.6.0_45/javax/swing/GraphicsWrapper.java,Java,,10,8,12,30
/jdk1.6.0_45/javax/swing/GrayFilter.java,Java,,31,9,37,77
/jdk1.6.0_45/javax/swing/GroupLayout.java,Java,,2064,295,1291,3650
/jdk1.6.0_45/javax/swing/Icon.java,Java,,9,6,26,41
/jdk1.6.0_45/javax/swing/ImageIcon.java,Java,,280,66,332,678
/jdk1.6.0_45/javax/swing/InputMap.java,Java,,116,25,73,214
/jdk1.6.0_45/javax/swing/InputVerifier.java,Java,,8,11,98,117
/jdk1.6.0_45/javax/swing/InternalFrameFocusTraversalPolicy.java,Java,,10,4,37,51
/jdk1.6.0_45/javax/swing/JApplet.java,Java,,157,47,350,554
/jdk1.6.0_45/javax/swing/JButton.java,Java,,85,30,190,305
/jdk1.6.0_45/javax/swing/JCheckBox.java,Java,,93,36,205,334
/jdk1.6.0_45/javax/swing/JCheckBoxMenuItem.java,Java,,83,25,182,290
/jdk1.6.0_45/javax/swing/JColorChooser.java,Java,,305,93,345,743
/jdk1.6.0_45/javax/swing/JComboBox.java,Java,,861,195,1336,2392
/jdk1.6.0_45/javax/swing/JComponent.java,Java,,2352,431,2698,5481
/jdk1.6.0_45/javax/swing/JDesktopPane.java,Java,,300,56,264,620
/jdk1.6.0_45/javax/swing/JDialog.java,Java,,297,70,872,1239
/jdk1.6.0_45/javax/swing/JEditorPane.java,Java,,1262,181,1051,2494
/jdk1.6.0_45/javax/swing/JFileChooser.java,Java,,727,175,1040,1942
/jdk1.6.0_45/javax/swing/JFormattedTextField.java,Java,,414,88,668,1170
/jdk1.6.0_45/javax/swing/JFrame.java,Java,,261,62,595,918
/jdk1.6.0_45/javax/swing/JInternalFrame.java,Java,,891,186,1324,2401
/jdk1.6.0_45/javax/swing/JLabel.java,Java,,702,130,784,1616
/jdk1.6.0_45/javax/swing/JLayeredPane.java,Java,,311,68,389,768
/jdk1.6.0_45/javax/swing/JList.java,Java,,1581,338,1748,3667
/jdk1.6.0_45/javax/swing/JMenu.java,Java,,719,147,744,1610
/jdk1.6.0_45/javax/swing/JMenuBar.java,Java,,322,76,350,748
/jdk1.6.0_45/javax/swing/JMenuItem.java,Java,,420,84,429,933
/jdk1.6.0_45/javax/swing/JOptionPane.java,Java,,914,164,1500,2578
/jdk1.6.0_45/javax/swing/JPanel.java,Java,,63,23,146,232
/jdk1.6.0_45/javax/swing/JPasswordField.java,Java,,208,44,396,648
/jdk1.6.0_45/javax/swing/JPopupMenu.java,Java,,695,152,652,1499
/jdk1.6.0_45/javax/swing/JProgressBar.java,Java,,305,91,714,1110
/jdk1.6.0_45/javax/swing/JRadioButton.java,Java,,71,32,181,284
/jdk1.6.0_45/javax/swing/JRadioButtonMenuItem.java,Java,,72,22,170,264
/jdk1.6.0_45/javax/swing/JRootPane.java,Java,,353,85,647,1085
/jdk1.6.0_45/javax/swing/JScrollBar.java,Java,,306,111,486,903
/jdk1.6.0_45/javax/swing/JScrollPane.java,Java,,528,149,855,1532
/jdk1.6.0_45/javax/swing/JSeparator.java,Java,,86,25,166,277
/jdk1.6.0_45/javax/swing/JSlider.java,Java,,502,167,817,1486
/jdk1.6.0_45/javax/swing/JSpinner.java,Java,,787,207,1034,2028
/jdk1.6.0_45/javax/swing/JSplitPane.java,Java,,407,166,663,1236
/jdk1.6.0_45/javax/swing/JTabbedPane.java,Java,,999,248,1141,2388
/jdk1.6.0_45/javax/swing/JTable.java,Java,,4460,839,4292,9591
/jdk1.6.0_45/javax/swing/JTextArea.java,Java,,301,54,458,813
/jdk1.6.0_45/javax/swing/JTextField.java,Java,,329,69,547,945
/jdk1.6.0_45/javax/swing/JTextPane.java,Java,,177,35,294,506
/jdk1.6.0_45/javax/swing/JToggleButton.java,Java,,147,49,212,408
/jdk1.6.0_45/javax/swing/JToolBar.java,Java,[WDW - need to add orientation from BoxLayout,375,83,394,852
/jdk1.6.0_45/javax/swing/JToolTip.java,Java,,80,30,157,267
/jdk1.6.0_45/javax/swing/JTree.java,Java,,2561,481,2274,5316
/jdk1.6.0_45/javax/swing/JViewport.java,Java,,790,189,802,1781
/jdk1.6.0_45/javax/swing/JWindow.java,Java,,170,44,439,653
/jdk1.6.0_45/javax/swing/KeyboardManager.java,Java,,215,49,88,352
/jdk1.6.0_45/javax/swing/KeyStroke.java,Java,,61,11,219,291
/jdk1.6.0_45/javax/swing/LayoutComparator.java,Java,,92,24,27,143
/jdk1.6.0_45/javax/swing/LayoutFocusTraversalPolicy.java,Java,,107,11,138,256
/jdk1.6.0_45/javax/swing/LayoutStyle.java,Java,,40,11,149,200
/jdk1.6.0_45/javax/swing/LegacyGlueFocusTraversalPolicy.java,Java,,147,15,21,183
/jdk1.6.0_45/javax/swing/ListCellRenderer.java,Java,,11,4,80,95
/jdk1.6.0_45/javax/swing/ListModel.java,Java,,9,7,37,53
/jdk1.6.0_45/javax/swing/ListSelectionModel.java,Java,,28,36,232,296
/jdk1.6.0_45/javax/swing/LookAndFeel.java,Java,,153,46,512,711
/jdk1.6.0_45/javax/swing/MenuElement.java,Java,,10,10,47,67
/jdk1.6.0_45/javax/swing/MenuSelectionManager.java,Java,,321,54,110,485
/jdk1.6.0_45/javax/swing/MultiUIDefaults.java,Java,,176,28,11,215
/jdk1.6.0_45/javax/swing/MutableComboBoxModel.java,Java,,7,8,41,56
/jdk1.6.0_45/javax/swing/OverlayLayout.java,Java,,119,27,124,270
/jdk1.6.0_45/javax/swing/plaf/ActionMapUIResource.java,Java,,6,4,14,24
/jdk1.6.0_45/javax/swing/plaf/basic/BasicArrowButton.java,Java,,155,32,106,293
/jdk1.6.0_45/javax/swing/plaf/basic/BasicBorders.java,Java,,460,86,66,612
/jdk1.6.0_45/javax/swing/plaf/basic/BasicButtonListener.java,Java,,224,37,40,301
/jdk1.6.0_45/javax/swing/plaf/basic/BasicButtonUI.java,Java,,298,68,88,454
/jdk1.6.0_45/javax/swing/plaf/basic/BasicCheckBoxMenuItemUI.java,Java,,32,15,14,61
/jdk1.6.0_45/javax/swing/plaf/basic/BasicCheckBoxUI.java,Java,,24,11,24,59
/jdk1.6.0_45/javax/swing/plaf/basic/BasicColorChooserUI.java,Java,,244,52,31,327
/jdk1.6.0_45/javax/swing/plaf/basic/BasicComboBoxEditor.java,Java,,79,22,49,150
/jdk1.6.0_45/javax/swing/plaf/basic/BasicComboBoxRenderer.java,Java,,61,20,48,129
/jdk1.6.0_45/javax/swing/plaf/basic/BasicComboBoxUI.java,Java,,1173,228,554,1955
/jdk1.6.0_45/javax/swing/plaf/basic/BasicComboPopup.java,Java,,647,141,490,1278
/jdk1.6.0_45/javax/swing/plaf/basic/BasicDesktopIconUI.java,Java,,197,48,40,285
/jdk1.6.0_45/javax/swing/plaf/basic/BasicDesktopPaneUI.java,Java,,529,60,107,696
/jdk1.6.0_45/javax/swing/plaf/basic/BasicDirectoryModel.java,Java,,316,60,102,478
/jdk1.6.0_45/javax/swing/plaf/basic/BasicEditorPaneUI.java,Java,,282,30,86,398
/jdk1.6.0_45/javax/swing/plaf/basic/BasicFileChooserUI.java,Java,,971,188,160,1319
/jdk1.6.0_45/javax/swing/plaf/basic/BasicFormattedTextFieldUI.java,Java,,11,3,26,40
/jdk1.6.0_45/javax/swing/plaf/basic/BasicGraphicsUtils.java,Java,,190,54,53,297
/jdk1.6.0_45/javax/swing/plaf/basic/BasicHTML.java,Java,,275,55,297,627
/jdk1.6.0_45/javax/swing/plaf/basic/BasicIconFactory.java,Java,,151,33,22,206
/jdk1.6.0_45/javax/swing/plaf/basic/BasicInternalFrameTitlePane.java,Java,,569,104,99,772
/jdk1.6.0_45/javax/swing/plaf/basic/BasicInternalFrameUI.java,Java,,1084,201,172,1457
/jdk1.6.0_45/javax/swing/plaf/basic/BasicLabelUI.java,Java,,334,49,82,465
/jdk1.6.0_45/javax/swing/plaf/basic/BasicListUI.java,Java,,1864,318,686,2868
/jdk1.6.0_45/javax/swing/plaf/basic/BasicLookAndFeel.java,Java,,1689,171,414,2274
/jdk1.6.0_45/javax/swing/plaf/basic/BasicMenuBarUI.java,Java,,162,39,22,223
/jdk1.6.0_45/javax/swing/plaf/basic/BasicMenuItemUI.java,Java,,678,93,171,942
/jdk1.6.0_45/javax/swing/plaf/basic/BasicMenuUI.java,Java,,414,76,124,614
/jdk1.6.0_45/javax/swing/plaf/basic/BasicOptionPaneUI.java,Java,,1015,172,254,1441
/jdk1.6.0_45/javax/swing/plaf/basic/BasicPanelUI.java,Java,,54,13,29,96
/jdk1.6.0_45/javax/swing/plaf/basic/BasicPasswordFieldUI.java,Java,,36,16,44,96
/jdk1.6.0_45/javax/swing/plaf/basic/BasicPopupMenuSeparatorUI.java,Java,,27,9,13,49
/jdk1.6.0_45/javax/swing/plaf/basic/BasicPopupMenuUI.java,Java,,907,132,115,1154
/jdk1.6.0_45/javax/swing/plaf/basic/BasicProgressBarUI.java,Java,,686,135,438,1259
/jdk1.6.0_45/javax/swing/plaf/basic/BasicRadioButtonMenuItemUI.java,Java,,33,13,13,59
/jdk1.6.0_45/javax/swing/plaf/basic/BasicRadioButtonUI.java,Java,,160,40,44,244
/jdk1.6.0_45/javax/swing/plaf/basic/BasicRootPaneUI.java,Java,,173,33,25,231
/jdk1.6.0_45/javax/swing/plaf/basic/BasicScrollBarUI.java,Java,,1083,216,286,1585
/jdk1.6.0_45/javax/swing/plaf/basic/BasicScrollPaneUI.java,Java,,820,132,206,1158
/jdk1.6.0_45/javax/swing/plaf/basic/BasicSeparatorUI.java,Java,,69,22,14,105
/jdk1.6.0_45/javax/swing/plaf/basic/BasicSliderUI.java,Java,,1465,271,231,1967
/jdk1.6.0_45/javax/swing/plaf/basic/BasicSpinnerUI.java,Java,,635,117,300,1052
/jdk1.6.0_45/javax/swing/plaf/basic/BasicSplitPaneDivider.java,Java,,636,146,291,1073
/jdk1.6.0_45/javax/swing/plaf/basic/BasicSplitPaneUI.java,Java,,1298,281,652,2231
/jdk1.6.0_45/javax/swing/plaf/basic/BasicTabbedPaneUI.java,Java,,2934,399,585,3918
/jdk1.6.0_45/javax/swing/plaf/basic/BasicTableHeaderUI.java,Java,,674,122,150,946
/jdk1.6.0_45/javax/swing/plaf/basic/BasicTableUI.java,Java,,1511,305,359,2175
/jdk1.6.0_45/javax/swing/plaf/basic/BasicTextAreaUI.java,Java,,202,37,138,377
/jdk1.6.0_45/javax/swing/plaf/basic/BasicTextFieldUI.java,Java,,198,29,176,403
/jdk1.6.0_45/javax/swing/plaf/basic/BasicTextPaneUI.java,Java,,25,8,48,81
/jdk1.6.0_45/javax/swing/plaf/basic/BasicTextUI.java,Java,,1355,246,1034,2635
/jdk1.6.0_45/javax/swing/plaf/basic/BasicToggleButtonUI.java,Java,,99,31,28,158
/jdk1.6.0_45/javax/swing/plaf/basic/BasicToolBarSeparatorUI.java,Java,,47,13,14,74
/jdk1.6.0_45/javax/swing/plaf/basic/BasicToolBarUI.java,Java,,988,184,255,1427
/jdk1.6.0_45/javax/swing/plaf/basic/BasicToolTipUI.java,Java,,167,32,37,236
/jdk1.6.0_45/javax/swing/plaf/basic/BasicTransferable.java,Java,,154,31,80,265
/jdk1.6.0_45/javax/swing/plaf/basic/BasicTreeUI.java,Java,,3035,607,852,4494
/jdk1.6.0_45/javax/swing/plaf/basic/BasicViewportUI.java,Java,,32,11,13,56
/jdk1.6.0_45/javax/swing/plaf/basic/CenterLayout.java,Java,,40,11,12,63
/jdk1.6.0_45/javax/swing/plaf/basic/ComboPopup.java,Java,,15,11,58,84
/jdk1.6.0_45/javax/swing/plaf/basic/DefaultMenuLayout.java,Java,,21,8,16,45
/jdk1.6.0_45/javax/swing/plaf/basic/DragRecognitionSupport.java,Java,,95,25,47,167
/jdk1.6.0_45/javax/swing/plaf/basic/LazyActionMap.java,Java,,87,17,44,148
/jdk1.6.0_45/javax/swing/plaf/BorderUIResource.java,Java,,152,43,33,228
/jdk1.6.0_45/javax/swing/plaf/ButtonUI.java,Java,,8,2,12,22
/jdk1.6.0_45/javax/swing/plaf/ColorChooserUI.java,Java,,6,6,13,25
/jdk1.6.0_45/javax/swing/plaf/ColorUIResource.java,Java,,18,7,24,49
/jdk1.6.0_45/javax/swing/plaf/ComboBoxUI.java,Java,,7,6,22,35
/jdk1.6.0_45/javax/swing/plaf/ComponentInputMapUIResource.java,Java,,8,4,14,26
/jdk1.6.0_45/javax/swing/plaf/ComponentUI.java,Java,,64,19,260,343
/jdk1.6.0_45/javax/swing/plaf/DesktopIconUI.java,Java,,3,4,12,19
/jdk1.6.0_45/javax/swing/plaf/DesktopPaneUI.java,Java,,3,4,12,19
/jdk1.6.0_45/javax/swing/plaf/DimensionUIResource.java,Java,,9,4,26,39
/jdk1.6.0_45/javax/swing/plaf/FileChooserUI.java,Java,,14,7,12,33
/jdk1.6.0_45/javax/swing/plaf/FontUIResource.java,Java,,12,5,25,42
/jdk1.6.0_45/javax/swing/plaf/IconUIResource.java,Java,,25,8,33,66
/jdk1.6.0_45/javax/swing/plaf/InputMapUIResource.java,Java,,6,4,14,24
/jdk1.6.0_45/javax/swing/plaf/InsetsUIResource.java,Java,,9,4,25,38
/jdk1.6.0_45/javax/swing/plaf/InternalFrameUI.java,Java,,3,3,12,18
/jdk1.6.0_45/javax/swing/plaf/LabelUI.java,Java,,3,2,12,17
/jdk1.6.0_45/javax/swing/plaf/ListUI.java,Java,,10,9,48,67
/jdk1.6.0_45/javax/swing/plaf/MenuBarUI.java,Java,,5,5,13,23
/jdk1.6.0_45/javax/swing/plaf/MenuItemUI.java,Java,,5,3,14,22
/jdk1.6.0_45/javax/swing/plaf/metal/DefaultMetalTheme.java,Java,,178,40,198,416
/jdk1.6.0_45/javax/swing/plaf/metal/MetalBorders.java,Java,,760,167,93,1020
/jdk1.6.0_45/javax/swing/plaf/metal/MetalBumps.java,Java,,168,32,29,229
/jdk1.6.0_45/javax/swing/plaf/metal/MetalButtonUI.java,Java,,112,23,55,190
/jdk1.6.0_45/javax/swing/plaf/metal/MetalCheckBoxIcon.java,Java,,55,14,21,90
/jdk1.6.0_45/javax/swing/plaf/metal/MetalCheckBoxUI.java,Java,,37,15,31,83
/jdk1.6.0_45/javax/swing/plaf/metal/MetalComboBoxButton.java,Java,,147,31,29,207
/jdk1.6.0_45/javax/swing/plaf/metal/MetalComboBoxEditor.java,Java,,67,14,46,127
/jdk1.6.0_45/javax/swing/plaf/metal/MetalComboBoxIcon.java,Java,,24,11,22,57
/jdk1.6.0_45/javax/swing/plaf/metal/MetalComboBoxUI.java,Java,,229,39,102,370
/jdk1.6.0_45/javax/swing/plaf/metal/MetalDesktopIconUI.java,Java,,87,21,19,127
/jdk1.6.0_45/javax/swing/plaf/metal/MetalFileChooserUI.java,Java,,935,200,145,1280
/jdk1.6.0_45/javax/swing/plaf/metal/MetalFontDesktopProperty.java,Java,,33,8,39,80
/jdk1.6.0_45/javax/swing/plaf/metal/MetalHighContrastTheme.java,Java,,121,33,18,172
/jdk1.6.0_45/javax/swing/plaf/metal/MetalIconFactory.java,Java,,1974,372,304,2650
/jdk1.6.0_45/javax/swing/plaf/metal/MetalInternalFrameTitlePane.java,Java,,404,69,61,534
/jdk1.6.0_45/javax/swing/plaf/metal/MetalInternalFrameUI.java,Java,,176,37,26,239
/jdk1.6.0_45/javax/swing/plaf/metal/MetalLabelUI.java,Java,,32,12,27,71
/jdk1.6.0_45/javax/swing/plaf/metal/MetalLookAndFeel.java,Java,,1493,196,818,2507
/jdk1.6.0_45/javax/swing/plaf/metal/MetalMenuBarUI.java,Java,,48,6,48,102
/jdk1.6.0_45/javax/swing/plaf/metal/MetalPopupMenuSeparatorUI.java,Java,,29,13,13,55
/jdk1.6.0_45/javax/swing/plaf/metal/MetalProgressBarUI.java,Java,,96,25,52,173
/jdk1.6.0_45/javax/swing/plaf/metal/MetalRadioButtonUI.java,Java,,135,34,40,209
/jdk1.6.0_45/javax/swing/plaf/metal/MetalRootPaneUI.java,Java,,594,93,285,972
/jdk1.6.0_45/javax/swing/plaf/metal/MetalScrollBarUI.java,Java,,355,151,35,541
/jdk1.6.0_45/javax/swing/plaf/metal/MetalScrollButton.java,Java,,228,57,45,330
/jdk1.6.0_45/javax/swing/plaf/metal/MetalScrollPaneUI.java,Java,,87,19,31,137
/jdk1.6.0_45/javax/swing/plaf/metal/MetalSeparatorUI.java,Java,,45,15,22,82
/jdk1.6.0_45/javax/swing/plaf/metal/MetalSliderUI.java,Java,,390,66,60,516
/jdk1.6.0_45/javax/swing/plaf/metal/MetalSplitPaneDivider.java,Java,,269,41,89,399
/jdk1.6.0_45/javax/swing/plaf/metal/MetalSplitPaneUI.java,Java,,13,6,27,46
/jdk1.6.0_45/javax/swing/plaf/metal/MetalTabbedPaneUI.java,Java,,862,167,185,1214
/jdk1.6.0_45/javax/swing/plaf/metal/MetalTextFieldUI.java,Java,,15,7,29,51
/jdk1.6.0_45/javax/swing/plaf/metal/MetalTheme.java,Java,,68,56,344,468
/jdk1.6.0_45/javax/swing/plaf/metal/MetalTitlePane.java,Java,,674,135,214,1023
/jdk1.6.0_45/javax/swing/plaf/metal/MetalToggleButtonUI.java,Java,,122,26,60,208
/jdk1.6.0_45/javax/swing/plaf/metal/MetalToolBarUI.java,Java,,245,42,93,380
/jdk1.6.0_45/javax/swing/plaf/metal/MetalToolTipUI.java,Java,,124,27,29,180
/jdk1.6.0_45/javax/swing/plaf/metal/MetalTreeUI.java,Java,,127,40,54,221
/jdk1.6.0_45/javax/swing/plaf/metal/MetalUtils.java,Java,,297,51,87,435
/jdk1.6.0_45/javax/swing/plaf/metal/OceanTheme.java,Java,,248,54,141,443
/jdk1.6.0_45/javax/swing/plaf/multi/MultiButtonUI.java,Java,,88,18,87,193
/jdk1.6.0_45/javax/swing/plaf/multi/MultiColorChooserUI.java,Java,,88,18,87,193
/jdk1.6.0_45/javax/swing/plaf/multi/MultiComboBoxUI.java,Java,,110,21,102,233
/jdk1.6.0_45/javax/swing/plaf/multi/MultiDesktopIconUI.java,Java,,88,18,87,193
/jdk1.6.0_45/javax/swing/plaf/multi/MultiDesktopPaneUI.java,Java,,88,18,87,193
/jdk1.6.0_45/javax/swing/plaf/multi/MultiFileChooserUI.java,Java,,135,24,117,276
/jdk1.6.0_45/javax/swing/plaf/multi/MultiInternalFrameUI.java,Java,,88,18,87,193
/jdk1.6.0_45/javax/swing/plaf/multi/MultiLabelUI.java,Java,,88,18,87,193
/jdk1.6.0_45/javax/swing/plaf/multi/MultiListUI.java,Java,,115,21,105,241
/jdk1.6.0_45/javax/swing/plaf/multi/MultiLookAndFeel.java,Java,,123,16,147,286
/jdk1.6.0_45/javax/swing/plaf/multi/MultiMenuBarUI.java,Java,,88,18,87,193
/jdk1.6.0_45/javax/swing/plaf/multi/MultiMenuItemUI.java,Java,,89,19,90,198
/jdk1.6.0_45/javax/swing/plaf/multi/MultiOptionPaneUI.java,Java,,102,20,96,218
/jdk1.6.0_45/javax/swing/plaf/multi/MultiPanelUI.java,Java,,88,18,87,193
/jdk1.6.0_45/javax/swing/plaf/multi/MultiPopupMenuUI.java,Java,,107,20,101,228
/jdk1.6.0_45/javax/swing/plaf/multi/MultiProgressBarUI.java,Java,,88,18,87,193
/jdk1.6.0_45/javax/swing/plaf/multi/MultiRootPaneUI.java,Java,,88,18,88,194
/jdk1.6.0_45/javax/swing/plaf/multi/MultiScrollBarUI.java,Java,,88,18,87,193
/jdk1.6.0_45/javax/swing/plaf/multi/MultiScrollPaneUI.java,Java,,88,18,87,193
/jdk1.6.0_45/javax/swing/plaf/multi/MultiSeparatorUI.java,Java,,88,18,87,193
/jdk1.6.0_45/javax/swing/plaf/multi/MultiSliderUI.java,Java,,88,18,87,193
/jdk1.6.0_45/javax/swing/plaf/multi/MultiSpinnerUI.java,Java,,88,18,88,194
/jdk1.6.0_45/javax/swing/plaf/multi/MultiSplitPaneUI.java,Java,,128,24,114,266
/jdk1.6.0_45/javax/swing/plaf/multi/MultiTabbedPaneUI.java,Java,,114,21,105,240
/jdk1.6.0_45/javax/swing/plaf/multi/MultiTableHeaderUI.java,Java,,88,18,87,193
/jdk1.6.0_45/javax/swing/plaf/multi/MultiTableUI.java,Java,,88,18,87,193
/jdk1.6.0_45/javax/swing/plaf/multi/MultiTextUI.java,Java,,173,28,142,343
/jdk1.6.0_45/javax/swing/plaf/multi/MultiToolBarUI.java,Java,,88,18,87,193
/jdk1.6.0_45/javax/swing/plaf/multi/MultiToolTipUI.java,Java,,88,18,87,193
/jdk1.6.0_45/javax/swing/plaf/multi/MultiTreeUI.java,Java,,165,28,141,334
/jdk1.6.0_45/javax/swing/plaf/multi/MultiViewportUI.java,Java,,88,18,87,193
/jdk1.6.0_45/javax/swing/plaf/OptionPaneUI.java,Java,,7,5,20,32
/jdk1.6.0_45/javax/swing/plaf/PanelUI.java,Java,,3,4,12,19
/jdk1.6.0_45/javax/swing/plaf/PopupMenuUI.java,Java,,14,7,26,47
/jdk1.6.0_45/javax/swing/plaf/ProgressBarUI.java,Java,,3,3,12,18
/jdk1.6.0_45/javax/swing/plaf/RootPaneUI.java,Java,,3,2,13,18
/jdk1.6.0_45/javax/swing/plaf/ScrollBarUI.java,Java,,3,2,12,17
/jdk1.6.0_45/javax/swing/plaf/ScrollPaneUI.java,Java,,3,4,12,19
/jdk1.6.0_45/javax/swing/plaf/SeparatorUI.java,Java,,3,4,13,20
/jdk1.6.0_45/javax/swing/plaf/SliderUI.java,Java,,3,3,12,18
/jdk1.6.0_45/javax/swing/plaf/SpinnerUI.java,Java,,3,4,13,20
/jdk1.6.0_45/javax/swing/plaf/SplitPaneUI.java,Java,,12,8,32,52
/jdk1.6.0_45/javax/swing/plaf/synth/ColorType.java,Java,,34,12,78,124
/jdk1.6.0_45/javax/swing/plaf/synth/DefaultMenuLayout.java,Java,,26,10,18,54
/jdk1.6.0_45/javax/swing/plaf/synth/DefaultSynthStyleFactory.java,Java,,106,24,62,192
/jdk1.6.0_45/javax/swing/plaf/synth/ImagePainter.java,Java,,778,149,75,1002
/jdk1.6.0_45/javax/swing/plaf/synth/ParsedSynthStyle.java,Java,,1831,312,15,2158
/jdk1.6.0_45/javax/swing/plaf/synth/Region.java,Java,,173,60,316,549
/jdk1.6.0_45/javax/swing/plaf/synth/SynthArrowButton.java,Java,,89,17,21,127
/jdk1.6.0_45/javax/swing/plaf/synth/SynthBorder.java,Java,,93,8,31,132
/jdk1.6.0_45/javax/swing/plaf/synth/SynthButtonUI.java,Java,,338,55,52,445
/jdk1.6.0_45/javax/swing/plaf/synth/SynthCheckBoxMenuItemUI.java,Java,,42,10,15,67
/jdk1.6.0_45/javax/swing/plaf/synth/SynthCheckBoxUI.java,Java,,22,8,15,45
/jdk1.6.0_45/javax/swing/plaf/synth/SynthColorChooserUI.java,Java,,93,25,13,131
/jdk1.6.0_45/javax/swing/plaf/synth/SynthComboBoxUI.java,Java,,445,96,238,779
/jdk1.6.0_45/javax/swing/plaf/synth/SynthComboPopup.java,Java,,44,6,25,75
/jdk1.6.0_45/javax/swing/plaf/synth/SynthConstants.java,Java,,11,3,40,54
/jdk1.6.0_45/javax/swing/plaf/synth/SynthContext.java,Java,,97,27,64,188
/jdk1.6.0_45/javax/swing/plaf/synth/SynthDefaultLookup.java,Java,,17,2,12,31
/jdk1.6.0_45/javax/swing/plaf/synth/SynthDesktopIconUI.java,Java,,139,25,13,177
/jdk1.6.0_45/javax/swing/plaf/synth/SynthDesktopPaneUI.java,Java,,353,54,27,434
/jdk1.6.0_45/javax/swing/plaf/synth/SynthEditorPaneUI.java,Java,,92,22,35,149
/jdk1.6.0_45/javax/swing/plaf/synth/SynthFormattedTextFieldUI.java,Java,,21,5,25,51
/jdk1.6.0_45/javax/swing/plaf/synth/SynthGraphicsUtils.java,Java,,377,68,201,646
/jdk1.6.0_45/javax/swing/plaf/synth/SynthInternalFrameTitlePane.java,Java,,406,46,25,477
/jdk1.6.0_45/javax/swing/plaf/synth/SynthInternalFrameUI.java,Java,,147,34,17,198
/jdk1.6.0_45/javax/swing/plaf/synth/SynthLabelUI.java,Java,,182,32,21,235
/jdk1.6.0_45/javax/swing/plaf/synth/SynthListUI.java,Java,,136,33,12,181
/jdk1.6.0_45/javax/swing/plaf/synth/SynthLookAndFeel.java,Java,,595,93,297,985
/jdk1.6.0_45/javax/swing/plaf/synth/SynthMenuBarUI.java,Java,,95,21,12,128
/jdk1.6.0_45/javax/swing/plaf/synth/SynthMenuItemLayoutHelper.java,Java,,218,28,44,290
/jdk1.6.0_45/javax/swing/plaf/synth/SynthMenuItemUI.java,Java,,173,41,17,231
/jdk1.6.0_45/javax/swing/plaf/synth/SynthMenuUI.java,Java,,175,35,18,228
/jdk1.6.0_45/javax/swing/plaf/synth/SynthOptionPaneUI.java,Java,,139,36,23,198
/jdk1.6.0_45/javax/swing/plaf/synth/SynthPainter.java,Java,,573,139,1689,2401
/jdk1.6.0_45/javax/swing/plaf/synth/SynthPanelUI.java,Java,,84,25,13,122
/jdk1.6.0_45/javax/swing/plaf/synth/SynthParser.java,Java,,1084,104,136,1324
/jdk1.6.0_45/javax/swing/plaf/synth/SynthPasswordFieldUI.java,Java,,34,9,35,78
/jdk1.6.0_45/javax/swing/plaf/synth/SynthPopupMenuUI.java,Java,,101,26,14,141
/jdk1.6.0_45/javax/swing/plaf/synth/SynthProgressBarUI.java,Java,,308,41,36,385
/jdk1.6.0_45/javax/swing/plaf/synth/SynthRadioButtonMenuItemUI.java,Java,,41,7,13,61
/jdk1.6.0_45/javax/swing/plaf/synth/SynthRadioButtonUI.java,Java,,26,8,18,52
/jdk1.6.0_45/javax/swing/plaf/synth/SynthRootPaneUI.java,Java,,74,19,17,110
/jdk1.6.0_45/javax/swing/plaf/synth/SynthScrollBarUI.java,Java,,288,54,49,391
/jdk1.6.0_45/javax/swing/plaf/synth/SynthScrollPaneUI.java,Java,,194,45,15,254
/jdk1.6.0_45/javax/swing/plaf/synth/SynthSeparatorUI.java,Java,,126,31,14,171
/jdk1.6.0_45/javax/swing/plaf/synth/SynthSliderUI.java,Java,,745,129,77,951
/jdk1.6.0_45/javax/swing/plaf/synth/SynthSpinnerUI.java,Java,,265,62,137,464
/jdk1.6.0_45/javax/swing/plaf/synth/SynthSplitPaneDivider.java,Java,,96,17,21,134
/jdk1.6.0_45/javax/swing/plaf/synth/SynthSplitPaneUI.java,Java,,195,50,52,297
/jdk1.6.0_45/javax/swing/plaf/synth/SynthStyle.java,Java,,792,62,182,1036
/jdk1.6.0_45/javax/swing/plaf/synth/SynthStyleFactory.java,Java,,10,3,48,61
/jdk1.6.0_45/javax/swing/plaf/synth/SynthTabbedPaneUI.java,Java,,619,100,110,829
/jdk1.6.0_45/javax/swing/plaf/synth/SynthTableHeaderUI.java,Java,,148,33,21,202
/jdk1.6.0_45/javax/swing/plaf/synth/SynthTableUI.java,Java,,586,108,73,767
/jdk1.6.0_45/javax/swing/plaf/synth/SynthTextAreaUI.java,Java,,86,24,41,151
/jdk1.6.0_45/javax/swing/plaf/synth/SynthTextFieldUI.java,Java,,148,39,50,237
/jdk1.6.0_45/javax/swing/plaf/synth/SynthTextPaneUI.java,Java,,70,17,58,145
/jdk1.6.0_45/javax/swing/plaf/synth/SynthToggleButtonUI.java,Java,,27,6,15,48
/jdk1.6.0_45/javax/swing/plaf/synth/SynthToolBarUI.java,Java,,354,64,46,464
/jdk1.6.0_45/javax/swing/plaf/synth/SynthToolTipUI.java,Java,,123,27,15,165
/jdk1.6.0_45/javax/swing/plaf/synth/SynthTreeUI.java,Java,,651,117,33,801
/jdk1.6.0_45/javax/swing/plaf/synth/SynthViewportUI.java,Java,,92,25,17,134
/jdk1.6.0_45/javax/swing/plaf/TabbedPaneUI.java,Java,,8,3,13,24
/jdk1.6.0_45/javax/swing/plaf/TableHeaderUI.java,Java,,3,2,12,17
/jdk1.6.0_45/javax/swing/plaf/TableUI.java,Java,,3,2,12,17
/jdk1.6.0_45/javax/swing/plaf/TextUI.java,Java,,28,11,109,148
/jdk1.6.0_45/javax/swing/plaf/ToolBarUI.java,Java,,5,5,12,22
/jdk1.6.0_45/javax/swing/plaf/ToolTipUI.java,Java,,3,2,12,17
/jdk1.6.0_45/javax/swing/plaf/TreeUI.java,Java,,18,12,58,88
/jdk1.6.0_45/javax/swing/plaf/UIResource.java,Java,,3,4,43,50
/jdk1.6.0_45/javax/swing/plaf/ViewportUI.java,Java,,3,4,12,19
/jdk1.6.0_45/javax/swing/Popup.java,Java,,104,28,113,245
/jdk1.6.0_45/javax/swing/PopupFactory.java,Java,,571,121,252,944
/jdk1.6.0_45/javax/swing/ProgressMonitor.java,Java,,460,100,472,1032
/jdk1.6.0_45/javax/swing/ProgressMonitorInputStream.java,Java,,73,25,73,171
/jdk1.6.0_45/javax/swing/Renderer.java,Java,,6,3,25,34
/jdk1.6.0_45/javax/swing/RepaintManager.java,Java,,983,165,525,1673
/jdk1.6.0_45/javax/swing/RootPaneContainer.java,Java,,13,18,132,163
/jdk1.6.0_45/javax/swing/RowFilter.java,Java,,238,54,300,592
/jdk1.6.0_45/javax/swing/RowSorter.java,Java,,79,28,301,408
/jdk1.6.0_45/javax/swing/Scrollable.java,Java,,11,11,90,112
/jdk1.6.0_45/javax/swing/ScrollPaneConstants.java,Java,,25,8,68,101
/jdk1.6.0_45/javax/swing/ScrollPaneLayout.java,Java,,518,138,412,1068
/jdk1.6.0_45/javax/swing/SingleSelectionModel.java,Java,,10,8,42,60
/jdk1.6.0_45/javax/swing/SizeRequirements.java,Java,,175,27,269,471
/jdk1.6.0_45/javax/swing/SizeSequence.java,Java,,140,24,226,390
/jdk1.6.0_45/javax/swing/SortingFocusTraversalPolicy.java,Java,,315,67,211,593
/jdk1.6.0_45/javax/swing/SortOrder.java,Java,,6,3,28,37
/jdk1.6.0_45/javax/swing/SpinnerDateModel.java,Java,,110,33,304,447
/jdk1.6.0_45/javax/swing/SpinnerListModel.java,Java,,73,28,130,231
/jdk1.6.0_45/javax/swing/SpinnerModel.java,Java,,12,14,96,122
/jdk1.6.0_45/javax/swing/SpinnerNumberModel.java,Java,,118,39,277,434
/jdk1.6.0_45/javax/swing/Spring.java,Java,,293,93,288,674
/jdk1.6.0_45/javax/swing/SpringLayout.java,Java,,507,95,613,1215
/jdk1.6.0_45/javax/swing/SwingConstants.java,Java,,22,8,91,121
/jdk1.6.0_45/javax/swing/SwingHeavyWeight.java,Java,,3,1,13,17
/jdk1.6.0_45/javax/swing/SwingPaintEventDispatcher.java,Java,,56,6,15,77
/jdk1.6.0_45/javax/swing/SwingUtilities.java,Java,,1111,167,663,1941
/jdk1.6.0_45/javax/swing/SwingWorker.java,Java,,268,47,533,848
/jdk1.6.0_45/javax/swing/table/AbstractTableModel.java,Java,,74,24,226,324
/jdk1.6.0_45/javax/swing/table/DefaultTableCellRenderer.java,Java,,145,43,193,381
/jdk1.6.0_45/javax/swing/table/DefaultTableColumnModel.java,Java,,268,73,383,724
/jdk1.6.0_45/javax/swing/table/DefaultTableModel.java,Java,,214,55,422,691
/jdk1.6.0_45/javax/swing/table/JTableHeader.java,Java,,780,156,518,1454
/jdk1.6.0_45/javax/swing/table/TableCellEditor.java,Java,,9,7,40,56
/jdk1.6.0_45/javax/swing/table/TableCellRenderer.java,Java,,8,5,64,77
/jdk1.6.0_45/javax/swing/table/TableColumn.java,Java,,226,76,511,813
/jdk1.6.0_45/javax/swing/table/TableColumnModel.java,Java,,27,26,171,224
/jdk1.6.0_45/javax/swing/table/TableModel.java,Java,,15,13,99,127
/jdk1.6.0_45/javax/swing/table/TableRowSorter.java,Java,,99,21,171,291
/jdk1.6.0_45/javax/swing/table/TableStringConverter.java,Java,,4,1,26,31
/jdk1.6.0_45/javax/swing/TablePrintable.java,Java,,207,93,199,499
/jdk1.6.0_45/javax/swing/text/AbstractDocument.java,Java,,1288,300,1523,3111
/jdk1.6.0_45/javax/swing/text/AbstractWriter.java,Java,,329,54,313,696
/jdk1.6.0_45/javax/swing/text/AsyncBoxView.java,Java,,649,109,645,1403
/jdk1.6.0_45/javax/swing/text/AttributeSet.java,Java,,23,18,135,176
/jdk1.6.0_45/javax/swing/text/BadLocationException.java,Java,,12,3,33,48
/jdk1.6.0_45/javax/swing/text/BoxView.java,Java,,565,84,522,1171
/jdk1.6.0_45/javax/swing/text/Caret.java,Java,,24,21,143,188
/jdk1.6.0_45/javax/swing/text/ChangedCharSetException.java,Java,,16,7,13,36
/jdk1.6.0_45/javax/swing/text/ComponentView.java,Java,,234,37,205,476
/jdk1.6.0_45/javax/swing/text/CompositeView.java,Java,,321,47,409,777
/jdk1.6.0_45/javax/swing/text/DateFormatter.java,Java,,64,17,62,143
/jdk1.6.0_45/javax/swing/text/DefaultCaret.java,Java,,984,147,773,1904
/jdk1.6.0_45/javax/swing/text/DefaultEditorKit.java,Java,,1134,219,933,2286
/jdk1.6.0_45/javax/swing/text/DefaultFormatter.java,Java,,372,78,293,743
/jdk1.6.0_45/javax/swing/text/DefaultFormatterFactory.java,Java,,84,22,190,296
/jdk1.6.0_45/javax/swing/text/DefaultHighlighter.java,Java,,368,52,194,614
/jdk1.6.0_45/javax/swing/text/DefaultStyledDocument.java,Java,,1552,217,830,2599
/jdk1.6.0_45/javax/swing/text/DefaultTextUI.java,Java,,5,5,15,25
/jdk1.6.0_45/javax/swing/text/Document.java,Java,,23,23,413,459
/jdk1.6.0_45/javax/swing/text/DocumentFilter.java,Java,,26,8,124,158
/jdk1.6.0_45/javax/swing/text/EditorKit.java,Java,,34,16,141,191
/jdk1.6.0_45/javax/swing/text/Element.java,Java,,13,14,96,123
/jdk1.6.0_45/javax/swing/text/ElementIterator.java,Java,,167,42,155,364
/jdk1.6.0_45/javax/swing/text/FieldView.java,Java,,149,19,126,294
/jdk1.6.0_45/javax/swing/text/FlowView.java,Java,,409,67,378,854
/jdk1.6.0_45/javax/swing/text/GapContent.java,Java,,545,96,298,939
/jdk1.6.0_45/javax/swing/text/GapVector.java,Java,,120,33,131,284
/jdk1.6.0_45/javax/swing/text/GlyphPainter1.java,Java,,120,23,90,233
/jdk1.6.0_45/javax/swing/text/GlyphPainter2.java,Java,,211,26,127,364
/jdk1.6.0_45/javax/swing/text/GlyphView.java,Java,,658,97,547,1302
/jdk1.6.0_45/javax/swing/text/Highlighter.java,Java,,22,20,94,136
/jdk1.6.0_45/javax/swing/text/html/AccessibleHTML.java,Java,,1551,296,1194,3041
/jdk1.6.0_45/javax/swing/text/html/BlockView.java,Java,,206,32,188,426
/jdk1.6.0_45/javax/swing/text/html/BRView.java,Java,,14,4,22,40
/jdk1.6.0_45/javax/swing/text/html/CommentView.java,Java,,92,13,19,124
/jdk1.6.0_45/javax/swing/text/html/CSS.java,Java,,2133,327,787,3247
/jdk1.6.0_45/javax/swing/text/html/CSSParser.java,Java,,583,77,177,837
/jdk1.6.0_45/javax/swing/text/html/EditableView.java,Java,,70,11,30,111
/jdk1.6.0_45/javax/swing/text/html/FormSubmitEvent.java,Java,,21,9,45,75
/jdk1.6.0_45/javax/swing/text/html/FormView.java,Java,,544,74,297,915
/jdk1.6.0_45/javax/swing/text/html/FrameSetView.java,Java,,178,32,96,306
/jdk1.6.0_45/javax/swing/text/html/FrameView.java,Java,,288,52,122,462
/jdk1.6.0_45/javax/swing/text/html/HiddenTagView.java,Java,,254,39,51,344
/jdk1.6.0_45/javax/swing/text/html/HRuleView.java,Java,,177,27,96,300
/jdk1.6.0_45/javax/swing/text/html/HTML.java,Java,,411,47,222,680
/jdk1.6.0_45/javax/swing/text/html/HTMLDocument.java,Java,,2079,297,1413,3789
/jdk1.6.0_45/javax/swing/text/html/HTMLEditorKit.java,Java,,1296,166,772,2234
/jdk1.6.0_45/javax/swing/text/html/HTMLFrameHyperlinkEvent.java,Java,,30,11,55,96
/jdk1.6.0_45/javax/swing/text/html/HTMLWriter.java,Java,,819,105,335,1259
/jdk1.6.0_45/javax/swing/text/html/ImageView.java,Java,,612,95,273,980
/jdk1.6.0_45/javax/swing/text/html/InlineView.java,Java,,176,20,132,328
/jdk1.6.0_45/javax/swing/text/html/IsindexView.java,Java,,51,15,31,97
/jdk1.6.0_45/javax/swing/text/html/LineView.java,Java,,63,11,95,169
/jdk1.6.0_45/javax/swing/text/html/ListView.java,Java,,53,8,44,105
/jdk1.6.0_45/javax/swing/text/html/Map.java,Java,,348,48,92,488
/jdk1.6.0_45/javax/swing/text/html/MinimalHTMLWriter.java,Java,,348,82,279,709
/jdk1.6.0_45/javax/swing/text/html/MuxingAttributeSet.java,Java,,148,28,118,294
/jdk1.6.0_45/javax/swing/text/html/NoFramesView.java,Java,,57,15,84,156
/jdk1.6.0_45/javax/swing/text/html/ObjectView.java,Java,,75,11,80,166
/jdk1.6.0_45/javax/swing/text/html/Option.java,Java,,37,12,55,104
/jdk1.6.0_45/javax/swing/text/html/OptionComboBoxModel.java,Java,,13,7,26,46
/jdk1.6.0_45/javax/swing/text/html/OptionListModel.java,Java,,305,74,177,556
/jdk1.6.0_45/javax/swing/text/html/ParagraphView.java,Java,,151,22,113,286
/jdk1.6.0_45/javax/swing/text/html/parser/AttributeList.java,Java,,83,19,53,155
/jdk1.6.0_45/javax/swing/text/html/parser/ContentModel.java,Java,,144,26,68,238
/jdk1.6.0_45/javax/swing/text/html/parser/ContentModelState.java,Java,,173,27,78,278
/jdk1.6.0_45/javax/swing/text/html/parser/DocumentParser.java,Java,,152,19,93,264
/jdk1.6.0_45/javax/swing/text/html/parser/DTD.java,Java,,263,42,148,453
/jdk1.6.0_45/javax/swing/text/html/parser/DTDConstants.java,Java,,39,6,20,65
/jdk1.6.0_45/javax/swing/text/html/parser/Element.java,Java,,79,22,57,158
/jdk1.6.0_45/javax/swing/text/html/parser/Entity.java,Java,,53,15,55,123
/jdk1.6.0_45/javax/swing/text/html/parser/Parser.java,Java,,1567,246,495,2308
/jdk1.6.0_45/javax/swing/text/html/parser/ParserDelegator.java,Java,,65,21,28,114
/jdk1.6.0_45/javax/swing/text/html/parser/ResourceLoader.java,Java,,16,7,20,43
/jdk1.6.0_45/javax/swing/text/html/parser/TagElement.java,Java,,33,15,13,61
/jdk1.6.0_45/javax/swing/text/html/parser/TagStack.java,Java,,123,29,53,205
/jdk1.6.0_45/javax/swing/text/html/ResourceLoader.java,Java,,16,7,20,43
/jdk1.6.0_45/javax/swing/text/html/StyleSheet.java,Java,,2103,224,1014,3341
/jdk1.6.0_45/javax/swing/text/html/TableView.java,Java,,1030,167,587,1784
/jdk1.6.0_45/javax/swing/text/html/TextAreaDocument.java,Java,,20,12,23,55
/jdk1.6.0_45/javax/swing/text/IconView.java,Java,,56,12,84,152
/jdk1.6.0_45/javax/swing/text/InternationalFormatter.java,Java,,569,96,421,1086
/jdk1.6.0_45/javax/swing/text/JTextComponent.java,Java,,2425,401,2199,5025
/jdk1.6.0_45/javax/swing/text/Keymap.java,Java,,18,16,94,128
/jdk1.6.0_45/javax/swing/text/LabelView.java,Java,,96,25,179,300
/jdk1.6.0_45/javax/swing/text/LayeredHighlighter.java,Java,,14,4,28,46
/jdk1.6.0_45/javax/swing/text/LayoutQueue.java,Java,,62,15,35,112
/jdk1.6.0_45/javax/swing/text/MaskFormatter.java,Java,,469,86,443,998
/jdk1.6.0_45/javax/swing/text/MutableAttributeSet.java,Java,,10,20,51,81
/jdk1.6.0_45/javax/swing/text/NavigationFilter.java,Java,,22,8,100,130
/jdk1.6.0_45/javax/swing/text/NumberFormatter.java,Java,,285,45,158,488
/jdk1.6.0_45/javax/swing/text/ParagraphView.java,Java,,612,73,439,1124
/jdk1.6.0_45/javax/swing/text/PasswordView.java,Java,,112,12,94,218
/jdk1.6.0_45/javax/swing/text/PlainDocument.java,Java,,172,16,119,307
/jdk1.6.0_45/javax/swing/text/PlainView.java,Java,,376,45,268,689
/jdk1.6.0_45/javax/swing/text/Position.java,Java,,15,8,53,76
/jdk1.6.0_45/javax/swing/text/rtf/AbstractFilter.java,Java,,108,27,78,213
/jdk1.6.0_45/javax/swing/text/rtf/Constants.java,Java,,28,10,22,60
/jdk1.6.0_45/javax/swing/text/rtf/MockAttributeSet.java,Java,,78,22,8,108
/jdk1.6.0_45/javax/swing/text/rtf/RTFAttribute.java,Java,,26,7,16,49
/jdk1.6.0_45/javax/swing/text/rtf/RTFAttributes.java,Java,,324,64,16,404
/jdk1.6.0_45/javax/swing/text/rtf/RTFEditorKit.java,Java,,43,13,82,138
/jdk1.6.0_45/javax/swing/text/rtf/RTFGenerator.java,Java,,764,130,97,991
/jdk1.6.0_45/javax/swing/text/rtf/RTFParser.java,Java,,228,35,53,316
/jdk1.6.0_45/javax/swing/text/rtf/RTFReader.java,Java,,1121,228,282,1631
/jdk1.6.0_45/javax/swing/text/Segment.java,Java,,122,31,148,301
/jdk1.6.0_45/javax/swing/text/SegmentCache.java,Java,,39,15,56,110
/jdk1.6.0_45/javax/swing/text/SimpleAttributeSet.java,Java,,200,35,153,388
/jdk1.6.0_45/javax/swing/text/StateInvariantError.java,Java,,7,2,19,28
/jdk1.6.0_45/javax/swing/text/StringContent.java,Java,,264,40,177,481
/jdk1.6.0_45/javax/swing/text/Style.java,Java,,11,10,37,58
/jdk1.6.0_45/javax/swing/text/StyleConstants.java,Java,,282,100,453,835
/jdk1.6.0_45/javax/swing/text/StyleContext.java,Java,,715,147,746,1608
/jdk1.6.0_45/javax/swing/text/StyledDocument.java,Java,,17,16,127,160
/jdk1.6.0_45/javax/swing/text/StyledEditorKit.java,Java,,397,76,405,878
/jdk1.6.0_45/javax/swing/text/TabableView.java,Java,,5,4,44,53
/jdk1.6.0_45/javax/swing/text/TabExpander.java,Java,,4,4,22,30
/jdk1.6.0_45/javax/swing/text/TableView.java,Java,,427,75,389,891
/jdk1.6.0_45/javax/swing/text/TabSet.java,Java,,103,17,75,195
/jdk1.6.0_45/javax/swing/text/TabStop.java,Java,,76,15,70,161
/jdk1.6.0_45/javax/swing/text/TextAction.java,Java,,45,6,69,120
/jdk1.6.0_45/javax/swing/text/TextLayoutStrategy.java,Java,,288,51,183,522
/jdk1.6.0_45/javax/swing/text/Utilities.java,Java,,682,52,317,1051
/jdk1.6.0_45/javax/swing/text/View.java,Java,,378,66,883,1327
/jdk1.6.0_45/javax/swing/text/ViewFactory.java,Java,,5,4,22,31
/jdk1.6.0_45/javax/swing/text/WrappedPlainView.java,Java,,454,65,321,840
/jdk1.6.0_45/javax/swing/text/ZoneView.java,Java,,247,49,338,634
/jdk1.6.0_45/javax/swing/Timer.java,Java,,170,70,356,596
/jdk1.6.0_45/javax/swing/TimerQueue.java,Java,,172,60,42,274
/jdk1.6.0_45/javax/swing/ToolTipManager.java,Java,,581,87,227,895
/jdk1.6.0_45/javax/swing/TransferHandler.java,Java,,800,205,724,1729
/jdk1.6.0_45/javax/swing/tree/AbstractLayoutCache.java,Java,,140,56,318,514
/jdk1.6.0_45/javax/swing/tree/DefaultMutableTreeNode.java,Java,,646,227,617,1490
/jdk1.6.0_45/javax/swing/tree/DefaultTreeCellEditor.java,Java,,361,88,288,737
/jdk1.6.0_45/javax/swing/tree/DefaultTreeCellRenderer.java,Java,,277,81,253,611
/jdk1.6.0_45/javax/swing/tree/DefaultTreeModel.java,Java,,263,57,343,663
/jdk1.6.0_45/javax/swing/tree/DefaultTreeSelectionModel.java,Java,,702,118,393,1213
/jdk1.6.0_45/javax/swing/tree/ExpandVetoException.java,Java,,12,6,28,46
/jdk1.6.0_45/javax/swing/tree/FixedHeightLayoutCache.java,Java,,964,185,435,1584
/jdk1.6.0_45/javax/swing/tree/MutableTreeNode.java,Java,,10,8,38,56
/jdk1.6.0_45/javax/swing/tree/RowMapper.java,Java,,6,3,20,29
/jdk1.6.0_45/javax/swing/tree/TreeCellEditor.java,Java,,10,4,34,48
/jdk1.6.0_45/javax/swing/tree/TreeCellRenderer.java,Java,,8,4,47,59
/jdk1.6.0_45/javax/swing/tree/TreeModel.java,Java,,13,15,115,143
/jdk1.6.0_45/javax/swing/tree/TreeNode.java,Java,,12,10,48,70
/jdk1.6.0_45/javax/swing/tree/TreePath.java,Java,,138,33,149,320
/jdk1.6.0_45/javax/swing/tree/TreeSelectionModel.java,Java,,36,33,225,294
/jdk1.6.0_45/javax/swing/tree/VariableHeightLayoutCache.java,Java,,1046,191,513,1750
/jdk1.6.0_45/javax/swing/UIDefaults.java,Java,,471,103,630,1204
/jdk1.6.0_45/javax/swing/UIManager.java,Java,,579,136,738,1453
/jdk1.6.0_45/javax/swing/undo/AbstractUndoableEdit.java,Java,,73,24,165,262
/jdk1.6.0_45/javax/swing/undo/CannotRedoException.java,Java,,3,2,21,26
/jdk1.6.0_45/javax/swing/undo/CannotUndoException.java,Java,,3,3,21,27
/jdk1.6.0_45/javax/swing/undo/CompoundEdit.java,Java,,110,21,114,245
/jdk1.6.0_45/javax/swing/undo/StateEdit.java,Java,,59,27,90,176
/jdk1.6.0_45/javax/swing/undo/StateEditable.java,Java,,7,8,21,36
/jdk1.6.0_45/javax/swing/undo/UndoableEdit.java,Java,,15,13,156,184
/jdk1.6.0_45/javax/swing/undo/UndoableEditSupport.java,Java,,70,17,75,162
/jdk1.6.0_45/javax/swing/undo/UndoManager.java,Java,,210,44,355,609
/jdk1.6.0_45/javax/swing/UnsupportedLookAndFeelException.java,Java,,7,1,26,34
/jdk1.6.0_45/javax/swing/ViewportLayout.java,Java,,82,20,84,186
/jdk1.6.0_45/javax/swing/WindowConstants.java,Java,,8,7,52,67
/jdk1.6.0_45/javax/tools/Diagnostic.java,Java,,21,14,117,152
/jdk1.6.0_45/javax/tools/DiagnosticCollector.java,Java,,14,5,20,39
/jdk1.6.0_45/javax/tools/DiagnosticListener.java,Java,,4,2,25,31
/jdk1.6.0_45/javax/tools/FileObject.java,Java,,20,13,110,143
/jdk1.6.0_45/javax/tools/ForwardingFileObject.java,Java,,41,14,47,102
/jdk1.6.0_45/javax/tools/ForwardingJavaFileManager.java,Java,,75,18,56,149
/jdk1.6.0_45/javax/tools/ForwardingJavaFileObject.java,Java,,25,9,19,53
/jdk1.6.0_45/javax/tools/JavaCompiler.java,Java,,26,9,276,311
/jdk1.6.0_45/javax/tools/JavaFileManager.java,Java,,43,17,324,384
/jdk1.6.0_45/javax/tools/JavaFileObject.java,Java,,26,12,80,118
/jdk1.6.0_45/javax/tools/OptionChecker.java,Java,,4,4,20,28
/jdk1.6.0_45/javax/tools/package-info.java,Java,,1,1,58,60
/jdk1.6.0_45/javax/tools/SimpleJavaFileObject.java,Java,,70,19,110,199
/jdk1.6.0_45/javax/tools/StandardJavaFileManager.java,Java,,17,11,194,222
/jdk1.6.0_45/javax/tools/StandardLocation.java,Java,,30,13,43,86
/jdk1.6.0_45/javax/tools/Tool.java,Java,,9,6,39,54
/jdk1.6.0_45/javax/tools/ToolProvider.java,Java,,63,9,36,108
/jdk1.6.0_45/javax/xml/bind/annotation/adapters/CollapsedStringAdapter.java,Java,,44,17,38,99
/jdk1.6.0_45/javax/xml/bind/annotation/adapters/HexBinaryAdapter.java,Java,,12,4,13,29
/jdk1.6.0_45/javax/xml/bind/annotation/adapters/NormalizedStringAdapter.java,Java,,24,14,34,72
/jdk1.6.0_45/javax/xml/bind/annotation/adapters/XmlAdapter.java,Java,,6,5,162,173
/jdk1.6.0_45/javax/xml/bind/annotation/adapters/XmlJavaTypeAdapter.java,Java,,24,11,62,97
/jdk1.6.0_45/javax/xml/bind/annotation/adapters/XmlJavaTypeAdapters.java,Java,,9,3,30,42
/jdk1.6.0_45/javax/xml/bind/annotation/DomHandler.java,Java,,9,5,85,99
/jdk1.6.0_45/javax/xml/bind/annotation/W3CDomHandler.java,Java,,47,13,29,89
/jdk1.6.0_45/javax/xml/bind/annotation/XmlAccessOrder.java,Java,,5,4,21,30
/jdk1.6.0_45/javax/xml/bind/annotation/XmlAccessorOrder.java,Java,,11,5,45,61
/jdk1.6.0_45/javax/xml/bind/annotation/XmlAccessorType.java,Java,,11,6,64,81
/jdk1.6.0_45/javax/xml/bind/annotation/XmlAccessType.java,Java,,7,6,39,52
/jdk1.6.0_45/javax/xml/bind/annotation/XmlAnyAttribute.java,Java,,12,4,38,54
/jdk1.6.0_45/javax/xml/bind/annotation/XmlAnyElement.java,Java,,18,7,245,270
/jdk1.6.0_45/javax/xml/bind/annotation/XmlAttachmentRef.java,Java,,10,4,41,55
/jdk1.6.0_45/javax/xml/bind/annotation/XmlAttribute.java,Java,,11,7,115,133
/jdk1.6.0_45/javax/xml/bind/annotation/XmlElement.java,Java,,16,14,162,192
/jdk1.6.0_45/javax/xml/bind/annotation/XmlElementDecl.java,Java,,16,10,170,196
/jdk1.6.0_45/javax/xml/bind/annotation/XmlElementRef.java,Java,,15,6,227,248
/jdk1.6.0_45/javax/xml/bind/annotation/XmlElementRefs.java,Java,,12,3,24,39
/jdk1.6.0_45/javax/xml/bind/annotation/XmlElements.java,Java,,11,3,143,157
/jdk1.6.0_45/javax/xml/bind/annotation/XmlElementWrapper.java,Java,,14,6,100,120
/jdk1.6.0_45/javax/xml/bind/annotation/XmlEnum.java,Java,,9,4,42,55
/jdk1.6.0_45/javax/xml/bind/annotation/XmlEnumValue.java,Java,,10,3,90,103
/jdk1.6.0_45/javax/xml/bind/annotation/XmlID.java,Java,,7,7,64,78
/jdk1.6.0_45/javax/xml/bind/annotation/XmlIDREF.java,Java,,7,4,220,231
/jdk1.6.0_45/javax/xml/bind/annotation/XmlInlineBinaryData.java,Java,,15,4,21,40
/jdk1.6.0_45/javax/xml/bind/annotation/XmlList.java,Java,,10,2,74,86
/jdk1.6.0_45/javax/xml/bind/annotation/XmlMimeType.java,Java,,14,4,23,41
/jdk1.6.0_45/javax/xml/bind/annotation/XmlMixed.java,Java,,12,5,95,112
/jdk1.6.0_45/javax/xml/bind/annotation/XmlNs.java,Java,,9,7,26,42
/jdk1.6.0_45/javax/xml/bind/annotation/XmlNsForm.java,Java,,2,5,43,50
/jdk1.6.0_45/javax/xml/bind/annotation/XmlRegistry.java,Java,,9,3,11,23
/jdk1.6.0_45/javax/xml/bind/annotation/XmlRootElement.java,Java,,11,6,145,162
/jdk1.6.0_45/javax/xml/bind/annotation/XmlSchema.java,Java,,14,11,162,187
/jdk1.6.0_45/javax/xml/bind/annotation/XmlSchemaType.java,Java,,14,11,65,90
/jdk1.6.0_45/javax/xml/bind/annotation/XmlSchemaTypes.java,Java,,9,3,29,41
/jdk1.6.0_45/javax/xml/bind/annotation/XmlSeeAlso.java,Java,,11,2,42,55
/jdk1.6.0_45/javax/xml/bind/annotation/XmlTransient.java,Java,,7,5,65,77
/jdk1.6.0_45/javax/xml/bind/annotation/XmlType.java,Java,,14,11,410,435
/jdk1.6.0_45/javax/xml/bind/annotation/XmlValue.java,Java,,7,4,101,112
/jdk1.6.0_45/javax/xml/bind/attachment/AttachmentMarshaller.java,Java,,9,7,160,176
/jdk1.6.0_45/javax/xml/bind/attachment/AttachmentUnmarshaller.java,Java,,7,6,104,117
/jdk1.6.0_45/javax/xml/bind/Binder.java,Java,,21,20,360,401
/jdk1.6.0_45/javax/xml/bind/ContextFinder.java,Java,,293,65,134,492
/jdk1.6.0_45/javax/xml/bind/DataBindingException.java,Java,,9,2,11,22
/jdk1.6.0_45/javax/xml/bind/DatatypeConverter.java,Java,,131,44,449,624
/jdk1.6.0_45/javax/xml/bind/DatatypeConverterImpl.java,Java,,582,169,140,891
/jdk1.6.0_45/javax/xml/bind/DatatypeConverterInterface.java,Java,,43,41,420,504
/jdk1.6.0_45/javax/xml/bind/Element.java,Java,,3,3,17,23
/jdk1.6.0_45/javax/xml/bind/GetPropertyAction.java,Java,,11,4,4,19
/jdk1.6.0_45/javax/xml/bind/helpers/AbstractMarshallerImpl.java,Java,,259,72,144,475
/jdk1.6.0_45/javax/xml/bind/helpers/AbstractUnmarshallerImpl.java,Java,,219,63,133,415
/jdk1.6.0_45/javax/xml/bind/helpers/DefaultValidationEventHandler.java,Java,,62,16,34,112
/jdk1.6.0_45/javax/xml/bind/helpers/Messages.java,Java,,44,19,14,77
/jdk1.6.0_45/javax/xml/bind/helpers/NotIdentifiableEventImpl.java,Java,,15,8,43,66
/jdk1.6.0_45/javax/xml/bind/helpers/ParseConversionEventImpl.java,Java,,16,8,43,67
/jdk1.6.0_45/javax/xml/bind/helpers/PrintConversionEventImpl.java,Java,,16,8,43,67
/jdk1.6.0_45/javax/xml/bind/helpers/ValidationEventImpl.java,Java,,68,17,70,155
/jdk1.6.0_45/javax/xml/bind/helpers/ValidationEventLocatorImpl.java,Java,,103,27,123,253
/jdk1.6.0_45/javax/xml/bind/JAXB.java,Java,,231,33,340,604
/jdk1.6.0_45/javax/xml/bind/JAXBContext.java,Java,,52,32,603,687
/jdk1.6.0_45/javax/xml/bind/JAXBElement.java,Java,,55,23,120,198
/jdk1.6.0_45/javax/xml/bind/JAXBException.java,Java,,52,19,94,165
/jdk1.6.0_45/javax/xml/bind/JAXBIntrospector.java,Java,,13,5,54,72
/jdk1.6.0_45/javax/xml/bind/MarshalException.java,Java,,18,10,54,82
/jdk1.6.0_45/javax/xml/bind/Marshaller.java,Java,,58,39,711,808
/jdk1.6.0_45/javax/xml/bind/Messages.java,Java,,40,17,14,71
/jdk1.6.0_45/javax/xml/bind/NotIdentifiableEvent.java,Java,,3,3,14,20
/jdk1.6.0_45/javax/xml/bind/ParseConversionEvent.java,Java,,3,3,15,21
/jdk1.6.0_45/javax/xml/bind/PrintConversionEvent.java,Java,,3,3,15,21
/jdk1.6.0_45/javax/xml/bind/PropertyException.java,Java,,26,12,56,94
/jdk1.6.0_45/javax/xml/bind/SchemaOutputResolver.java,Java,,6,2,49,57
/jdk1.6.0_45/javax/xml/bind/TypeConstraintException.java,Java,,47,19,98,164
/jdk1.6.0_45/javax/xml/bind/UnmarshalException.java,Java,,18,10,56,84
/jdk1.6.0_45/javax/xml/bind/Unmarshaller.java,Java,,51,35,1038,1124
/jdk1.6.0_45/javax/xml/bind/UnmarshallerHandler.java,Java,,6,2,55,63
/jdk1.6.0_45/javax/xml/bind/util/JAXBResult.java,Java,,25,9,95,129
/jdk1.6.0_45/javax/xml/bind/util/JAXBSource.java,Java,,123,29,98,250
/jdk1.6.0_45/javax/xml/bind/util/Messages.java,Java,,34,15,14,63
/jdk1.6.0_45/javax/xml/bind/util/ValidationEventCollector.java,Java,,44,9,40,93
/jdk1.6.0_45/javax/xml/bind/ValidationEvent.java,Java,,10,10,53,73
/jdk1.6.0_45/javax/xml/bind/ValidationEventHandler.java,Java,,4,4,68,76
/jdk1.6.0_45/javax/xml/bind/ValidationEventLocator.java,Java,,9,9,53,71
/jdk1.6.0_45/javax/xml/bind/ValidationException.java,Java,,18,8,54,80
/jdk1.6.0_45/javax/xml/bind/Validator.java,Java,,12,9,245,266
/jdk1.6.0_45/javax/xml/bind/WhiteSpaceProcessor.java,Java,,82,29,62,173
/jdk1.6.0_45/javax/xml/crypto/AlgorithmMethod.java,Java,,6,4,27,37
/jdk1.6.0_45/javax/xml/crypto/Data.java,Java,,3,2,16,21
/jdk1.6.0_45/javax/xml/crypto/dom/DOMCryptoContext.java,Java,,102,21,99,222
/jdk1.6.0_45/javax/xml/crypto/dom/DOMStructure.java,Java,,23,6,38,67
/jdk1.6.0_45/javax/xml/crypto/dom/DOMURIReference.java,Java,,6,3,21,30
/jdk1.6.0_45/javax/xml/crypto/dsig/CanonicalizationMethod.java,Java,,14,7,62,83
/jdk1.6.0_45/javax/xml/crypto/dsig/DigestMethod.java,Java,,12,7,58,77
/jdk1.6.0_45/javax/xml/crypto/dsig/dom/DOMSignContext.java,Java,,74,11,103,188
/jdk1.6.0_45/javax/xml/crypto/dsig/dom/DOMValidateContext.java,Java,,41,7,61,109
/jdk1.6.0_45/javax/xml/crypto/dsig/keyinfo/KeyInfo.java,Java,,11,5,86,102
/jdk1.6.0_45/javax/xml/crypto/dsig/keyinfo/KeyInfoFactory.java,Java,,106,27,368,501
/jdk1.6.0_45/javax/xml/crypto/dsig/keyinfo/KeyName.java,Java,,5,3,38,46
/jdk1.6.0_45/javax/xml/crypto/dsig/keyinfo/KeyValue.java,Java,,14,5,94,113
/jdk1.6.0_45/javax/xml/crypto/dsig/keyinfo/PGPData.java,Java,,10,6,79,95
/jdk1.6.0_45/javax/xml/crypto/dsig/keyinfo/RetrievalMethod.java,Java,,13,5,73,91
/jdk1.6.0_45/javax/xml/crypto/dsig/keyinfo/X509Data.java,Java,,10,5,77,92
/jdk1.6.0_45/javax/xml/crypto/dsig/keyinfo/X509IssuerSerial.java,Java,,8,4,56,68
/jdk1.6.0_45/javax/xml/crypto/dsig/Manifest.java,Java,,8,5,56,69
/jdk1.6.0_45/javax/xml/crypto/dsig/Reference.java,Java,,17,10,120,147
/jdk1.6.0_45/javax/xml/crypto/dsig/SignatureMethod.java,Java,,14,6,56,76
/jdk1.6.0_45/javax/xml/crypto/dsig/SignatureProperties.java,Java,,9,5,56,70
/jdk1.6.0_45/javax/xml/crypto/dsig/SignatureProperty.java,Java,,8,5,61,74
/jdk1.6.0_45/javax/xml/crypto/dsig/SignedInfo.java,Java,,11,7,63,81
/jdk1.6.0_45/javax/xml/crypto/dsig/spec/C14NMethodParameterSpec.java,Java,,3,2,17,22
/jdk1.6.0_45/javax/xml/crypto/dsig/spec/DigestMethodParameterSpec.java,Java,,4,2,17,23
/jdk1.6.0_45/javax/xml/crypto/dsig/spec/ExcC14NParameterSpec.java,Java,,27,7,60,94
/jdk1.6.0_45/javax/xml/crypto/dsig/spec/HMACParameterSpec.java,Java,,11,5,38,54
/jdk1.6.0_45/javax/xml/crypto/dsig/spec/SignatureMethodParameterSpec.java,Java,,4,2,17,23
/jdk1.6.0_45/javax/xml/crypto/dsig/spec/TransformParameterSpec.java,Java,,4,2,17,23
/jdk1.6.0_45/javax/xml/crypto/dsig/spec/XPathFilter2ParameterSpec.java,Java,,28,5,38,71
/jdk1.6.0_45/javax/xml/crypto/dsig/spec/XPathFilterParameterSpec.java,Java,,40,7,58,105
/jdk1.6.0_45/javax/xml/crypto/dsig/spec/XPathType.java,Java,,58,14,106,178
/jdk1.6.0_45/javax/xml/crypto/dsig/spec/XSLTTransformParameterSpec.java,Java,,15,4,38,57
/jdk1.6.0_45/javax/xml/crypto/dsig/Transform.java,Java,,23,10,94,127
/jdk1.6.0_45/javax/xml/crypto/dsig/TransformException.java,Java,,42,12,81,135
/jdk1.6.0_45/javax/xml/crypto/dsig/TransformService.java,Java,,151,16,205,372
/jdk1.6.0_45/javax/xml/crypto/dsig/XMLObject.java,Java,,10,7,89,106
/jdk1.6.0_45/javax/xml/crypto/dsig/XMLSignature.java,Java,,27,14,182,223
/jdk1.6.0_45/javax/xml/crypto/dsig/XMLSignatureException.java,Java,,42,12,78,132
/jdk1.6.0_45/javax/xml/crypto/dsig/XMLSignatureFactory.java,Java,,140,38,594,772
/jdk1.6.0_45/javax/xml/crypto/dsig/XMLSignContext.java,Java,,4,2,36,42
/jdk1.6.0_45/javax/xml/crypto/dsig/XMLValidateContext.java,Java,,3,2,37,42
/jdk1.6.0_45/javax/xml/crypto/KeySelector.java,Java,,40,14,77,131
/jdk1.6.0_45/javax/xml/crypto/KeySelectorException.java,Java,,33,12,82,127
/jdk1.6.0_45/javax/xml/crypto/KeySelectorResult.java,Java,,5,3,25,33
/jdk1.6.0_45/javax/xml/crypto/MarshalException.java,Java,,38,12,84,134
/jdk1.6.0_45/javax/xml/crypto/NodeSetData.java,Java,,5,3,27,35
/jdk1.6.0_45/javax/xml/crypto/NoSuchMechanismException.java,Java,,38,12,85,135
/jdk1.6.0_45/javax/xml/crypto/OctetStreamData.java,Java,,31,8,49,88
/jdk1.6.0_45/javax/xml/crypto/URIDereferencer.java,Java,,5,2,46,53
/jdk1.6.0_45/javax/xml/crypto/URIReference.java,Java,,5,3,31,39
/jdk1.6.0_45/javax/xml/crypto/URIReferenceException.java,Java,,46,15,106,167
/jdk1.6.0_45/javax/xml/crypto/XMLCryptoContext.java,Java,,17,15,173,205
/jdk1.6.0_45/javax/xml/crypto/XMLStructure.java,Java,,4,2,23,29
/jdk1.6.0_45/javax/xml/datatype/DatatypeConfigurationException.java,Java,,15,12,55,82
/jdk1.6.0_45/javax/xml/datatype/DatatypeConstants.java,Java,,55,47,175,277
/jdk1.6.0_45/javax/xml/datatype/DatatypeFactory.java,Java,,282,62,722,1066
/jdk1.6.0_45/javax/xml/datatype/Duration.java,Java,,186,55,751,992
/jdk1.6.0_45/javax/xml/datatype/FactoryFinder.java,Java,,185,33,111,329
/jdk1.6.0_45/javax/xml/datatype/SecuritySupport.java,Java,,65,11,32,108
/jdk1.6.0_45/javax/xml/datatype/XMLGregorianCalendar.java,Java,,102,58,902,1062
/jdk1.6.0_45/javax/xml/namespace/NamespaceContext.java,Java,,7,8,276,291
/jdk1.6.0_45/javax/xml/namespace/QName.java,Java,,125,31,358,514
/jdk1.6.0_45/javax/xml/parsers/DocumentBuilder.java,Java,,80,43,228,351
/jdk1.6.0_45/javax/xml/parsers/DocumentBuilderFactory.java,Java,,114,54,450,618
/jdk1.6.0_45/javax/xml/parsers/FactoryConfigurationError.java,Java,,30,21,77,128
/jdk1.6.0_45/javax/xml/parsers/FactoryFinder.java,Java,,185,34,111,330
/jdk1.6.0_45/javax/xml/parsers/ParserConfigurationException.java,Java,,9,10,41,60
/jdk1.6.0_45/javax/xml/parsers/SAXParser.java,Java,,150,43,342,535
/jdk1.6.0_45/javax/xml/parsers/SAXParserFactory.java,Java,,86,34,357,477
/jdk1.6.0_45/javax/xml/parsers/SecuritySupport.java,Java,,65,13,34,112
/jdk1.6.0_45/javax/xml/soap/AttachmentPart.java,Java,,61,38,433,532
/jdk1.6.0_45/javax/xml/soap/Detail.java,Java,,8,8,89,105
/jdk1.6.0_45/javax/xml/soap/DetailEntry.java,Java,,3,4,35,42
/jdk1.6.0_45/javax/xml/soap/FactoryFinder.java,Java,,112,21,103,236
/jdk1.6.0_45/javax/xml/soap/MessageFactory.java,Java,,33,17,136,186
/jdk1.6.0_45/javax/xml/soap/MimeHeader.java,Java,,15,8,53,76
/jdk1.6.0_45/javax/xml/soap/MimeHeaders.java,Java,,123,32,120,275
/jdk1.6.0_45/javax/xml/soap/Name.java,Java,,7,6,103,116
/jdk1.6.0_45/javax/xml/soap/Node.java,Java,,9,9,100,118
/jdk1.6.0_45/javax/xml/soap/SAAJMetaFactory.java,Java,,24,8,67,99
/jdk1.6.0_45/javax/xml/soap/SAAJResult.java,Java,,19,11,108,138
/jdk1.6.0_45/javax/xml/soap/SOAPBody.java,Java,,22,19,262,303
/jdk1.6.0_45/javax/xml/soap/SOAPBodyElement.java,Java,,3,3,43,49
/jdk1.6.0_45/javax/xml/soap/SOAPConnection.java,Java,,11,7,83,101
/jdk1.6.0_45/javax/xml/soap/SOAPConnectionFactory.java,Java,,21,7,45,73
/jdk1.6.0_45/javax/xml/soap/SOAPConstants.java,Java,,42,24,141,207
/jdk1.6.0_45/javax/xml/soap/SOAPElement.java,Java,,44,34,452,530
/jdk1.6.0_45/javax/xml/soap/SOAPElementFactory.java,Java,,25,10,109,144
/jdk1.6.0_45/javax/xml/soap/SOAPEnvelope.java,Java,,12,8,186,206
/jdk1.6.0_45/javax/xml/soap/SOAPException.java,Java,,41,12,116,169
/jdk1.6.0_45/javax/xml/soap/SOAPFactory.java,Java,,49,22,214,285
/jdk1.6.0_45/javax/xml/soap/SOAPFault.java,Java,,34,33,450,517
/jdk1.6.0_45/javax/xml/soap/SOAPFaultElement.java,Java,,3,3,37,43
/jdk1.6.0_45/javax/xml/soap/SOAPHeader.java,Java,,22,18,230,270
/jdk1.6.0_45/javax/xml/soap/SOAPHeaderElement.java,Java,,11,11,150,172
/jdk1.6.0_45/javax/xml/soap/SOAPMessage.java,Java,,52,29,381,462
/jdk1.6.0_45/javax/xml/soap/SOAPPart.java,Java,,36,18,217,271
/jdk1.6.0_45/javax/xml/soap/Text.java,Java,,4,4,40,48
/jdk1.6.0_45/javax/xml/stream/EventFilter.java,Java,,5,0,15,20
/jdk1.6.0_45/javax/xml/stream/events/Attribute.java,Java,,8,7,26,41
/jdk1.6.0_45/javax/xml/stream/events/Characters.java,Java,,7,5,36,48
/jdk1.6.0_45/javax/xml/stream/events/Comment.java,Java,,4,2,11,17
/jdk1.6.0_45/javax/xml/stream/events/DTD.java,Java,,8,6,32,46
/jdk1.6.0_45/javax/xml/stream/events/EndDocument.java,Java,,3,1,10,14
/jdk1.6.0_45/javax/xml/stream/events/EndElement.java,Java,,7,4,20,31
/jdk1.6.0_45/javax/xml/stream/events/EntityDeclaration.java,Java,,9,7,36,52
/jdk1.6.0_45/javax/xml/stream/events/EntityReference.java,Java,,5,2,27,34
/jdk1.6.0_45/javax/xml/stream/events/Namespace.java,Java,,7,5,19,31
/jdk1.6.0_45/javax/xml/stream/events/NotationDeclaration.java,Java,,6,2,22,30
/jdk1.6.0_45/javax/xml/stream/events/ProcessingInstruction.java,Java,,5,2,17,24
/jdk1.6.0_45/javax/xml/stream/events/StartDocument.java,Java,,9,7,31,47
/jdk1.6.0_45/javax/xml/stream/events/StartElement.java,Java,,13,9,67,89
/jdk1.6.0_45/javax/xml/stream/events/XMLEvent.java,Java,,22,20,109,151
/jdk1.6.0_45/javax/xml/stream/FactoryConfigurationError.java,Java,,33,10,44,87
/jdk1.6.0_45/javax/xml/stream/FactoryFinder.java,Java,,194,34,112,340
/jdk1.6.0_45/javax/xml/stream/Location.java,Java,,8,5,36,49
/jdk1.6.0_45/javax/xml/stream/SecuritySupport.java,Java,,65,13,34,112
/jdk1.6.0_45/javax/xml/stream/StreamFilter.java,Java,,4,1,17,22
/jdk1.6.0_45/javax/xml/stream/util/EventReaderDelegate.java,Java,,60,16,30,106
/jdk1.6.0_45/javax/xml/stream/util/StreamReaderDelegate.java,Java,,177,53,29,259
/jdk1.6.0_45/javax/xml/stream/util/XMLEventAllocator.java,Java,,11,6,37,54
/jdk1.6.0_45/javax/xml/stream/util/XMLEventConsumer.java,Java,,7,3,20,30
/jdk1.6.0_45/javax/xml/stream/XMLEventFactory.java,Java,,94,25,265,384
/jdk1.6.0_45/javax/xml/stream/XMLEventReader.java,Java,,12,6,57,75
/jdk1.6.0_45/javax/xml/stream/XMLEventWriter.java,Java,,16,14,198,228
/jdk1.6.0_45/javax/xml/stream/XMLInputFactory.java,Java,,99,42,273,414
/jdk1.6.0_45/javax/xml/stream/XMLOutputFactory.java,Java,,55,21,207,283
/jdk1.6.0_45/javax/xml/stream/XMLReporter.java,Java,,5,2,19,26
/jdk1.6.0_45/javax/xml/stream/XMLResolver.java,Java,,8,2,22,32
/jdk1.6.0_45/javax/xml/stream/XMLStreamConstants.java,Java,,18,18,71,107
/jdk1.6.0_45/javax/xml/stream/XMLStreamException.java,Java,,39,12,50,101
/jdk1.6.0_45/javax/xml/stream/XMLStreamReader.java,Java,,53,50,573,676
/jdk1.6.0_45/javax/xml/stream/XMLStreamWriter.java,Java,,75,41,387,503
/jdk1.6.0_45/javax/xml/transform/dom/DOMLocator.java,Java,,6,8,38,52
/jdk1.6.0_45/javax/xml/transform/dom/DOMResult.java,Java,,84,31,250,365
/jdk1.6.0_45/javax/xml/transform/dom/DOMSource.java,Java,,29,15,96,140
/jdk1.6.0_45/javax/xml/transform/ErrorListener.java,Java,,9,6,104,119
/jdk1.6.0_45/javax/xml/transform/FactoryFinder.java,Java,,215,33,116,364
/jdk1.6.0_45/javax/xml/transform/OutputKeys.java,Java,,15,14,173,202
/jdk1.6.0_45/javax/xml/transform/Result.java,Java,,9,7,72,88
/jdk1.6.0_45/javax/xml/transform/sax/SAXResult.java,Java,,34,18,94,146
/jdk1.6.0_45/javax/xml/transform/sax/SAXSource.java,Java,,59,24,130,213
/jdk1.6.0_45/javax/xml/transform/sax/SAXTransformerFactory.java,Java,,22,14,116,152
/jdk1.6.0_45/javax/xml/transform/sax/TemplatesHandler.java,Java,,8,8,54,70
/jdk1.6.0_45/javax/xml/transform/sax/TransformerHandler.java,Java,,13,9,56,78
/jdk1.6.0_45/javax/xml/transform/SecuritySupport.java,Java,,65,11,34,110
/jdk1.6.0_45/javax/xml/transform/Source.java,Java,,5,5,45,55
/jdk1.6.0_45/javax/xml/transform/SourceLocator.java,Java,,7,7,84,98
/jdk1.6.0_45/javax/xml/transform/stax/StAXResult.java,Java,,39,21,126,186
/jdk1.6.0_45/javax/xml/transform/stax/StAXSource.java,Java,,62,24,153,239
/jdk1.6.0_45/javax/xml/transform/stream/StreamResult.java,Java,,48,22,135,205
/jdk1.6.0_45/javax/xml/transform/stream/StreamSource.java,Java,,61,27,199,287
/jdk1.6.0_45/javax/xml/transform/Templates.java,Java,,6,9,69,84
/jdk1.6.0_45/javax/xml/transform/Transformer.java,Java,,28,20,294,342
/jdk1.6.0_45/javax/xml/transform/TransformerConfigurationException.java,Java,,24,9,71,104
/jdk1.6.0_45/javax/xml/transform/TransformerException.java,Java,,164,61,147,372
/jdk1.6.0_45/javax/xml/transform/TransformerFactory.java,Java,,47,22,316,385
/jdk1.6.0_45/javax/xml/transform/TransformerFactoryConfigurationError.java,Java,,30,21,73,124
/jdk1.6.0_45/javax/xml/transform/URIResolver.java,Java,,5,4,43,52
/jdk1.6.0_45/javax/xml/validation/Schema.java,Java,,7,6,94,107
/jdk1.6.0_45/javax/xml/validation/SchemaFactory.java,Java,,93,33,630,756
/jdk1.6.0_45/javax/xml/validation/SchemaFactoryFinder.java,Java,,347,65,176,588
/jdk1.6.0_45/javax/xml/validation/SchemaFactoryLoader.java,Java,,6,5,60,71
/jdk1.6.0_45/javax/xml/validation/SecuritySupport.java,Java,,117,14,34,165
/jdk1.6.0_45/javax/xml/validation/TypeInfoProvider.java,Java,,10,9,181,200
/jdk1.6.0_45/javax/xml/validation/Validator.java,Java,,52,29,427,508
/jdk1.6.0_45/javax/xml/validation/ValidatorHandler.java,Java,,45,25,418,488
/jdk1.6.0_45/javax/xml/ws/Action.java,Java,,15,7,35,57
/jdk1.6.0_45/javax/xml/ws/AsyncHandler.java,Java,,4,3,15,22
/jdk1.6.0_45/javax/xml/ws/Binding.java,Java,,6,6,35,47
/jdk1.6.0_45/javax/xml/ws/BindingProvider.java,Java,,23,16,124,163
/jdk1.6.0_45/javax/xml/ws/BindingType.java,Java,,12,3,27,42
/jdk1.6.0_45/javax/xml/ws/Dispatch.java,Java,,8,7,81,96
/jdk1.6.0_45/javax/xml/ws/Endpoint.java,Java,,34,27,279,340
/jdk1.6.0_45/javax/xml/ws/EndpointReference.java,Java,,26,8,136,170
/jdk1.6.0_45/javax/xml/ws/FaultAction.java,Java,,13,5,25,43
/jdk1.6.0_45/javax/xml/ws/handler/Handler.java,Java,,8,6,53,67
/jdk1.6.0_45/javax/xml/ws/handler/HandlerResolver.java,Java,,4,3,26,33
/jdk1.6.0_45/javax/xml/ws/handler/LogicalHandler.java,Java,,3,2,9,14
/jdk1.6.0_45/javax/xml/ws/handler/LogicalMessageContext.java,Java,,6,4,16,26
/jdk1.6.0_45/javax/xml/ws/handler/MessageContext.java,Java,,43,23,119,185
/jdk1.6.0_45/javax/xml/ws/handler/PortInfo.java,Java,,7,7,32,46
/jdk1.6.0_45/javax/xml/ws/handler/soap/SOAPHandler.java,Java,,8,4,17,29
/jdk1.6.0_45/javax/xml/ws/handler/soap/SOAPMessageContext.java,Java,,13,7,59,79
/jdk1.6.0_45/javax/xml/ws/Holder.java,Java,,9,5,20,34
/jdk1.6.0_45/javax/xml/ws/http/HTTPBinding.java,Java,,5,5,12,22
/jdk1.6.0_45/javax/xml/ws/http/HTTPException.java,Java,,11,6,19,36
/jdk1.6.0_45/javax/xml/ws/LogicalMessage.java,Java,,9,7,56,72
/jdk1.6.0_45/javax/xml/ws/ProtocolException.java,Java,,15,5,48,68
/jdk1.6.0_45/javax/xml/ws/Provider.java,Java,,4,3,36,43
/jdk1.6.0_45/javax/xml/ws/RequestWrapper.java,Java,,14,8,25,47
/jdk1.6.0_45/javax/xml/ws/RespectBinding.java,Java,,16,4,67,87
/jdk1.6.0_45/javax/xml/ws/RespectBindingFeature.java,Java,,18,7,81,106
/jdk1.6.0_45/javax/xml/ws/Response.java,Java,,6,3,23,32
/jdk1.6.0_45/javax/xml/ws/ResponseWrapper.java,Java,,14,14,30,58
/jdk1.6.0_45/javax/xml/ws/Service.java,Java,,92,38,566,696
/jdk1.6.0_45/javax/xml/ws/ServiceMode.java,Java,,14,3,16,33
/jdk1.6.0_45/javax/xml/ws/soap/Addressing.java,Java,,18,7,63,88
/jdk1.6.0_45/javax/xml/ws/soap/AddressingFeature.java,Java,,27,9,106,142
/jdk1.6.0_45/javax/xml/ws/soap/MTOM.java,Java,,15,5,29,49
/jdk1.6.0_45/javax/xml/ws/soap/MTOMFeature.java,Java,,34,14,66,114
/jdk1.6.0_45/javax/xml/ws/soap/SOAPBinding.java,Java,,17,16,57,90
/jdk1.6.0_45/javax/xml/ws/soap/SOAPFaultException.java,Java,,12,6,37,55
/jdk1.6.0_45/javax/xml/ws/spi/FactoryFinder.java,Java,,100,20,39,159
/jdk1.6.0_45/javax/xml/ws/spi/Provider.java,Java,,55,17,213,285
/jdk1.6.0_45/javax/xml/ws/spi/ServiceDelegate.java,Java,,46,34,522,602
/jdk1.6.0_45/javax/xml/ws/spi/WebServiceFeatureAnnotation.java,Java,,14,4,35,53
/jdk1.6.0_45/javax/xml/ws/WebEndpoint.java,Java,,12,3,21,36
/jdk1.6.0_45/javax/xml/ws/WebFault.java,Java,,14,5,20,39
/jdk1.6.0_45/javax/xml/ws/WebServiceClient.java,Java,,14,5,24,43
/jdk1.6.0_45/javax/xml/ws/WebServiceContext.java,Java,,13,9,109,131
/jdk1.6.0_45/javax/xml/ws/WebServiceException.java,Java,,15,8,36,59
/jdk1.6.0_45/javax/xml/ws/WebServiceFeature.java,Java,,9,9,43,61
/jdk1.6.0_45/javax/xml/ws/WebServicePermission.java,Java,,11,7,41,59
/jdk1.6.0_45/javax/xml/ws/WebServiceProvider.java,Java,,15,6,22,43
/jdk1.6.0_45/javax/xml/ws/WebServiceRef.java,Java,,16,8,55,79
/jdk1.6.0_45/javax/xml/ws/WebServiceRefs.java,Java,,12,4,15,31
/jdk1.6.0_45/javax/xml/ws/wsaddressing/package-info.java,Java,,3,2,4,9
/jdk1.6.0_45/javax/xml/ws/wsaddressing/W3CEndpointReference.java,Java,,79,18,39,136
/jdk1.6.0_45/javax/xml/ws/wsaddressing/W3CEndpointReferenceBuilder.java,Java,,55,15,169,239
/jdk1.6.0_45/javax/xml/XMLConstants.java,Java,,21,17,158,196
/jdk1.6.0_45/javax/xml/xpath/SecuritySupport.java,Java,,116,14,32,162
/jdk1.6.0_45/javax/xml/xpath/XPath.java,Java,,26,16,280,322
/jdk1.6.0_45/javax/xml/xpath/XPathConstants.java,Java,,11,11,65,87
/jdk1.6.0_45/javax/xml/xpath/XPathException.java,Java,,40,15,79,134
/jdk1.6.0_45/javax/xml/xpath/XPathExpression.java,Java,,13,8,182,203
/jdk1.6.0_45/javax/xml/xpath/XPathExpressionException.java,Java,,10,6,61,77
/jdk1.6.0_45/javax/xml/xpath/XPathFactory.java,Java,,82,31,274,387
/jdk1.6.0_45/javax/xml/xpath/XPathFactoryConfigurationException.java,Java,,10,6,60,76
/jdk1.6.0_45/javax/xml/xpath/XPathFactoryFinder.java,Java,,350,64,151,565
/jdk1.6.0_45/javax/xml/xpath/XPathFunction.java,Java,,6,5,49,60
/jdk1.6.0_45/javax/xml/xpath/XPathFunctionException.java,Java,,10,6,59,75
/jdk1.6.0_45/javax/xml/xpath/XPathFunctionResolver.java,Java,,5,4,60,69
/jdk1.6.0_45/javax/xml/xpath/XPathVariableResolver.java,Java,,5,4,52,61
/jdk1.6.0_45/launcher/java.c,C/C++/ObjC,,1386,178,449,2013
/jdk1.6.0_45/launcher/java.h,h,,40,18,35,93
/jdk1.6.0_45/launcher/java_md.c,C/C++/ObjC,,844,136,380,1360
/jdk1.6.0_45/launcher/java_md.h,h,,28,8,17,53
/jdk1.6.0_45/launcher/jli_util.c,C/C++/ObjC,,38,5,22,65
/jdk1.6.0_45/launcher/jli_util.h,h,,8,4,6,18
/jdk1.6.0_45/launcher/manifest_info.h,h,,73,16,49,138
/jdk1.6.0_45/launcher/parse_manifest.c,C/C++/ObjC,,347,37,229,613
/jdk1.6.0_45/launcher/splashscreen.h,h,,5,4,6,15
/jdk1.6.0_45/launcher/splashscreen_stubs.c,C/C++/ObjC,,31,10,19,60
/jdk1.6.0_45/launcher/version_comp.c,C/C++/ObjC,,212,25,102,339
/jdk1.6.0_45/launcher/version_comp.h,h,,7,3,9,19
/jdk1.6.0_45/launcher/wildcard.c,C/C++/ObjC,,332,38,107,477
/jdk1.6.0_45/launcher/wildcard.h,h,,8,3,6,17
/jdk1.6.0_45/org/ietf/jgss/ChannelBinding.java,Java,,63,23,109,195
/jdk1.6.0_45/org/ietf/jgss/GSSContext.java,Java,,62,45,1223,1330
/jdk1.6.0_45/org/ietf/jgss/GSSCredential.java,Java,,21,24,309,354
/jdk1.6.0_45/org/ietf/jgss/GSSException.java,Java,,108,60,218,386
/jdk1.6.0_45/org/ietf/jgss/GSSManager.java,Java,,38,19,655,712
/jdk1.6.0_45/org/ietf/jgss/GSSName.java,Java,,27,19,231,277
/jdk1.6.0_45/org/ietf/jgss/MessageProp.java,Java,,67,21,130,218
/jdk1.6.0_45/org/ietf/jgss/Oid.java,Java,,83,23,93,199
/jdk1.6.0_45/org/omg/CORBA/ACTIVITY_COMPLETED.java,Java,,18,7,44,69
/jdk1.6.0_45/org/omg/CORBA/ACTIVITY_REQUIRED.java,Java,,18,7,42,67
/jdk1.6.0_45/org/omg/CORBA/Any.java,Java,,81,58,565,704
/jdk1.6.0_45/org/omg/CORBA/AnyHolder.java,Java,,21,9,60,90
/jdk1.6.0_45/org/omg/CORBA/AnySeqHelper.java,Java,,46,10,27,83
/jdk1.6.0_45/org/omg/CORBA/AnySeqHolder.java,Java,,24,9,15,48
/jdk1.6.0_45/org/omg/CORBA/ARG_IN.java,Java,,4,4,29,37
/jdk1.6.0_45/org/omg/CORBA/ARG_INOUT.java,Java,,4,7,30,41
/jdk1.6.0_45/org/omg/CORBA/ARG_OUT.java,Java,,4,6,29,39
/jdk1.6.0_45/org/omg/CORBA/BAD_CONTEXT.java,Java,,15,7,47,69
/jdk1.6.0_45/org/omg/CORBA/BAD_INV_ORDER.java,Java,,15,8,45,68
/jdk1.6.0_45/org/omg/CORBA/BAD_OPERATION.java,Java,,15,7,43,65
/jdk1.6.0_45/org/omg/CORBA/BAD_PARAM.java,Java,,15,7,52,74
/jdk1.6.0_45/org/omg/CORBA/BAD_POLICY.java,Java,,4,2,16,22
/jdk1.6.0_45/org/omg/CORBA/BAD_POLICY_TYPE.java,Java,,4,2,16,22
/jdk1.6.0_45/org/omg/CORBA/BAD_POLICY_VALUE.java,Java,,4,2,18,24
/jdk1.6.0_45/org/omg/CORBA/BAD_QOS.java,Java,,18,7,41,66
/jdk1.6.0_45/org/omg/CORBA/BAD_TYPECODE.java,Java,,15,7,44,66
/jdk1.6.0_45/org/omg/CORBA/BooleanHolder.java,Java,,21,9,62,92
/jdk1.6.0_45/org/omg/CORBA/BooleanSeqHelper.java,Java,,44,10,27,81
/jdk1.6.0_45/org/omg/CORBA/BooleanSeqHolder.java,Java,,24,9,15,48
/jdk1.6.0_45/org/omg/CORBA/Bounds.java,Java,,9,5,22,36
/jdk1.6.0_45/org/omg/CORBA/ByteHolder.java,Java,,21,10,62,93
/jdk1.6.0_45/org/omg/CORBA/CharHolder.java,Java,,21,10,63,94
/jdk1.6.0_45/org/omg/CORBA/CharSeqHelper.java,Java,,44,10,27,81
/jdk1.6.0_45/org/omg/CORBA/CharSeqHolder.java,Java,,24,9,15,48
/jdk1.6.0_45/org/omg/CORBA/CODESET_INCOMPATIBLE.java,Java,,18,7,40,65
/jdk1.6.0_45/org/omg/CORBA/COMM_FAILURE.java,Java,,15,7,51,73
/jdk1.6.0_45/org/omg/CORBA/CompletionStatus.java,Java,,27,13,85,125
/jdk1.6.0_45/org/omg/CORBA/CompletionStatusHelper.java,Java,,37,10,14,61
/jdk1.6.0_45/org/omg/CORBA/Context.java,Java,,11,19,198,228
/jdk1.6.0_45/org/omg/CORBA/ContextList.java,Java,,7,12,70,89
/jdk1.6.0_45/org/omg/CORBA/CTX_RESTRICT_SCOPE.java,Java,,4,4,28,36
/jdk1.6.0_45/org/omg/CORBA/Current.java,Java,,4,3,23,30
/jdk1.6.0_45/org/omg/CORBA/CurrentHelper.java,Java,,43,11,15,69
/jdk1.6.0_45/org/omg/CORBA/CurrentHolder.java,Java,,24,8,15,47
/jdk1.6.0_45/org/omg/CORBA/CurrentOperations.java,Java,,4,3,16,23
/jdk1.6.0_45/org/omg/CORBA/CustomMarshal.java,Java,,7,3,29,39
/jdk1.6.0_45/org/omg/CORBA/DataInputStream.java,Java,,36,34,258,328
/jdk1.6.0_45/org/omg/CORBA/DataOutputStream.java,Java,,36,34,196,266
/jdk1.6.0_45/org/omg/CORBA/DATA_CONVERSION.java,Java,,15,7,46,68
/jdk1.6.0_45/org/omg/CORBA/DefinitionKind.java,Java,,114,113,256,483
/jdk1.6.0_45/org/omg/CORBA/DefinitionKindHelper.java,Java,,37,10,15,62
/jdk1.6.0_45/org/omg/CORBA/DomainManager.java,Java,,5,4,17,26
/jdk1.6.0_45/org/omg/CORBA/DomainManagerOperations.java,Java,,5,4,23,32
/jdk1.6.0_45/org/omg/CORBA/DoubleHolder.java,Java,,21,12,59,92
/jdk1.6.0_45/org/omg/CORBA/DoubleSeqHelper.java,Java,,44,10,27,81
/jdk1.6.0_45/org/omg/CORBA/DoubleSeqHolder.java,Java,,24,9,15,48
/jdk1.6.0_45/org/omg/CORBA/DynamicImplementation.java,Java,,12,5,12,29
/jdk1.6.0_45/org/omg/CORBA/DynAny.java,Java,,90,66,557,713
/jdk1.6.0_45/org/omg/CORBA/DynAnyPackage/Invalid.java,Java,,10,5,18,33
/jdk1.6.0_45/org/omg/CORBA/DynAnyPackage/InvalidSeq.java,Java,,10,5,19,34
/jdk1.6.0_45/org/omg/CORBA/DynAnyPackage/InvalidValue.java,Java,,10,4,22,36
/jdk1.6.0_45/org/omg/CORBA/DynAnyPackage/TypeMismatch.java,Java,,10,5,19,34
/jdk1.6.0_45/org/omg/CORBA/DynArray.java,Java,,8,5,25,38
/jdk1.6.0_45/org/omg/CORBA/DynEnum.java,Java,,9,6,31,46
/jdk1.6.0_45/org/omg/CORBA/DynFixed.java,Java,,8,4,27,39
/jdk1.6.0_45/org/omg/CORBA/DynSequence.java,Java,,10,7,38,55
/jdk1.6.0_45/org/omg/CORBA/DynStruct.java,Java,,10,6,36,52
/jdk1.6.0_45/org/omg/CORBA/DynUnion.java,Java,,13,10,53,76
/jdk1.6.0_45/org/omg/CORBA/DynValue.java,Java,,9,6,40,55
/jdk1.6.0_45/org/omg/CORBA/Environment.java,Java,,6,10,28,44
/jdk1.6.0_45/org/omg/CORBA/ExceptionList.java,Java,,9,11,73,93
/jdk1.6.0_45/org/omg/CORBA/FieldNameHelper.java,Java,,40,10,14,64
/jdk1.6.0_45/org/omg/CORBA/FixedHolder.java,Java,,21,11,49,81
/jdk1.6.0_45/org/omg/CORBA/FloatHolder.java,Java,,21,9,58,88
/jdk1.6.0_45/org/omg/CORBA/FloatSeqHelper.java,Java,,44,10,27,81
/jdk1.6.0_45/org/omg/CORBA/FloatSeqHolder.java,Java,,24,9,15,48
/jdk1.6.0_45/org/omg/CORBA/FREE_MEM.java,Java,,15,6,43,64
/jdk1.6.0_45/org/omg/CORBA/IdentifierHelper.java,Java,,40,10,15,65
/jdk1.6.0_45/org/omg/CORBA/IDLType.java,Java,,4,6,24,34
/jdk1.6.0_45/org/omg/CORBA/IDLTypeHelper.java,Java,,51,11,15,77
/jdk1.6.0_45/org/omg/CORBA/IDLTypeOperations.java,Java,,5,4,31,40
/jdk1.6.0_45/org/omg/CORBA/IMP_LIMIT.java,Java,,15,7,46,68
/jdk1.6.0_45/org/omg/CORBA/INITIALIZE.java,Java,,15,6,49,70
/jdk1.6.0_45/org/omg/CORBA/INTERNAL.java,Java,,15,6,49,70
/jdk1.6.0_45/org/omg/CORBA/INTF_REPOS.java,Java,,15,6,42,63
/jdk1.6.0_45/org/omg/CORBA/IntHolder.java,Java,,21,9,65,95
/jdk1.6.0_45/org/omg/CORBA/INVALID_ACTIVITY.java,Java,,18,7,43,68
/jdk1.6.0_45/org/omg/CORBA/INVALID_TRANSACTION.java,Java,,15,6,44,65
/jdk1.6.0_45/org/omg/CORBA/INV_FLAG.java,Java,,15,6,44,65
/jdk1.6.0_45/org/omg/CORBA/INV_IDENT.java,Java,,15,6,45,66
/jdk1.6.0_45/org/omg/CORBA/INV_OBJREF.java,Java,,15,6,51,72
/jdk1.6.0_45/org/omg/CORBA/INV_POLICY.java,Java,,15,6,42,63
/jdk1.6.0_45/org/omg/CORBA/IRObject.java,Java,,5,2,17,24
/jdk1.6.0_45/org/omg/CORBA/IRObjectOperations.java,Java,,6,6,53,65
/jdk1.6.0_45/org/omg/CORBA/LocalObject.java,Java,,89,39,361,489
/jdk1.6.0_45/org/omg/CORBA/LongHolder.java,Java,,21,10,60,91
/jdk1.6.0_45/org/omg/CORBA/LongLongSeqHelper.java,Java,,44,10,27,81
/jdk1.6.0_45/org/omg/CORBA/LongLongSeqHolder.java,Java,,24,9,15,48
/jdk1.6.0_45/org/omg/CORBA/LongSeqHelper.java,Java,,44,10,27,81
/jdk1.6.0_45/org/omg/CORBA/LongSeqHolder.java,Java,,24,9,15,48
/jdk1.6.0_45/org/omg/CORBA/MARSHAL.java,Java,,15,6,49,70
/jdk1.6.0_45/org/omg/CORBA/NamedValue.java,Java,,6,10,92,108
/jdk1.6.0_45/org/omg/CORBA/NameValuePair.java,Java,,10,8,27,45
/jdk1.6.0_45/org/omg/CORBA/NameValuePairHelper.java,Java,,67,10,14,91
/jdk1.6.0_45/org/omg/CORBA/NO_IMPLEMENT.java,Java,,15,6,48,69
/jdk1.6.0_45/org/omg/CORBA/NO_MEMORY.java,Java,,15,7,41,63
/jdk1.6.0_45/org/omg/CORBA/NO_PERMISSION.java,Java,,15,6,41,62
/jdk1.6.0_45/org/omg/CORBA/NO_RESOURCES.java,Java,,15,6,42,63
/jdk1.6.0_45/org/omg/CORBA/NO_RESPONSE.java,Java,,15,6,42,63
/jdk1.6.0_45/org/omg/CORBA/NVList.java,Java,,9,16,136,161
/jdk1.6.0_45/org/omg/CORBA/Object.java,Java,,25,35,204,264
/jdk1.6.0_45/org/omg/CORBA/ObjectHelper.java,Java,,37,11,19,67
/jdk1.6.0_45/org/omg/CORBA/ObjectHolder.java,Java,,21,9,64,94
/jdk1.6.0_45/org/omg/CORBA/OBJECT_NOT_EXIST.java,Java,,15,6,51,72
/jdk1.6.0_45/org/omg/CORBA/OBJ_ADAPTER.java,Java,,15,6,46,67
/jdk1.6.0_45/org/omg/CORBA/OctetSeqHelper.java,Java,,44,10,27,81
/jdk1.6.0_45/org/omg/CORBA/OctetSeqHolder.java,Java,,24,9,15,48
/jdk1.6.0_45/org/omg/CORBA/OMGVMCID.java,Java,,4,5,16,25
/jdk1.6.0_45/org/omg/CORBA/ORB.java,Java,,302,103,902,1307
/jdk1.6.0_45/org/omg/CORBA/ORBPackage/InconsistentTypeCode.java,Java,,10,4,20,34
/jdk1.6.0_45/org/omg/CORBA/ORBPackage/InvalidName.java,Java,,9,4,23,36
/jdk1.6.0_45/org/omg/CORBA/ParameterMode.java,Java,,29,8,14,51
/jdk1.6.0_45/org/omg/CORBA/ParameterModeHelper.java,Java,,37,11,14,62
/jdk1.6.0_45/org/omg/CORBA/ParameterModeHolder.java,Java,,24,9,14,47
/jdk1.6.0_45/org/omg/CORBA/PERSIST_STORE.java,Java,,15,6,41,62
/jdk1.6.0_45/org/omg/CORBA/Policy.java,Java,,4,3,22,29
/jdk1.6.0_45/org/omg/CORBA/PolicyError.java,Java,,15,7,31,53
/jdk1.6.0_45/org/omg/CORBA/PolicyErrorCodeHelper.java,Java,,40,11,11,62
/jdk1.6.0_45/org/omg/CORBA/PolicyErrorHelper.java,Java,,62,11,12,85
/jdk1.6.0_45/org/omg/CORBA/PolicyErrorHolder.java,Java,,24,9,10,43
/jdk1.6.0_45/org/omg/CORBA/PolicyHelper.java,Java,,51,11,15,77
/jdk1.6.0_45/org/omg/CORBA/PolicyHolder.java,Java,,24,8,15,47
/jdk1.6.0_45/org/omg/CORBA/PolicyListHelper.java,Java,,46,10,15,71
/jdk1.6.0_45/org/omg/CORBA/PolicyListHolder.java,Java,,24,9,15,48
/jdk1.6.0_45/org/omg/CORBA/PolicyOperations.java,Java,,7,6,41,54
/jdk1.6.0_45/org/omg/CORBA/PolicyTypeHelper.java,Java,,40,11,16,67
/jdk1.6.0_45/org/omg/CORBA/portable/ApplicationException.java,Java,,16,6,24,46
/jdk1.6.0_45/org/omg/CORBA/portable/BoxedValueHelper.java,Java,,7,2,14,23
/jdk1.6.0_45/org/omg/CORBA/portable/CustomValue.java,Java,,4,5,20,29
/jdk1.6.0_45/org/omg/CORBA/portable/Delegate.java,Java,,84,30,277,391
/jdk1.6.0_45/org/omg/CORBA/portable/IDLEntity.java,Java,,3,3,13,19
/jdk1.6.0_45/org/omg/CORBA/portable/IndirectionException.java,Java,,9,4,39,52
/jdk1.6.0_45/org/omg/CORBA/portable/InputStream.java,Java,,68,12,223,303
/jdk1.6.0_45/org/omg/CORBA/portable/InvokeHandler.java,Java,,6,4,45,55
/jdk1.6.0_45/org/omg/CORBA/portable/ObjectImpl.java,Java,,155,38,324,517
/jdk1.6.0_45/org/omg/CORBA/portable/OutputStream.java,Java,,66,11,193,270
/jdk1.6.0_45/org/omg/CORBA/portable/RemarshalException.java,Java,,6,2,20,28
/jdk1.6.0_45/org/omg/CORBA/portable/ResponseHandler.java,Java,,5,3,28,36
/jdk1.6.0_45/org/omg/CORBA/portable/ServantObject.java,Java,,5,4,22,31
/jdk1.6.0_45/org/omg/CORBA/portable/Streamable.java,Java,,7,4,32,43
/jdk1.6.0_45/org/omg/CORBA/portable/StreamableValue.java,Java,,3,5,17,25
/jdk1.6.0_45/org/omg/CORBA/portable/UnknownException.java,Java,,8,1,33,42
/jdk1.6.0_45/org/omg/CORBA/portable/ValueBase.java,Java,,4,2,29,35
/jdk1.6.0_45/org/omg/CORBA/portable/ValueFactory.java,Java,,5,3,33,41
/jdk1.6.0_45/org/omg/CORBA/portable/ValueInputStream.java,Java,,5,5,24,34
/jdk1.6.0_45/org/omg/CORBA/portable/ValueOutputStream.java,Java,,5,3,23,31
/jdk1.6.0_45/org/omg/CORBA/Principal.java,Java,,12,4,24,40
/jdk1.6.0_45/org/omg/CORBA/PrincipalHolder.java,Java,,22,10,44,76
/jdk1.6.0_45/org/omg/CORBA/PRIVATE_MEMBER.java,Java,,4,2,23,29
/jdk1.6.0_45/org/omg/CORBA/PUBLIC_MEMBER.java,Java,,4,2,24,30
/jdk1.6.0_45/org/omg/CORBA/REBIND.java,Java,,18,7,44,69
/jdk1.6.0_45/org/omg/CORBA/RepositoryIdHelper.java,Java,,40,10,16,66
/jdk1.6.0_45/org/omg/CORBA/Request.java,Java,,25,50,209,284
/jdk1.6.0_45/org/omg/CORBA/ServerRequest.java,Java,,39,19,239,297
/jdk1.6.0_45/org/omg/CORBA/ServiceDetail.java,Java,,11,5,35,51
/jdk1.6.0_45/org/omg/CORBA/ServiceDetailHelper.java,Java,,50,6,11,67
/jdk1.6.0_45/org/omg/CORBA/ServiceInformation.java,Java,,13,7,24,44
/jdk1.6.0_45/org/omg/CORBA/ServiceInformationHelper.java,Java,,58,7,11,76
/jdk1.6.0_45/org/omg/CORBA/ServiceInformationHolder.java,Java,,20,10,63,93
/jdk1.6.0_45/org/omg/CORBA/SetOverrideType.java,Java,,25,11,69,105
/jdk1.6.0_45/org/omg/CORBA/SetOverrideTypeHelper.java,Java,,37,10,14,61
/jdk1.6.0_45/org/omg/CORBA/ShortHolder.java,Java,,21,9,63,93
/jdk1.6.0_45/org/omg/CORBA/ShortSeqHelper.java,Java,,44,10,27,81
/jdk1.6.0_45/org/omg/CORBA/ShortSeqHolder.java,Java,,24,9,15,48
/jdk1.6.0_45/org/omg/CORBA/StringHolder.java,Java,,21,9,62,92
/jdk1.6.0_45/org/omg/CORBA/StringSeqHelper.java,Java,,46,11,7,64
/jdk1.6.0_45/org/omg/CORBA/StringSeqHolder.java,Java,,24,10,7,41
/jdk1.6.0_45/org/omg/CORBA/StringValueHelper.java,Java,,73,14,35,122
/jdk1.6.0_45/org/omg/CORBA/StructMember.java,Java,,12,8,51,71
/jdk1.6.0_45/org/omg/CORBA/StructMemberHelper.java,Java,,74,10,15,99
/jdk1.6.0_45/org/omg/CORBA/SystemException.java,Java,,45,11,45,101
/jdk1.6.0_45/org/omg/CORBA/TCKind.java,Java,,149,79,310,538
/jdk1.6.0_45/org/omg/CORBA/TIMEOUT.java,Java,,18,7,41,66
/jdk1.6.0_45/org/omg/CORBA/TRANSACTION_MODE.java,Java,,15,6,44,65
/jdk1.6.0_45/org/omg/CORBA/TRANSACTION_REQUIRED.java,Java,,15,6,41,62
/jdk1.6.0_45/org/omg/CORBA/TRANSACTION_ROLLEDBACK.java,Java,,15,6,45,66
/jdk1.6.0_45/org/omg/CORBA/TRANSACTION_UNAVAILABLE.java,Java,,16,6,44,66
/jdk1.6.0_45/org/omg/CORBA/TRANSIENT.java,Java,,15,6,44,65
/jdk1.6.0_45/org/omg/CORBA/TypeCode.java,Java,,29,39,448,516
/jdk1.6.0_45/org/omg/CORBA/TypeCodeHolder.java,Java,,21,9,63,93
/jdk1.6.0_45/org/omg/CORBA/TypeCodePackage/BadKind.java,Java,,9,4,25,38
/jdk1.6.0_45/org/omg/CORBA/TypeCodePackage/Bounds.java,Java,,9,5,24,38
/jdk1.6.0_45/org/omg/CORBA/ULongLongSeqHelper.java,Java,,44,10,27,81
/jdk1.6.0_45/org/omg/CORBA/ULongLongSeqHolder.java,Java,,24,9,15,48
/jdk1.6.0_45/org/omg/CORBA/ULongSeqHelper.java,Java,,44,10,27,81
/jdk1.6.0_45/org/omg/CORBA/ULongSeqHolder.java,Java,,24,9,15,48
/jdk1.6.0_45/org/omg/CORBA/UnionMember.java,Java,,14,9,54,77
/jdk1.6.0_45/org/omg/CORBA/UnionMemberHelper.java,Java,,81,10,15,106
/jdk1.6.0_45/org/omg/CORBA/UNKNOWN.java,Java,,15,6,50,71
/jdk1.6.0_45/org/omg/CORBA/UnknownUserException.java,Java,,11,7,31,49
/jdk1.6.0_45/org/omg/CORBA/UnknownUserExceptionHelper.java,Java,,61,10,17,88
/jdk1.6.0_45/org/omg/CORBA/UnknownUserExceptionHolder.java,Java,,24,8,15,47
/jdk1.6.0_45/org/omg/CORBA/UNSUPPORTED_POLICY.java,Java,,4,2,17,23
/jdk1.6.0_45/org/omg/CORBA/UNSUPPORTED_POLICY_VALUE.java,Java,,4,2,18,24
/jdk1.6.0_45/org/omg/CORBA/UserException.java,Java,,9,5,27,41
/jdk1.6.0_45/org/omg/CORBA/UShortSeqHelper.java,Java,,44,10,27,81
/jdk1.6.0_45/org/omg/CORBA/UShortSeqHolder.java,Java,,24,9,15,48
/jdk1.6.0_45/org/omg/CORBA/ValueBaseHelper.java,Java,,37,12,22,71
/jdk1.6.0_45/org/omg/CORBA/ValueBaseHolder.java,Java,,21,10,58,89
/jdk1.6.0_45/org/omg/CORBA/ValueMember.java,Java,,20,12,71,103
/jdk1.6.0_45/org/omg/CORBA/ValueMemberHelper.java,Java,,106,10,15,131
/jdk1.6.0_45/org/omg/CORBA/VersionSpecHelper.java,Java,,40,10,15,65
/jdk1.6.0_45/org/omg/CORBA/VisibilityHelper.java,Java,,40,11,16,67
/jdk1.6.0_45/org/omg/CORBA/VM_ABSTRACT.java,Java,,4,2,16,22
/jdk1.6.0_45/org/omg/CORBA/VM_CUSTOM.java,Java,,4,2,16,22
/jdk1.6.0_45/org/omg/CORBA/VM_NONE.java,Java,,4,4,19,27
/jdk1.6.0_45/org/omg/CORBA/VM_TRUNCATABLE.java,Java,,4,2,18,24
/jdk1.6.0_45/org/omg/CORBA/WCharSeqHelper.java,Java,,44,10,27,81
/jdk1.6.0_45/org/omg/CORBA/WCharSeqHolder.java,Java,,24,9,15,48
/jdk1.6.0_45/org/omg/CORBA/WrongTransaction.java,Java,,9,4,25,38
/jdk1.6.0_45/org/omg/CORBA/WrongTransactionHelper.java,Java,,54,9,17,80
/jdk1.6.0_45/org/omg/CORBA/WrongTransactionHolder.java,Java,,24,8,15,47
/jdk1.6.0_45/org/omg/CORBA/WStringSeqHelper.java,Java,,46,11,7,64
/jdk1.6.0_45/org/omg/CORBA/WStringSeqHolder.java,Java,,24,10,7,41
/jdk1.6.0_45/org/omg/CORBA/WStringValueHelper.java,Java,,73,16,38,127
/jdk1.6.0_45/org/omg/CORBA/_IDLTypeStub.java,Java,,90,13,32,135
/jdk1.6.0_45/org/omg/CORBA/_PolicyStub.java,Java,,89,14,43,146
/jdk1.6.0_45/org/omg/CORBA_2_3/ORB.java,Java,,23,13,37,73
/jdk1.6.0_45/org/omg/CORBA_2_3/portable/Delegate.java,Java,,6,4,29,39
/jdk1.6.0_45/org/omg/CORBA_2_3/portable/InputStream.java,Java,,24,11,61,96
/jdk1.6.0_45/org/omg/CORBA_2_3/portable/ObjectImpl.java,Java,,10,6,28,44
/jdk1.6.0_45/org/omg/CORBA_2_3/portable/OutputStream.java,Java,,18,9,49,76
/jdk1.6.0_45/org/omg/CosNaming/Binding.java,Java,,14,7,7,28
/jdk1.6.0_45/org/omg/CosNaming/BindingHelper.java,Java,,68,10,6,84
/jdk1.6.0_45/org/omg/CosNaming/BindingHolder.java,Java,,24,8,6,38
/jdk1.6.0_45/org/omg/CosNaming/BindingIterator.java,Java,,4,4,14,22
/jdk1.6.0_45/org/omg/CosNaming/BindingIteratorHelper.java,Java,,67,13,14,94
/jdk1.6.0_45/org/omg/CosNaming/BindingIteratorHolder.java,Java,,24,9,14,47
/jdk1.6.0_45/org/omg/CosNaming/BindingIteratorOperations.java,Java,,7,7,30,44
/jdk1.6.0_45/org/omg/CosNaming/BindingIteratorPOA.java,Java,,70,21,32,123
/jdk1.6.0_45/org/omg/CosNaming/BindingListHelper.java,Java,,46,11,9,66
/jdk1.6.0_45/org/omg/CosNaming/BindingListHolder.java,Java,,24,10,9,43
/jdk1.6.0_45/org/omg/CosNaming/BindingType.java,Java,,27,8,10,45
/jdk1.6.0_45/org/omg/CosNaming/BindingTypeHelper.java,Java,,37,11,10,58
/jdk1.6.0_45/org/omg/CosNaming/BindingTypeHolder.java,Java,,24,9,10,43
/jdk1.6.0_45/org/omg/CosNaming/IstringHelper.java,Java,,40,10,6,56
/jdk1.6.0_45/org/omg/CosNaming/NameComponent.java,Java,,14,6,6,26
/jdk1.6.0_45/org/omg/CosNaming/NameComponentHelper.java,Java,,68,10,6,84
/jdk1.6.0_45/org/omg/CosNaming/NameComponentHolder.java,Java,,24,8,6,38
/jdk1.6.0_45/org/omg/CosNaming/NameHelper.java,Java,,46,11,9,66
/jdk1.6.0_45/org/omg/CosNaming/NameHolder.java,Java,,24,10,9,43
/jdk1.6.0_45/org/omg/CosNaming/NamingContext.java,Java,,4,4,15,23
/jdk1.6.0_45/org/omg/CosNaming/NamingContextExt.java,Java,,4,4,19,27
/jdk1.6.0_45/org/omg/CosNaming/NamingContextExtHelper.java,Java,,67,13,19,99
/jdk1.6.0_45/org/omg/CosNaming/NamingContextExtHolder.java,Java,,24,9,19,52
/jdk1.6.0_45/org/omg/CosNaming/NamingContextExtOperations.java,Java,,8,8,67,83
/jdk1.6.0_45/org/omg/CosNaming/NamingContextExtPackage/AddressHelper.java,Java,,40,11,9,60
/jdk1.6.0_45/org/omg/CosNaming/NamingContextExtPackage/InvalidAddress.java,Java,,12,7,6,25
/jdk1.6.0_45/org/omg/CosNaming/NamingContextExtPackage/InvalidAddressHelper.java,Java,,54,10,8,72
/jdk1.6.0_45/org/omg/CosNaming/NamingContextExtPackage/InvalidAddressHolder.java,Java,,24,8,6,38
/jdk1.6.0_45/org/omg/CosNaming/NamingContextExtPackage/StringNameHelper.java,Java,,40,11,10,61
/jdk1.6.0_45/org/omg/CosNaming/NamingContextExtPackage/URLStringHelper.java,Java,,40,11,10,61
/jdk1.6.0_45/org/omg/CosNaming/NamingContextExtPOA.java,Java,,294,43,230,567
/jdk1.6.0_45/org/omg/CosNaming/NamingContextHelper.java,Java,,67,13,15,95
/jdk1.6.0_45/org/omg/CosNaming/NamingContextHolder.java,Java,,24,9,15,48
/jdk1.6.0_45/org/omg/CosNaming/NamingContextOperations.java,Java,,14,14,176,204
/jdk1.6.0_45/org/omg/CosNaming/NamingContextPackage/AlreadyBound.java,Java,,12,7,6,25
/jdk1.6.0_45/org/omg/CosNaming/NamingContextPackage/AlreadyBoundHelper.java,Java,,54,10,8,72
/jdk1.6.0_45/org/omg/CosNaming/NamingContextPackage/AlreadyBoundHolder.java,Java,,24,8,6,38
/jdk1.6.0_45/org/omg/CosNaming/NamingContextPackage/CannotProceed.java,Java,,22,8,6,36
/jdk1.6.0_45/org/omg/CosNaming/NamingContextPackage/CannotProceedHelper.java,Java,,70,10,8,88
/jdk1.6.0_45/org/omg/CosNaming/NamingContextPackage/CannotProceedHolder.java,Java,,24,8,6,38
/jdk1.6.0_45/org/omg/CosNaming/NamingContextPackage/InvalidName.java,Java,,12,7,6,25
/jdk1.6.0_45/org/omg/CosNaming/NamingContextPackage/InvalidNameHelper.java,Java,,54,10,8,72
/jdk1.6.0_45/org/omg/CosNaming/NamingContextPackage/InvalidNameHolder.java,Java,,24,8,6,38
/jdk1.6.0_45/org/omg/CosNaming/NamingContextPackage/NotEmpty.java,Java,,12,7,6,25
/jdk1.6.0_45/org/omg/CosNaming/NamingContextPackage/NotEmptyHelper.java,Java,,54,10,8,72
/jdk1.6.0_45/org/omg/CosNaming/NamingContextPackage/NotEmptyHolder.java,Java,,24,8,6,38
/jdk1.6.0_45/org/omg/CosNaming/NamingContextPackage/NotFound.java,Java,,22,8,6,36
/jdk1.6.0_45/org/omg/CosNaming/NamingContextPackage/NotFoundHelper.java,Java,,70,10,8,88
/jdk1.6.0_45/org/omg/CosNaming/NamingContextPackage/NotFoundHolder.java,Java,,24,8,6,38
/jdk1.6.0_45/org/omg/CosNaming/NamingContextPackage/NotFoundReason.java,Java,,29,8,9,46
/jdk1.6.0_45/org/omg/CosNaming/NamingContextPackage/NotFoundReasonHelper.java,Java,,37,11,9,57
/jdk1.6.0_45/org/omg/CosNaming/NamingContextPackage/NotFoundReasonHolder.java,Java,,24,9,9,42
/jdk1.6.0_45/org/omg/CosNaming/NamingContextPOA.java,Java,,223,35,178,436
/jdk1.6.0_45/org/omg/CosNaming/_BindingIteratorImplBase.java,Java,,71,3,16,90
/jdk1.6.0_45/org/omg/CosNaming/_BindingIteratorStub.java,Java,,92,14,31,137
/jdk1.6.0_45/org/omg/CosNaming/_NamingContextExtStub.java,Java,,377,36,229,642
/jdk1.6.0_45/org/omg/CosNaming/_NamingContextImplBase.java,Java,,370,3,16,389
/jdk1.6.0_45/org/omg/CosNaming/_NamingContextStub.java,Java,,281,28,177,486
/jdk1.6.0_45/org/omg/Dynamic/Parameter.java,Java,,14,6,6,26
/jdk1.6.0_45/org/omg/DynamicAny/AnySeqHelper.java,Java,,46,10,6,62
/jdk1.6.0_45/org/omg/DynamicAny/DynAny.java,Java,,4,4,73,81
/jdk1.6.0_45/org/omg/DynamicAny/DynAnyFactory.java,Java,,4,4,27,35
/jdk1.6.0_45/org/omg/DynamicAny/DynAnyFactoryHelper.java,Java,,67,13,27,107
/jdk1.6.0_45/org/omg/DynamicAny/DynAnyFactoryOperations.java,Java,,6,6,68,80
/jdk1.6.0_45/org/omg/DynamicAny/DynAnyFactoryPackage/InconsistentTypeCode.java,Java,,12,7,6,25
/jdk1.6.0_45/org/omg/DynamicAny/DynAnyFactoryPackage/InconsistentTypeCodeHelper.java,Java,,54,10,8,72
/jdk1.6.0_45/org/omg/DynamicAny/DynAnyHelper.java,Java,,67,13,73,153
/jdk1.6.0_45/org/omg/DynamicAny/DynAnyOperations.java,Java,,54,54,461,569
/jdk1.6.0_45/org/omg/DynamicAny/DynAnyPackage/InvalidValue.java,Java,,12,7,6,25
/jdk1.6.0_45/org/omg/DynamicAny/DynAnyPackage/InvalidValueHelper.java,Java,,54,10,8,72
/jdk1.6.0_45/org/omg/DynamicAny/DynAnyPackage/TypeMismatch.java,Java,,12,7,6,25
/jdk1.6.0_45/org/omg/DynamicAny/DynAnyPackage/TypeMismatchHelper.java,Java,,54,10,8,72
/jdk1.6.0_45/org/omg/DynamicAny/DynAnySeqHelper.java,Java,,46,10,6,62
/jdk1.6.0_45/org/omg/DynamicAny/DynArray.java,Java,,4,4,11,19
/jdk1.6.0_45/org/omg/DynamicAny/DynArrayHelper.java,Java,,67,13,11,91
/jdk1.6.0_45/org/omg/DynamicAny/DynArrayOperations.java,Java,,8,8,29,45
/jdk1.6.0_45/org/omg/DynamicAny/DynEnum.java,Java,,4,4,10,18
/jdk1.6.0_45/org/omg/DynamicAny/DynEnumHelper.java,Java,,67,13,10,90
/jdk1.6.0_45/org/omg/DynamicAny/DynEnumOperations.java,Java,,8,8,30,46
/jdk1.6.0_45/org/omg/DynamicAny/DynFixed.java,Java,,4,4,11,19
/jdk1.6.0_45/org/omg/DynamicAny/DynFixedHelper.java,Java,,67,13,11,91
/jdk1.6.0_45/org/omg/DynamicAny/DynFixedOperations.java,Java,,6,6,26,38
/jdk1.6.0_45/org/omg/DynamicAny/DynSequence.java,Java,,4,4,9,17
/jdk1.6.0_45/org/omg/DynamicAny/DynSequenceHelper.java,Java,,67,13,9,89
/jdk1.6.0_45/org/omg/DynamicAny/DynSequenceOperations.java,Java,,10,10,57,77
/jdk1.6.0_45/org/omg/DynamicAny/DynStruct.java,Java,,4,4,10,18
/jdk1.6.0_45/org/omg/DynamicAny/DynStructHelper.java,Java,,67,13,10,90
/jdk1.6.0_45/org/omg/DynamicAny/DynStructOperations.java,Java,,10,10,66,86
/jdk1.6.0_45/org/omg/DynamicAny/DynUnion.java,Java,,4,4,16,24
/jdk1.6.0_45/org/omg/DynamicAny/DynUnionHelper.java,Java,,67,13,16,96
/jdk1.6.0_45/org/omg/DynamicAny/DynUnionOperations.java,Java,,13,13,75,101
/jdk1.6.0_45/org/omg/DynamicAny/DynValue.java,Java,,4,4,18,26
/jdk1.6.0_45/org/omg/DynamicAny/DynValueBox.java,Java,,4,4,13,21
/jdk1.6.0_45/org/omg/DynamicAny/DynValueBoxOperations.java,Java,,8,8,37,53
/jdk1.6.0_45/org/omg/DynamicAny/DynValueCommon.java,Java,,4,4,9,17
/jdk1.6.0_45/org/omg/DynamicAny/DynValueCommonOperations.java,Java,,7,7,20,34
/jdk1.6.0_45/org/omg/DynamicAny/DynValueHelper.java,Java,,67,13,18,98
/jdk1.6.0_45/org/omg/DynamicAny/DynValueOperations.java,Java,,10,10,80,100
/jdk1.6.0_45/org/omg/DynamicAny/FieldNameHelper.java,Java,,40,10,6,56
/jdk1.6.0_45/org/omg/DynamicAny/NameDynAnyPair.java,Java,,14,8,12,34
/jdk1.6.0_45/org/omg/DynamicAny/NameDynAnyPairHelper.java,Java,,67,10,6,83
/jdk1.6.0_45/org/omg/DynamicAny/NameDynAnyPairSeqHelper.java,Java,,46,10,6,62
/jdk1.6.0_45/org/omg/DynamicAny/NameValuePair.java,Java,,14,8,12,34
/jdk1.6.0_45/org/omg/DynamicAny/NameValuePairHelper.java,Java,,67,10,6,83
/jdk1.6.0_45/org/omg/DynamicAny/NameValuePairSeqHelper.java,Java,,46,10,6,62
/jdk1.6.0_45/org/omg/DynamicAny/_DynAnyFactoryStub.java,Java,,57,15,69,141
/jdk1.6.0_45/org/omg/DynamicAny/_DynAnyStub.java,Java,,537,159,462,1158
/jdk1.6.0_45/org/omg/DynamicAny/_DynArrayStub.java,Java,,578,171,418,1167
/jdk1.6.0_45/org/omg/DynamicAny/_DynEnumStub.java,Java,,578,171,419,1168
/jdk1.6.0_45/org/omg/DynamicAny/_DynFixedStub.java,Java,,558,165,415,1138
/jdk1.6.0_45/org/omg/DynamicAny/_DynSequenceStub.java,Java,,598,177,446,1221
/jdk1.6.0_45/org/omg/DynamicAny/_DynStructStub.java,Java,,598,177,455,1230
/jdk1.6.0_45/org/omg/DynamicAny/_DynUnionStub.java,Java,,628,186,464,1278
/jdk1.6.0_45/org/omg/DynamicAny/_DynValueStub.java,Java,,629,186,480,1295
/jdk1.6.0_45/org/omg/IOP/Codec.java,Java,,4,4,17,25
/jdk1.6.0_45/org/omg/IOP/CodecFactory.java,Java,,4,4,11,19
/jdk1.6.0_45/org/omg/IOP/CodecFactoryHelper.java,Java,,55,13,11,79
/jdk1.6.0_45/org/omg/IOP/CodecFactoryOperations.java,Java,,5,5,19,29
/jdk1.6.0_45/org/omg/IOP/CodecFactoryPackage/UnknownEncoding.java,Java,,12,7,6,25
/jdk1.6.0_45/org/omg/IOP/CodecFactoryPackage/UnknownEncodingHelper.java,Java,,54,10,8,72
/jdk1.6.0_45/org/omg/IOP/CodecOperations.java,Java,,8,8,61,77
/jdk1.6.0_45/org/omg/IOP/CodecPackage/FormatMismatch.java,Java,,12,7,6,25
/jdk1.6.0_45/org/omg/IOP/CodecPackage/FormatMismatchHelper.java,Java,,54,10,8,72
/jdk1.6.0_45/org/omg/IOP/CodecPackage/InvalidTypeForEncoding.java,Java,,12,7,6,25
/jdk1.6.0_45/org/omg/IOP/CodecPackage/InvalidTypeForEncodingHelper.java,Java,,54,10,8,72
/jdk1.6.0_45/org/omg/IOP/CodecPackage/TypeMismatch.java,Java,,12,7,6,25
/jdk1.6.0_45/org/omg/IOP/CodecPackage/TypeMismatchHelper.java,Java,,54,10,8,72
/jdk1.6.0_45/org/omg/IOP/CodeSets.java,Java,,5,4,11,20
/jdk1.6.0_45/org/omg/IOP/ComponentIdHelper.java,Java,,40,11,10,61
/jdk1.6.0_45/org/omg/IOP/Encoding.java,Java,,16,9,15,40
/jdk1.6.0_45/org/omg/IOP/ENCODING_CDR_ENCAPS.java,Java,,5,4,10,19
/jdk1.6.0_45/org/omg/IOP/ExceptionDetailMessage.java,Java,,5,4,26,35
/jdk1.6.0_45/org/omg/IOP/IOR.java,Java,,14,8,11,33
/jdk1.6.0_45/org/omg/IOP/IORHelper.java,Java,,72,10,6,88
/jdk1.6.0_45/org/omg/IOP/IORHolder.java,Java,,24,8,6,38
/jdk1.6.0_45/org/omg/IOP/MultipleComponentProfileHelper.java,Java,,46,11,7,64
/jdk1.6.0_45/org/omg/IOP/MultipleComponentProfileHolder.java,Java,,24,10,7,41
/jdk1.6.0_45/org/omg/IOP/ProfileIdHelper.java,Java,,40,11,7,58
/jdk1.6.0_45/org/omg/IOP/RMICustomMaxStreamFormat.java,Java,,5,4,13,22
/jdk1.6.0_45/org/omg/IOP/ServiceContext.java,Java,,14,8,8,30
/jdk1.6.0_45/org/omg/IOP/ServiceContextHelper.java,Java,,71,10,6,87
/jdk1.6.0_45/org/omg/IOP/ServiceContextHolder.java,Java,,24,8,6,38
/jdk1.6.0_45/org/omg/IOP/ServiceContextListHelper.java,Java,,46,11,7,64
/jdk1.6.0_45/org/omg/IOP/ServiceContextListHolder.java,Java,,24,10,7,41
/jdk1.6.0_45/org/omg/IOP/ServiceIdHelper.java,Java,,40,11,7,58
/jdk1.6.0_45/org/omg/IOP/TaggedComponent.java,Java,,14,8,8,30
/jdk1.6.0_45/org/omg/IOP/TaggedComponentHelper.java,Java,,71,10,6,87
/jdk1.6.0_45/org/omg/IOP/TaggedComponentHolder.java,Java,,24,8,6,38
/jdk1.6.0_45/org/omg/IOP/TaggedProfile.java,Java,,14,8,8,30
/jdk1.6.0_45/org/omg/IOP/TaggedProfileHelper.java,Java,,71,10,6,87
/jdk1.6.0_45/org/omg/IOP/TaggedProfileHolder.java,Java,,24,8,6,38
/jdk1.6.0_45/org/omg/IOP/TAG_ALTERNATE_IIOP_ADDRESS.java,Java,,5,4,32,41
/jdk1.6.0_45/org/omg/IOP/TAG_CODE_SETS.java,Java,,5,4,16,25
/jdk1.6.0_45/org/omg/IOP/TAG_INTERNET_IOP.java,Java,,5,4,31,40
/jdk1.6.0_45/org/omg/IOP/TAG_JAVA_CODEBASE.java,Java,,5,4,19,28
/jdk1.6.0_45/org/omg/IOP/TAG_MULTIPLE_COMPONENTS.java,Java,,5,4,17,26
/jdk1.6.0_45/org/omg/IOP/TAG_ORB_TYPE.java,Java,,5,4,24,33
/jdk1.6.0_45/org/omg/IOP/TAG_POLICIES.java,Java,,5,4,10,19
/jdk1.6.0_45/org/omg/IOP/TAG_RMI_CUSTOM_MAX_STREAM_FORMAT.java,Java,,5,4,15,24
/jdk1.6.0_45/org/omg/IOP/TransactionService.java,Java,,5,4,11,20
/jdk1.6.0_45/org/omg/Messaging/SyncScopeHelper.java,Java,,40,11,7,58
/jdk1.6.0_45/org/omg/Messaging/SYNC_WITH_TRANSPORT.java,Java,,5,4,10,19
/jdk1.6.0_45/org/omg/PortableInterceptor/ACTIVE.java,Java,,5,4,8,17
/jdk1.6.0_45/org/omg/PortableInterceptor/AdapterManagerIdHelper.java,Java,,40,11,12,63
/jdk1.6.0_45/org/omg/PortableInterceptor/AdapterNameHelper.java,Java,,42,11,9,62
/jdk1.6.0_45/org/omg/PortableInterceptor/AdapterStateHelper.java,Java,,40,11,9,60
/jdk1.6.0_45/org/omg/PortableInterceptor/ClientRequestInfo.java,Java,,4,4,220,228
/jdk1.6.0_45/org/omg/PortableInterceptor/ClientRequestInfoOperations.java,Java,,13,13,319,345
/jdk1.6.0_45/org/omg/PortableInterceptor/ClientRequestInterceptor.java,Java,,4,4,22,30
/jdk1.6.0_45/org/omg/PortableInterceptor/ClientRequestInterceptorOperations.java,Java,,9,9,175,193
/jdk1.6.0_45/org/omg/PortableInterceptor/Current.java,Java,,4,4,23,31
/jdk1.6.0_45/org/omg/PortableInterceptor/CurrentHelper.java,Java,,55,13,23,91
/jdk1.6.0_45/org/omg/PortableInterceptor/CurrentOperations.java,Java,,6,6,52,64
/jdk1.6.0_45/org/omg/PortableInterceptor/DISCARDING.java,Java,,5,4,8,17
/jdk1.6.0_45/org/omg/PortableInterceptor/ForwardRequest.java,Java,,19,9,9,37
/jdk1.6.0_45/org/omg/PortableInterceptor/ForwardRequestHelper.java,Java,,61,10,8,79
/jdk1.6.0_45/org/omg/PortableInterceptor/HOLDING.java,Java,,5,4,9,18
/jdk1.6.0_45/org/omg/PortableInterceptor/INACTIVE.java,Java,,5,4,9,18
/jdk1.6.0_45/org/omg/PortableInterceptor/Interceptor.java,Java,,4,4,9,17
/jdk1.6.0_45/org/omg/PortableInterceptor/InterceptorOperations.java,Java,,6,6,38,50
/jdk1.6.0_45/org/omg/PortableInterceptor/InvalidSlot.java,Java,,12,7,6,25
/jdk1.6.0_45/org/omg/PortableInterceptor/InvalidSlotHelper.java,Java,,54,10,8,72
/jdk1.6.0_45/org/omg/PortableInterceptor/IORInfo.java,Java,,4,4,14,22
/jdk1.6.0_45/org/omg/PortableInterceptor/IORInfoOperations.java,Java,,12,12,82,106
/jdk1.6.0_45/org/omg/PortableInterceptor/IORInterceptor.java,Java,,4,4,20,28
/jdk1.6.0_45/org/omg/PortableInterceptor/IORInterceptorOperations.java,Java,,5,5,40,50
/jdk1.6.0_45/org/omg/PortableInterceptor/IORInterceptor_3_0.java,Java,,4,3,6,13
/jdk1.6.0_45/org/omg/PortableInterceptor/IORInterceptor_3_0Helper.java,Java,,55,12,6,73
/jdk1.6.0_45/org/omg/PortableInterceptor/IORInterceptor_3_0Holder.java,Java,,24,8,6,38
/jdk1.6.0_45/org/omg/PortableInterceptor/IORInterceptor_3_0Operations.java,Java,,7,6,34,47
/jdk1.6.0_45/org/omg/PortableInterceptor/LOCATION_FORWARD.java,Java,,5,4,15,24
/jdk1.6.0_45/org/omg/PortableInterceptor/NON_EXISTENT.java,Java,,5,4,8,17
/jdk1.6.0_45/org/omg/PortableInterceptor/ObjectIdHelper.java,Java,,42,11,9,62
/jdk1.6.0_45/org/omg/PortableInterceptor/ObjectReferenceFactory.java,Java,,5,6,13,24
/jdk1.6.0_45/org/omg/PortableInterceptor/ObjectReferenceFactoryHelper.java,Java,,52,13,9,74
/jdk1.6.0_45/org/omg/PortableInterceptor/ObjectReferenceFactoryHolder.java,Java,,24,9,9,42
/jdk1.6.0_45/org/omg/PortableInterceptor/ObjectReferenceTemplate.java,Java,,7,7,13,27
/jdk1.6.0_45/org/omg/PortableInterceptor/ObjectReferenceTemplateHelper.java,Java,,52,13,13,78
/jdk1.6.0_45/org/omg/PortableInterceptor/ObjectReferenceTemplateHolder.java,Java,,24,9,13,46
/jdk1.6.0_45/org/omg/PortableInterceptor/ObjectReferenceTemplateSeqHelper.java,Java,,46,11,9,66
/jdk1.6.0_45/org/omg/PortableInterceptor/ObjectReferenceTemplateSeqHolder.java,Java,,24,10,9,43
/jdk1.6.0_45/org/omg/PortableInterceptor/ORBIdHelper.java,Java,,40,11,7,58
/jdk1.6.0_45/org/omg/PortableInterceptor/ORBInitializer.java,Java,,4,4,116,124
/jdk1.6.0_45/org/omg/PortableInterceptor/ORBInitializerOperations.java,Java,,6,6,144,156
/jdk1.6.0_45/org/omg/PortableInterceptor/ORBInitInfo.java,Java,,4,4,19,27
/jdk1.6.0_45/org/omg/PortableInterceptor/ORBInitInfoOperations.java,Java,,14,14,106,134
/jdk1.6.0_45/org/omg/PortableInterceptor/ORBInitInfoPackage/DuplicateName.java,Java,,19,9,9,37
/jdk1.6.0_45/org/omg/PortableInterceptor/ORBInitInfoPackage/DuplicateNameHelper.java,Java,,61,10,8,79
/jdk1.6.0_45/org/omg/PortableInterceptor/ORBInitInfoPackage/InvalidName.java,Java,,12,7,6,25
/jdk1.6.0_45/org/omg/PortableInterceptor/ORBInitInfoPackage/InvalidNameHelper.java,Java,,54,10,8,72
/jdk1.6.0_45/org/omg/PortableInterceptor/ORBInitInfoPackage/ObjectIdHelper.java,Java,,40,11,7,58
/jdk1.6.0_45/org/omg/PortableInterceptor/PolicyFactory.java,Java,,4,4,19,27
/jdk1.6.0_45/org/omg/PortableInterceptor/PolicyFactoryOperations.java,Java,,5,5,40,50
/jdk1.6.0_45/org/omg/PortableInterceptor/RequestInfo.java,Java,,4,4,21,29
/jdk1.6.0_45/org/omg/PortableInterceptor/RequestInfoOperations.java,Java,,18,18,256,292
/jdk1.6.0_45/org/omg/PortableInterceptor/ServerIdHelper.java,Java,,40,11,7,58
/jdk1.6.0_45/org/omg/PortableInterceptor/ServerRequestInfo.java,Java,,4,4,218,226
/jdk1.6.0_45/org/omg/PortableInterceptor/ServerRequestInfoOperations.java,Java,,15,15,306,336
/jdk1.6.0_45/org/omg/PortableInterceptor/ServerRequestInterceptor.java,Java,,4,4,22,30
/jdk1.6.0_45/org/omg/PortableInterceptor/ServerRequestInterceptorOperations.java,Java,,9,9,180,198
/jdk1.6.0_45/org/omg/PortableInterceptor/SUCCESSFUL.java,Java,,5,4,15,24
/jdk1.6.0_45/org/omg/PortableInterceptor/SYSTEM_EXCEPTION.java,Java,,5,4,15,24
/jdk1.6.0_45/org/omg/PortableInterceptor/TRANSPORT_RETRY.java,Java,,5,4,15,24
/jdk1.6.0_45/org/omg/PortableInterceptor/UNKNOWN.java,Java,,5,4,9,18
/jdk1.6.0_45/org/omg/PortableInterceptor/USER_EXCEPTION.java,Java,,5,4,15,24
/jdk1.6.0_45/org/omg/PortableServer/AdapterActivator.java,Java,,4,4,13,21
/jdk1.6.0_45/org/omg/PortableServer/AdapterActivatorOperations.java,Java,,5,5,26,36
/jdk1.6.0_45/org/omg/PortableServer/Current.java,Java,,4,4,24,32
/jdk1.6.0_45/org/omg/PortableServer/CurrentHelper.java,Java,,52,13,30,95
/jdk1.6.0_45/org/omg/PortableServer/CurrentOperations.java,Java,,6,6,44,56
/jdk1.6.0_45/org/omg/PortableServer/CurrentPackage/NoContext.java,Java,,12,7,6,25
/jdk1.6.0_45/org/omg/PortableServer/CurrentPackage/NoContextHelper.java,Java,,54,10,8,72
/jdk1.6.0_45/org/omg/PortableServer/DynamicImplementation.java,Java,,4,2,19,25
/jdk1.6.0_45/org/omg/PortableServer/ForwardRequest.java,Java,,19,8,6,33
/jdk1.6.0_45/org/omg/PortableServer/ForwardRequestHelper.java,Java,,61,10,8,79
/jdk1.6.0_45/org/omg/PortableServer/IdAssignmentPolicy.java,Java,,4,4,11,19
/jdk1.6.0_45/org/omg/PortableServer/IdAssignmentPolicyOperations.java,Java,,5,5,14,24
/jdk1.6.0_45/org/omg/PortableServer/IdAssignmentPolicyValue.java,Java,,27,8,15,50
/jdk1.6.0_45/org/omg/PortableServer/IdUniquenessPolicy.java,Java,,4,4,11,19
/jdk1.6.0_45/org/omg/PortableServer/IdUniquenessPolicyOperations.java,Java,,5,5,14,24
/jdk1.6.0_45/org/omg/PortableServer/IdUniquenessPolicyValue.java,Java,,27,8,13,48
/jdk1.6.0_45/org/omg/PortableServer/ID_ASSIGNMENT_POLICY_ID.java,Java,,5,4,9,18
/jdk1.6.0_45/org/omg/PortableServer/ID_UNIQUENESS_POLICY_ID.java,Java,,5,4,9,18
/jdk1.6.0_45/org/omg/PortableServer/ImplicitActivationPolicy.java,Java,,4,4,10,18
/jdk1.6.0_45/org/omg/PortableServer/ImplicitActivationPolicyOperations.java,Java,,5,5,13,23
/jdk1.6.0_45/org/omg/PortableServer/ImplicitActivationPolicyValue.java,Java,,27,8,15,50
/jdk1.6.0_45/org/omg/PortableServer/IMPLICIT_ACTIVATION_POLICY_ID.java,Java,,5,4,9,18
/jdk1.6.0_45/org/omg/PortableServer/LifespanPolicy.java,Java,,4,4,11,19
/jdk1.6.0_45/org/omg/PortableServer/LifespanPolicyOperations.java,Java,,5,5,14,24
/jdk1.6.0_45/org/omg/PortableServer/LifespanPolicyValue.java,Java,,27,8,14,49
/jdk1.6.0_45/org/omg/PortableServer/LIFESPAN_POLICY_ID.java,Java,,5,4,9,18
/jdk1.6.0_45/org/omg/PortableServer/POA.java,Java,,4,4,16,24
/jdk1.6.0_45/org/omg/PortableServer/POAHelper.java,Java,,50,12,22,84
/jdk1.6.0_45/org/omg/PortableServer/POAManager.java,Java,,4,4,12,20
/jdk1.6.0_45/org/omg/PortableServer/POAManagerOperations.java,Java,,9,9,60,78
/jdk1.6.0_45/org/omg/PortableServer/POAManagerPackage/AdapterInactive.java,Java,,12,7,6,25
/jdk1.6.0_45/org/omg/PortableServer/POAManagerPackage/AdapterInactiveHelper.java,Java,,54,10,8,72
/jdk1.6.0_45/org/omg/PortableServer/POAManagerPackage/State.java,Java,,31,8,9,48
/jdk1.6.0_45/org/omg/PortableServer/POAOperations.java,Java,,36,36,395,467
/jdk1.6.0_45/org/omg/PortableServer/POAPackage/AdapterAlreadyExists.java,Java,,12,7,6,25
/jdk1.6.0_45/org/omg/PortableServer/POAPackage/AdapterAlreadyExistsHelper.java,Java,,54,10,8,72
/jdk1.6.0_45/org/omg/PortableServer/POAPackage/AdapterNonExistent.java,Java,,12,7,6,25
/jdk1.6.0_45/org/omg/PortableServer/POAPackage/AdapterNonExistentHelper.java,Java,,54,10,8,72
/jdk1.6.0_45/org/omg/PortableServer/POAPackage/InvalidPolicy.java,Java,,19,8,6,33
/jdk1.6.0_45/org/omg/PortableServer/POAPackage/InvalidPolicyHelper.java,Java,,61,10,8,79
/jdk1.6.0_45/org/omg/PortableServer/POAPackage/NoServant.java,Java,,12,7,6,25
/jdk1.6.0_45/org/omg/PortableServer/POAPackage/NoServantHelper.java,Java,,54,10,8,72
/jdk1.6.0_45/org/omg/PortableServer/POAPackage/ObjectAlreadyActive.java,Java,,12,7,6,25
/jdk1.6.0_45/org/omg/PortableServer/POAPackage/ObjectAlreadyActiveHelper.java,Java,,54,10,8,72
/jdk1.6.0_45/org/omg/PortableServer/POAPackage/ObjectNotActive.java,Java,,12,7,6,25
/jdk1.6.0_45/org/omg/PortableServer/POAPackage/ObjectNotActiveHelper.java,Java,,54,10,8,72
/jdk1.6.0_45/org/omg/PortableServer/POAPackage/ServantAlreadyActive.java,Java,,12,7,6,25
/jdk1.6.0_45/org/omg/PortableServer/POAPackage/ServantAlreadyActiveHelper.java,Java,,54,10,8,72
/jdk1.6.0_45/org/omg/PortableServer/POAPackage/ServantNotActive.java,Java,,12,7,6,25
/jdk1.6.0_45/org/omg/PortableServer/POAPackage/ServantNotActiveHelper.java,Java,,54,10,8,72
/jdk1.6.0_45/org/omg/PortableServer/POAPackage/WrongAdapter.java,Java,,12,7,6,25
/jdk1.6.0_45/org/omg/PortableServer/POAPackage/WrongAdapterHelper.java,Java,,54,10,8,72
/jdk1.6.0_45/org/omg/PortableServer/POAPackage/WrongPolicy.java,Java,,12,7,6,25
/jdk1.6.0_45/org/omg/PortableServer/POAPackage/WrongPolicyHelper.java,Java,,54,10,8,72
/jdk1.6.0_45/org/omg/PortableServer/portable/Delegate.java,Java,,13,11,74,98
/jdk1.6.0_45/org/omg/PortableServer/RequestProcessingPolicy.java,Java,,4,4,11,19
/jdk1.6.0_45/org/omg/PortableServer/RequestProcessingPolicyOperations.java,Java,,5,5,14,24
/jdk1.6.0_45/org/omg/PortableServer/RequestProcessingPolicyValue.java,Java,,29,8,24,61
/jdk1.6.0_45/org/omg/PortableServer/REQUEST_PROCESSING_POLICY_ID.java,Java,,5,4,9,18
/jdk1.6.0_45/org/omg/PortableServer/Servant.java,Java,,80,18,150,248
/jdk1.6.0_45/org/omg/PortableServer/ServantActivator.java,Java,,4,4,10,18
/jdk1.6.0_45/org/omg/PortableServer/ServantActivatorHelper.java,Java,,67,13,10,90
/jdk1.6.0_45/org/omg/PortableServer/ServantActivatorOperations.java,Java,,6,6,48,60
/jdk1.6.0_45/org/omg/PortableServer/ServantActivatorPOA.java,Java,,34,13,12,59
/jdk1.6.0_45/org/omg/PortableServer/ServantLocator.java,Java,,4,4,24,32
/jdk1.6.0_45/org/omg/PortableServer/ServantLocatorHelper.java,Java,,67,13,24,104
/jdk1.6.0_45/org/omg/PortableServer/ServantLocatorOperations.java,Java,,6,6,55,67
/jdk1.6.0_45/org/omg/PortableServer/ServantLocatorPackage/CookieHolder.java,Java,,18,8,13,39
/jdk1.6.0_45/org/omg/PortableServer/ServantLocatorPOA.java,Java,,34,13,26,73
/jdk1.6.0_45/org/omg/PortableServer/ServantManager.java,Java,,4,4,17,25
/jdk1.6.0_45/org/omg/PortableServer/ServantManagerOperations.java,Java,,4,4,17,25
/jdk1.6.0_45/org/omg/PortableServer/ServantRetentionPolicy.java,Java,,4,4,10,18
/jdk1.6.0_45/org/omg/PortableServer/ServantRetentionPolicyOperations.java,Java,,5,5,13,23
/jdk1.6.0_45/org/omg/PortableServer/ServantRetentionPolicyValue.java,Java,,27,8,14,49
/jdk1.6.0_45/org/omg/PortableServer/SERVANT_RETENTION_POLICY_ID.java,Java,,5,4,9,18
/jdk1.6.0_45/org/omg/PortableServer/ThreadPolicy.java,Java,,4,4,11,19
/jdk1.6.0_45/org/omg/PortableServer/ThreadPolicyOperations.java,Java,,5,5,14,24
/jdk1.6.0_45/org/omg/PortableServer/ThreadPolicyValue.java,Java,,27,8,13,48
/jdk1.6.0_45/org/omg/PortableServer/THREAD_POLICY_ID.java,Java,,5,4,9,18
/jdk1.6.0_45/org/omg/PortableServer/_ServantActivatorStub.java,Java,,58,15,49,122
/jdk1.6.0_45/org/omg/PortableServer/_ServantLocatorStub.java,Java,,58,15,56,129
/jdk1.6.0_45/org/omg/SendingContext/RunTime.java,Java,,4,2,22,28
/jdk1.6.0_45/org/omg/SendingContext/RunTimeOperations.java,Java,,4,2,22,28
/jdk1.6.0_45/org/omg/stub/java/rmi/_Remote_Stub.java,Java,,11,6,28,45
/jdk1.6.0_45/org/w3c/dom/Attr.java,Java,,11,8,256,275
/jdk1.6.0_45/org/w3c/dom/bootstrap/DOMImplementationRegistry.java,Java,,209,22,169,400
/jdk1.6.0_45/org/w3c/dom/CDATASection.java,Java,,3,2,49,54
/jdk1.6.0_45/org/w3c/dom/CharacterData.java,Java,,23,9,121,153
/jdk1.6.0_45/org/w3c/dom/Comment.java,Java,,3,2,25,30
/jdk1.6.0_45/org/w3c/dom/css/Counter.java,Java,,6,5,27,38
/jdk1.6.0_45/org/w3c/dom/css/CSS2Properties.java,Java,,370,125,1282,1777
/jdk1.6.0_45/org/w3c/dom/css/CSSCharsetRule.java,Java,,7,4,40,51
/jdk1.6.0_45/org/w3c/dom/css/CSSFontFaceRule.java,Java,,4,3,21,28
/jdk1.6.0_45/org/w3c/dom/css/CSSImportRule.java,Java,,7,6,31,44
/jdk1.6.0_45/org/w3c/dom/css/CSSMediaRule.java,Java,,12,7,57,76
/jdk1.6.0_45/org/w3c/dom/css/CSSPageRule.java,Java,,8,5,31,44
/jdk1.6.0_45/org/w3c/dom/css/CSSPrimitiveValue.java,Java,,47,12,237,296
/jdk1.6.0_45/org/w3c/dom/css/CSSRule.java,Java,,17,8,72,97
/jdk1.6.0_45/org/w3c/dom/css/CSSRuleList.java,Java,,5,4,34,43
/jdk1.6.0_45/org/w3c/dom/css/CSSStyleDeclaration.java,Java,,19,12,131,162
/jdk1.6.0_45/org/w3c/dom/css/CSSStyleRule.java,Java,,8,5,34,47
/jdk1.6.0_45/org/w3c/dom/css/CSSStyleSheet.java,Java,,12,7,66,85
/jdk1.6.0_45/org/w3c/dom/css/CSSUnknownRule.java,Java,,3,2,17,22
/jdk1.6.0_45/org/w3c/dom/css/CSSValue.java,Java,,12,6,53,71
/jdk1.6.0_45/org/w3c/dom/css/CSSValueList.java,Java,,5,4,37,46
/jdk1.6.0_45/org/w3c/dom/css/DocumentCSS.java,Java,,7,4,39,50
/jdk1.6.0_45/org/w3c/dom/css/DOMImplementationCSS.java,Java,,8,4,28,40
/jdk1.6.0_45/org/w3c/dom/css/ElementCSSInlineStyle.java,Java,,4,3,25,32
/jdk1.6.0_45/org/w3c/dom/css/Rect.java,Java,,7,6,31,44
/jdk1.6.0_45/org/w3c/dom/css/RGBColor.java,Java,,6,5,36,47
/jdk1.6.0_45/org/w3c/dom/css/ViewCSS.java,Java,,7,4,32,43
/jdk1.6.0_45/org/w3c/dom/Document.java,Java,,53,29,733,815
/jdk1.6.0_45/org/w3c/dom/DocumentFragment.java,Java,,3,2,48,53
/jdk1.6.0_45/org/w3c/dom/DocumentType.java,Java,,9,8,66,83
/jdk1.6.0_45/org/w3c/dom/DOMConfiguration.java,Java,,11,6,396,413
/jdk1.6.0_45/org/w3c/dom/DOMError.java,Java,,12,9,66,87
/jdk1.6.0_45/org/w3c/dom/DOMErrorHandler.java,Java,,4,3,38,45
/jdk1.6.0_45/org/w3c/dom/DOMException.java,Java,,26,3,104,133
/jdk1.6.0_45/org/w3c/dom/DOMImplementation.java,Java,,15,6,115,136
/jdk1.6.0_45/org/w3c/dom/DOMImplementationList.java,Java,,5,4,34,43
/jdk1.6.0_45/org/w3c/dom/DOMImplementationSource.java,Java,,5,4,49,58
/jdk1.6.0_45/org/w3c/dom/DOMLocator.java,Java,,9,8,41,58
/jdk1.6.0_45/org/w3c/dom/DOMStringList.java,Java,,6,5,39,50
/jdk1.6.0_45/org/w3c/dom/Element.java,Java,,49,22,368,439
/jdk1.6.0_45/org/w3c/dom/Entity.java,Java,,9,8,73,90
/jdk1.6.0_45/org/w3c/dom/EntityReference.java,Java,,3,2,38,43
/jdk1.6.0_45/org/w3c/dom/events/DocumentEvent.java,Java,,6,4,46,56
/jdk1.6.0_45/org/w3c/dom/events/Event.java,Java,,18,13,110,141
/jdk1.6.0_45/org/w3c/dom/events/EventException.java,Java,,9,3,24,36
/jdk1.6.0_45/org/w3c/dom/events/EventListener.java,Java,,4,3,34,41
/jdk1.6.0_45/org/w3c/dom/events/EventTarget.java,Java,,11,5,86,102
/jdk1.6.0_45/org/w3c/dom/events/MouseEvent.java,Java,,29,14,113,156
/jdk1.6.0_45/org/w3c/dom/events/MutationEvent.java,Java,,20,10,78,108
/jdk1.6.0_45/org/w3c/dom/events/UIEvent.java,Java,,11,6,41,58
/jdk1.6.0_45/org/w3c/dom/html/HTMLAnchorElement.java,Java,,29,17,66,112
/jdk1.6.0_45/org/w3c/dom/html/HTMLAppletElement.java,Java,,25,14,64,103
/jdk1.6.0_45/org/w3c/dom/html/HTMLAreaElement.java,Java,,19,11,49,79
/jdk1.6.0_45/org/w3c/dom/html/HTMLBaseElement.java,Java,,7,5,22,34
/jdk1.6.0_45/org/w3c/dom/html/HTMLBaseFontElement.java,Java,,9,6,28,43
/jdk1.6.0_45/org/w3c/dom/html/HTMLBodyElement.java,Java,,15,9,45,69
/jdk1.6.0_45/org/w3c/dom/html/HTMLBRElement.java,Java,,5,4,19,28
/jdk1.6.0_45/org/w3c/dom/html/HTMLButtonElement.java,Java,,15,10,42,67
/jdk1.6.0_45/org/w3c/dom/html/HTMLCollection.java,Java,,7,7,43,57
/jdk1.6.0_45/org/w3c/dom/html/HTMLDirectoryElement.java,Java,,5,4,20,29
/jdk1.6.0_45/org/w3c/dom/html/HTMLDivElement.java,Java,,5,4,19,28
/jdk1.6.0_45/org/w3c/dom/html/HTMLDListElement.java,Java,,5,4,19,28
/jdk1.6.0_45/org/w3c/dom/html/HTMLDocument.java,Java,,24,20,111,155
/jdk1.6.0_45/org/w3c/dom/html/HTMLDOMImplementation.java,Java,,5,5,25,35
/jdk1.6.0_45/org/w3c/dom/html/HTMLElement.java,Java,,14,9,43,66
/jdk1.6.0_45/org/w3c/dom/html/HTMLFieldSetElement.java,Java,,4,4,20,28
/jdk1.6.0_45/org/w3c/dom/html/HTMLFontElement.java,Java,,9,6,28,43
/jdk1.6.0_45/org/w3c/dom/html/HTMLFormElement.java,Java,,19,13,55,87
/jdk1.6.0_45/org/w3c/dom/html/HTMLFrameElement.java,Java,,21,13,52,86
/jdk1.6.0_45/org/w3c/dom/html/HTMLFrameSetElement.java,Java,,7,5,23,35
/jdk1.6.0_45/org/w3c/dom/html/HTMLHeadElement.java,Java,,5,4,19,28
/jdk1.6.0_45/org/w3c/dom/html/HTMLHeadingElement.java,Java,,5,4,20,29
/jdk1.6.0_45/org/w3c/dom/html/HTMLHRElement.java,Java,,11,7,32,50
/jdk1.6.0_45/org/w3c/dom/html/HTMLHtmlElement.java,Java,,5,4,20,29
/jdk1.6.0_45/org/w3c/dom/html/HTMLIFrameElement.java,Java,,25,15,59,99
/jdk1.6.0_45/org/w3c/dom/html/HTMLImageElement.java,Java,,29,16,65,110
/jdk1.6.0_45/org/w3c/dom/html/HTMLInputElement.java,Java,,41,25,131,197
/jdk1.6.0_45/org/w3c/dom/html/HTMLIsIndexElement.java,Java,,6,5,24,35
/jdk1.6.0_45/org/w3c/dom/html/HTMLLabelElement.java,Java,,8,6,28,42
/jdk1.6.0_45/org/w3c/dom/html/HTMLLegendElement.java,Java,,8,6,29,43
/jdk1.6.0_45/org/w3c/dom/html/HTMLLIElement.java,Java,,7,5,24,36
/jdk1.6.0_45/org/w3c/dom/html/HTMLLinkElement.java,Java,,21,12,51,84
/jdk1.6.0_45/org/w3c/dom/html/HTMLMapElement.java,Java,,6,5,22,33
/jdk1.6.0_45/org/w3c/dom/html/HTMLMenuElement.java,Java,,5,4,20,29
/jdk1.6.0_45/org/w3c/dom/html/HTMLMetaElement.java,Java,,11,7,31,49
/jdk1.6.0_45/org/w3c/dom/html/HTMLModElement.java,Java,,7,5,24,36
/jdk1.6.0_45/org/w3c/dom/html/HTMLObjectElement.java,Java,,40,23,97,160
/jdk1.6.0_45/org/w3c/dom/html/HTMLOListElement.java,Java,,9,6,27,42
/jdk1.6.0_45/org/w3c/dom/html/HTMLOptGroupElement.java,Java,,7,5,24,36
/jdk1.6.0_45/org/w3c/dom/html/HTMLOptionElement.java,Java,,16,11,51,78
/jdk1.6.0_45/org/w3c/dom/html/HTMLParagraphElement.java,Java,,5,4,19,28
/jdk1.6.0_45/org/w3c/dom/html/HTMLParamElement.java,Java,,11,7,33,51
/jdk1.6.0_45/org/w3c/dom/html/HTMLPreElement.java,Java,,5,4,19,28
/jdk1.6.0_45/org/w3c/dom/html/HTMLQuoteElement.java,Java,,5,4,20,29
/jdk1.6.0_45/org/w3c/dom/html/HTMLScriptElement.java,Java,,17,10,40,67
/jdk1.6.0_45/org/w3c/dom/html/HTMLSelectElement.java,Java,,28,19,87,134
/jdk1.6.0_45/org/w3c/dom/html/HTMLStyleElement.java,Java,,9,6,27,42
/jdk1.6.0_45/org/w3c/dom/html/HTMLTableCaptionElement.java,Java,,5,4,19,28
/jdk1.6.0_45/org/w3c/dom/html/HTMLTableCellElement.java,Java,,32,18,76,126
/jdk1.6.0_45/org/w3c/dom/html/HTMLTableColElement.java,Java,,15,9,39,63
/jdk1.6.0_45/org/w3c/dom/html/HTMLTableElement.java,Java,,40,26,123,189
/jdk1.6.0_45/org/w3c/dom/html/HTMLTableRowElement.java,Java,,21,14,68,103
/jdk1.6.0_45/org/w3c/dom/html/HTMLTableSectionElement.java,Java,,17,11,57,85
/jdk1.6.0_45/org/w3c/dom/html/HTMLTextAreaElement.java,Java,,26,17,71,114
/jdk1.6.0_45/org/w3c/dom/html/HTMLTitleElement.java,Java,,5,4,18,27
/jdk1.6.0_45/org/w3c/dom/html/HTMLUListElement.java,Java,,7,5,23,35
/jdk1.6.0_45/org/w3c/dom/ls/DOMImplementationLS.java,Java,,12,8,102,122
/jdk1.6.0_45/org/w3c/dom/ls/LSException.java,Java,,10,3,34,47
/jdk1.6.0_45/org/w3c/dom/ls/LSInput.java,Java,,19,10,189,218
/jdk1.6.0_45/org/w3c/dom/ls/LSLoadEvent.java,Java,,7,5,23,35
/jdk1.6.0_45/org/w3c/dom/ls/LSOutput.java,Java,,11,6,89,106
/jdk1.6.0_45/org/w3c/dom/ls/LSParser.java,Java,,26,12,428,466
/jdk1.6.0_45/org/w3c/dom/ls/LSParserFilter.java,Java,,12,7,153,172
/jdk1.6.0_45/org/w3c/dom/ls/LSProgressEvent.java,Java,,7,6,35,48
/jdk1.6.0_45/org/w3c/dom/ls/LSResourceResolver.java,Java,,8,3,70,81
/jdk1.6.0_45/org/w3c/dom/ls/LSSerializer.java,Java,,19,9,408,436
/jdk1.6.0_45/org/w3c/dom/ls/LSSerializerFilter.java,Java,,5,4,54,63
/jdk1.6.0_45/org/w3c/dom/NamedNodeMap.java,Java,,18,10,155,183
/jdk1.6.0_45/org/w3c/dom/NameList.java,Java,,9,7,52,68
/jdk1.6.0_45/org/w3c/dom/Node.java,Java,,74,38,812,924
/jdk1.6.0_45/org/w3c/dom/NodeList.java,Java,,5,4,32,41
/jdk1.6.0_45/org/w3c/dom/Notation.java,Java,,5,4,31,40
/jdk1.6.0_45/org/w3c/dom/ProcessingInstruction.java,Java,,7,4,40,51
/jdk1.6.0_45/org/w3c/dom/ranges/DocumentRange.java,Java,,4,3,26,33
/jdk1.6.0_45/org/w3c/dom/ranges/Range.java,Java,,61,28,327,416
/jdk1.6.0_45/org/w3c/dom/ranges/RangeException.java,Java,,10,3,26,39
/jdk1.6.0_45/org/w3c/dom/stylesheets/DocumentStyle.java,Java,,4,3,27,34
/jdk1.6.0_45/org/w3c/dom/stylesheets/LinkStyle.java,Java,,4,3,24,31
/jdk1.6.0_45/org/w3c/dom/stylesheets/MediaList.java,Java,,13,8,64,85
/jdk1.6.0_45/org/w3c/dom/stylesheets/StyleSheet.java,Java,,12,10,81,103
/jdk1.6.0_45/org/w3c/dom/stylesheets/StyleSheetList.java,Java,,5,4,33,42
/jdk1.6.0_45/org/w3c/dom/Text.java,Java,,9,6,143,158
/jdk1.6.0_45/org/w3c/dom/traversal/DocumentTraversal.java,Java,,15,5,73,93
/jdk1.6.0_45/org/w3c/dom/traversal/NodeFilter.java,Java,,21,6,117,144
/jdk1.6.0_45/org/w3c/dom/traversal/NodeIterator.java,Java,,14,10,85,109
/jdk1.6.0_45/org/w3c/dom/traversal/TreeWalker.java,Java,,19,15,145,179
/jdk1.6.0_45/org/w3c/dom/TypeInfo.java,Java,,12,6,167,185
/jdk1.6.0_45/org/w3c/dom/UserDataHandler.java,Java,,13,4,55,72
/jdk1.6.0_45/org/w3c/dom/views/AbstractView.java,Java,,4,3,20,27
/jdk1.6.0_45/org/w3c/dom/views/DocumentView.java,Java,,4,3,23,30
/jdk1.6.0_45/org/w3c/dom/xpath/XPathEvaluator.java,Java,,15,7,111,133
/jdk1.6.0_45/org/w3c/dom/xpath/XPathException.java,Java,,10,3,26,39
/jdk1.6.0_45/org/w3c/dom/xpath/XPathExpression.java,Java,,9,5,52,66
/jdk1.6.0_45/org/w3c/dom/xpath/XPathNamespace.java,Java,,7,6,52,65
/jdk1.6.0_45/org/w3c/dom/xpath/XPathNSResolver.java,Java,,4,4,27,35
/jdk1.6.0_45/org/w3c/dom/xpath/XPathResult.java,Java,,31,14,167,212
/jdk1.6.0_45/org/xml/sax/AttributeList.java,Java,,9,21,163,193
/jdk1.6.0_45/org/xml/sax/Attributes.java,Java,,16,34,207,257
/jdk1.6.0_45/org/xml/sax/ContentHandler.java,Java,,27,25,367,419
/jdk1.6.0_45/org/xml/sax/DocumentHandler.java,Java,,18,20,194,232
/jdk1.6.0_45/org/xml/sax/DTDHandler.java,Java,,12,8,97,117
/jdk1.6.0_45/org/xml/sax/EntityResolver.java,Java,,7,8,104,119
/jdk1.6.0_45/org/xml/sax/ErrorHandler.java,Java,,9,11,119,139
/jdk1.6.0_45/org/xml/sax/ext/Attributes2.java,Java,,11,9,112,132
/jdk1.6.0_45/org/xml/sax/ext/Attributes2Impl.java,Java,,129,46,133,308
/jdk1.6.0_45/org/xml/sax/ext/DeclHandler.java,Java,,18,13,115,146
/jdk1.6.0_45/org/xml/sax/ext/DefaultHandler2.java,Java,,55,24,51,130
/jdk1.6.0_45/org/xml/sax/ext/EntityResolver2.java,Java,,17,6,174,197
/jdk1.6.0_45/org/xml/sax/ext/LexicalHandler.java,Java,,20,18,174,212
/jdk1.6.0_45/org/xml/sax/ext/Locator2.java,Java,,7,5,63,75
/jdk1.6.0_45/org/xml/sax/ext/Locator2Impl.java,Java,,26,15,60,101
/jdk1.6.0_45/org/xml/sax/HandlerBase.java,Java,,61,42,266,369
/jdk1.6.0_45/org/xml/sax/helpers/AttributeListImpl.java,Java,,90,43,179,312
/jdk1.6.0_45/org/xml/sax/helpers/AttributesImpl.java,Java,,255,75,288,618
/jdk1.6.0_45/org/xml/sax/helpers/DefaultHandler.java,Java,,86,51,330,467
/jdk1.6.0_45/org/xml/sax/helpers/LocatorImpl.java,Java,,51,36,127,214
/jdk1.6.0_45/org/xml/sax/helpers/NamespaceSupport.java,Java,,277,93,454,824
/jdk1.6.0_45/org/xml/sax/helpers/NewInstance.java,Java,,24,6,33,63
/jdk1.6.0_45/org/xml/sax/helpers/ParserAdapter.java,Java,,452,142,452,1046
/jdk1.6.0_45/org/xml/sax/helpers/ParserFactory.java,Java,,31,11,81,123
/jdk1.6.0_45/org/xml/sax/helpers/SecuritySupport.java,Java,,63,12,15,90
/jdk1.6.0_45/org/xml/sax/helpers/XMLFilterImpl.java,Java,,255,106,352,713
/jdk1.6.0_45/org/xml/sax/helpers/XMLReaderAdapter.java,Java,,178,85,275,538
/jdk1.6.0_45/org/xml/sax/helpers/XMLReaderFactory.java,Java,,87,19,113,219
/jdk1.6.0_45/org/xml/sax/InputSource.java,Java,,65,36,235,336
/jdk1.6.0_45/org/xml/sax/Locator.java,Java,,7,13,116,136
/jdk1.6.0_45/org/xml/sax/Parser.java,Java,,16,19,174,209
/jdk1.6.0_45/org/xml/sax/SAXException.java,Java,,48,24,91,163
/jdk1.6.0_45/org/xml/sax/SAXNotRecognizedException.java,Java,,13,8,34,55
/jdk1.6.0_45/org/xml/sax/SAXNotSupportedException.java,Java,,13,7,35,55
/jdk1.6.0_45/org/xml/sax/SAXParseException.java,Java,,63,34,174,271
/jdk1.6.0_45/org/xml/sax/XMLFilter.java,Java,,6,8,51,65
/jdk1.6.0_45/org/xml/sax/XMLReader.java,Java,,25,40,339,404
/jdk1.6.0_45/sunw/io/Serializable.java,Java,,3,3,30,36
/jdk1.6.0_45/sunw/util/EventListener.java,Java,,3,3,30,36
/jdk1.6.0_45/sunw/util/EventObject.java,Java,,7,6,30,43
