CommandHandler.java,Java,,13,8,11,32
NameServiceStartThread.java,Java,,29,7,9,45
ORBD.java,Java,,244,50,56,350
ProcessMonitorThread.java,Java,,55,12,21,88
RepositoryImpl.java,Java,,348,78,46,472
ServerMain.java,Java,,247,71,63,381
ServerManagerImpl.java,Java,,467,109,52,628
ServerTableEntry.java,Java,,380,91,55,526
ServerTool.java,Java,,729,166,61,956
CopierManagerImpl.java,Java,,38,12,6,56
FallbackObjectCopierImpl.java,Java,,22,5,10,37
JavaStreamObjectCopierImpl.java,Java,,39,13,8,60
ORBStreamObjectCopierImpl.java,Java,,27,10,8,45
ReferenceObjectCopierImpl.java,Java,,9,4,6,19
AnyImpl.java,Java,,817,136,368,1321
AnyImplHelper.java,Java,,37,9,17,63
AsynchInvoke.java,Java,,25,15,36,76
ContextImpl.java,Java,,53,16,14,83
ContextListImpl.java,Java,,43,10,15,68
CORBAObjectImpl.java,Java,,8,2,17,27
EnvironmentImpl.java,Java,,22,9,14,45
ExceptionListImpl.java,Java,,40,14,14,68
NamedValueImpl.java,Java,,38,9,16,63
NVListImpl.java,Java,,65,16,16,97
PrincipalImpl.java,Java,,13,5,14,32
RequestImpl.java,Java,,249,49,60,358
ServerRequestImpl.java,Java,,139,41,61,241
TCUtility.java,Java,,233,55,25,313
TypeCodeFactory.java,Java,,7,5,6,18
TypeCodeImpl.java,Java,,1745,288,364,2397
TypeCodeImplHelper.java,Java,,41,10,14,65
DynAnyBasicImpl.java,Java,,535,58,25,618
DynAnyCollectionImpl.java,Java,,117,25,45,187
DynAnyComplexImpl.java,Java,,278,40,85,403
DynAnyConstructedImpl.java,Java,,790,72,57,919
DynAnyFactoryImpl.java,Java,,36,15,18,69
DynAnyImpl.java,Java,,118,27,37,182
DynAnyUtil.java,Java,,214,17,89,320
DynArrayImpl.java,Java,,65,18,37,120
DynEnumImpl.java,Java,,110,21,41,172
DynFixedImpl.java,Java,,122,11,59,192
DynSequenceImpl.java,Java,,129,25,85,239
DynStructImpl.java,Java,,40,10,19,69
DynUnionImpl.java,Java,,249,32,86,367
DynValueBoxImpl.java,Java,,88,15,12,115
DynValueCommonImpl.java,Java,,79,18,32,129
DynValueImpl.java,Java,,25,7,9,41
BufferManagerFactory.java,Java,,92,14,19,125
BufferManagerRead.java,Java,,15,13,49,77
BufferManagerReadGrow.java,Java,,48,18,15,81
BufferManagerReadStream.java,Java,,237,51,52,340
BufferManagerWrite.java,Java,,29,20,84,133
BufferManagerWriteCollect.java,Java,,128,39,46,213
BufferManagerWriteGrow.java,Java,,38,17,19,74
BufferManagerWriteStream.java,Java,,53,25,30,108
BufferQueue.java,Java,,24,6,12,42
ByteBufferWithInfo.java,Java,,153,36,50,239
CachedCodeBase.java,Java,,109,43,43,195
CDRInputObject.java,Java,,136,46,67,249
CDRInputStream.java,Java,,346,108,65,519
CDRInputStreamBase.java,Java,,111,31,41,183
CDRInputStream_1_0.java,Java,,1494,445,502,2441
CDRInputStream_1_1.java,Java,,75,45,51,171
CDRInputStream_1_2.java,Java,,56,25,45,126
CDROutputObject.java,Java,,195,42,68,305
CDROutputStream.java,Java,,309,66,38,413
CDROutputStreamBase.java,Java,,101,31,27,159
CDROutputStream_1_0.java,Java,,1254,377,300,1931
CDROutputStream_1_1.java,Java,,54,30,48,132
CDROutputStream_1_2.java,Java,,138,69,134,341
CodeSetCache.java,Java,,33,15,43,91
CodeSetComponentInfo.java,Java,,197,60,68,325
CodeSetConversion.java,Java,,314,113,262,689
EncapsInputStream.java,Java,,92,26,49,167
EncapsOutputStream.java,Java,,59,20,46,125
IDLJavaSerializationInputStream.java,Java,,748,161,156,1065
IDLJavaSerializationOutputStream.java,Java,,557,129,94,780
MarkAndResetHandler.java,Java,,7,4,10,21
MarshalInputStream.java,Java,,44,10,30,84
MarshalOutputStream.java,Java,,46,13,12,71
OSFCodeSetRegistry.java,Java,,104,21,87,212
RestorableInputStream.java,Java,,6,2,11,19
TypeCodeInputStream.java,Java,,117,21,35,173
TypeCodeOutputStream.java,Java,,132,26,84,242
TypeCodeReader.java,Java,,44,7,8,59
WrapperInputStream.java,Java,,154,21,18,193
CDREncapsCodec.java,Java,,94,29,75,198
ClientRequestInfoImpl.java,Java,,497,135,325,957
CodecFactoryImpl.java,Java,,51,16,37,104
InterceptorInvoker.java,Java,,335,74,235,644
InterceptorList.java,Java,,130,30,83,243
IORInfoImpl.java,Java,,151,53,96,300
ORBInitInfoImpl.java,Java,,175,50,138,363
PICurrent.java,Java,,69,25,61,155
PIHandlerImpl.java,Java,,552,138,244,934
PINoOpHandlerImpl.java,Java,,117,47,12,176
RequestInfoImpl.java,Java,,394,120,392,906
ServerRequestInfoImpl.java,Java,,452,138,299,889
SlotTable.java,Java,,44,13,33,90
SlotTableStack.java,Java,,78,25,67,170
FVDCodeBaseImpl.java,Java,,103,28,37,168
IIOPInputStream.java,Java,,1712,371,629,2712
IIOPOutputStream.java,Java,,534,127,141,802
InputStreamHook.java,Java,,267,85,101,453
ObjectStreamClass.java,Java,,996,218,554,1768
ObjectStreamClassCorbaExt.java,Java,,51,14,29,94
ObjectStreamField.java,Java,,154,36,65,255
OptionalDataException.java,Java,,13,6,41,60
OutputStreamHook.java,Java,,141,66,89,296
TypeMismatchException.java,Java,,12,3,14,29
ValueHandlerImpl.java,Java,,576,131,159,866
ValueUtility.java,Java,,321,65,65,451
ByteBuffer.java,Java,,80,18,92,190
EncapsulationUtility.java,Java,,72,18,31,121
FreezableList.java,Java,,85,24,15,124
GenericIdentifiable.java,Java,,54,16,10,80
GenericTaggedComponent.java,Java,,23,8,14,45
GenericTaggedProfile.java,Java,,58,17,10,85
IdentifiableFactoryFinderBase.java,Java,,45,14,6,65
AlternateIIOPAddressComponentImpl.java,Java,,43,15,9,67
CodeSetsComponentImpl.java,Java,,57,18,10,85
IIOPAddressBase.java,Java,,42,12,15,69
IIOPAddressClosureImpl.java,Java,,24,8,9,41
IIOPAddressImpl.java,Java,,38,13,9,60
IIOPProfileImpl.java,Java,,228,65,37,330
IIOPProfileTemplateImpl.java,Java,,101,33,19,153
JavaCodebaseComponentImpl.java,Java,,43,16,9,68
JavaSerializationComponent.java,Java,,42,13,15,70
MaxStreamFormatVersionComponentImpl.java,Java,,51,19,11,81
ORBTypeComponentImpl.java,Java,,41,15,9,65
RequestPartitioningComponentImpl.java,Java,,56,16,3,75
IORImpl.java,Java,,202,65,51,318
IORTemplateImpl.java,Java,,81,25,14,120
IORTemplateListImpl.java,Java,,84,17,10,111
JIDLObjectKeyTemplate.java,Java,,37,14,14,65
NewObjectKeyTemplateBase.java,Java,,37,12,7,56
ObjectAdapterIdArray.java,Java,,28,8,8,44
ObjectAdapterIdBase.java,Java,,57,17,6,80
ObjectAdapterIdNumber.java,Java,,15,5,12,32
ObjectIdImpl.java,Java,,35,10,9,54
ObjectKeyFactoryImpl.java,Java,,119,35,66,220
ObjectKeyImpl.java,Java,,54,18,9,81
ObjectKeyTemplateBase.java,Java,,128,38,13,179
ObjectReferenceFactoryImpl.java,Java,,75,25,24,124
ObjectReferenceProducerBase.java,Java,,26,13,6,45
ObjectReferenceTemplateImpl.java,Java,,95,28,24,147
OldJIDLObjectKeyTemplate.java,Java,,52,20,29,101
OldObjectKeyTemplateBase.java,Java,,21,7,10,38
OldPOAObjectKeyTemplate.java,Java,,49,13,14,76
POAObjectKeyTemplate.java,Java,,43,16,14,73
StubIORImpl.java,Java,,172,37,42,251
TaggedComponentFactoryFinderImpl.java,Java,,33,11,10,54
TaggedProfileFactoryFinderImpl.java,Java,,17,7,9,33
TaggedProfileTemplateFactoryFinderImpl.java,Java,,18,8,9,35
WireObjectKeyTemplate.java,Java,,91,27,19,137
StubDelegateImpl.java,Java,,92,31,67,190
Util.java,Java,,457,78,211,746
PortableRemoteObject.java,Java,,181,54,111,346
DefaultSocketFactory.java,Java,,88,17,8,113
EndPointInfoImpl.java,Java,,76,16,7,99
LegacyServerSocketManagerImpl.java,Java,,121,23,26,170
SocketFactoryAcceptorImpl.java,Java,,46,12,18,76
SocketFactoryConnectionImpl.java,Java,,72,13,17,102
SocketFactoryContactInfoImpl.java,Java,,56,16,22,94
SocketFactoryContactInfoListImpl.java,Java,,23,8,15,46
SocketFactoryContactInfoListIteratorImpl.java,Java,,66,15,18,99
USLPort.java,Java,,14,6,7,27
ActivationSystemException.java,Java,,186,66,13,265
InterceptorsSystemException.java,Java,,702,238,25,965
IORSystemException.java,Java,,360,123,16,499
NamingSystemException.java,Java,,523,179,16,718
OMGSystemException.java,Java,,2814,951,64,3829
ORBUtilSystemException.java,Java,,6740,2213,49,9002
POASystemException.java,Java,,1539,521,34,2094
UtilSystemException.java,Java,,686,224,25,935
MonitoredAttributeInfoFactoryImpl.java,Java,,14,3,6,23
MonitoredAttributeInfoImpl.java,Java,,27,10,6,43
MonitoredObjectFactoryImpl.java,Java,,10,5,6,21
MonitoredObjectImpl.java,Java,,91,27,15,133
MonitoringManagerFactoryImpl.java,Java,,21,7,6,34
MonitoringManagerImpl.java,Java,,26,12,6,44
BindingIteratorImpl.java,Java,,57,18,92,167
InternalBindingKey.java,Java,,52,8,24,84
InternalBindingValue.java,Java,,15,5,13,33
InterOperableNamingImpl.java,Java,,297,22,77,396
NamingContextDataStore.java,Java,,25,11,61,97
NamingContextImpl.java,Java,,502,66,442,1010
NamingUtils.java,Java,,52,15,47,114
TransientBindingIterator.java,Java,,57,10,49,116
TransientNameServer.java,Java,,132,32,54,218
TransientNameService.java,Java,,68,19,53,140
TransientNamingContext.java,Java,,178,30,132,340
CorbalocURL.java,Java,,140,18,112,270
CorbanameURL.java,Java,,55,10,38,103
IIOPEndpointInfo.java,Java,,41,14,20,75
INSURL.java,Java,,9,9,17,35
INSURLBase.java,Java,,32,11,16,59
INSURLHandler.java,Java,,25,9,13,47
NamingConstants.java,Java,,7,5,11,23
Utility.java,Java,,48,12,25,85
InternalBindingKey.java,Java,,79,13,41,133
InternalBindingValue.java,Java,,25,8,33,66
NameServer.java,Java,,48,17,21,86
NameService.java,Java,,129,24,79,232
NamingContextImpl.java,Java,,632,118,553,1303
PersistentBindingIterator.java,Java,,66,12,61,139
ServantManagerImpl.java,Java,,180,49,30,259
NullServantImpl.java,Java,,15,6,6,27
ActiveObjectMap.java,Java,,187,44,17,248
AOMEntry.java,Java,,148,33,24,205
BadServerIdHandler.java,Java,,6,3,28,37
DelegateImpl.java,Java,,101,19,9,129
IdAssignmentPolicyImpl.java,Java,,30,10,6,46
IdUniquenessPolicyImpl.java,Java,,29,10,6,45
ImplicitActivationPolicyImpl.java,Java,,31,10,6,47
LifespanPolicyImpl.java,Java,,29,10,6,45
POACurrent.java,Java,,115,25,24,164
POAFactory.java,Java,,164,41,17,222
POAImpl.java,Java,,1055,261,358,1674
POAManagerImpl.java,Java,,364,80,85,529
POAPolicyMediator.java,Java,,30,19,58,107
POAPolicyMediatorBase.java,Java,,92,25,14,131
POAPolicyMediatorBase_R.java,Java,,133,40,16,189
POAPolicyMediatorFactory.java,Java,,23,2,9,34
POAPolicyMediatorImpl_NR_UDS.java,Java,,81,23,13,117
POAPolicyMediatorImpl_NR_USM.java,Java,,109,28,13,150
POAPolicyMediatorImpl_R_AOM.java,Java,,60,14,16,90
POAPolicyMediatorImpl_R_UDS.java,Java,,69,19,12,100
POAPolicyMediatorImpl_R_USM.java,Java,,260,53,49,362
Policies.java,Java,,243,43,48,334
RequestProcessingPolicyImpl.java,Java,,40,11,6,57
ServantRetentionPolicyImpl.java,Java,,29,10,6,45
ThreadPolicyImpl.java,Java,,29,10,6,45
TOA.java,Java,,6,5,17,28
TOAFactory.java,Java,,63,22,11,96
TOAImpl.java,Java,,126,32,52,210
TransientObjectManager.java,Java,,132,37,21,190
AppletDataCollector.java,Java,,23,9,8,40
DataCollectorBase.java,Java,,306,81,68,455
DataCollectorFactory.java,Java,,32,10,6,48
NormalDataCollector.java,Java,,26,9,6,41
NormalParserAction.java,Java,,18,6,10,34
NormalParserData.java,Java,,22,7,6,35
ORBConfiguratorImpl.java,Java,,441,89,80,610
ORBDataParserImpl.java,Java,,299,56,46,401
ORBImpl.java,Java,,1343,279,467,2089
ORBSingleton.java,Java,,557,142,58,757
ORBVersionImpl.java,Java,,51,19,10,80
ParserAction.java,Java,,8,6,16,30
ParserActionBase.java,Java,,51,16,6,73
ParserActionFactory.java,Java,,15,5,6,26
ParserDataBase.java,Java,,25,5,6,36
ParserTable.java,Java,,836,113,102,1051
PrefixParserAction.java,Java,,72,15,17,104
PrefixParserData.java,Java,,32,10,6,48
PropertyOnlyDataCollector.java,Java,,22,8,0,30
CacheTable.java,Java,,124,6,15,145
Constant.java,Java,,13,6,6,25
Future.java,Java,,21,6,6,33
CondVar.java,Java,,112,28,176,316
DebugMutex.java,Java,,68,12,108,188
Mutex.java,Java,,54,10,105,169
ReentrantMutex.java,Java,,180,33,113,326
Sync.java,Java,,13,21,306,340
SyncUtil.java,Java,,17,4,10,31
CorbaResourceUtil.java,Java,,57,14,6,77
DenseIntMapImpl.java,Java,,34,9,17,60
GuardedAction.java,Java,,38,9,6,53
NameBase.java,Java,,43,10,7,60
StateEngineImpl.java,Java,,221,55,35,311
GetPropertyAction.java,Java,,16,6,48,70
Graph.java,Java,,7,4,6,17
GraphImpl.java,Java,,112,29,28,169
Node.java,Java,,6,3,10,19
NodeData.java,Java,,31,8,13,52
HexOutputStream.java,Java,,30,10,23,63
IIOPInputStream_1_3.java,Java,,19,4,16,39
IIOPInputStream_1_3_1.java,Java,,15,5,15,35
IIOPOutputStream_1_3.java,Java,,24,6,20,50
IIOPOutputStream_1_3_1.java,Java,,20,9,19,48
LegacyHookGetFields.java,Java,,73,24,41,138
LegacyHookPutFields.java,Java,,37,13,42,92
LogKeywords.java,Java,,48,14,23,85
ObjectStreamClassUtil_1_3.java,Java,,370,71,112,553
ObjectStreamClass_1_3_1.java,Java,,707,161,394,1262
ObjectStreamField.java,Java,,139,34,81,254
ObjectUtility.java,Java,,547,79,78,704
ObjectWriter.java,Java,,145,36,17,198
ORBClassLoader.java,Java,,15,2,12,29
ORBConstants.java,Java,,196,95,162,453
ORBUtility.java,Java,,567,99,181,847
RepIdDelegator.java,Java,,108,33,18,159
RepIdDelegator_1_3.java,Java,,108,33,18,159
RepIdDelegator_1_3_1.java,Java,,108,33,18,159
RepositoryIdCache_1_3.java,Java,,41,18,35,94
RepositoryIdCache_1_3_1.java,Java,,41,18,27,86
RepositoryIdFactory.java,Java,,56,9,20,85
RepositoryIdInterface.java,Java,,14,6,10,30
RepositoryIdStrings.java,Java,,16,9,10,35
RepositoryIdUtility.java,Java,,20,6,15,41
RepositoryId_1_3.java,Java,,671,168,136,975
RepositoryId_1_3_1.java,Java,,717,182,148,1047
StackImpl.java,Java,,35,9,17,61
ThreadPoolImpl.java,Java,,328,80,114,522
ThreadPoolManagerImpl.java,Java,,104,33,78,215
TimeoutException.java,Java,,4,4,5,13
WorkQueueImpl.java,Java,,123,36,21,180
ValueHandlerImpl_1_3.java,Java,,123,33,79,235
ValueHandlerImpl_1_3_1.java,Java,,24,7,28,59
DynamicAccessPermission.java,Java,,12,6,27,45
DynamicMethodMarshallerImpl.java,Java,,361,67,19,447
DynamicStubImpl.java,Java,,106,27,9,142
ExceptionHandler.java,Java,,10,6,23,39
ExceptionHandlerImpl.java,Java,,192,50,36,278
IDLNameTranslatorImpl.java,Java,,510,171,232,913
IDLType.java,Java,,56,21,29,106
IDLTypeException.java,Java,,7,5,10,22
IDLTypesUtil.java,Java,,390,93,97,580
InvocationHandlerFactoryImpl.java,Java,,82,23,35,140
JNDIStateFactoryImpl.java,Java,,72,25,55,152
PresentationManagerImpl.java,Java,,225,59,23,307
ReflectiveTie.java,Java,,117,29,12,158
StubConnectImpl.java,Java,,58,20,20,98
StubFactoryBase.java,Java,,30,10,6,46
StubFactoryDynamicBase.java,Java,,25,8,8,41
StubFactoryFactoryBase.java,Java,,11,4,11,26
StubFactoryFactoryDynamicBase.java,Java,,58,18,7,83
StubFactoryFactoryProxyImpl.java,Java,,11,3,6,20
StubFactoryFactoryStaticImpl.java,Java,,87,23,21,131
StubFactoryProxyImpl.java,Java,,25,6,8,39
StubFactoryStaticImpl.java,Java,,24,6,6,36
StubInvocationHandlerImpl.java,Java,,141,32,22,195
AddressingDispositionException.java,Java,,11,6,21,38
BootstrapServerRequestDispatcher.java,Java,,73,21,37,131
CorbaClientDelegateImpl.java,Java,,295,65,66,426
CorbaClientRequestDispatcherImpl.java,Java,,642,162,190,994
CorbaInvocationInfo.java,Java,,68,21,11,100
CorbaMessageMediatorImpl.java,Java,,1651,312,393,2356
CorbaServerRequestDispatcherImpl.java,Java,,578,130,162,870
FullServantCacheLocalCRDImpl.java,Java,,39,15,9,63
AddressingDispositionHelper.java,Java,,40,11,12,63
CancelRequestMessage.java,Java,,5,3,12,20
CancelRequestMessage_1_0.java,Java,,28,15,16,59
CancelRequestMessage_1_1.java,Java,,28,15,16,59
CancelRequestMessage_1_2.java,Java,,28,15,16,59
FragmentMessage.java,Java,,5,3,12,20
FragmentMessage_1_1.java,Java,,29,13,20,62
FragmentMessage_1_2.java,Java,,55,16,20,91
IORAddressingInfo.java,Java,,14,7,12,33
IORAddressingInfoHelper.java,Java,,66,11,12,89
KeyAddr.java,Java,,5,4,12,21
LocateReplyMessage.java,Java,,11,5,12,28
LocateReplyMessage_1_0.java,Java,,76,27,20,123
LocateReplyMessage_1_1.java,Java,,77,26,20,123
LocateReplyMessage_1_2.java,Java,,115,33,30,178
LocateReplyOrReplyMessage.java,Java,,10,6,7,23
LocateRequestMessage.java,Java,,6,4,12,22
LocateRequestMessage_1_0.java,Java,,48,18,17,83
LocateRequestMessage_1_1.java,Java,,49,19,17,85
LocateRequestMessage_1_2.java,Java,,46,18,17,81
Message.java,Java,,42,20,18,80
MessageBase.java,Java,,702,107,139,948
MessageHandler.java,Java,,21,10,24,55
Message_1_0.java,Java,,71,24,31,126
Message_1_1.java,Java,,96,32,51,179
Message_1_2.java,Java,,42,11,11,64
ProfileAddr.java,Java,,5,4,12,21
ReferenceAddr.java,Java,,5,4,12,21
ReplyMessage.java,Java,,15,6,14,35
ReplyMessage_1_0.java,Java,,131,32,22,185
ReplyMessage_1_1.java,Java,,132,31,22,185
ReplyMessage_1_2.java,Java,,141,37,37,215
RequestMessage.java,Java,,15,9,13,37
RequestMessage_1_0.java,Java,,97,26,21,144
RequestMessage_1_1.java,Java,,118,23,17,158
RequestMessage_1_2.java,Java,,116,28,39,183
TargetAddress.java,Java,,77,17,12,106
TargetAddressHelper.java,Java,,108,14,15,137
InfoOnlyServantCacheLocalCRDImpl.java,Java,,29,12,9,50
INSServerRequestDispatcher.java,Java,,40,11,32,83
JIDLLocalCRDImpl.java,Java,,41,16,15,72
LocalClientRequestDispatcherBase.java,Java,,66,21,35,122
MinimalServantCacheLocalCRDImpl.java,Java,,27,10,6,43
NotLocalLocalCRDImpl.java,Java,,25,9,15,49
POALocalCRDImpl.java,Java,,91,24,30,145
RequestCanceledException.java,Java,,10,5,9,24
RequestDispatcherRegistryImpl.java,Java,,111,29,25,165
ServantCacheLocalCRDBase.java,Java,,49,18,11,78
SharedCDRClientRequestDispatcherImpl.java,Java,,132,29,43,204
SpecialMethod.java,Java,,119,25,7,151
BootstrapResolverImpl.java,Java,,85,30,25,140
CompositeResolverImpl.java,Java,,27,6,0,33
FileResolverImpl.java,Java,,65,16,11,92
INSURLOperationImpl.java,Java,,210,35,64,309
LocalResolverImpl.java,Java,,21,7,6,34
ORBDefaultInitRefResolverImpl.java,Java,,29,9,6,44
ORBInitRefResolverImpl.java,Java,,31,9,0,40
SplitLocalResolverImpl.java,Java,,27,9,6,42
ByteBufferPoolImpl.java,Java,,93,25,71,189
CorbaConnectionCacheBase.java,Java,,158,35,48,241
CorbaContactInfoBase.java,Java,,189,43,42,274
CorbaContactInfoListImpl.java,Java,,139,30,53,222
CorbaContactInfoListIteratorImpl.java,Java,,147,37,57,241
CorbaInboundConnectionCacheImpl.java,Java,,133,25,26,184
CorbaOutboundConnectionCacheImpl.java,Java,,143,24,25,192
CorbaResponseWaitingRoomImpl.java,Java,,196,53,55,304
CorbaTransportManagerImpl.java,Java,,190,30,34,254
DefaultIORToSocketInfoImpl.java,Java,,47,10,12,69
DefaultSocketFactoryImpl.java,Java,,59,15,9,83
EventHandlerBase.java,Java,,95,19,18,132
ListenerThreadImpl.java,Java,,85,24,20,129
ReaderThreadImpl.java,Java,,90,24,21,135
ReadTCPTimeoutsImpl.java,Java,,23,6,11,40
SelectorImpl.java,Java,,423,51,50,524
SharedCDRContactInfoImpl.java,Java,,110,25,34,169
SocketOrChannelAcceptorImpl.java,Java,,468,81,97,646
SocketOrChannelConnectionImpl.java,Java,,1091,213,336,1640
SocketOrChannelContactInfoImpl.java,Java,,134,30,35,199
IdentityHashtable.java,Java,,162,33,172,367
IdentityHashtableEnumerator.java,Java,,37,7,18,62
JDKBridge.java,Java,,91,20,71,182
JDKClassLoader.java,Java,,86,25,65,176
ORBProperties.java,Java,,29,11,16,56
PackagePrefixChecker.java,Java,,35,14,11,60
RepositoryId.java,Java,,679,176,125,980
RepositoryIdCache.java,Java,,41,18,35,94
SUNVMCID.java,Java,,4,4,15,23
Utility.java,Java,,643,118,225,986
Version.java,Java,,16,5,14,35
ORBSingleton.java,Java,,8,4,11,23
BootstrapServer.java,Java,,59,21,35,115
ORB.java,Java,,9,2,9,20
PIORB.java,Java,,9,4,11,24
IIOPInputStream.java,Java,,26,5,17,48
IIOPOutputStream.java,Java,,14,6,13,33
LibraryManager.java,Java,,7,4,14,25
ObjectStreamClass.java,Java,,4,4,7,15
POAORB.java,Java,,8,2,9,19
ORB.java,Java,,11,3,25,39
Broker.java,Java,,10,5,10,25
InputObject.java,Java,,9,8,29,46
OutputObject.java,Java,,9,7,31,47
ClientDelegate.java,Java,,8,5,28,41
ClientInvocationInfo.java,Java,,18,14,10,42
ClientRequestDispatcher.java,Java,,20,6,61,87
MessageMediator.java,Java,,21,15,77,113
ProtocolHandler.java,Java,,6,4,25,35
ServerRequestDispatcher.java,Java,,6,4,20,30
Acceptor.java,Java,,28,21,145,194
ByteBufferPool.java,Java,,8,4,10,22
Connection.java,Java,,29,30,154,213
ConnectionCache.java,Java,,10,8,10,28
ContactInfo.java,Java,,33,20,162,215
ContactInfoList.java,Java,,6,4,24,34
ContactInfoListIterator.java,Java,,12,7,46,65
EventHandler.java,Java,,20,21,16,57
InboundConnectionCache.java,Java,,8,5,10,23
ListenerThread.java,Java,,6,11,10,27
OutboundConnectionCache.java,Java,,8,5,10,23
ReaderThread.java,Java,,5,11,10,26
ResponseWaitingRoom.java,Java,,11,9,11,31
Selector.java,Java,,10,11,10,31
TransportManager.java,Java,,20,14,10,44
Activator.java,Java,,4,3,6,13
ActivatorHelper.java,Java,,67,12,6,85
ActivatorHolder.java,Java,,24,8,6,38
ActivatorOperations.java,Java,,16,15,42,73
BadServerDefinition.java,Java,,19,8,6,33
BadServerDefinitionHelper.java,Java,,61,10,8,79
BadServerDefinitionHolder.java,Java,,24,8,6,38
EndPointInfo.java,Java,,14,6,6,26
EndPointInfoHelper.java,Java,,67,10,6,83
EndPointInfoHolder.java,Java,,24,8,6,38
EndpointInfoListHelper.java,Java,,46,11,8,65
EndpointInfoListHolder.java,Java,,24,10,8,42
IIOP_CLEAR_TEXT.java,Java,,5,4,11,20
InitialNameService.java,Java,,4,4,9,17
InitialNameServiceHelper.java,Java,,67,13,9,89
InitialNameServiceHolder.java,Java,,24,9,9,42
InitialNameServiceOperations.java,Java,,5,5,11,21
NameAlreadyBound.java,Java,,12,7,6,25
NameAlreadyBoundHelper.java,Java,,54,10,8,72
NameAlreadyBoundHolder.java,Java,,24,8,6,38
InvalidORBid.java,Java,,12,7,6,25
InvalidORBidHelper.java,Java,,54,10,8,72
InvalidORBidHolder.java,Java,,24,8,6,38
Locator.java,Java,,4,3,6,13
LocatorHelper.java,Java,,67,12,6,85
LocatorHolder.java,Java,,24,8,6,38
LocatorOperations.java,Java,,8,7,19,34
ServerLocationPerORB.java,Java,,14,6,6,26
ServerLocationPerORBHelper.java,Java,,68,10,6,84
ServerLocationPerORBHolder.java,Java,,24,8,6,38
ServerLocationPerType.java,Java,,14,6,6,26
ServerLocationPerTypeHelper.java,Java,,68,10,6,84
ServerLocationPerTypeHolder.java,Java,,24,8,6,38
NoSuchEndPoint.java,Java,,12,7,6,25
NoSuchEndPointHelper.java,Java,,54,10,8,72
NoSuchEndPointHolder.java,Java,,24,8,6,38
ORBAlreadyRegistered.java,Java,,19,8,6,33
ORBAlreadyRegisteredHelper.java,Java,,62,10,8,80
ORBAlreadyRegisteredHolder.java,Java,,24,8,6,38
ORBidListHelper.java,Java,,47,11,8,66
ORBidListHolder.java,Java,,24,10,8,42
ORBPortInfo.java,Java,,14,6,6,26
ORBPortInfoHelper.java,Java,,68,10,6,84
ORBPortInfoHolder.java,Java,,24,8,6,38
ORBPortInfoListHelper.java,Java,,46,11,8,65
ORBPortInfoListHolder.java,Java,,24,10,8,42
ORBProxy.java,Java,,4,4,8,16
ORBProxyHelper.java,Java,,67,13,8,88
ORBProxyHolder.java,Java,,24,9,8,41
ORBProxyOperations.java,Java,,5,5,14,24
Repository.java,Java,,4,3,6,13
RepositoryHelper.java,Java,,67,12,6,85
RepositoryHolder.java,Java,,24,8,6,38
RepositoryOperations.java,Java,,13,12,29,54
AppNamesHelper.java,Java,,46,11,8,65
AppNamesHolder.java,Java,,24,10,8,42
ServerDef.java,Java,,22,11,11,44
ServerDefHelper.java,Java,,94,10,6,110
ServerDefHolder.java,Java,,24,8,6,38
ServerAlreadyActive.java,Java,,19,8,6,33
ServerAlreadyActiveHelper.java,Java,,62,10,8,80
ServerAlreadyActiveHolder.java,Java,,24,8,6,38
ServerAlreadyInstalled.java,Java,,19,8,6,33
ServerAlreadyInstalledHelper.java,Java,,62,10,8,80
ServerAlreadyInstalledHolder.java,Java,,24,8,6,38
ServerAlreadyRegistered.java,Java,,19,8,6,33
ServerAlreadyRegisteredHelper.java,Java,,62,10,8,80
ServerAlreadyRegisteredHolder.java,Java,,24,8,6,38
ServerAlreadyUninstalled.java,Java,,19,8,6,33
ServerAlreadyUninstalledHelper.java,Java,,62,10,8,80
ServerAlreadyUninstalledHolder.java,Java,,24,8,6,38
ServerHeldDown.java,Java,,19,8,6,33
ServerHeldDownHelper.java,Java,,62,10,8,80
ServerHeldDownHolder.java,Java,,24,8,6,38
ServerIdsHelper.java,Java,,47,11,8,66
ServerIdsHolder.java,Java,,24,10,8,42
ServerManager.java,Java,,4,4,10,18
ServerManagerHelper.java,Java,,67,13,10,90
ServerManagerHolder.java,Java,,24,9,10,43
ServerManagerOperations.java,Java,,4,4,10,18
ServerNotActive.java,Java,,19,8,6,33
ServerNotActiveHelper.java,Java,,62,10,8,80
ServerNotActiveHolder.java,Java,,24,8,6,38
ServerNotRegistered.java,Java,,19,8,6,33
ServerNotRegisteredHelper.java,Java,,62,10,8,80
ServerNotRegisteredHolder.java,Java,,24,8,6,38
ServerProxy.java,Java,,4,4,8,16
ServerProxyHelper.java,Java,,67,13,8,88
ServerProxyHolder.java,Java,,24,9,8,41
ServerProxyOperations.java,Java,,7,7,16,30
TCPPortHelper.java,Java,,40,11,11,62
_ActivatorImplBase.java,Java,,208,36,44,288
_ActivatorStub.java,Java,,294,31,43,368
_InitialNameServiceImplBase.java,Java,,48,15,13,76
_InitialNameServiceStub.java,Java,,49,10,12,71
_LocatorImplBase.java,Java,,108,20,21,149
_LocatorStub.java,Java,,125,15,20,160
_ORBProxyImplBase.java,Java,,43,15,16,74
_ORBProxyStub.java,Java,,45,10,15,70
_RepositoryImplBase.java,Java,,159,30,31,220
_RepositoryStub.java,Java,,219,25,30,274
_ServerManagerImplBase.java,Java,,285,45,61,391
_ServerManagerStub.java,Java,,395,40,60,495
_ServerProxyImplBase.java,Java,,54,19,18,91
_ServerProxyStub.java,Java,,77,14,17,108
Activator.java,Java,,4,3,6,13
ActivatorHelper.java,Java,,67,12,6,85
ActivatorHolder.java,Java,,24,8,6,38
ActivatorOperations.java,Java,,12,11,14,37
BadServerDefinition.java,Java,,19,8,6,33
BadServerDefinitionHelper.java,Java,,61,10,8,79
BadServerDefinitionHolder.java,Java,,24,8,6,38
EndPointInfo.java,Java,,14,6,6,26
EndPointInfoHelper.java,Java,,67,10,6,83
EndPointInfoHolder.java,Java,,24,8,6,38
EndpointInfoListHelper.java,Java,,46,10,6,62
EndpointInfoListHolder.java,Java,,24,9,6,39
IIOP_CLEAR_TEXT.java,Java,,5,4,7,16
InitialNameService.java,Java,,4,3,6,13
InitialNameServiceHelper.java,Java,,67,12,6,85
InitialNameServiceHolder.java,Java,,24,8,6,38
InitialNameServiceOperations.java,Java,,5,4,7,16
NameAlreadyBound.java,Java,,12,7,6,25
NameAlreadyBoundHelper.java,Java,,54,10,8,72
NameAlreadyBoundHolder.java,Java,,24,8,6,38
InvalidORBid.java,Java,,12,7,6,25
InvalidORBidHelper.java,Java,,54,10,8,72
InvalidORBidHolder.java,Java,,24,8,6,38
Locator.java,Java,,4,3,6,13
LocatorHelper.java,Java,,67,12,6,85
LocatorHolder.java,Java,,24,8,6,38
LocatorOperations.java,Java,,8,7,10,25
ServerLocation.java,Java,,14,6,6,26
ServerLocationHelper.java,Java,,68,10,6,84
ServerLocationHolder.java,Java,,24,8,6,38
ServerLocationPerORB.java,Java,,14,6,6,26
ServerLocationPerORBHelper.java,Java,,68,10,6,84
ServerLocationPerORBHolder.java,Java,,24,8,6,38
NoSuchEndPoint.java,Java,,12,7,6,25
NoSuchEndPointHelper.java,Java,,54,10,8,72
NoSuchEndPointHolder.java,Java,,24,8,6,38
ORBAlreadyRegistered.java,Java,,19,8,6,33
ORBAlreadyRegisteredHelper.java,Java,,62,10,8,80
ORBAlreadyRegisteredHolder.java,Java,,24,8,6,38
ORBidHelper.java,Java,,40,11,7,58
ORBidListHelper.java,Java,,47,10,6,63
ORBidListHolder.java,Java,,24,9,6,39
ORBPortInfo.java,Java,,14,6,6,26
ORBPortInfoHelper.java,Java,,68,10,6,84
ORBPortInfoHolder.java,Java,,24,8,6,38
ORBPortInfoListHelper.java,Java,,46,10,6,62
ORBPortInfoListHolder.java,Java,,24,9,6,39
POANameHelper.java,Java,,46,10,6,62
POANameHolder.java,Java,,24,9,6,39
Repository.java,Java,,4,3,6,13
RepositoryHelper.java,Java,,67,12,6,85
RepositoryHolder.java,Java,,24,8,6,38
RepositoryOperations.java,Java,,13,12,15,40
ServerDef.java,Java,,20,9,9,38
ServerDefHelper.java,Java,,87,10,6,103
ServerDefHolder.java,Java,,24,8,6,38
StringSeqHelper.java,Java,,46,10,6,62
StringSeqHolder.java,Java,,24,9,6,39
Server.java,Java,,4,4,8,16
ServerAlreadyActive.java,Java,,19,8,6,33
ServerAlreadyActiveHelper.java,Java,,62,10,8,80
ServerAlreadyActiveHolder.java,Java,,24,8,6,38
ServerAlreadyInstalled.java,Java,,19,8,6,33
ServerAlreadyInstalledHelper.java,Java,,62,10,8,80
ServerAlreadyInstalledHolder.java,Java,,24,8,6,38
ServerAlreadyRegistered.java,Java,,19,8,6,33
ServerAlreadyRegisteredHelper.java,Java,,62,10,8,80
ServerAlreadyRegisteredHolder.java,Java,,24,8,6,38
ServerAlreadyUninstalled.java,Java,,19,8,6,33
ServerAlreadyUninstalledHelper.java,Java,,62,10,8,80
ServerAlreadyUninstalledHolder.java,Java,,24,8,6,38
ServerHeldDown.java,Java,,19,8,6,33
ServerHeldDownHelper.java,Java,,62,10,8,80
ServerHeldDownHolder.java,Java,,24,8,6,38
ServerHelper.java,Java,,67,13,8,88
ServerHolder.java,Java,,24,9,8,41
ServerIdHelper.java,Java,,40,10,6,56
ServerIdsHelper.java,Java,,47,10,6,63
ServerIdsHolder.java,Java,,24,9,6,39
ServerManager.java,Java,,4,3,6,13
ServerManagerHelper.java,Java,,67,12,6,85
ServerManagerHolder.java,Java,,24,8,6,38
ServerManagerOperations.java,Java,,4,3,6,13
ServerNotActive.java,Java,,19,8,6,33
ServerNotActiveHelper.java,Java,,62,10,8,80
ServerNotActiveHolder.java,Java,,24,8,6,38
ServerNotRegistered.java,Java,,19,8,6,33
ServerNotRegisteredHelper.java,Java,,62,10,8,80
ServerNotRegisteredHolder.java,Java,,24,8,6,38
ServerOperations.java,Java,,7,7,16,30
TCPPortHelper.java,Java,,40,10,6,56
_ActivatorImplBase.java,Java,,165,28,16,209
_ActivatorStub.java,Java,,213,23,15,251
_InitialNameServiceImplBase.java,Java,,48,14,9,71
_InitialNameServiceStub.java,Java,,49,9,8,66
_LocatorImplBase.java,Java,,108,20,12,140
_LocatorStub.java,Java,,125,15,11,151
_RepositoryImplBase.java,Java,,159,30,17,206
_RepositoryStub.java,Java,,219,25,16,260
_ServerImplBase.java,Java,,54,19,18,91
_ServerManagerImplBase.java,Java,,242,36,20,298
_ServerManagerStub.java,Java,,314,31,19,364
_ServerStub.java,Java,,77,14,17,108
CopierManager.java,Java,,9,6,19,34
CopyobjectDefaults.java,Java,,52,10,20,82
ObjectCopier.java,Java,,4,2,14,20
ObjectCopierFactory.java,Java,,5,3,10,18
ReflectiveCopyException.java,Java,,15,3,6,24
TransactionService.java,Java,,7,5,56,68
CorbaInputObject.java,Java,,8,3,6,17
CorbaOutputObject.java,Java,,22,7,6,35
CopyObjectPolicy.java,Java,,31,9,9,49
RequestPartitioningPolicy.java,Java,,45,11,10,66
ServantCachingPolicy.java,Java,,73,22,48,143
ZeroPortPolicy.java,Java,,36,11,9,56
EncapsulationFactoryBase.java,Java,,20,8,6,34
Identifiable.java,Java,,5,4,15,24
IdentifiableBase.java,Java,,14,5,16,35
IdentifiableContainerBase.java,Java,,44,11,18,73
IdentifiableFactory.java,Java,,7,5,14,26
IdentifiableFactoryFinder.java,Java,,7,4,20,31
AlternateIIOPAddressComponent.java,Java,,7,3,9,19
CodeSetsComponent.java,Java,,7,4,9,20
GIOPVersion.java,Java,,134,43,24,201
IIOPAddress.java,Java,,7,4,9,20
IIOPFactories.java,Java,,182,30,11,223
IIOPProfile.java,Java,,12,8,22,42
IIOPProfileTemplate.java,Java,,12,7,16,35
JavaCodebaseComponent.java,Java,,6,3,9,18
MaxStreamFormatVersionComponent.java,Java,,6,2,8,16
ORBTypeComponent.java,Java,,6,3,9,18
RequestPartitioningComponent.java,Java,,6,2,6,14
IOR.java,Java,,19,14,35,68
IORFactories.java,Java,,114,31,40,185
IORFactory.java,Java,,6,4,17,27
IORTemplate.java,Java,,7,4,12,23
IORTemplateList.java,Java,,4,4,12,20
MakeImmutable.java,Java,,4,2,6,12
ObjectAdapterId.java,Java,,7,5,17,29
ObjectId.java,Java,,5,2,9,16
ObjectKey.java,Java,,10,7,17,34
ObjectKeyFactory.java,Java,,9,5,14,28
ObjectKeyTemplate.java,Java,,16,12,28,56
TaggedComponent.java,Java,,7,3,12,22
TaggedComponentBase.java,Java,,16,6,10,32
TaggedComponentFactoryFinder.java,Java,,6,2,9,17
TaggedProfile.java,Java,,12,9,27,48
TaggedProfileTemplate.java,Java,,19,10,31,60
TaggedProfileTemplateBase.java,Java,,32,10,6,48
Writeable.java,Java,,6,3,11,20
WriteContents.java,Java,,5,3,6,14
Connection.java,Java,,5,3,9,17
GetEndPointInfoAgainException.java,Java,,15,6,13,34
LegacyServerSocketEndPointInfo.java,Java,,13,10,24,47
LegacyServerSocketManager.java,Java,,12,7,10,29
ORBSocketFactory.java,Java,,20,15,307,342
IORInfoExt.java,Java,,9,5,7,21
ORBInitInfoExt.java,Java,,6,3,14,23
RequestInfoExt.java,Java,,6,4,17,27
UnknownType.java,Java,,14,3,6,23
CORBALogDomains.java,Java,,29,27,87,143
LogWrapperBase.java,Java,,49,12,13,74
LogWrapperFactory.java,Java,,6,4,6,16
LongMonitoredAttributeBase.java,Java,,12,10,33,55
MonitoredAttribute.java,Java,,10,7,78,95
MonitoredAttributeBase.java,Java,,34,15,51,100
MonitoredAttributeInfo.java,Java,,8,5,56,69
MonitoredAttributeInfoFactory.java,Java,,5,2,22,29
MonitoredObject.java,Java,,19,8,146,173
MonitoredObjectFactory.java,Java,,4,1,20,25
MonitoringConstants.java,Java,,72,12,13,97
MonitoringFactories.java,Java,,24,7,62,93
MonitoringManager.java,Java,,9,5,37,51
MonitoringManagerFactory.java,Java,,6,2,19,27
StatisticMonitoredAttribute.java,Java,,31,18,66,115
StatisticsAccumulator.java,Java,,88,32,87,207
StringMonitoredAttributeBase.java,Java,,14,10,34,58
NullServant.java,Java,,6,3,18,27
OADefault.java,Java,,18,4,10,32
OADestroyed.java,Java,,3,1,9,13
OAInvocationInfo.java,Java,,51,18,23,92
ObjectAdapter.java,Java,,25,25,181,231
ObjectAdapterBase.java,Java,,129,38,18,185
ObjectAdapterFactory.java,Java,,10,8,14,32
DataCollector.java,Java,,10,5,32,47
Operation.java,Java,,4,1,11,16
OperationFactory.java,Java,,405,99,42,546
ORB.java,Java,,311,100,120,531
ORBConfigurator.java,Java,,4,2,13,19
ORBData.java,Java,,65,48,27,140
ORBVersion.java,Java,,14,6,6,26
ORBVersionFactory.java,Java,,53,14,28,95
ParserData.java,Java,,11,9,6,26
ParserDataFactory.java,Java,,19,3,6,28
ParserImplBase.java,Java,,80,20,18,118
ParserImplTableBase.java,Java,,113,25,17,155
PropertyParser.java,Java,,46,11,10,67
StringPair.java,Java,,32,10,6,48
Closure.java,Java,,4,2,6,12
ClosureFactory.java,Java,,14,5,6,25
Action.java,Java,,5,4,30,39
ActionBase.java,Java,,5,3,6,14
FSM.java,Java,,6,5,29,40
FSMImpl.java,Java,,44,14,40,98
FSMTest.java,Java,,172,31,6,209
Guard.java,Java,,44,14,28,86
GuardBase.java,Java,,5,3,6,14
Input.java,Java,,4,3,17,24
InputImpl.java,Java,,5,3,6,14
State.java,Java,,6,4,29,39
StateEngine.java,Java,,17,12,65,94
StateEngineFactory.java,Java,,9,4,12,25
StateImpl.java,Java,,54,17,10,81
CompositeInvocationHandler.java,Java,,9,3,5,17
CompositeInvocationHandlerImpl.java,Java,,42,11,3,56
DelegateInvocationHandlerImpl.java,Java,,31,7,10,48
InvocationHandlerFactory.java,Java,,7,6,11,24
LinkedInvocationHandler.java,Java,,8,5,10,23
NoSuchThreadPoolException.java,Java,,4,4,5,13
NoSuchWorkQueueException.java,Java,,4,4,5,13
ThreadPool.java,Java,,17,16,64,97
ThreadPoolChooser.java,Java,,7,5,21,33
ThreadPoolManager.java,Java,,14,12,51,77
Work.java,Java,,8,9,19,36
WorkQueue.java,Java,,11,10,27,48
DynamicMethodMarshaller.java,Java,,20,15,42,77
DynamicStub.java,Java,,15,12,25,52
IDLNameTranslator.java,Java,,9,7,23,39
PresentationDefaults.java,Java,,28,11,6,45
PresentationManager.java,Java,,38,23,91,152
StubAdapter.java,Java,,134,25,32,191
StubWrapper.java,Java,,108,27,9,144
ClientDelegateFactory.java,Java,,6,4,8,18
CorbaClientDelegate.java,Java,,6,3,7,16
CorbaMessageMediator.java,Java,,80,25,24,129
CorbaProtocolHandler.java,Java,,39,11,10,60
CorbaServerRequestDispatcher.java,Java,,9,7,19,35
ForwardException.java,Java,,38,15,13,66
InitialServerRequestDispatcher.java,Java,,7,4,14,25
LocalClientRequestDispatcher.java,Java,,12,8,35,55
LocalClientRequestDispatcherFactory.java,Java,,5,4,6,15
PIHandler.java,Java,,54,40,173,267
RequestDispatcherDefault.java,Java,,74,16,7,97
RequestDispatcherRegistry.java,Java,,19,16,42,77
LocalResolver.java,Java,,5,3,12,20
Resolver.java,Java,,5,3,18,26
ResolverDefault.java,Java,,52,13,22,87
CodeSetServiceContext.java,Java,,35,9,7,51
MaxStreamFormatVersionServiceContext.java,Java,,41,17,11,69
ORBVersionServiceContext.java,Java,,39,14,12,65
SendingContextServiceContext.java,Java,,35,9,7,51
ServiceContext.java,Java,,39,11,52,102
ServiceContextData.java,Java,,109,22,13,144
ServiceContextRegistry.java,Java,,49,13,17,79
ServiceContexts.java,Java,,209,81,104,394
UEInfoServiceContext.java,Java,,38,12,7,57
UnknownServiceContext.java,Java,,37,11,6,54
CorbaAcceptor.java,Java,,14,6,11,31
CorbaConnection.java,Java,,74,39,38,151
CorbaConnectionCache.java,Java,,5,3,10,18
CorbaContactInfo.java,Java,,15,5,10,30
CorbaContactInfoList.java,Java,,15,9,10,34
CorbaContactInfoListFactory.java,Java,,8,5,19,32
CorbaContactInfoListIterator.java,Java,,11,8,8,27
CorbaResponseWaitingRoom.java,Java,,11,5,10,26
CorbaTransportManager.java,Java,,20,8,12,40
IIOPPrimaryToContactInfo.java,Java,,13,9,45,67
IORToSocketInfo.java,Java,,7,5,15,27
IORTransformer.java,Java,,8,4,10,22
ORBSocketFactory.java,Java,,22,10,10,42
ReadTimeouts.java,Java,,7,3,7,17
ReadTimeoutsFactory.java,Java,,8,2,1,11
SocketInfo.java,Java,,8,7,10,25
SocketOrChannelAcceptor.java,Java,,6,4,10,20
TransportDefault.java,Java,,57,9,11,77
ImageFormatException.java,Java,,10,4,40,54
JPEGCodec.java,Java,,49,13,90,152
JPEGDecodeParam.java,Java,,62,45,264,371
JPEGEncodeParam.java,Java,,27,20,211,258
JPEGHuffmanTable.java,Java,,139,31,73,243
JPEGImageDecoder.java,Java,,23,14,105,142
JPEGImageEncoder.java,Java,,29,23,180,232
JPEGQTable.java,Java,,62,20,70,152
TruncatedFileException.java,Java,,19,8,57,84
XmlChars.java,Java,,177,38,212,427
XmlNames.java,Java,,72,23,135,230
BMPConstants.java,Java,,21,5,9,35
BMPImageReader.java,Java,,1362,274,150,1786
BMPImageReaderSpi.java,Java,,58,13,6,77
BMPImageWriter.java,Java,,1013,171,127,1311
BMPImageWriterSpi.java,Java,,66,16,6,88
BMPMetadata.java,Java,,221,51,17,289
BMPMetadataFormat.java,Java,,156,22,12,190
BMPMetadataFormatResources.java,Java,,34,10,7,51
BogusColorSpace.java,Java,,61,23,34,118
I18N.java,Java,,7,2,6,15
I18NImpl.java,Java,,17,4,23,44
ImageUtil.java,Java,,838,122,193,1153
InputStreamAdapter.java,Java,,17,8,9,34
StandardMetadataFormat.java,Java,,363,61,57,481
StandardMetadataFormatResources.java,Java,,129,55,8,192
SubImageInputStream.java,Java,,40,10,9,59
GIFImageMetadata.java,Java,,293,70,46,409
GIFImageMetadataFormat.java,Java,,122,16,15,153
GIFImageMetadataFormatResources.java,Java,,70,8,8,86
GIFImageReader.java,Java,,801,161,183,1145
GIFImageReaderSpi.java,Java,,56,17,9,82
GIFStreamMetadata.java,Java,,181,54,35,270
GIFStreamMetadataFormat.java,Java,,67,11,10,88
GIFStreamMetadataFormatResources.java,Java,,37,8,8,53
AdobeMarkerSegment.java,Java,,90,15,14,119
COMMarkerSegment.java,Java,,57,13,46,116
DHTMarkerSegment.java,Java,,177,30,35,242
DQTMarkerSegment.java,Java,,218,26,48,292
DRIMarkerSegment.java,Java,,37,12,17,66
JFIFMarkerSegment.java,Java,,1201,131,215,1547
JPEG.java,Java,,196,48,96,340
JPEGBuffer.java,Java,,134,20,83,237
JPEGImageMetadataFormat.java,Java,,302,37,9,348
JPEGImageMetadataFormatResources.java,Java,,106,7,12,125
JPEGImageReader.java,Java,,926,170,321,1417
JPEGImageReaderResources.java,Java,,15,7,6,28
JPEGImageReaderSpi.java,Java,,68,12,12,92
JPEGImageWriter.java,Java,,1264,167,212,1643
JPEGImageWriterResources.java,Java,,51,7,6,64
JPEGImageWriterSpi.java,Java,,74,16,9,99
JPEGMetadata.java,Java,,1788,186,424,2398
JPEGMetadataFormat.java,Java,,105,17,17,139
JPEGMetadataFormatResources.java,Java,,30,5,8,43
JPEGStreamMetadataFormat.java,Java,,17,6,6,29
JPEGStreamMetadataFormatResources.java,Java,,14,5,9,28
MarkerSegment.java,Java,,139,21,47,207
SOFMarkerSegment.java,Java,,219,25,22,266
SOSMarkerSegment.java,Java,,179,24,20,223
PNGImageReader.java,Java,,1219,225,172,1616
PNGImageReaderSpi.java,Java,,63,16,9,88
PNGImageWriter.java,Java,,890,174,77,1141
PNGImageWriterSpi.java,Java,,76,19,16,111
PNGMetadata.java,Java,,1598,244,159,2001
PNGMetadataFormat.java,Java,,323,118,41,482
PNGMetadataFormatResources.java,Java,,168,23,8,199
RowFilter.java,Java,,132,33,12,177
WBMPImageReader.java,Java,,223,57,34,314
WBMPImageReaderSpi.java,Java,,60,14,7,81
WBMPImageWriter.java,Java,,222,44,31,297
WBMPImageWriterSpi.java,Java,,57,12,6,75
WBMPMetadata.java,Java,,82,27,7,116
WBMPMetadataFormat.java,Java,,33,12,7,52
FileImageInputStreamSpi.java,Java,,30,9,6,45
FileImageOutputStreamSpi.java,Java,,31,9,6,46
InputStreamImageInputStreamSpi.java,Java,,41,12,6,59
OutputStreamImageOutputStreamSpi.java,Java,,41,11,6,58
RAFImageInputStreamSpi.java,Java,,32,9,6,47
RAFImageOutputStreamSpi.java,Java,,33,9,6,48
StreamCloser.java,Java,,75,13,21,109
BluecurveColorType.java,Java,,24,8,17,49
BluecurveEngine.java,Java,,394,28,22,444
BluecurveEngineParser.java,Java,,79,19,16,114
BluecurveStyle.java,Java,,108,17,33,158
BlueprintEngine.java,Java,,870,103,165,1138
BlueprintEngineParser.java,Java,,897,175,39,1111
BlueprintGraphicsUtils.java,Java,,25,4,11,40
BlueprintStyle.java,Java,,483,118,91,692
CircularIdentityList.java,Java,,93,16,28,137
GTKColorChooserPanel.java,Java,,857,148,278,1283
GTKColorType.java,Java,,108,14,28,150
GTKConstants.java,Java,,23,16,15,54
GTKEngine.java,Java,,1014,118,92,1224
GTKEngineParser.java,Java,,8,6,64,78
GTKFileChooserUI.java,Java,,1029,207,105,1341
GTKGraphicsUtils.java,Java,,47,5,21,73
GTKIconFactory.java,Java,,340,52,36,428
GTKLookAndFeel.java,Java,,1269,161,155,1585
GTKPainter.java,Java,,1105,149,171,1425
GTKParser.java,Java,,1448,356,59,1863
GTKRegion.java,Java,,9,3,13,25
GTKScanner.java,Java,,639,123,15,777
GTKStyle.java,Java,,1148,196,434,1778
GTKStyleFactory.java,Java,,571,79,163,813
Metacity.java,Java,,1729,219,39,1987
PangoFonts.java,Java,,80,18,100,198
PixmapEngine.java,Java,,408,35,104,547
PixmapEngineParser.java,Java,,627,117,18,762
PixmapStyle.java,Java,,375,90,76,541
PropertyParser.java,Java,,135,39,18,192
gtk.java,Java,,44,2,0,46
gtk_de.java,Java,,44,2,0,46
gtk_es.java,Java,,44,2,0,46
gtk_fr.java,Java,,44,2,0,46
gtk_it.java,Java,,44,2,0,46
gtk_ja.java,Java,,44,2,0,46
gtk_ko.java,Java,,44,2,0,46
gtk_sv.java,Java,,44,2,0,46
gtk_zh_CN.java,Java,,44,2,0,46
gtk_zh_HK.java,Java,,44,2,0,46
gtk_zh_TW.java,Java,,44,2,0,46
XColors.java,Java,,788,16,10,814
MotifBorders.java,Java,,524,130,95,749
MotifButtonListener.java,Java,,14,7,13,34
MotifButtonUI.java,Java,,75,24,36,135
MotifCheckBoxMenuItemUI.java,Java,,71,25,14,110
MotifCheckBoxUI.java,Java,,34,14,25,73
MotifComboBoxRenderer.java,Java,,44,17,35,96
MotifComboBoxUI.java,Java,,245,41,30,316
MotifDesktopIconUI.java,Java,,257,54,32,343
MotifDesktopPaneUI.java,Java,,177,31,42,250
MotifEditorPaneUI.java,Java,,13,7,33,53
MotifFileChooserUI.java,Java,,612,123,57,792
MotifGraphicsUtils.java,Java,,317,63,75,455
MotifIconFactory.java,Java,,355,58,38,451
MotifInternalFrameTitlePane.java,Java,,283,50,18,351
MotifInternalFrameUI.java,Java,,137,27,42,206
MotifLabelUI.java,Java,,19,5,20,44
MotifLookAndFeel.java,Java,,1087,130,53,1270
MotifMenuBarUI.java,Java,,23,8,22,53
MotifMenuItemUI.java,Java,,68,23,13,104
MotifMenuMouseListener.java,Java,,17,2,12,31
MotifMenuMouseMotionListener.java,Java,,11,3,12,26
MotifMenuUI.java,Java,,94,24,27,145
MotifOptionPaneUI.java,Java,,49,13,35,97
MotifPasswordFieldUI.java,Java,,13,10,33,56
MotifPopupMenuSeparatorUI.java,Java,,27,9,13,49
MotifPopupMenuUI.java,Java,,63,15,23,101
MotifProgressBarUI.java,Java,,13,6,22,41
MotifRadioButtonMenuItemUI.java,Java,,74,23,20,117
MotifRadioButtonUI.java,Java,,40,16,31,87
MotifScrollBarButton.java,Java,,154,25,16,195
MotifScrollBarUI.java,Java,,53,18,20,91
MotifScrollPaneUI.java,Java,,86,20,21,127
MotifSeparatorUI.java,Java,,16,9,21,46
MotifSliderUI.java,Java,,82,29,32,143
MotifSplitPaneDivider.java,Java,,181,36,61,278
MotifSplitPaneUI.java,Java,,18,6,25,49
MotifTabbedPaneUI.java,Java,,218,33,38,289
MotifTextAreaUI.java,Java,,13,5,35,53
MotifTextFieldUI.java,Java,,13,5,33,51
MotifTextPaneUI.java,Java,,13,7,33,53
MotifTextUI.java,Java,,69,13,76,158
MotifToggleButtonUI.java,Java,,60,19,31,110
MotifTreeCellRenderer.java,Java,,51,16,29,96
MotifTreeUI.java,Java,,74,24,47,145
motif.java,Java,,27,2,0,29
motif_de.java,Java,,28,2,0,30
motif_es.java,Java,,27,2,0,29
motif_fr.java,Java,,27,2,0,29
motif_it.java,Java,,27,2,0,29
motif_ja.java,Java,,27,2,0,29
motif_ko.java,Java,,27,2,0,29
motif_sv.java,Java,,27,2,0,29
motif_zh_CN.java,Java,,27,2,0,29
motif_zh_HK.java,Java,,27,2,0,29
motif_zh_TW.java,Java,,27,2,0,29
DesktopProperty.java,Java,,139,31,106,276
windows.java,Java,,33,2,0,35
windows_de.java,Java,,33,2,0,35
windows_es.java,Java,,33,2,0,35
windows_fr.java,Java,,33,2,0,35
windows_it.java,Java,,33,2,0,35
windows_ja.java,Java,,33,2,0,35
windows_ko.java,Java,,33,2,0,35
windows_sv.java,Java,,33,2,0,35
windows_zh_CN.java,Java,,33,2,0,35
windows_zh_HK.java,Java,,33,2,0,35
windows_zh_TW.java,Java,,33,2,0,35
TMSchema.java,Java,,376,93,53,522
WindowsBorders.java,Java,,234,44,47,325
WindowsButtonListener.java,Java,,9,7,23,39
WindowsButtonUI.java,Java,,171,36,63,270
WindowsCheckBoxMenuItemUI.java,Java,,48,14,25,87
WindowsCheckBoxUI.java,Java,,36,15,28,79
WindowsClassicLookAndFeel.java,Java,,3,2,19,24
WindowsComboBoxUI.java,Java,,378,48,80,506
WindowsDesktopIconUI.java,Java,,42,14,24,80
WindowsDesktopManager.java,Java,,44,9,30,83
WindowsDesktopPaneUI.java,Java,,27,7,20,54
WindowsEditorPaneUI.java,Java,,14,7,30,51
WindowsFileChooserUI.java,Java,,917,193,143,1253
WindowsGraphicsUtils.java,Java,,64,12,36,112
WindowsIconFactory.java,Java,,729,85,63,877
WindowsInternalFrameTitlePane.java,Java,,392,52,40,484
WindowsInternalFrameUI.java,Java,,74,24,22,120
WindowsLabelUI.java,Java,,59,15,21,95
WindowsListUI.java,Java,,5,6,6,17
WindowsLookAndFeel.java,Java,,1757,202,264,2223
WindowsMenuBarUI.java,Java,,129,13,27,169
WindowsMenuItemUI.java,Java,,110,21,34,165
WindowsMenuItemUIAccessor.java,Java,,11,5,13,29
WindowsMenuUI.java,Java,,171,33,48,252
WindowsOptionPaneUI.java,Java,,8,6,16,30
WindowsPasswordFieldUI.java,Java,,13,9,30,52
WindowsPopupMenuSeparatorUI.java,Java,,43,12,18,73
WindowsPopupMenuUI.java,Java,,108,17,65,190
WindowsPopupWindow.java,Java,,34,10,34,78
WindowsProgressBarUI.java,Java,,156,23,32,211
WindowsRadioButtonMenuItemUI.java,Java,,47,14,25,86
WindowsRadioButtonUI.java,Java,,59,20,34,113
WindowsRootPaneUI.java,Java,,130,18,15,163
WindowsScrollBarUI.java,Java,,312,44,48,404
WindowsScrollPaneUI.java,Java,,5,6,16,27
WindowsSeparatorUI.java,Java,,3,3,12,18
WindowsSliderUI.java,Java,,103,20,17,140
WindowsSpinnerUI.java,Java,,38,11,6,55
WindowsSplitPaneDivider.java,Java,,23,7,25,55
WindowsSplitPaneUI.java,Java,,18,10,22,50
WindowsTabbedPaneUI.java,Java,,152,26,33,211
WindowsTableHeaderUI.java,Java,,124,23,6,153
WindowsTableUI.java,Java,,5,6,6,17
WindowsTextAreaUI.java,Java,,13,8,30,51
WindowsTextFieldUI.java,Java,,68,17,72,157
WindowsTextPaneUI.java,Java,,14,6,30,50
WindowsTextUI.java,Java,,139,15,65,219
WindowsToggleButtonUI.java,Java,,102,29,37,168
WindowsToolBarSeparatorUI.java,Java,,75,20,13,108
WindowsToolBarUI.java,Java,,55,15,6,76
WindowsTreeUI.java,Java,,132,29,56,217
WindowsUtils.java,Java,,40,8,24,72
XPStyle.java,Java,,404,87,164,655
SwingUtilities2.java,Java,,654,107,386,1147
AnnotationDesc.java,Java,,9,9,45,63
AnnotationTypeDoc.java,Java,,4,4,19,27
AnnotationTypeElementDoc.java,Java,,4,4,19,27
AnnotationValue.java,Java,,5,5,32,42
ClassDoc.java,Java,,30,31,263,324
ConstructorDoc.java,Java,,3,2,12,17
Doc.java,Java,,27,26,192,245
DocErrorReporter.java,Java,,9,8,48,65
Doclet.java,Java,,16,7,71,94
ExecutableMemberDoc.java,Java,,15,14,93,122
FieldDoc.java,Java,,9,8,44,61
LanguageVersion.java,Java,,5,5,20,30
MemberDoc.java,Java,,4,3,22,29
MethodDoc.java,Java,,9,9,59,77
PackageDoc.java,Java,,13,12,86,111
Parameter.java,Java,,8,9,41,58
ParameterizedType.java,Java,,8,8,76,92
ParamTag.java,Java,,6,5,38,49
ProgramElementDoc.java,Java,,15,13,80,108
RootDoc.java,Java,,9,8,74,91
SeeTag.java,Java,,9,8,92,109
SerialFieldTag.java,Java,,8,7,54,69
SourcePosition.java,Java,,8,6,23,37
Tag.java,Java,,11,10,117,138
ThrowsTag.java,Java,,7,6,48,61
Type.java,Java,,14,13,108,135
TypeVariable.java,Java,,5,5,32,42
WildcardType.java,Java,,5,5,35,45
action_part.java,Java,,33,22,38,93
action_production.java,Java,,16,7,16,39
assoc.java,Java,,7,5,5,17
emit.java,Java,,463,142,292,897
internal_error.java,Java,,15,3,4,22
lalr_item.java,Java,,143,58,129,330
lalr_item_set.java,Java,,162,75,134,371
lalr_state.java,Java,,435,135,314,884
lalr_transition.java,Java,,32,20,41,93
lexer.java,Java,,266,88,188,542
lr_item_core.java,Java,,129,59,92,280
Main.java,Java,,475,119,251,845
nonassoc_action.java,Java,,26,17,28,71
non_terminal.java,Java,,131,67,103,301
parser.java,Java,,1347,285,217,1849
parse_action.java,Java,,27,25,40,92
parse_action_row.java,Java,,37,24,45,106
parse_action_table.java,Java,,71,23,49,143
parse_reduce_row.java,Java,,11,10,20,41
parse_reduce_table.java,Java,,44,21,34,99
production.java,Java,,359,142,255,756
production_part.java,Java,,36,19,39,94
reduce_action.java,Java,,32,20,32,84
lr_parser.java,Java,,490,203,535,1228
Scanner.java,Java,,4,2,15,21
Symbol.java,Java,,38,25,48,111
virtual_parse_stack.java,Java,,49,32,64,145
shift_action.java,Java,,29,20,33,82
sym.java,Java,,33,4,6,43
symbol.java,Java,,28,25,54,107
symbol_part.java,Java,,42,21,37,100
symbol_set.java,Java,,102,53,76,231
terminal.java,Java,,64,41,64,169
terminal_set.java,Java,,115,56,82,253
version.java,Java,,10,15,29,54
Main.java,Java,,5467,899,1509,7875
JmxProperties.java,Java,,14,13,68,95
ServiceName.java,Java,,14,11,54,79
DefaultMBeanServerInterceptor.java,Java,,1113,218,442,1773
MBeanServerInterceptor.java,Java,,106,35,545,686
BaseMetaDataImpl.java,Java,,182,49,34,265
ClassLoaderRepositorySupport.java,Java,,177,46,82,305
DynamicMetaDataImpl.java,Java,,198,42,37,277
GetPropertyAction.java,Java,,11,5,12,28
Introspector.java,Java,,274,71,217,562
JmxMBeanServer.java,Java,,467,126,906,1499
JmxMBeanServerBuilder.java,Java,,15,5,77,97
MBeanInstantiator.java,Java,,48,20,186,254
MBeanInstantiatorImpl.java,Java,,372,86,73,531
MBeanServerDelegateImpl.java,Java,,185,38,107,330
MetaData.java,Java,,31,26,141,198
MetaDataImpl.java,Java,,186,60,75,321
ModifiableClassLoaderRepository.java,Java,,11,9,33,53
NamedObject.java,Java,,37,17,51,105
ObjectInputStreamWithLoader.java,Java,,24,12,18,54
Repository.java,Java,,17,18,92,127
RepositorySupport.java,Java,,328,107,242,677
SecureClassLoaderRepository.java,Java,,23,3,20,46
StandardMBeanMetaDataImpl.java,Java,,31,12,72,115
StandardMetaDataImpl.java,Java,,653,137,252,1042
SunJmxMBeanServer.java,Java,,13,12,56,81
ArrayNotificationBuffer.java,Java,,552,96,128,776
ArrayQueue.java,Java,,63,9,7,79
ClientCommunicatorAdmin.java,Java,,149,44,39,232
ClientListenerInfo.java,Java,,34,7,6,47
ClientNotifForwarder.java,Java,,578,150,149,877
ListenerInfo.java,Java,,60,17,18,95
NotificationBuffer.java,Java,,13,4,41,58
ProxyInputStream.java,Java,,152,49,6,207
ProxyRef.java,Java,,50,15,6,71
RMIExporter.java,Java,,18,5,18,41
ServerCommunicatorAdmin.java,Java,,135,38,41,214
ServerNotifForwarder.java,Java,,211,50,26,287
Unmarshal.java,Java,,7,3,6,16
ClientProvider.java,Java,,19,5,6,30
ServerProvider.java,Java,,21,6,6,33
ClientProvider.java,Java,,19,5,6,30
ServerProvider.java,Java,,21,6,6,33
FileLoginModule.java,Java,,287,65,193,545
JMXPluggableAuthenticator.java,Java,,187,37,104,328
JMXSubjectDomainCombiner.java,Java,,53,12,47,112
MBeanServerAccessController.java,Java,,374,51,219,644
MBeanServerFileAccessController.java,Java,,293,43,191,527
SubjectDelegator.java,Java,,54,14,28,96
CacheMap.java,Java,,46,10,44,100
ClassLoaderWithRepository.java,Java,,24,7,6,37
ClassLogger.java,Java,,171,44,13,228
EnvHelp.java,Java,,358,71,217,646
OrderClassLoaders.java,Java,,19,5,6,30
Service.java,Java,,150,23,157,330
SnmpEntryOid.java,Java,,11,2,21,34
SnmpErrorHandlerAgent.java,Java,,71,43,88,202
SnmpGenericMetaServer.java,Java,,15,10,93,118
SnmpGenericObjectServer.java,Java,,260,54,244,558
SnmpIndex.java,Java,,66,21,90,177
SnmpMib.java,Java,,429,143,418,990
SnmpMibAgent.java,Java,,293,68,391,752
SnmpMibAgentMBean.java,Java,,38,30,237,305
SnmpMibEntry.java,Java,,31,13,137,181
SnmpMibGroup.java,Java,,155,61,290,506
SnmpMibHandler.java,Java,,17,13,113,143
SnmpMibNode.java,Java,,116,44,242,402
SnmpMibOid.java,Java,,266,80,200,546
SnmpMibRequest.java,Java,,23,12,125,160
SnmpMibRequestImpl.java,Java,,79,25,123,227
SnmpMibSubRequest.java,Java,,22,12,162,196
SnmpMibTable.java,Java,,813,224,1475,2512
SnmpRequestTree.java,Java,,534,163,359,1056
SnmpStandardMetaServer.java,Java,,11,6,87,104
SnmpStandardObjectServer.java,Java,,54,14,180,248
SnmpTableCallbackHandler.java,Java,,13,3,45,61
SnmpTableEntryFactory.java,Java,,10,6,61,77
SnmpTableEntryNotification.java,Java,,25,18,86,129
SnmpTableSupport.java,Java,,125,51,380,556
SnmpUserDataFactory.java,Java,,10,4,95,109
BerDecoder.java,Java,,380,121,246,747
BerEncoder.java,Java,,196,94,177,467
BerException.java,Java,,17,13,20,50
ClientHandler.java,Java,,78,27,41,146
CommunicationException.java,Java,,20,10,35,65
CommunicatorServer.java,Java,,600,140,593,1333
CommunicatorServerMBean.java,Java,,13,16,130,159
SnmpAdaptorServer.java,Java,,1171,269,1174,2614
SnmpAdaptorServerMBean.java,Java,,98,73,515,686
SnmpInformHandler.java,Java,,8,7,51,66
SnmpInformRequest.java,Java,,693,156,354,1203
SnmpMibTree.java,Java,,158,46,50,254
SnmpQManager.java,Java,,251,64,35,350
SnmpRequestCounter.java,Java,,10,6,25,41
SnmpRequestHandler.java,Java,,759,135,257,1151
SnmpResponseHandler.java,Java,,90,28,30,148
SnmpSendServer.java,Java,,143,34,38,215
SnmpSession.java,Java,,289,65,157,511
SnmpSocket.java,Java,,182,53,94,329
SnmpSubBulkRequestHandler.java,Java,,190,42,81,313
SnmpSubNextRequestHandler.java,Java,,143,26,80,249
SnmpSubRequestHandler.java,Java,,342,96,207,645
SnmpTimerServer.java,Java,,92,26,27,145
DefaultPaths.java,Java,,105,20,105,230
SnmpProperties.java,Java,,32,19,114,165
Enumerated.java,Java,,60,39,107,206
EnumRowStatus.java,Java,,89,31,171,291
InetAddressAcl.java,Java,,15,14,85,114
SnmpAccessControlModel.java,Java,,25,3,50,78
SnmpAccessControlSubSystem.java,Java,,21,2,39,62
SnmpDecryptedPdu.java,Java,,7,1,28,36
SnmpEngineImpl.java,Java,,200,53,182,435
SnmpIncomingRequest.java,Java,,36,9,105,150
SnmpIncomingResponse.java,Java,,29,9,70,108
SnmpLcd.java,Java,,54,15,50,119
SnmpModel.java,Java,,5,1,24,30
SnmpModelLcd.java,Java,,3,2,12,17
SnmpMsgProcessingModel.java,Java,,38,9,86,133
SnmpMsgProcessingSubSystem.java,Java,,51,9,90,150
SnmpOutgoingRequest.java,Java,,21,5,48,74
SnmpSecurityCache.java,Java,,3,1,16,20
SnmpSecurityModel.java,Java,,64,4,94,162
SnmpSecuritySubSystem.java,Java,,66,5,95,166
SnmpSubSystem.java,Java,,12,6,41,59
SnmpTools.java,Java,,67,7,37,111
AclEntryImpl.java,Java,,94,39,125,258
AclImpl.java,Java,,87,30,161,278
ASCII_CharStream.java,Java,,306,56,22,384
GroupImpl.java,Java,,43,21,67,131
Host.java,Java,,128,30,28,186
JDMAccess.java,Java,,25,10,19,54
JDMAclBlock.java,Java,,18,10,23,51
JDMAclItem.java,Java,,23,10,15,48
JDMCommunities.java,Java,,19,9,15,43
JDMCommunity.java,Java,,19,9,15,43
JDMEnterprise.java,Java,,16,8,15,39
JDMHost.java,Java,,15,11,15,41
JDMHostInform.java,Java,,16,7,10,33
JDMHostName.java,Java,,24,11,15,50
JDMHostTrap.java,Java,,16,8,15,39
JDMInformBlock.java,Java,,18,9,18,45
JDMInformCommunity.java,Java,,19,7,10,36
JDMInformInterestedHost.java,Java,,15,6,10,31
JDMInformItem.java,Java,,19,7,10,36
JDMIpAddress.java,Java,,25,11,15,51
JDMIpMask.java,Java,,25,12,15,52
JDMIpV6Address.java,Java,,9,5,11,25
JDMManagers.java,Java,,15,7,15,37
JDMNetMask.java,Java,,25,6,11,42
JDMNetMaskV6.java,Java,,14,5,11,30
JDMSecurityDefs.java,Java,,15,7,15,37
JDMTrapBlock.java,Java,,18,10,19,47
JDMTrapCommunity.java,Java,,19,8,15,42
JDMTrapInterestedHost.java,Java,,15,7,15,37
JDMTrapItem.java,Java,,19,9,15,43
JDMTrapNum.java,Java,,17,8,15,40
JJTParserState.java,Java,,81,20,29,130
NetMaskImpl.java,Java,,166,37,70,273
Node.java,Java,,10,11,25,46
OwnerImpl.java,Java,,44,18,61,123
ParseError.java,Java,,8,3,11,22
ParseException.java,Java,,109,14,75,198
Parser.java,Java,,1174,57,35,1266
ParserConstants.java,Java,,80,6,7,93
ParserTokenManager.java,Java,,1481,8,7,1496
ParserTreeConstants.java,Java,,58,5,7,70
PermissionImpl.java,Java,,24,14,38,76
PrincipalImpl.java,Java,,49,18,68,135
SimpleNode.java,Java,,85,24,35,144
SnmpAcl.java,Java,,251,49,187,487
Token.java,Java,,19,12,62,93
TokenMgrError.java,Java,,72,14,54,140
SnmpMsgTranslator.java,Java,,19,1,58,78
ServiceName.java,Java,,24,23,108,155
SnmpAckPdu.java,Java,,4,0,21,25
SnmpBadSecurityLevelException.java,Java,,6,0,16,22
SnmpCounter.java,Java,,19,12,55,86
SnmpCounter64.java,Java,,70,23,108,201
SnmpDataTypeEnums.java,Java,,25,33,92,150
SnmpDefinitions.java,Java,,82,80,349,511
SnmpEngine.java,Java,,7,3,46,56
SnmpEngineFactory.java,Java,,6,2,36,44
SnmpEngineId.java,Java,,238,48,187,473
SnmpEngineParameters.java,Java,,35,11,54,100
SnmpGauge.java,Java,,19,12,55,86
SnmpInt.java,Java,,98,29,142,269
SnmpIpAddress.java,Java,,91,22,91,204
SnmpMessage.java,Java,,224,39,126,389
SnmpMsg.java,Java,,273,36,156,465
SnmpNull.java,Java,,64,22,82,168
SnmpOid.java,Java,,319,63,265,647
SnmpOidDatabase.java,Java,,13,13,53,79
SnmpOidDatabaseSupport.java,Java,,67,16,61,144
SnmpOidRecord.java,Java,,20,11,65,96
SnmpOidTable.java,Java,,9,11,52,72
SnmpOidTableSupport.java,Java,,87,30,87,204
SnmpOpaque.java,Java,,26,12,49,87
SnmpParameters.java,Java,,89,24,120,233
SnmpParams.java,Java,,16,5,41,62
SnmpPdu.java,Java,,34,10,66,110
SnmpPduBulk.java,Java,,30,16,62,108
SnmpPduBulkType.java,Java,,7,5,32,44
SnmpPduFactory.java,Java,,6,9,67,82
SnmpPduFactoryBER.java,Java,,34,10,72,116
SnmpPduPacket.java,Java,,6,7,38,51
SnmpPduRequest.java,Java,,26,16,58,100
SnmpPduRequestType.java,Java,,7,1,38,46
SnmpPduTrap.java,Java,,12,19,54,85
SnmpPeer.java,Java,,137,59,255,451
SnmpScopedPduBulk.java,Java,,36,10,49,95
SnmpScopedPduPacket.java,Java,,17,12,62,91
SnmpScopedPduRequest.java,Java,,32,10,43,85
SnmpSecurityException.java,Java,,12,1,38,51
SnmpSecurityParameters.java,Java,,8,2,30,40
SnmpStatusException.java,Java,,32,30,78,140
SnmpString.java,Java,,117,27,121,265
SnmpStringFixed.java,Java,,75,16,90,181
SnmpTimeticks.java,Java,,45,17,76,138
SnmpTooBigException.java,Java,,13,15,47,75
SnmpUnknownAccContrModelException.java,Java,,7,2,22,31
SnmpUnknownModelException.java,Java,,6,0,20,26
SnmpUnknownModelLcdException.java,Java,,6,0,20,26
SnmpUnknownMsgProcModelException.java,Java,,7,2,20,29
SnmpUnknownSecModelException.java,Java,,7,2,20,29
SnmpUnknownSubSystemException.java,Java,,6,0,20,26
SnmpUnsignedInt.java,Java,,32,15,66,113
SnmpUsmKeyHandler.java,Java,,10,8,66,84
SnmpV3Message.java,Java,,283,48,159,490
SnmpValue.java,Java,,19,14,51,84
SnmpVarBind.java,Java,,268,84,391,743
SnmpVarBindList.java,Java,,244,53,260,557
Task.java,Java,,4,1,47,52
TaskServer.java,Java,,4,4,34,42
ThreadService.java,Java,,142,44,56,242
ThreadContext.java,Java,,80,22,211,313
Timestamp.java,Java,,41,22,75,138
UserAcl.java,Java,,11,11,61,83
Trace.java,Java,,67,19,92,178
TraceDestination.java,Java,,16,7,52,75
TraceImplementation.java,Java,,135,34,88,257
TraceManager.java,Java,,95,14,170,279
TraceTags.java,Java,,16,16,54,86
AnnotationProcessor.java,Java,,6,7,34,47
AnnotationProcessorEnvironment.java,Java,,20,22,118,160
AnnotationProcessorFactory.java,Java,,10,10,66,86
AnnotationProcessorListener.java,Java,,2,2,14,18
AnnotationProcessors.java,Java,,31,15,56,102
Filer.java,Java,,17,12,104,133
Messager.java,Java,,10,12,49,71
RoundCompleteEvent.java,Java,,15,5,31,51
RoundCompleteListener.java,Java,,4,2,19,25
RoundState.java,Java,,7,5,30,42
AnnotationMirror.java,Java,,9,8,47,64
AnnotationTypeDeclaration.java,Java,,5,7,22,34
AnnotationTypeElementDeclaration.java,Java,,5,6,23,34
AnnotationValue.java,Java,,7,7,45,59
ClassDeclaration.java,Java,,8,10,48,66
ConstructorDeclaration.java,Java,,3,4,14,21
Declaration.java,Java,,15,15,116,146
EnumConstantDeclaration.java,Java,,4,4,17,25
EnumDeclaration.java,Java,,5,7,20,32
ExecutableDeclaration.java,Java,,9,11,42,62
FieldDeclaration.java,Java,,7,9,40,56
InterfaceDeclaration.java,Java,,4,6,24,34
MemberDeclaration.java,Java,,4,5,25,34
MethodDeclaration.java,Java,,6,7,23,36
Modifier.java,Java,,21,9,25,55
PackageDeclaration.java,Java,,9,11,58,78
ParameterDeclaration.java,Java,,5,7,19,31
TypeDeclaration.java,Java,,12,14,97,123
TypeParameterDeclaration.java,Java,,7,9,30,46
AnnotationType.java,Java,,5,7,17,29
ArrayType.java,Java,,4,5,21,30
ClassType.java,Java,,6,8,37,51
DeclaredType.java,Java,,9,11,68,88
EnumType.java,Java,,5,7,17,29
InterfaceType.java,Java,,5,7,24,36
MirroredTypeException.java,Java,,19,11,33,63
MirroredTypesException.java,Java,,27,11,34,72
PrimitiveType.java,Java,,14,6,24,44
ReferenceType.java,Java,,3,4,15,22
TypeMirror.java,Java,,9,9,44,62
TypeVariable.java,Java,,5,7,22,34
VoidType.java,Java,,4,6,16,26
WildcardType.java,Java,,6,8,37,51
DeclarationFilter.java,Java,,106,39,151,296
Declarations.java,Java,,6,8,32,46
DeclarationScanner.java,Java,,103,38,103,244
DeclarationVisitor.java,Java,,21,21,84,126
DeclarationVisitors.java,Java,,13,5,62,80
SimpleDeclarationVisitor.java,Java,,53,23,117,193
SimpleTypeVisitor.java,Java,,40,19,93,152
SourceOrderDeclScanner.java,Java,,143,51,36,230
SourcePosition.java,Java,,7,9,33,49
Types.java,Java,,20,17,129,166
TypeVisitor.java,Java,,16,18,80,114
FactoryEnumeration.java,Java,,50,10,33,93
NamedWeakReference.java,Java,,11,8,12,31
ResourceManager.java,Java,,263,53,228,544
VersionHelper.java,Java,,65,21,52,138
VersionHelper12.java,Java,,174,29,32,235
AccessFlags.java,Java,,70,20,69,159
Attribute.java,Java,,98,36,140,274
ClassParser.java,Java,,120,41,168,329
Code.java,Java,,152,50,171,373
CodeException.java,Java,,72,21,134,227
Constant.java,Java,,43,13,92,148
ConstantClass.java,Java,,39,14,100,153
ConstantCP.java,Java,,40,12,102,154
ConstantDouble.java,Java,,36,8,98,142
ConstantFieldref.java,Java,,19,6,79,104
ConstantFloat.java,Java,,36,6,99,141
ConstantInteger.java,Java,,36,14,98,148
ConstantInterfaceMethodref.java,Java,,19,6,79,104
ConstantLong.java,Java,,36,5,98,139
ConstantMethodref.java,Java,,19,6,79,104
ConstantNameAndType.java,Java,,48,15,108,171
ConstantObject.java,Java,,4,2,63,69
ConstantPool.java,Java,,161,42,166,369
ConstantString.java,Java,,41,6,100,147
ConstantUtf8.java,Java,,35,12,96,143
ConstantValue.java,Java,,79,16,109,204
Deprecated.java,Java,,48,16,106,170
DescendingVisitor.java,Java,,219,55,77,351
EmptyVisitor.java,Java,,37,4,63,104
ExceptionTable.java,Java,,70,17,115,202
Field.java,Java,,47,15,95,157
FieldOrMethod.java,Java,,83,25,115,223
InnerClass.java,Java,,84,15,122,221
InnerClasses.java,Java,,56,17,108,181
JavaClass.java,Java,,302,69,235,606
LineNumber.java,Java,,44,15,105,164
LineNumberTable.java,Java,,89,27,118,234
LocalVariable.java,Java,,87,28,142,257
LocalVariableTable.java,Java,,70,22,104,196
Method.java,Java,,80,24,112,216
Node.java,Java,,4,2,59,65
PMGClass.java,Java,,56,16,117,189
Signature.java,Java,,133,44,118,295
SourceFile.java,Java,,44,13,108,165
StackMap.java,Java,,56,22,107,185
StackMapEntry.java,Java,,90,26,93,209
StackMapType.java,Java,,59,18,95,172
Synthetic.java,Java,,51,14,106,171
Unknown.java,Java,,73,21,111,205
Utility.java,Java,,749,210,396,1355
Visitor.java,Java,,34,2,64,100
Constants.java,Java,,621,34,113,768
ExceptionConstants.java,Java,,36,12,75,123
AALOAD.java,Java,,13,4,70,87
AASTORE.java,Java,,13,4,70,87
ACONST_NULL.java,Java,,16,5,73,94
AllocationInstruction.java,Java,,2,3,59,64
ALOAD.java,Java,,13,4,75,92
ANEWARRAY.java,Java,,33,9,72,114
ARETURN.java,Java,,13,4,71,88
ArithmeticInstruction.java,Java,,31,7,68,106
ArrayInstruction.java,Java,,32,6,68,106
ARRAYLENGTH.java,Java,,15,5,72,92
ArrayType.java,Java,,53,17,86,156
ASTORE.java,Java,,13,4,75,92
ATHROW.java,Java,,14,5,73,92
BALOAD.java,Java,,13,4,70,87
BasicType.java,Java,,28,6,67,101
BASTORE.java,Java,,13,4,70,87
BIPUSH.java,Java,,34,12,86,132
BranchHandle.java,Java,,48,18,85,151
BranchInstruction.java,Java,,87,26,133,246
BREAKPOINT.java,Java,,9,4,67,80
CALOAD.java,Java,,13,4,70,87
CASTORE.java,Java,,13,4,70,87
CHECKCAST.java,Java,,32,8,77,117
ClassGen.java,Java,,218,67,149,434
ClassGenException.java,Java,,5,3,60,68
ClassObserver.java,Java,,4,3,60,67
CodeExceptionGen.java,Java,,71,20,110,201
CompoundInstruction.java,Java,,4,3,69,76
ConstantPoolGen.java,Java,,373,149,260,782
ConstantPushInstruction.java,Java,,4,3,63,70
ConversionInstruction.java,Java,,29,5,68,102
CPInstruction.java,Java,,48,17,101,166
D2F.java,Java,,13,4,70,87
D2I.java,Java,,13,4,70,87
D2L.java,Java,,13,4,70,87
DADD.java,Java,,13,4,71,88
DALOAD.java,Java,,13,4,70,87
DASTORE.java,Java,,13,4,70,87
DCMPG.java,Java,,16,6,71,93
DCMPL.java,Java,,16,5,71,92
DCONST.java,Java,,27,10,75,112
DDIV.java,Java,,13,4,71,88
DLOAD.java,Java,,13,4,75,92
DMUL.java,Java,,13,4,71,88
DNEG.java,Java,,13,4,68,85
DREM.java,Java,,13,4,71,88
DRETURN.java,Java,,13,4,70,87
DSTORE.java,Java,,13,4,75,92
DSUB.java,Java,,13,4,71,88
DUP.java,Java,,12,4,68,84
DUP2.java,Java,,12,4,68,84
DUP2_X1.java,Java,,10,4,68,82
DUP2_X2.java,Java,,10,4,68,82
DUP_X1.java,Java,,10,4,68,82
DUP_X2.java,Java,,10,4,68,82
EmptyVisitor.java,Java,,183,2,59,244
ExceptionThrower.java,Java,,4,2,73,79
F2D.java,Java,,13,4,70,87
F2I.java,Java,,13,4,70,87
F2L.java,Java,,13,4,70,87
FADD.java,Java,,13,4,70,87
FALOAD.java,Java,,13,4,70,87
FASTORE.java,Java,,13,4,70,87
FCMPG.java,Java,,16,5,70,91
FCMPL.java,Java,,16,5,70,91
FCONST.java,Java,,29,10,75,114
FDIV.java,Java,,13,4,70,87
FieldGen.java,Java,,154,53,103,310
FieldGenOrMethodGen.java,Java,,35,13,81,129
FieldInstruction.java,Java,,29,10,77,116
FieldObserver.java,Java,,4,3,60,67
FieldOrMethod.java,Java,,31,9,77,117
FLOAD.java,Java,,13,4,75,92
FMUL.java,Java,,13,4,70,87
FNEG.java,Java,,13,4,68,85
FREM.java,Java,,13,4,70,87
FRETURN.java,Java,,13,4,70,87
FSTORE.java,Java,,13,4,75,92
FSUB.java,Java,,13,4,70,87
GETFIELD.java,Java,,32,11,74,117
GETSTATIC.java,Java,,29,10,74,113
GOTO.java,Java,,35,9,78,122
GotoInstruction.java,Java,,9,3,63,75
GOTO_W.java,Java,,26,6,78,110
I2B.java,Java,,13,4,70,87
I2C.java,Java,,13,4,70,87
I2D.java,Java,,13,4,70,87
I2F.java,Java,,13,4,70,87
I2L.java,Java,,13,4,70,87
I2S.java,Java,,13,4,68,85
IADD.java,Java,,13,4,70,87
IALOAD.java,Java,,13,4,71,88
IAND.java,Java,,13,4,68,85
IASTORE.java,Java,,13,4,71,88
ICONST.java,Java,,26,9,75,110
IDIV.java,Java,,17,5,72,94
IFEQ.java,Java,,16,6,76,98
IFGE.java,Java,,16,6,76,98
IFGT.java,Java,,16,6,76,98
IfInstruction.java,Java,,8,5,69,82
IFLE.java,Java,,16,6,76,98
IFLT.java,Java,,16,6,76,98
IFNE.java,Java,,16,6,76,98
IFNONNULL.java,Java,,16,5,76,97
IFNULL.java,Java,,16,6,76,98
IF_ACMPEQ.java,Java,,16,5,76,97
IF_ACMPNE.java,Java,,16,6,76,98
IF_ICMPEQ.java,Java,,16,6,76,98
IF_ICMPGE.java,Java,,16,6,76,98
IF_ICMPGT.java,Java,,16,6,76,98
IF_ICMPLE.java,Java,,16,6,76,98
IF_ICMPLT.java,Java,,16,6,76,98
IF_ICMPNE.java,Java,,16,6,76,98
IINC.java,Java,,68,19,92,179
ILOAD.java,Java,,13,4,75,92
IMPDEP1.java,Java,,9,4,67,80
IMPDEP2.java,Java,,9,4,67,80
IMUL.java,Java,,13,4,70,87
IndexedInstruction.java,Java,,5,3,60,68
INEG.java,Java,,13,4,68,85
INSTANCEOF.java,Java,,26,8,72,106
Instruction.java,Java,,98,32,146,276
InstructionConstants.java,Java,,237,8,81,326
InstructionFactory.java,Java,,399,62,132,593
InstructionHandle.java,Java,,110,35,139,284
InstructionList.java,Java,,612,195,480,1287
InstructionListObserver.java,Java,,4,3,60,67
InstructionTargeter.java,Java,,5,2,63,70
InvokeInstruction.java,Java,,45,14,87,146
INVOKEINTERFACE.java,Java,,59,18,86,163
INVOKESPECIAL.java,Java,,30,9,74,113
INVOKESTATIC.java,Java,,28,9,73,110
INVOKEVIRTUAL.java,Java,,30,9,73,112
IOR.java,Java,,13,4,68,85
IREM.java,Java,,17,5,72,94
IRETURN.java,Java,,13,4,70,87
ISHL.java,Java,,13,4,68,85
ISHR.java,Java,,13,4,68,85
ISTORE.java,Java,,13,4,75,92
ISUB.java,Java,,13,4,70,87
IUSHR.java,Java,,13,4,68,85
IXOR.java,Java,,13,4,68,85
JSR.java,Java,,35,9,75,119
JsrInstruction.java,Java,,26,11,79,116
JSR_W.java,Java,,26,6,78,110
L2D.java,Java,,13,4,68,85
L2F.java,Java,,13,4,68,85
L2I.java,Java,,13,4,68,85
LADD.java,Java,,13,4,69,86
LALOAD.java,Java,,13,4,70,87
LAND.java,Java,,13,4,69,86
LASTORE.java,Java,,13,4,70,87
LCMP.java,Java,,9,4,69,82
LCONST.java,Java,,27,10,75,112
LDC.java,Java,,72,16,84,172
LDC2_W.java,Java,,34,9,73,116
LDC_W.java,Java,,15,4,68,87
LDIV.java,Java,,17,5,69,91
LineNumberGen.java,Java,,38,11,81,130
LLOAD.java,Java,,13,4,72,89
LMUL.java,Java,,13,4,69,86
LNEG.java,Java,,13,4,68,85
LoadClass.java,Java,,5,3,78,86
LoadInstruction.java,Java,,18,5,78,101
LocalVariableGen.java,Java,,77,20,94,191
LocalVariableInstruction.java,Java,,99,22,106,227
LOOKUPSWITCH.java,Java,,40,12,81,133
LOR.java,Java,,13,4,68,85
LREM.java,Java,,15,5,68,88
LRETURN.java,Java,,13,4,68,85
LSHL.java,Java,,13,4,68,85
LSHR.java,Java,,13,4,68,85
LSTORE.java,Java,,13,4,72,89
LSUB.java,Java,,13,4,69,86
LUSHR.java,Java,,13,4,68,85
LXOR.java,Java,,13,4,68,85
MethodGen.java,Java,,504,138,296,938
MethodObserver.java,Java,,4,3,60,67
MONITORENTER.java,Java,,15,5,68,88
MONITOREXIT.java,Java,,15,5,68,88
MULTIANEWARRAY.java,Java,,59,20,93,172
NamedAndTyped.java,Java,,7,4,60,71
NEW.java,Java,,30,9,72,111
NEWARRAY.java,Java,,40,12,89,141
NOP.java,Java,,9,4,67,80
ObjectType.java,Java,,45,12,79,136
POP.java,Java,,12,4,69,85
POP2.java,Java,,12,4,69,85
PopInstruction.java,Java,,3,3,62,68
PUSH.java,Java,,80,15,101,196
PushInstruction.java,Java,,3,3,67,73
PUTFIELD.java,Java,,29,11,74,114
PUTSTATIC.java,Java,,30,10,74,114
ReferenceType.java,Java,,95,30,133,258
RET.java,Java,,54,16,91,161
RETURN.java,Java,,13,4,68,85
ReturnaddressType.java,Java,,22,8,72,102
ReturnInstruction.java,Java,,28,8,68,104
SALOAD.java,Java,,13,4,68,85
SASTORE.java,Java,,13,4,68,85
Select.java,Java,,98,36,122,256
SIPUSH.java,Java,,34,11,84,129
StackConsumer.java,Java,,4,3,61,68
StackInstruction.java,Java,,10,5,68,83
StackProducer.java,Java,,4,3,62,69
StoreInstruction.java,Java,,19,5,78,102
SWAP.java,Java,,12,4,68,84
SWITCH.java,Java,,79,22,82,183
TABLESWITCH.java,Java,,44,16,87,147
TargetLostException.java,Java,,9,4,87,100
Type.java,Java,,104,28,100,232
TypedInstruction.java,Java,,4,3,60,67
UnconditionalBranch.java,Java,,2,3,62,67
VariableLengthInstruction.java,Java,,2,3,65,70
Visitor.java,Java,,183,2,62,247
Repository.java,Java,,125,48,122,295
AttributeHTML.java,Java,,139,47,70,256
ByteSequence.java,Java,,16,5,61,82
Class2HTML.java,Java,,138,31,93,262
ClassLoader.java,Java,,74,22,104,200
ClassPath.java,Java,,156,55,111,322
ClassQueue.java,Java,,14,3,61,78
ClassStack.java,Java,,10,3,60,73
ClassVector.java,Java,,14,4,61,79
CodeHTML.java,Java,,381,100,137,618
ConstantHTML.java,Java,,151,39,72,262
InstructionFinder.java,Java,,203,59,178,440
MethodHTML.java,Java,,94,27,78,199
AssertionViolatedException.java,Java,,28,5,82,115
ClassConstraintException.java,Java,,11,4,68,83
CodeConstraintException.java,Java,,9,1,67,77
InvalidMethodException.java,Java,,7,2,62,71
LinkingConstraintException.java,Java,,3,1,70,74
LoadingException.java,Java,,11,4,67,82
LocalVariableInfoInconsistentException.java,Java,,9,3,69,81
StaticCodeConstraintException.java,Java,,6,2,63,71
StaticCodeInstructionConstraintException.java,Java,,6,2,66,74
StaticCodeInstructionOperandConstraintException.java,Java,,6,2,66,74
StructuralCodeConstraintException.java,Java,,9,1,72,82
Utility.java,Java,,11,4,61,76
VerificationException.java,Java,,9,2,71,82
VerifierConstraintViolatedException.java,Java,,20,5,82,107
GraphicalVerifier.java,Java,,39,6,64,109
NativeVerifier.java,Java,,37,9,70,116
PassVerifier.java,Java,,24,9,110,143
DOUBLE_Upper.java,Java,,12,6,61,79
IntList.java,Java,,19,3,63,85
LocalVariableInfo.java,Java,,40,7,98,145
LocalVariablesInfo.java,Java,,28,10,75,113
LONG_Upper.java,Java,,12,6,61,79
Pass1Verifier.java,Java,,49,12,153,214
Pass2Verifier.java,Java,,851,139,345,1335
Pass3aVerifier.java,Java,,685,107,278,1070
StringRepresentation.java,Java,,111,3,89,203
ControlFlowGraph.java,Java,,208,59,199,466
ExceptionHandler.java,Java,,16,7,70,93
ExceptionHandlers.java,Java,,31,6,70,107
ExecutionVisitor.java,Java,,807,22,297,1126
Frame.java,Java,,42,15,96,153
GenericArray.java,Java,,3,2,61,66
InstConstraintVisitor.java,Java,,1593,264,795,2652
InstructionContext.java,Java,,13,10,118,141
LocalVariables.java,Java,,97,18,114,229
OperandStack.java,Java,,113,24,138,275
Pass3bVerifier.java,Java,,199,35,132,366
Subroutine.java,Java,,11,9,106,126
Subroutines.java,Java,,346,64,258,668
UninitializedObjectType.java,Java,,17,7,73,97
TransitiveHull.java,Java,,50,17,71,138
VerificationResult.java,Java,,36,13,89,138
Verifier.java,Java,,141,28,114,283
VerifierAppFrame.java,Java,,289,36,65,390
VerifierFactory.java,Java,,36,13,93,142
VerifierFactoryListModel.java,Java,,36,11,60,107
VerifierFactoryObserver.java,Java,,4,2,70,76
VerifyDialog.java,Java,,322,48,189,559
HTMLAnchorElementImpl.java,Java,,119,61,71,251
HTMLAppletElementImpl.java,Java,,99,52,67,218
HTMLAreaElementImpl.java,Java,,81,40,69,190
HTMLBaseElementImpl.java,Java,,27,16,67,110
HTMLBaseFontElementImpl.java,Java,,35,21,67,123
HTMLBodyElementImpl.java,Java,,59,32,67,158
HTMLBRElementImpl.java,Java,,19,13,67,99
HTMLBuilder.java,Java,,131,46,102,279
HTMLButtonElementImpl.java,Java,,68,32,69,169
HTMLCollectionImpl.java,Java,,213,69,290,572
HTMLDirectoryElementImpl.java,Java,,19,13,67,99
HTMLDivElementImpl.java,Java,,19,12,67,98
HTMLDListElementImpl.java,Java,,19,13,67,99
HTMLDocumentImpl.java,Java,,451,105,258,814
HTMLDOMImplementationImpl.java,Java,,28,15,88,131
HTMLElementImpl.java,Java,,160,57,128,345
HTMLFieldSetElementImpl.java,Java,,11,9,67,87
HTMLFontElementImpl.java,Java,,35,20,62,117
HTMLFormControl.java,Java,,4,2,64,70
HTMLFormElementImpl.java,Java,,81,42,76,199
HTMLFrameElementImpl.java,Java,,80,43,67,190
HTMLFrameSetElementImpl.java,Java,,27,17,67,111
HTMLHeadElementImpl.java,Java,,19,13,67,99
HTMLHeadingElementImpl.java,Java,,19,13,67,99
HTMLHRElementImpl.java,Java,,43,25,67,135
HTMLHtmlElementImpl.java,Java,,19,13,67,99
HTMLIFrameElementImpl.java,Java,,96,49,67,212
HTMLImageElementImpl.java,Java,,115,61,67,243
HTMLInputElementImpl.java,Java,,168,85,77,330
HTMLIsIndexElementImpl.java,Java,,19,13,67,99
HTMLLabelElementImpl.java,Java,,33,18,69,120
HTMLLegendElementImpl.java,Java,,33,18,69,120
HTMLLIElementImpl.java,Java,,27,17,67,111
HTMLLinkElementImpl.java,Java,,83,45,67,195
HTMLMapElementImpl.java,Java,,27,18,67,112
HTMLMenuElementImpl.java,Java,,19,13,67,99
HTMLMetaElementImpl.java,Java,,43,26,67,136
HTMLModElementImpl.java,Java,,27,18,67,112
HTMLObjectElementImpl.java,Java,,159,75,67,301
HTMLOListElementImpl.java,Java,,35,21,67,123
HTMLOptGroupElementImpl.java,Java,,27,17,67,111
HTMLOptionElementImpl.java,Java,,119,42,89,250
HTMLParagraphElementImpl.java,Java,,19,13,67,99
HTMLParamElementImpl.java,Java,,43,25,67,135
HTMLPreElementImpl.java,Java,,19,13,67,99
HTMLQuoteElementImpl.java,Java,,19,13,67,99
HTMLScriptElementImpl.java,Java,,88,38,71,197
HTMLSelectElementImpl.java,Java,,119,56,88,263
HTMLStyleElementImpl.java,Java,,35,21,67,123
HTMLTableCaptionElementImpl.java,Java,,19,13,67,99
HTMLTableCellElementImpl.java,Java,,180,70,69,319
HTMLTableColElementImpl.java,Java,,65,33,69,167
HTMLTableElementImpl.java,Java,,279,92,68,439
HTMLTableRowElementImpl.java,Java,,175,58,72,305
HTMLTableSectionElementImpl.java,Java,,111,41,69,221
HTMLTextAreaElementImpl.java,Java,,102,55,74,231
HTMLTitleElementImpl.java,Java,,40,15,71,126
HTMLUListElementImpl.java,Java,,27,17,67,111
NameNodeListImpl.java,Java,,41,16,133,190
ObjectFactory.java,Java,,247,53,241,541
SecuritySupport.java,Java,,52,14,88,154
SecuritySupport12.java,Java,,95,13,63,171
CharacterArrayCharacterIterator.java,Java,,29,7,68,104
CharacterIterator.java,Java,,8,5,65,78
RE.java,Java,,895,161,707,1763
ReaderCharacterIterator.java,Java,,112,17,71,200
recompile.java,Java,,56,11,108,175
RECompiler.java,Java,,931,178,364,1473
REDebugCompiler.java,Java,,101,21,107,229
REProgram.java,Java,,68,14,103,185
RESyntaxException.java,Java,,8,2,66,76
RETest.java,Java,,294,50,170,514
REUtil.java,Java,,17,4,78,99
StreamCharacterIterator.java,Java,,109,17,71,197
StringCharacterIterator.java,Java,,25,7,66,98
WMLAccessElementImpl.java,Java,,31,13,60,104
WMLAElementImpl.java,Java,,37,15,60,112
WMLAnchorElementImpl.java,Java,,31,13,60,104
WMLBElementImpl.java,Java,,25,11,60,96
WMLBigElementImpl.java,Java,,25,11,60,96
WMLBrElementImpl.java,Java,,25,11,60,96
WMLCardElementImpl.java,Java,,61,23,60,144
WMLDocumentImpl.java,Java,,79,12,61,152
WMLDoElementImpl.java,Java,,49,19,60,128
WMLDOMImplementationImpl.java,Java,,18,7,65,90
WMLElementImpl.java,Java,,47,13,60,120
WMLEmElementImpl.java,Java,,25,11,60,96
WMLFieldsetElementImpl.java,Java,,31,13,60,104
WMLGoElementImpl.java,Java,,43,17,60,120
WMLHeadElementImpl.java,Java,,19,9,60,88
WMLIElementImpl.java,Java,,25,11,60,96
WMLImgElementImpl.java,Java,,73,27,60,160
WMLInputElementImpl.java,Java,,79,29,60,168
WMLMetaElementImpl.java,Java,,49,17,60,126
WMLNoopElementImpl.java,Java,,19,8,60,87
WMLOneventElementImpl.java,Java,,25,11,60,96
WMLOptgroupElementImpl.java,Java,,31,13,60,104
WMLOptionElementImpl.java,Java,,43,17,60,120
WMLPElementImpl.java,Java,,37,15,60,112
WMLPostfieldElementImpl.java,Java,,31,13,60,104
WMLPrevElementImpl.java,Java,,19,9,60,88
WMLRefreshElementImpl.java,Java,,19,9,60,88
WMLSelectElementImpl.java,Java,,67,24,60,151
WMLSetvarElementImpl.java,Java,,31,13,60,104
WMLSmallElementImpl.java,Java,,25,11,60,96
WMLStrongElementImpl.java,Java,,25,11,60,96
WMLTableElementImpl.java,Java,,43,17,60,120
WMLTdElementImpl.java,Java,,25,11,60,96
WMLTemplateElementImpl.java,Java,,37,15,60,112
WMLTimerElementImpl.java,Java,,31,13,60,104
WMLTrElementImpl.java,Java,,19,9,60,88
WMLUElementImpl.java,Java,,25,11,60,96
WMLWmlElementImpl.java,Java,,25,11,60,96
WMLAccessElement.java,Java,,7,4,79,90
WMLAElement.java,Java,,11,6,70,87
WMLAnchorElement.java,Java,,7,4,70,81
WMLBElement.java,Java,,5,2,73,80
WMLBigElement.java,Java,,5,2,73,80
WMLBrElement.java,Java,,5,2,72,79
WMLCardElement.java,Java,,17,9,102,128
WMLDocument.java,Java,,4,3,65,72
WMLDoElement.java,Java,,13,7,70,90
WMLDOMImplementation.java,Java,,4,2,65,71
WMLElement.java,Java,,8,5,77,90
WMLEmElement.java,Java,,5,2,73,80
WMLFieldsetElement.java,Java,,7,3,76,86
WMLGoElement.java,Java,,11,11,65,87
WMLHeadElement.java,Java,,3,2,68,73
WMLIElement.java,Java,,5,2,73,80
WMLImgElement.java,Java,,21,10,109,140
WMLInputElement.java,Java,,23,12,112,147
WMLMetaElement.java,Java,,13,6,87,106
WMLNoopElement.java,Java,,3,1,65,69
WMLOneventElement.java,Java,,5,5,65,75
WMLOptgroupElement.java,Java,,7,4,77,88
WMLOptionElement.java,Java,,11,6,84,101
WMLPElement.java,Java,,9,5,83,97
WMLPostfieldElement.java,Java,,7,7,65,79
WMLPrevElement.java,Java,,3,2,65,70
WMLRefreshElement.java,Java,,3,2,65,70
WMLSelectElement.java,Java,,19,9,101,129
WMLSetvarElement.java,Java,,7,7,65,79
WMLSmallElement.java,Java,,5,2,74,81
WMLStrongElement.java,Java,,5,2,73,80
WMLTableElement.java,Java,,11,6,85,102
WMLTdElement.java,Java,,5,2,73,80
WMLTemplateElement.java,Java,,9,5,67,81
WMLTimerElement.java,Java,,7,3,77,87
WMLTrElement.java,Java,,3,2,68,73
WMLUElement.java,Java,,5,2,73,80
WMLWmlElement.java,Java,,5,2,73,80
ExpressionContext.java,Java,,17,11,63,91
ExsltBase.java,Java,,43,4,35,82
ExsltCommon.java,Java,,31,4,69,104
ExsltDatetime.java,Java,,564,79,468,1111
ExsltDynamic.java,Java,,296,70,246,612
ExsltMath.java,Java,,157,36,194,387
ExsltSets.java,Java,,103,28,106,237
ExsltStrings.java,Java,,156,34,163,353
Extensions.java,Java,,187,44,189,420
ObjectFactory.java,Java,,294,59,278,631
SecuritySupport.java,Java,,56,15,52,123
SecuritySupport12.java,Java,,102,15,27,144
XSLMessages.java,Java,,31,9,45,85
XSLTErrorResources.java,Java,,961,658,906,2525
XSLTErrorResources_de.java,Java,,947,657,880,2484
XSLTErrorResources_en.java,Java,,4,2,23,29
XSLTErrorResources_es.java,Java,,947,657,880,2484
XSLTErrorResources_fr.java,Java,,947,657,880,2484
XSLTErrorResources_it.java,Java,,947,657,880,2484
XSLTErrorResources_ja.java,Java,,947,657,880,2484
XSLTErrorResources_ko.java,Java,,947,657,880,2484
XSLTErrorResources_sv.java,Java,,781,968,598,2347
XSLTErrorResources_zh_CN.java,Java,,947,657,880,2484
XSLTErrorResources_zh_HK.java,Java,,4,2,66,72
XSLTErrorResources_zh_TW.java,Java,,947,657,880,2484
Constants.java,Java,,278,36,83,397
Version.java,Java,,46,11,94,151
EnvironmentCheck.java,Java,,717,167,407,1291
ObjectFactory.java,Java,,294,59,278,631
Process.java,Java,,742,108,106,956
SecuritySupport.java,Java,,56,15,52,123
SecuritySupport12.java,Java,,102,15,27,144
Compile.java,Java,,111,15,39,165
GetOpt.java,Java,,144,19,92,255
GetOptsException.java,Java,,6,2,21,29
IllegalArgumentException.java,Java,,6,3,18,27
MissingOptArgException.java,Java,,6,3,21,30
ObjectFactory.java,Java,,294,59,278,631
SecuritySupport.java,Java,,56,15,52,123
SecuritySupport12.java,Java,,102,15,27,144
Transform.java,Java,,238,31,39,308
CollatorFactory.java,Java,,7,4,22,33
AbsoluteLocationPath.java,Java,,67,12,25,104
AbsolutePathPattern.java,Java,,94,17,27,138
AlternativePattern.java,Java,,54,15,29,98
AncestorPattern.java,Java,,121,26,33,180
ApplyImports.java,Java,,92,21,50,163
ApplyTemplates.java,Java,,141,22,37,200
ArgumentList.java,Java,,14,4,22,40
Attribute.java,Java,,14,5,24,43
AttributeSet.java,Java,,117,29,62,208
AttributeValue.java,Java,,19,5,22,46
AttributeValueTemplate.java,Java,,201,21,39,261
BinOpExpr.java,Java,,85,14,29,128
BooleanCall.java,Java,,25,8,22,55
BooleanExpr.java,Java,,43,10,24,77
CallTemplate.java,Java,,143,29,67,239
CastCall.java,Java,,48,13,37,98
CastExpr.java,Java,,162,28,47,237
CeilingCall.java,Java,,19,5,22,46
Choose.java,Java,,100,19,45,164
Closure.java,Java,,7,6,35,48
Comment.java,Java,,68,12,34,114
CompilerException.java,Java,,22,8,21,51
ConcatCall.java,Java,,59,11,23,93
Constants.java,Java,,429,41,34,504
ContainsCall.java,Java,,50,14,41,105
Copy.java,Java,,100,14,35,149
CopyOf.java,Java,,97,15,27,139
CurrentCall.java,Java,,11,4,22,37
DecimalFormatting.java,Java,,170,28,56,254
DocumentCall.java,Java,,88,23,43,154
ElementAvailableCall.java,Java,,44,9,38,91
EqualityExpr.java,Java,,273,41,42,356
Expression.java,Java,,121,26,73,220
Fallback.java,Java,,32,10,35,77
FilteredAbsoluteLocationPath.java,Java,,67,12,24,103
FilterExpr.java,Java,,95,20,52,167
FilterParentPath.java,Java,,84,16,37,137
FloorCall.java,Java,,17,5,22,44
FlowList.java,Java,,72,14,29,115
ForEach.java,Java,,114,28,52,194
FormatNumberCall.java,Java,,75,13,24,112
FunctionAvailableCall.java,Java,,111,25,56,192
FunctionCall.java,Java,,762,141,164,1067
GenerateIdCall.java,Java,,25,5,23,53
IdKeyPattern.java,Java,,83,21,32,136
IdPattern.java,Java,,6,5,22,33
If.java,Java,,53,11,44,108
IllegalCharException.java,Java,,6,2,22,30
Import.java,Java,,102,20,29,151
Include.java,Java,,102,20,30,152
Instruction.java,Java,,16,4,28,48
IntExpr.java,Java,,25,7,22,54
Key.java,Java,,178,48,79,305
KeyCall.java,Java,,195,49,125,369
KeyPattern.java,Java,,6,4,22,32
LangCall.java,Java,,45,9,35,89
LastCall.java,Java,,37,8,22,67
LiteralAttribute.java,Java,,84,21,50,155
LiteralElement.java,Java,,358,60,138,556
LiteralExpr.java,Java,,40,12,31,83
LocalNameCall.java,Java,,31,9,32,72
LocationPathPattern.java,Java,,58,15,32,105
LogicalExpr.java,Java,,115,33,83,231
Message.java,Java,,98,22,39,159
Mode.java,Java,,983,210,351,1544
NameBase.java,Java,,69,16,41,126
NameCall.java,Java,,24,8,32,64
NamespaceAlias.java,Java,,19,7,27,53
NamespaceUriCall.java,Java,,25,8,32,65
NodeTest.java,Java,,13,5,23,41
NotCall.java,Java,,28,6,22,56
Number.java,Java,,441,76,84,601
NumberCall.java,Java,,35,9,22,66
ObjectFactory.java,Java,,294,59,278,631
Otherwise.java,Java,,24,5,22,51
Output.java,Java,,289,53,75,417
Param.java,Java,,151,24,77,252
ParameterRef.java,Java,,64,12,33,109
ParentLocationPath.java,Java,,143,31,41,215
ParentPattern.java,Java,,95,23,26,144
Parser.java,Java,,998,148,234,1380
Pattern.java,Java,,11,5,42,58
PositionCall.java,Java,,34,8,23,65
Predicate.java,Java,,355,78,185,618
ProcessingInstruction.java,Java,,85,19,33,137
ProcessingInstructionPattern.java,Java,,97,19,40,156
QName.java,Java,,45,14,23,82
RealExpr.java,Java,,25,7,22,54
RelationalExpr.java,Java,,204,35,40,279
RelativeLocationPath.java,Java,,5,2,22,29
RelativePathPattern.java,Java,,2,2,22,26
RoundCall.java,Java,,19,7,23,49
SecuritySupport.java,Java,,56,15,52,123
SecuritySupport12.java,Java,,102,15,27,144
SimpleAttributeValue.java,Java,,28,9,36,73
Sort.java,Java,,471,103,117,691
SourceLoader.java,Java,,5,5,30,40
StartsWithCall.java,Java,,42,12,35,89
Step.java,Java,,291,46,129,466
StepPattern.java,Java,,368,75,63,506
StringCall.java,Java,,41,9,22,72
StringLengthCall.java,Java,,26,5,22,53
Stylesheet.java,Java,,870,208,334,1412
sym.java,Java,,57,4,6,67
SymbolTable.java,Java,,160,38,64,262
SyntaxTreeNode.java,Java,,450,97,356,903
Template.java,Java,,233,58,48,339
TestSeq.java,Java,,135,39,111,285
Text.java,Java,,125,26,68,219
TopLevelElement.java,Java,,44,11,40,95
TransletOutput.java,Java,,76,23,46,145
UnaryOpExpr.java,Java,,45,13,29,87
UnionPathExpr.java,Java,,97,17,30,144
UnparsedEntityUriCall.java,Java,,35,7,26,68
UnresolvedRef.java,Java,,62,14,24,100
UnsupportedElement.java,Java,,79,16,53,148
UseAttributeSets.java,Java,,57,12,44,113
AttributeSetMethodGenerator.java,Java,,60,15,22,97
BooleanType.java,Java,,137,22,62,221
ClassGenerator.java,Java,,64,14,43,121
CompareGenerator.java,Java,,76,17,23,116
ErrorMessages.java,Java,,256,116,575,947
ErrorMessages_ca.java,Java,,199,106,542,847
ErrorMessages_cs.java,Java,,199,106,542,847
ErrorMessages_de.java,Java,,199,106,542,847
ErrorMessages_es.java,Java,,199,106,542,847
ErrorMessages_fr.java,Java,,199,106,542,847
ErrorMessages_it.java,Java,,199,106,542,847
ErrorMessages_ja.java,Java,,199,106,542,847
ErrorMessages_ko.java,Java,,199,106,542,847
ErrorMessages_sk.java,Java,,199,106,542,847
ErrorMessages_zh_CN.java,Java,,199,106,542,847
ErrorMessages_zh_TW.java,Java,,199,106,542,847
ErrorMsg.java,Java,,218,28,43,289
FilterGenerator.java,Java,,22,7,33,62
IntType.java,Java,,196,29,73,298
MatchGenerator.java,Java,,51,15,34,100
MethodGenerator.java,Java,,221,55,32,308
MethodType.java,Java,,126,17,26,169
MultiHashtable.java,Java,,26,4,22,52
NamedMethodGenerator.java,Java,,30,8,25,63
NodeCounterGenerator.java,Java,,25,7,39,71
NodeSetType.java,Java,,194,30,103,327
NodeSortRecordFactGenerator.java,Java,,14,5,26,45
NodeSortRecordGenerator.java,Java,,22,7,32,61
NodeType.java,Java,,201,33,87,321
NumberType.java,Java,,9,5,22,36
ObjectFactory.java,Java,,294,59,278,631
ObjectType.java,Java,,101,22,48,171
RealType.java,Java,,225,34,81,340
ReferenceType.java,Java,,257,32,87,376
ResultTreeType.java,Java,,272,46,143,461
RtMethodGenerator.java,Java,,33,9,24,66
SecuritySupport.java,Java,,56,15,52,123
SecuritySupport12.java,Java,,102,15,27,144
SlotAllocator.java,Java,,63,13,22,98
StringStack.java,Java,,13,5,22,40
StringType.java,Java,,129,23,75,227
TestGenerator.java,Java,,72,17,24,113
Type.java,Java,,164,39,92,295
TypeCheckError.java,Java,,40,12,22,74
Util.java,Java,,125,30,45,200
VoidType.java,Java,,47,11,38,96
ValueOf.java,Java,,81,14,41,136
Variable.java,Java,,114,17,60,191
VariableBase.java,Java,,153,32,94,279
VariableRef.java,Java,,59,10,26,95
VariableRefBase.java,Java,,75,19,59,153
When.java,Java,,50,14,39,103
Whitespace.java,Java,,347,66,128,541
WithParam.java,Java,,104,22,81,207
XPathLexer.java,Java,,1484,18,24,1526
XPathParser.java,Java,,2639,260,249,3148
XslAttribute.java,Java,,183,41,66,290
XslElement.java,Java,,188,40,62,290
XSLTC.java,Java,,517,105,273,895
AbsoluteIterator.java,Java,,50,12,35,97
AdaptiveResultTreeImpl.java,Java,,1093,148,79,1320
AnyNodeCounter.java,Java,,68,8,34,110
Axis.java,Java,,20,3,27,50
BitArray.java,Java,,158,33,72,263
CachedNodeListIterator.java,Java,,66,16,29,111
ClonedNodeListIterator.java,Java,,37,14,28,79
CollatorFactoryBase.java,Java,,19,8,21,48
CurrentNodeListFilter.java,Java,,7,3,23,33
CurrentNodeListIterator.java,Java,,117,28,52,197
DocumentCache.java,Java,,214,48,76,338
DOMAdapter.java,Java,,347,71,36,454
DOMBuilder.java,Java,,2,2,21,25
DOMWSFilter.java,Java,,62,14,52,128
DupFilterIterator.java,Java,,82,20,53,155
EmptyFilter.java,Java,,6,2,22,30
ExtendedSAX.java,Java,,9,2,21,32
Filter.java,Java,,4,2,22,28
FilteredStepIterator.java,Java,,20,7,25,52
FilterIterator.java,Java,,62,18,36,116
ForwardPositionIterator.java,Java,,41,11,53,105
KeyIndex.java,Java,,157,37,93,287
LoadDocument.java,Java,,186,33,71,290
MatchingIterator.java,Java,,61,18,46,125
MultiDOM.java,Java,,500,101,61,662
MultipleNodeCounter.java,Java,,64,13,26,103
NodeCounter.java,Java,,213,43,77,333
NodeIteratorBase.java,Java,,65,19,84,168
NodeSortRecord.java,Java,,130,30,81,241
NodeSortRecordFactory.java,Java,,92,21,49,162
NthIterator.java,Java,,61,13,39,113
ObjectFactory.java,Java,,294,59,278,631
SAXImpl.java,Java,,1175,238,482,1895
SecuritySupport.java,Java,,56,15,52,123
SecuritySupport12.java,Java,,102,15,27,144
SimpleResultTreeImpl.java,Java,,732,175,108,1015
SingleNodeCounter.java,Java,,84,12,23,119
SingletonIterator.java,Java,,53,11,26,90
SortingIterator.java,Java,,99,18,30,147
SortSettings.java,Java,,39,16,81,136
StepIterator.java,Java,,68,16,52,136
StripWhitespaceFilter.java,Java,,5,3,22,30
UnionIterator.java,Java,,164,25,41,230
XSLTCDTMManager.java,Java,,195,41,182,418
DOM.java,Java,,66,11,26,103
DOMCache.java,Java,,4,5,45,54
DOMEnhancedForDTM.java,Java,,12,1,30,43
NodeIterator.java,Java,,15,14,53,82
ProcessorVersion.java,Java,,10,4,33,47
AbstractTranslet.java,Java,,418,107,215,740
AttributeList.java,Java,,118,24,84,226
Attributes.java,Java,,29,10,22,61
BasisLibrary.java,Java,,1108,153,279,1540
Constants.java,Java,,19,6,24,49
ErrorMessages.java,Java,,57,32,190,279
ErrorMessages_ca.java,Java,,43,24,159,226
ErrorMessages_cs.java,Java,,43,24,159,226
ErrorMessages_de.java,Java,,43,24,159,226
ErrorMessages_es.java,Java,,43,24,159,226
ErrorMessages_fr.java,Java,,43,24,159,226
ErrorMessages_it.java,Java,,43,24,159,226
ErrorMessages_ja.java,Java,,43,24,159,226
ErrorMessages_ko.java,Java,,43,24,159,226
ErrorMessages_sk.java,Java,,43,24,159,226
ErrorMessages_zh_CN.java,Java,,43,24,159,226
ErrorMessages_zh_TW.java,Java,,43,24,159,226
Hashtable.java,Java,,198,42,101,341
MessageHandler.java,Java,,6,2,21,29
Node.java,Java,,9,3,24,36
ObjectFactory.java,Java,,294,59,278,631
Operators.java,Java,,12,3,22,37
OutputBuffer.java,Java,,7,6,21,34
StringOutputBuffer.java,Java,,22,9,21,52
TransletOutputHandlerFactory.java,Java,,161,39,22,222
WriterOutputBuffer.java,Java,,54,12,28,94
Parameter.java,Java,,16,5,23,44
SecuritySupport.java,Java,,56,15,52,123
SecuritySupport12.java,Java,,102,15,27,144
StringValueHandler.java,Java,,76,18,29,123
StripFilter.java,Java,,4,3,22,29
Translet.java,Java,,22,6,22,50
TransletException.java,Java,,13,6,23,42
DOM2SAX.java,Java,,300,56,116,472
DOM2TO.java,Java,,231,47,113,391
ObjectFactory.java,Java,,294,59,278,631
OutputSettings.java,Java,,17,7,21,45
SAX2DOM.java,Java,,150,33,47,230
SecuritySupport.java,Java,,56,15,52,123
SecuritySupport12.java,Java,,102,15,27,144
SmartTransformerFactoryImpl.java,Java,,281,34,165,480
TemplatesHandlerImpl.java,Java,,159,46,128,333
TemplatesImpl.java,Java,,205,55,164,424
TransformerFactoryImpl.java,Java,,824,149,440,1413
TransformerHandlerImpl.java,Java,,271,55,157,483
TransformerImpl.java,Java,,777,135,395,1307
TrAXFilter.java,Java,,97,20,25,142
Util.java,Java,,124,30,39,193
XSLTCSource.java,Java,,75,19,44,138
IntegerArray.java,Java,,158,33,32,223
JavaCupRedirect.java,Java,,54,12,75,141
ASDOMImplementationImpl.java,Java,,25,20,100,145
ASModelImpl.java,Java,,170,50,309,529
AttributeMap.java,Java,,328,67,205,600
AttrImpl.java,Java,,574,157,531,1262
AttrNSImpl.java,Java,,171,33,159,363
CDATASectionImpl.java,Java,,17,11,97,125
CharacterDataImpl.java,Java,,139,54,208,401
ChildNode.java,Java,,35,24,127,186
CommentImpl.java,Java,,18,11,78,107
CoreDocumentImpl.java,Java,,1230,303,1090,2623
CoreDOMImplementationImpl.java,Java,,206,23,231,460
DeepNodeListImpl.java,Java,,113,31,139,283
DeferredAttrImpl.java,Java,,32,20,130,182
DeferredAttrNSImpl.java,Java,,40,24,101,165
DeferredCDATASectionImpl.java,Java,,21,18,106,145
DeferredCommentImpl.java,Java,,21,18,87,126
DeferredDocumentImpl.java,Java,,1286,371,511,2168
DeferredDocumentTypeImpl.java,Java,,75,34,114,223
DeferredElementDefinitionImpl.java,Java,,39,26,97,162
DeferredElementImpl.java,Java,,41,25,109,175
DeferredElementNSImpl.java,Java,,51,28,107,186
DeferredEntityImpl.java,Java,,40,27,123,190
DeferredEntityReferenceImpl.java,Java,,31,22,138,191
DeferredNode.java,Java,,6,8,65,79
DeferredNotationImpl.java,Java,,27,20,106,153
DeferredProcessingInstructionImpl.java,Java,,23,18,89,130
DeferredTextImpl.java,Java,,22,20,101,143
DocumentFragmentImpl.java,Java,,47,17,126,190
DocumentImpl.java,Java,,607,113,554,1274
DocumentTypeImpl.java,Java,,231,74,217,522
DOMConfigurationImpl.java,Java,,649,131,337,1117
DOMErrorImpl.java,Java,,47,27,98,172
DOMImplementationImpl.java,Java,,51,19,117,187
DOMImplementationListImpl.java,Java,,23,8,38,69
DOMImplementationSourceImpl.java,Java,,73,10,89,172
DOMInputImpl.java,Java,,96,45,287,428
DOMLocatorImpl.java,Java,,51,28,112,191
DOMMessageFormatter.java,Java,,82,9,86,177
DOMNormalizer.java,Java,,1108,249,654,2011
DOMOutputImpl.java,Java,,35,24,150,209
DOMStringListImpl.java,Java,,28,12,85,125
DOMXSImplementationSourceImpl.java,Java,,39,9,87,135
ElementDefinitionImpl.java,Java,,35,20,102,157
ElementImpl.java,Java,,553,141,470,1164
ElementNSImpl.java,Java,,213,50,175,438
EntityImpl.java,Java,,119,66,189,374
EntityReferenceImpl.java,Java,,131,41,253,425
EventImpl.java,Java,,56,15,100,171
MutationEventImpl.java,Java,,49,12,87,148
LCount.java,Java,,13,4,81,98
NamedNodeMapImpl.java,Java,,290,82,257,629
NodeImpl.java,Java,,878,215,970,2063
NodeIteratorImpl.java,Java,,179,68,163,410
NodeListCache.java,Java,,12,9,69,90
NotationImpl.java,Java,,72,33,129,234
ObjectFactory.java,Java,,251,55,244,550
ParentNode.java,Java,,499,119,444,1062
ProcessingInstructionImpl.java,Java,,44,24,125,193
PSVIAttrNSImpl.java,Java,,91,38,160,289
PSVIDocumentImpl.java,Java,,55,22,112,189
PSVIDOMImplementationImpl.java,Java,,32,13,115,160
PSVIElementNSImpl.java,Java,,105,44,181,330
RangeExceptionImpl.java,Java,,7,3,59,69
RangeImpl.java,Java,,1210,177,635,2022
SecuritySupport.java,Java,,52,14,88,154
SecuritySupport12.java,Java,,95,13,63,171
TextImpl.java,Java,,168,48,171,387
TreeWalkerImpl.java,Java,,279,93,171,543
ASAttributeDeclaration.java,Java,,16,8,60,84
ASContentModel.java,Java,,21,10,108,139
ASDataType.java,Java,,50,4,160,214
ASElementDeclaration.java,Java,,23,12,115,150
ASEntityDeclaration.java,Java,,13,7,59,79
ASModel.java,Java,,36,21,178,235
ASNamedObjectMap.java,Java,,18,11,120,149
ASNotationDeclaration.java,Java,,7,4,33,44
ASObject.java,Java,,21,10,94,125
ASObjectList.java,Java,,5,4,33,42
CharacterDataEditAS.java,Java,,14,8,58,80
DocumentAS.java,Java,,16,11,89,116
DocumentEditAS.java,Java,,5,3,38,46
DOMASBuilder.java,Java,,11,6,79,96
DOMASException.java,Java,,12,3,37,52
DOMASWriter.java,Java,,7,4,38,49
DOMImplementationAS.java,Java,,6,5,37,48
ElementEditAS.java,Java,,25,16,109,150
NodeEditAS.java,Java,,17,9,89,115
Constants.java,Java,,249,154,277,680
DTDGrammar.java,Java,,1487,409,859,2755
DTDGrammarBucket.java,Java,,35,17,95,147
CMAny.java,Java,,63,26,99,188
CMBinOp.java,Java,,71,16,101,188
CMLeaf.java,Java,,66,27,90,183
CMNode.java,Java,,46,17,106,169
CMStateSet.java,Java,,189,27,122,338
CMUniOp.java,Java,,36,15,89,140
ContentModelValidator.java,Java,,5,6,74,85
DFAContentModel.java,Java,,370,118,540,1028
MixedContentModel.java,Java,,91,26,139,256
SimpleContentModel.java,Java,,92,35,190,317
XML11DTDProcessor.java,Java,,29,13,69,111
XML11DTDValidator.java,Java,,33,13,75,121
XML11NSDTDValidator.java,Java,,130,23,107,260
XMLAttributeDecl.java,Java,,17,11,78,106
XMLContentSpec.java,Java,,72,44,214,330
XMLDTDDescription.java,Java,,92,19,96,207
XMLDTDLoader.java,Java,,200,41,186,427
XMLDTDProcessor.java,Java,,737,226,732,1695
XMLDTDValidator.java,Java,,1085,286,747,2118
XMLDTDValidatorFilter.java,Java,,7,7,74,88
XMLElementDecl.java,Java,,29,18,90,137
XMLEntityDecl.java,Java,,38,17,100,155
XMLNotationDecl.java,Java,,19,11,79,109
XMLNSDTDValidator.java,Java,,133,29,107,269
XMLSimpleType.java,Java,,69,32,106,207
DatatypeException.java,Java,,39,11,91,141
DatatypeValidator.java,Java,,6,5,70,81
DTDDVFactoryImpl.java,Java,,31,12,75,118
ENTITYDatatypeValidator.java,Java,,10,8,86,104
IDDatatypeValidator.java,Java,,23,9,88,120
IDREFDatatypeValidator.java,Java,,20,9,85,114
ListDatatypeValidator.java,Java,,19,9,77,105
NMTOKENDatatypeValidator.java,Java,,12,6,75,93
NOTATIONDatatypeValidator.java,Java,,8,6,77,91
StringDatatypeValidator.java,Java,,8,6,81,95
XML11DTDDVFactoryImpl.java,Java,,31,11,77,119
XML11IDDatatypeValidator.java,Java,,24,10,89,123
XML11IDREFDatatypeValidator.java,Java,,21,10,86,117
XML11NMTOKENDatatypeValidator.java,Java,,13,7,76,96
DTDDVFactory.java,Java,,19,11,93,123
DVFactoryException.java,Java,,9,3,62,74
InvalidDatatypeFacetException.java,Java,,6,4,71,81
InvalidDatatypeValueException.java,Java,,6,4,70,80
ObjectFactory.java,Java,,251,55,244,550
SchemaDVFactory.java,Java,,29,16,139,184
SecuritySupport.java,Java,,52,14,88,154
SecuritySupport12.java,Java,,95,13,63,171
Base64.java,Java,,227,61,93,381
HexBin.java,Java,,62,8,75,145
ValidatedInfo.java,Java,,22,11,101,134
ValidationContext.java,Java,,14,10,72,96
AbstractDateTimeDV.java,Java,,440,91,251,782
AnySimpleDV.java,Java,,11,6,65,82
AnyURIDV.java,Java,,103,14,88,205
Base64BinaryDV.java,Java,,47,8,70,125
BaseDVFactory.java,Java,,138,30,117,285
BooleanDV.java,Java,,19,8,64,91
DateDV.java,Java,,33,10,75,118
DateTimeDV.java,Java,,25,11,76,112
DayDV.java,Java,,47,15,82,144
DecimalDV.java,Java,,193,35,96,324
DoubleDV.java,Java,,121,18,102,241
DurationDV.java,Java,,207,45,119,371
EntityDV.java,Java,,20,8,64,92
FloatDV.java,Java,,121,18,102,241
FullDVFactory.java,Java,,94,25,85,204
HexBinaryDV.java,Java,,47,8,67,122
IDDV.java,Java,,21,6,64,91
IDREFDV.java,Java,,18,8,64,90
IntegerDV.java,Java,,12,5,63,80
ListDV.java,Java,,55,11,68,134
MonthDayDV.java,Java,,52,17,88,157
MonthDV.java,Java,,69,17,107,193
QNameDV.java,Java,,49,16,75,140
SchemaDateTimeException.java,Java,,9,3,59,71
SchemaDVFactoryImpl.java,Java,,224,50,117,391
StringDV.java,Java,,12,6,64,82
TimeDV.java,Java,,38,13,89,140
TypeValidator.java,Java,,32,15,91,138
UnionDV.java,Java,,11,6,66,83
XSSimpleTypeDecl.java,Java,,1957,292,496,2745
YearDV.java,Java,,42,14,88,144
YearMonthDV.java,Java,,33,13,81,127
XSFacets.java,Java,,46,21,105,172
XSSimpleType.java,Java,,38,14,186,238
ExternalSubsetResolver.java,Java,,11,7,43,61
ASCIIReader.java,Java,,69,23,181,273
MalformedByteSequenceException.java,Java,,37,18,76,131
UCSReader.java,Java,,122,24,191,337
UTF8Reader.java,Java,,427,66,239,732
XMLMessageFormatter.java,Java,,54,13,90,157
RevalidationHandler.java,Java,,6,5,70,81
EntityState.java,Java,,5,4,76,85
ValidationManager.java,Java,,32,13,76,121
ValidationState.java,Java,,108,28,94,230
Version.java,Java,,11,10,77,98
XML11DocumentScannerImpl.java,Java,,326,32,186,544
XML11DTDScannerImpl.java,Java,,96,24,150,270
XML11EntityScanner.java,Java,,1020,87,361,1468
XML11NamespaceBinder.java,Java,,8,10,83,101
XML11NSDocumentScannerImpl.java,Java,,524,92,273,889
XMLDocumentFragmentScannerImpl.java,Java,,941,255,709,1905
XMLDocumentScannerImpl.java,Java,,722,169,467,1358
XMLDTDScannerImpl.java,Java,,1307,195,645,2147
XMLEntityDescription.java,Java,,6,6,33,45
XMLEntityHandler.java,Java,,10,7,95,112
XMLEntityManager.java,Java,,1513,322,896,2731
XMLEntityScanner.java,Java,,1071,126,583,1780
XMLErrorReporter.java,Java,,196,72,335,603
XMLNamespaceBinder.java,Java,,355,108,425,888
XMLNSDocumentScannerImpl.java,Java,,441,100,273,814
XMLScanner.java,Java,,859,149,447,1455
XMLVersionDetector.java,Java,,113,35,120,268
BMPattern.java,Java,,170,13,91,274
Match.java,Java,,98,14,111,223
Op.java,Java,,211,11,68,290
ParseException.java,Java,,11,4,73,88
ParserForXMLSchema.java,Java,,397,24,88,509
RangeToken.java,Java,,485,28,138,651
RegexParser.java,Java,,919,70,135,1124
RegularExpression.java,Java,,2126,242,821,3189
REUtil.java,Java,,260,26,86,372
Token.java,Java,,1271,139,152,1562
XPath.java,Java,,1328,155,533,2016
XPathException.java,Java,,16,8,70,94
AttributePSVImpl.java,Java,,78,31,149,258
DocumentImpl.java,Java,,44,12,89,145
DOMNodePool.java,Java,,95,30,94,219
DOMParser.java,Java,,103,24,133,260
ElementNSImpl.java,Java,,33,14,71,118
ElementPSVImpl.java,Java,,94,38,175,307
Field.java,Java,,79,35,126,240
FieldActivator.java,Java,,9,10,105,124
IdentityConstraint.java,Java,,120,38,128,286
IDValue.java,Java,,45,11,94,150
KeyRef.java,Java,,18,11,79,108
Selector.java,Java,,105,42,144,291
UniqueOrKey.java,Java,,9,6,72,87
ValueStore.java,Java,,6,8,91,105
XPathMatcher.java,Java,,278,59,228,565
CMBuilder.java,Java,,169,30,145,344
CMNodeFactory.java,Java,,81,32,128,241
XSAllCM.java,Java,,94,36,125,255
XSCMBinOp.java,Java,,60,16,102,178
XSCMLeaf.java,Java,,54,27,92,173
XSCMUniOp.java,Java,,31,15,90,136
XSCMValidator.java,Java,,14,15,101,130
XSDFACM.java,Java,,399,118,466,983
XSEmptyCM.java,Java,,34,23,113,170
AttrImpl.java,Java,,40,21,81,142
DefaultDocument.java,Java,,114,61,149,324
DefaultElement.java,Java,,75,47,67,189
DefaultNode.java,Java,,121,66,68,255
DefaultText.java,Java,,58,19,204,281
DefaultXMLDocumentHandler.java,Java,,174,70,664,908
ElementImpl.java,Java,,149,51,70,270
NamedNodeMapImpl.java,Java,,48,16,61,125
NodeImpl.java,Java,,39,23,62,124
SchemaDOM.java,Java,,235,49,113,397
SchemaDOMParser.java,Java,,143,40,230,413
SchemaParsingConfig.java,Java,,328,119,296,743
TextImpl.java,Java,,50,16,100,166
PSVIProvider.java,Java,,9,5,109,123
StringList.java,Java,,5,3,74,82
XSAnnotation.java,Java,,9,4,87,100
XSAttributeDeclaration.java,Java,,9,7,82,98
XSAttributeGroupDefinition.java,Java,,6,4,69,79
XSAttributeUse.java,Java,,7,6,75,88
XSComplexTypeDefinition.java,Java,,17,13,123,153
XSConstants.java,Java,,29,8,148,185
XSElementDeclaration.java,Java,,17,16,133,166
XSFacet.java,Java,,7,2,73,82
XSIDCDefinition.java,Java,,11,8,88,107
XSModel.java,Java,,21,13,144,178
XSModelGroup.java,Java,,9,6,83,98
XSModelGroupDefinition.java,Java,,5,4,66,75
XSMultiValueFacet.java,Java,,6,3,69,78
XSNamedMap.java,Java,,7,5,89,101
XSNamespaceItem.java,Java,,13,12,121,146
XSNamespaceItemList.java,Java,,5,4,75,84
XSNotationDeclaration.java,Java,,6,5,71,82
XSObject.java,Java,,7,5,78,90
XSObjectList.java,Java,,5,3,75,83
XSParticle.java,Java,,7,6,73,86
XSSimpleTypeDefinition.java,Java,,41,21,200,262
XSTerm.java,Java,,3,2,63,68
XSTypeDefinition.java,Java,,15,9,120,144
XSWildcard.java,Java,,13,8,100,121
SchemaGrammar.java,Java,,537,120,326,983
SchemaNamespaceSupport.java,Java,,50,8,90,148
SchemaSymbols.java,Java,,163,14,75,252
SubstitutionGroupHandler.java,Java,,169,35,153,357
XSAttributeChecker.java,Java,,1273,129,501,1903
XSDAbstractIDConstraintTraverser.java,Java,,104,19,79,202
XSDAbstractParticleTraverser.java,Java,,204,44,148,396
XSDAbstractTraverser.java,Java,,522,52,139,713
XSDAttributeGroupTraverser.java,Java,,85,33,86,204
XSDAttributeTraverser.java,Java,,244,59,141,444
XSDComplexTypeTraverser.java,Java,,823,142,252,1217
XSDElementTraverser.java,Java,,279,60,169,508
XSDGroupTraverser.java,Java,,130,27,87,244
XSDHandler.java,Java,,1527,187,629,2343
XSDKeyrefTraverser.java,Java,,53,14,74,141
XSDNotationTraverser.java,Java,,49,12,76,137
XSDocumentInfo.java,Java,,96,32,98,226
XSDSimpleTypeTraverser.java,Java,,303,46,151,500
XSDUniqueOrKeyTraverser.java,Java,,33,13,72,118
XSDWildcardTraverser.java,Java,,72,22,121,215
NSItemListImpl.java,Java,,28,10,77,115
ShortListImpl.java,Java,,26,9,83,118
SimpleLocator.java,Java,,55,19,86,160
StringListImpl.java,Java,,44,11,85,140
XInt.java,Java,,19,9,60,88
XIntPool.java,Java,,15,4,60,79
XSGrammarPool.java,Java,,24,7,67,98
XSNamedMap4Types.java,Java,,58,10,109,177
XSNamedMapImpl.java,Java,,73,11,124,208
XSObjectListImpl.java,Java,,42,14,85,141
XMLSchemaException.java,Java,,15,6,65,86
XMLSchemaLoader.java,Java,,849,125,324,1298
XMLSchemaValidator.java,Java,,2262,554,1199,4015
XSAnnotationImpl.java,Java,,74,17,112,203
XSAttributeDecl.java,Java,,83,21,115,219
XSAttributeGroupDecl.java,Java,,204,48,147,399
XSAttributeUseImpl.java,Java,,54,17,99,170
XSComplexTypeDecl.java,Java,,245,66,178,489
XSConstraints.java,Java,,962,201,317,1480
XSDDescription.java,Java,,103,23,172,298
XSDeclarationPool.java,Java,,213,52,82,347
XSElementDecl.java,Java,,174,39,180,393
XSGrammarBucket.java,Java,,72,15,115,202
XSGroupDecl.java,Java,,26,11,89,126
XSImplementationImpl.java,Java,,41,17,97,155
XSMessageFormatter.java,Java,,36,11,83,130
XSModelGroupImpl.java,Java,,129,27,112,268
XSModelImpl.java,Java,,282,41,196,519
XSNotationDecl.java,Java,,33,13,93,139
XSParticleDecl.java,Java,,125,25,118,268
XSWildcardDecl.java,Java,,306,81,240,627
DatatypeFactoryImpl.java,Java,,66,20,254,340
DurationImpl.java,Java,,793,169,967,1929
XMLGregorianCalendarImpl.java,Java,,1299,258,1440,2997
DefaultValidationErrorHandler.java,Java,,24,10,60,94
DocumentBuilderFactoryImpl.java,Java,,102,25,100,227
DocumentBuilderImpl.java,Java,,174,34,137,345
JAXPConstants.java,Java,,9,4,66,79
JAXPValidatorComponent.java,Java,,249,60,167,476
SAXParserFactoryImpl.java,Java,,84,16,88,188
SAXParserImpl.java,Java,,221,45,171,437
ErrorHandlerAdaptor.java,Java,,35,8,75,118
InsulatedValidatorComponent.java,Java,,51,27,131,209
ReadonlyGrammarPool.java,Java,,28,11,63,102
Util.java,Java,,36,9,71,116
ValidatorHandlerImpl.java,Java,,311,82,167,560
ValidatorImpl.java,Java,,165,26,100,291
WrappedSAXException.java,Java,,8,3,72,83
XercesConstants.java,Java,,15,13,73,101
XercesSchema.java,Java,,16,5,75,96
XNI2SAXEx.java,Java,,39,8,71,118
InsulatedSchemaValidator.java,Java,,29,7,70,106
SchemaFactoryImpl.java,Java,,144,34,86,264
SchemaImpl.java,Java,,15,6,69,90
XNI2SAX.java,Java,,104,26,73,203
AbstractDOMParser.java,Java,,1492,301,796,2589
AbstractSAXParser.java,Java,,1068,272,975,2315
AbstractXMLDocumentParser.java,Java,,170,73,607,850
BasicParserConfiguration.java,Java,,208,82,337,627
CachingParserPool.java,Java,,117,56,295,468
DOMASBuilderImpl.java,Java,,121,38,176,335
DOMParser.java,Java,,262,52,225,539
DOMParserImpl.java,Java,,742,84,262,1088
DTDConfiguration.java,Java,,414,124,351,889
DTDParser.java,Java,,100,40,377,517
IntegratedParserConfiguration.java,Java,,111,32,147,290
JAXPConfiguration.java,Java,,58,17,33,108
NonValidatingConfiguration.java,Java,,370,122,324,816
ObjectFactory.java,Java,,251,56,244,551
SAXParser.java,Java,,45,20,94,159
SecurityConfiguration.java,Java,,27,14,113,154
SecuritySupport.java,Java,,52,14,88,154
SecuritySupport12.java,Java,,95,13,63,171
StandardParserConfiguration.java,Java,,122,56,206,384
XIncludeParserConfiguration.java,Java,,130,28,109,267
XML11Configuration.java,Java,,789,212,526,1527
XMLDocumentParser.java,Java,,33,9,83,125
XMLGrammarCachingConfiguration.java,Java,,119,46,224,389
XMLGrammarParser.java,Java,,16,8,71,95
XMLGrammarPreparser.java,Java,,155,38,185,378
XMLParser.java,Java,,28,23,111,162
XPointerParserConfiguration.java,Java,,68,17,100,185
AttributesProxy.java,Java,,57,22,76,155
AugmentationsImpl.java,Java,,175,56,96,327
DatatypeMessageFormatter.java,Java,,52,10,27,89
DefaultErrorHandler.java,Java,,48,18,88,154
DOMEntityResolverWrapper.java,Java,,80,24,99,203
DOMErrorHandlerWrapper.java,Java,,141,39,146,326
DOMUtil.java,Java,,452,122,195,769
DraconianErrorHandler.java,Java,,17,4,65,86
EncodingMap.java,Java,,447,39,566,1052
EntityResolver2Wrapper.java,Java,,92,32,89,213
EntityResolverWrapper.java,Java,,59,20,100,179
ErrorHandlerProxy.java,Java,,29,6,75,110
ErrorHandlerWrapper.java,Java,,100,28,146,274
IntStack.java,Java,,52,17,85,154
LocatorProxy.java,Java,,29,13,81,123
LocatorWrapper.java,Java,,14,5,62,81
MessageFormatter.java,Java,,7,6,85,98
NamespaceSupport.java,Java,,134,54,158,346
ParserConfigurationSettings.java,Java,,98,50,183,331
SAX2XNI.java,Java,,138,33,81,252
SAXMessageFormatter.java,Java,,51,7,81,139
SecurityManager.java,Java,,66,23,125,214
ShadowedSymbolTable.java,Java,,26,18,115,159
SymbolHash.java,Java,,90,27,131,248
SymbolTable.java,Java,,107,44,186,337
SynchronizedSymbolTable.java,Java,,34,23,110,167
TeeXMLDocumentFilterImpl.java,Java,,106,29,78,213
TypeInfoImpl.java,Java,,42,11,77,130
URI.java,Java,,1057,184,759,2000
XML11Char.java,Java,,208,37,206,451
XMLAttributesImpl.java,Java,,408,101,587,1096
XMLChar.java,Java,,760,49,254,1063
XMLDocumentFilterImpl.java,Java,,83,28,67,178
XMLEntityDescriptionImpl.java,Java,,69,19,90,178
XMLErrorCode.java,Java,,22,10,50,82
XMLGrammarPoolImpl.java,Java,,157,32,215,404
XMLInputSourceAdaptor.java,Java,,22,6,75,103
XMLResourceIdentifierImpl.java,Java,,116,32,120,268
XMLStringBuffer.java,Java,,69,19,122,210
XMLSymbols.java,Java,,21,25,95,141
MultipleScopeNamespaceSupport.java,Java,,109,21,104,234
ObjectFactory.java,Java,,251,55,244,550
SecuritySupport.java,Java,,52,14,88,154
SecuritySupport12.java,Java,,95,13,63,171
XInclude11TextReader.java,Java,,14,5,80,99
XIncludeFatalError.java,Java,,19,6,69,94
XIncludeHandler.java,Java,,1531,215,629,2375
XIncludeInputSource.java,Java,,46,15,118,179
XIncludeMessageFormatter.java,Java,,36,11,81,128
XIncludeNamespaceSupport.java,Java,,30,10,94,134
XIncludeResourceError.java,Java,,19,6,69,94
XIncludeTextReader.java,Java,,276,42,205,523
XPointerElementHandler.java,Java,,455,123,181,759
XPointerFramework.java,Java,,122,23,60,205
XPointerSchema.java,Java,,13,12,20,45
Augmentations.java,Java,,9,15,103,127
Grammar.java,Java,,4,5,85,94
XMLDTDDescription.java,Java,,4,4,67,75
XMLGrammarDescription.java,Java,,7,8,82,97
XMLGrammarLoader.java,Java,,28,19,139,186
XMLGrammarPool.java,Java,,9,10,125,144
XMLSchemaDescription.java,Java,,19,11,146,176
XSGrammar.java,Java,,6,6,81,93
NamespaceContext.java,Java,,15,20,181,216
XMLComponent.java,Java,,13,11,140,164
XMLComponentManager.java,Java,,7,6,88,101
XMLConfigurationException.java,Java,,26,16,109,151
XMLDocumentFilter.java,Java,,5,5,64,74
XMLDocumentScanner.java,Java,,9,7,96,112
XMLDocumentSource.java,Java,,6,7,74,87
XMLDTDContentModelFilter.java,Java,,5,4,64,73
XMLDTDContentModelSource.java,Java,,6,7,74,87
XMLDTDFilter.java,Java,,5,4,64,73
XMLDTDScanner.java,Java,,12,8,116,136
XMLDTDSource.java,Java,,6,7,74,87
XMLEntityResolver.java,Java,,8,7,84,99
XMLErrorHandler.java,Java,,10,8,126,144
XMLInputSource.java,Java,,88,33,190,311
XMLParseException.java,Java,,89,25,92,206
XMLParserConfiguration.java,Java,,34,29,228,291
XMLPullParserConfiguration.java,Java,,10,10,115,135
QName.java,Java,,86,24,123,233
XMLAttributes.java,Java,,31,36,362,429
XMLDocumentFragmentHandler.java,Java,,35,18,244,297
XMLDocumentHandler.java,Java,,33,25,276,334
XMLDTDContentModelHandler.java,Java,,25,25,261,311
XMLDTDHandler.java,Java,,59,30,327,416
XMLLocator.java,Java,,10,11,79,100
XMLResourceIdentifier.java,Java,,13,14,75,102
XMLString.java,Java,,58,22,149,229
XNIException.java,Java,,19,11,97,127
AttributePSVI.java,Java,,4,3,63,70
ElementPSVI.java,Java,,7,6,74,87
ItemPSVI.java,Java,,24,14,188,226
LSInputList.java,Java,,6,5,74,85
PSVIProvider.java,Java,,7,5,118,130
ShortList.java,Java,,7,5,82,94
StringList.java,Java,,6,5,81,92
XSAnnotation.java,Java,,9,5,86,100
XSAttributeDeclaration.java,Java,,15,11,117,143
XSAttributeGroupDefinition.java,Java,,6,5,69,80
XSAttributeUse.java,Java,,13,9,110,132
XSComplexTypeDefinition.java,Java,,17,13,124,154
XSConstants.java,Java,,74,7,285,366
XSElementDeclaration.java,Java,,23,19,170,212
XSException.java,Java,,10,3,76,89
XSFacet.java,Java,,7,6,73,86
XSIDCDefinition.java,Java,,11,8,91,110
XSImplementation.java,Java,,6,5,77,88
XSLoader.java,Java,,10,8,112,130
XSModel.java,Java,,21,13,151,185
XSModelGroup.java,Java,,9,6,83,98
XSModelGroupDefinition.java,Java,,5,4,65,74
XSMultiValueFacet.java,Java,,6,5,70,81
XSNamedMap.java,Java,,7,5,92,104
XSNamespaceItem.java,Java,,13,12,122,147
XSNamespaceItemList.java,Java,,5,4,74,83
XSNotationDeclaration.java,Java,,6,5,70,81
XSObject.java,Java,,7,6,82,95
XSObjectList.java,Java,,5,4,74,83
XSParticle.java,Java,,7,6,75,88
XSSimpleTypeDefinition.java,Java,,42,23,215,280
XSTerm.java,Java,,3,2,62,67
XSTypeDefinition.java,Java,,16,10,120,146
XSWildcard.java,Java,,13,8,101,122
Axis.java,Java,,49,25,112,186
DTM.java,Java,,95,95,790,980
DTMAxisIterator.java,Java,,17,15,76,108
DTMAxisTraverser.java,Java,,14,5,95,114
DTMConfigurationException.java,Java,,25,8,65,98
DTMDOMException.java,Java,,12,2,37,51
DTMException.java,Java,,166,63,138,367
DTMFilter.java,Java,,21,20,145,186
DTMIterator.java,Java,,32,33,277,342
DTMManager.java,Java,,89,40,264,393
DTMWSFilter.java,Java,,8,5,41,54
FactoryFinder.java,Java,,151,34,172,357
ObjectFactory.java,Java,,294,59,278,631
ChunkedIntArray.java,Java,,146,22,136,304
CoroutineManager.java,Java,,91,23,228,342
CoroutineParser.java,Java,,14,13,111,138
CustomStringPool.java,Java,,32,6,48,86
DOM2DTM.java,Java,,904,192,673,1769
DOM2DTMdefaultNamespaceDeclarationNode.java,Java,,219,41,415,675
DTMAxisIteratorBase.java,Java,,101,40,138,279
DTMAxisIterNodeList.java,Java,,57,10,73,140
DTMChildIterNodeList.java,Java,,32,8,77,117
DTMDefaultBase.java,Java,,1028,291,1063,2382
DTMDefaultBaseIterators.java,Java,,1138,328,724,2190
DTMDefaultBaseTraversers.java,Java,,743,213,789,1745
DTMDocumentImpl.java,Java,,728,238,1453,2419
DTMManagerDefault.java,Java,,377,103,359,839
DTMNamedNodeMap.java,Java,,85,27,175,287
DTMNodeIterator.java,Java,,66,20,98,184
DTMNodeList.java,Java,,40,8,77,125
DTMNodeListBase.java,Java,,12,4,63,79
DTMNodeProxy.java,Java,,711,201,1254,2166
DTMSafeStringPool.java,Java,,60,14,34,108
DTMStringPool.java,Java,,100,25,64,189
DTMTreeWalker.java,Java,,237,56,111,404
EmptyIterator.java,Java,,21,18,21,60
ExpandedNameTable.java,Java,,168,50,174,392
ExtendedType.java,Java,,65,11,67,143
IncrementalSAXSource.java,Java,,12,11,64,87
IncrementalSAXSource_Filter.java,Java,,427,63,318,808
IncrementalSAXSource_Xerces.java,Java,,262,47,143,452
NodeLocator.java,Java,,39,9,60,108
ObjectFactory.java,Java,,294,59,278,631
SAX2DTM.java,Java,,1104,358,1066,2528
SAX2DTM2.java,Java,,1895,487,937,3319
SAX2RTFDTM.java,Java,,135,41,185,361
SecuritySupport.java,Java,,56,15,52,123
SecuritySupport12.java,Java,,102,15,27,144
SecuritySupport.java,Java,,56,15,52,123
SecuritySupport12.java,Java,,102,15,27,144
XMLErrorResources.java,Java,,280,104,131,515
XMLErrorResources_ca.java,Java,,274,102,131,507
XMLErrorResources_cs.java,Java,,274,102,131,507
XMLErrorResources_de.java,Java,,274,102,131,507
XMLErrorResources_en.java,Java,,4,2,23,29
XMLErrorResources_es.java,Java,,274,102,131,507
XMLErrorResources_fr.java,Java,,274,102,131,507
XMLErrorResources_it.java,Java,,274,102,131,507
XMLErrorResources_ja.java,Java,,274,102,131,507
XMLErrorResources_ko.java,Java,,274,102,131,507
XMLErrorResources_sk.java,Java,,274,102,131,507
XMLErrorResources_sv.java,Java,,203,257,167,627
XMLErrorResources_tr.java,Java,,274,102,131,507
XMLErrorResources_zh_CN.java,Java,,274,102,131,507
XMLErrorResources_zh_HK.java,Java,,4,3,66,73
XMLErrorResources_zh_TW.java,Java,,274,102,131,507
XMLMessages.java,Java,,102,29,86,217
BaseMarkupSerializer.java,Java,,1139,248,499,1886
DOMSerializer.java,Java,,14,18,88,120
DOMSerializerImpl.java,Java,,784,77,313,1174
ElementState.java,Java,,16,30,100,146
EncodingInfo.java,Java,,97,16,107,220
Encodings.java,Java,,66,14,82,162
HTMLdtd.java,Java,,269,88,239,596
HTMLSerializer.java,Java,,523,101,296,920
IndentPrinter.java,Java,,162,58,183,403
LineSeparator.java,Java,,8,16,73,97
Method.java,Java,,9,18,76,103
ObjectFactory.java,Java,,247,53,241,541
OutputFormat.java,Java,,332,160,508,1000
Printer.java,Java,,201,64,142,407
SecuritySupport.java,Java,,52,14,88,154
SecuritySupport12.java,Java,,95,13,63,171
Serializer.java,Java,,18,26,122,166
SerializerFactory.java,Java,,58,30,100,188
SerializerFactoryImpl.java,Java,,64,26,65,155
TextSerializer.java,Java,,189,76,165,430
XHTMLSerializer.java,Java,,29,18,92,139
XML11Serializer.java,Java,,312,69,200,581
XMLSerializer.java,Java,,877,174,439,1490
AttributesImplSerializer.java,Java,,74,17,90,181
CharInfo.java,Java,,255,80,274,609
DOMSerializer.java,Java,,7,3,46,56
ElemContext.java,Java,,57,18,141,216
ElemDesc.java,Java,,54,35,80,169
EmptySerializer.java,Java,,395,9,274,678
EncodingInfo.java,Java,,13,5,40,58
Encodings.java,Java,,265,39,126,430
ExtendedContentHandler.java,Java,,39,14,179,232
ExtendedLexicalHandler.java,Java,,6,2,28,36
Method.java,Java,,9,6,47,62
NamespaceMappings.java,Java,,129,33,131,293
ObjectFactory.java,Java,,294,59,278,631
OutputPropertiesFactory.java,Java,,254,45,131,430
OutputPropertyUtils.java,Java,,21,8,48,77
SecuritySupport.java,Java,,56,15,52,123
SecuritySupport12.java,Java,,102,15,27,144
SerializationHandler.java,Java,,33,13,69,115
Serializer.java,Java,,18,13,96,127
SerializerBase.java,Java,,535,139,608,1282
SerializerConstants.java,Java,,20,7,31,58
SerializerFactory.java,Java,,68,21,54,143
SerializerTrace.java,Java,,22,24,103,149
SerializerTraceWriter.java,Java,,140,43,135,318
ToHTMLSAXHandler.java,Java,,279,65,391,735
ToHTMLStream.java,Java,,1181,212,507,1900
ToSAXHandler.java,Java,,211,49,190,450
ToStream.java,Java,,1579,291,1043,2913
ToTextSAXHandler.java,Java,,213,55,141,409
ToTextStream.java,Java,,311,51,316,678
ToUnknownStream.java,Java,,658,151,492,1301
ToXMLSAXHandler.java,Java,,406,101,265,772
ToXMLStream.java,Java,,320,69,160,549
TransformStateSetter.java,Java,,8,6,36,50
Utils.java,Java,,27,4,45,76
WriterToASCI.java,Java,,45,15,82,142
WriterToUTF8.java,Java,,152,24,127,303
WriterToUTF8Buffered.java,Java,,221,59,202,482
XSLOutputAttributes.java,Java,,24,12,140,176
AttList.java,Java,,86,23,144,253
BoolStack.java,Java,,72,29,99,200
CharKey.java,Java,,24,9,51,84
Constants.java,Java,,32,9,69,110
DefaultErrorHandler.java,Java,,126,32,159,317
DOM2Helper.java,Java,,90,32,190,312
DOMBuilder.java,Java,,235,80,421,736
DOMHelper.java,Java,,607,170,529,1306
DOMOrder.java,Java,,5,2,32,39
ElemDesc.java,Java,,56,36,95,187
FastStringBuffer.java,Java,,539,192,565,1296
Hashtree2Node.java,Java,,69,12,58,139
IntStack.java,Java,,86,25,98,209
IntVector.java,Java,,177,70,170,417
ListingErrorHandler.java,Java,,236,65,264,565
LocaleUtility.java,Java,,45,17,24,86
MutableAttrListImpl.java,Java,,50,18,68,136
NameSpace.java,Java,,13,6,37,56
NamespaceSupport2.java,Java,,276,85,386,747
NodeConsumer.java,Java,,6,3,29,38
NodeVector.java,Java,,337,133,270,740
NSInfo.java,Java,,33,15,60,108
ObjectFactory.java,Java,,294,59,278,631
ObjectPool.java,Java,,70,26,80,176
ObjectStack.java,Java,,88,27,98,213
ObjectVector.java,Java,,183,74,172,429
PrefixResolver.java,Java,,8,5,57,70
PrefixResolverDefault.java,Java,,65,17,64,146
QName.java,Java,,342,94,272,708
RawCharacterHandler.java,Java,,6,2,32,40
XResourceBundle.java,Java,,77,18,55,150
XResourceBundleBase.java,Java,,7,4,37,48
XResources_de.java,Java,,26,7,48,81
XResources_en.java,Java,,26,7,48,81
XResources_es.java,Java,,26,7,48,81
XResources_fr.java,Java,,26,7,48,81
XResources_it.java,Java,,26,7,48,81
XResources_ja_JP_A.java,Java,,40,9,43,92
XResources_ja_JP_HA.java,Java,,40,9,43,92
XResources_ja_JP_HI.java,Java,,40,9,44,93
XResources_ja_JP_I.java,Java,,40,9,44,93
XResources_ko.java,Java,,34,9,41,84
XResources_sv.java,Java,,26,7,48,81
XResources_zh_CN.java,Java,,36,9,41,86
XResources_zh_HK.java,Java,,4,3,63,70
XResources_zh_TW.java,Java,,36,9,41,86
SAXSourceLocator.java,Java,,51,13,103,167
SecuritySupport.java,Java,,56,15,52,123
SecuritySupport12.java,Java,,102,15,27,144
SerializableLocatorImpl.java,Java,,51,33,139,223
StopParseException.java,Java,,8,2,28,38
StringBufferPool.java,Java,,15,4,39,58
StringComparable.java,Java,,155,30,28,213
StringToIntTable.java,Java,,82,35,77,194
StringToStringTable.java,Java,,104,40,96,240
StringToStringTableVector.java,Java,,80,32,85,197
StringVector.java,Java,,91,41,88,220
StylesheetPIHandler.java,Java,,206,33,99,338
SuballocatedByteVector.java,Java,,267,37,192,496
SuballocatedIntVector.java,Java,,290,47,218,555
SystemIDResolver.java,Java,,154,27,112,293
ThreadControllerWrapper.java,Java,,54,16,65,135
TreeWalker.java,Java,,302,72,117,491
Trie.java,Java,,93,24,86,203
UnImplNode.java,Java,,634,274,1151,2059
URI.java,Java,,901,220,527,1648
WrappedRuntimeException.java,Java,,19,9,43,71
WrongParserException.java,Java,,8,2,27,37
XMLChar.java,Java,,322,80,264,666
XMLCharacterRecognizer.java,Java,,41,15,51,107
XMLReaderManager.java,Java,,79,20,66,165
XMLString.java,Java,,47,40,586,673
XMLStringDefault.java,Java,,171,42,587,800
XMLStringFactory.java,Java,,10,5,54,69
XMLStringFactoryDefault.java,Java,,21,5,56,82
Arg.java,Java,,97,27,132,256
AttributeIterator.java,Java,,22,8,42,72
AxesWalker.java,Java,,273,79,235,587
BasicTestIterator.java,Java,,109,28,85,222
ChildIterator.java,Java,,42,14,58,114
ChildTestIterator.java,Java,,53,22,100,175
ContextNodeList.java,Java,,18,14,102,134
DescendantIterator.java,Java,,223,48,110,381
FilterExprIterator.java,Java,,97,26,96,219
FilterExprIteratorSimple.java,Java,,158,39,123,320
FilterExprWalker.java,Java,,155,43,151,349
HasPositionalPredChecker.java,Java,,55,12,55,122
IteratorPool.java,Java,,52,15,53,120
LocPathIterator.java,Java,,362,123,550,1035
MatchPatternIterator.java,Java,,196,44,87,327
NodeSequence.java,Java,,382,69,193,644
OneStepIterator.java,Java,,161,52,128,341
OneStepIteratorForward.java,Java,,47,20,101,168
PathComponent.java,Java,,5,3,26,34
PredicatedNodeTest.java,Java,,332,76,238,646
ReverseAxesWalker.java,Java,,108,38,98,244
RTFIterator.java,Java,,8,5,27,40
SelfIteratorNoPredicate.java,Java,,46,15,69,130
SubContextList.java,Java,,7,4,39,50
UnionChildIterator.java,Java,,71,13,63,147
UnionPathIterator.java,Java,,312,75,193,580
WalkerFactory.java,Java,,1245,195,391,1831
WalkingIterator.java,Java,,165,52,142,359
WalkingIteratorSorted.java,Java,,72,18,121,211
CachedXPathAPI.java,Java,,85,32,209,326
Compiler.java,Java,,599,145,500,1244
FuncLoader.java,Java,,38,10,54,102
FunctionTable.java,Java,,133,58,102,293
Keywords.java,Java,,218,69,90,377
Lexer.java,Java,,422,89,144,655
ObjectFactory.java,Java,,294,59,278,631
OpCodes.java,Java,,68,66,496,630
OpMap.java,Java,,192,57,204,453
OpMapVector.java,Java,,36,22,56,114
PsuedoNames.java,Java,,10,7,40,57
SecuritySupport.java,Java,,56,15,52,123
SecuritySupport12.java,Java,,102,15,27,144
XPathDumper.java,Java,,4,3,22,29
XPathParser.java,Java,,1249,393,709,2351
Expression.java,Java,,193,57,337,587
ExpressionNode.java,Java,,10,6,34,50
ExpressionOwner.java,Java,,6,5,32,43
ExtensionsProvider.java,Java,,16,7,35,58
FoundIndex.java,Java,,5,2,27,34
FuncBoolean.java,Java,,11,4,30,45
FuncCeiling.java,Java,,11,3,30,44
FuncConcat.java,Java,,32,10,45,87
FuncContains.java,Java,,16,7,31,54
FuncCount.java,Java,,15,6,40,61
FuncCurrent.java,Java,,36,8,35,79
FuncDoclocation.java,Java,,26,8,34,68
FuncExtElementAvailable.java,Java,,43,8,35,86
FuncExtFunction.java,Java,,131,42,146,319
FuncExtFunctionAvailable.java,Java,,49,7,31,87
FuncFalse.java,Java,,14,5,34,53
FuncFloor.java,Java,,11,3,30,44
FuncGenerateId.java,Java,,18,5,36,59
FuncId.java,Java,,81,22,45,148
FuncLang.java,Java,,38,10,31,79
FuncLast.java,Java,,39,12,52,103
FuncLocalPart.java,Java,,19,5,30,54
FuncNamespace.java,Java,,34,9,32,75
FuncNormalizeSpace.java,Java,,35,6,42,83
FuncNot.java,Java,,11,3,30,44
FuncNumber.java,Java,,11,3,30,44
FuncPosition.java,Java,,59,14,58,131
FuncQname.java,Java,,24,6,30,60
FuncRound.java,Java,,16,3,30,49
FuncStartsWith.java,Java,,12,3,30,45
FuncString.java,Java,,11,3,30,44
FuncStringLength.java,Java,,11,3,30,44
FuncSubstring.java,Java,,60,14,47,121
FuncSubstringAfter.java,Java,,17,5,30,52
FuncSubstringBefore.java,Java,,15,5,30,50
FuncSum.java,Java,,25,7,30,62
FuncSystemProperty.java,Java,,108,24,50,182
Function.java,Java,,48,14,79,141
Function2Args.java,Java,,78,21,82,181
Function3Args.java,Java,,78,21,81,180
FunctionDef1Arg.java,Java,,67,13,84,164
FunctionMultiArgs.java,Java,,120,29,84,233
FunctionOneArg.java,Java,,70,20,81,171
FuncTranslate.java,Java,,33,11,41,85
FuncTrue.java,Java,,14,5,34,53
FuncUnparsedEntityURI.java,Java,,17,6,29,52
ObjectFactory.java,Java,,294,60,278,632
SecuritySupport.java,Java,,56,15,52,123
SecuritySupport12.java,Java,,102,15,27,144
WrongNumberArgsException.java,Java,,8,3,29,40
JAXPExtensionsProvider.java,Java,,125,30,51,206
JAXPPrefixResolver.java,Java,,55,25,45,125
JAXPVariableStack.java,Java,,36,10,24,70
XPathExpressionImpl.java,Java,,192,37,161,390
XPathFactoryImpl.java,Java,,88,35,140,263
XPathImpl.java,Java,,260,50,229,539
NodeSet.java,Java,,598,234,542,1374
NodeSetDTM.java,Java,,398,167,686,1251
XBoolean.java,Java,,57,21,87,165
XBooleanStatic.java,Java,,21,6,39,66
XMLStringFactoryImpl.java,Java,,29,8,62,99
XNodeSet.java,Java,,406,101,454,961
XNodeSetForDOM.java,Java,,55,15,55,125
XNull.java,Java,,38,12,77,127
XNumber.java,Java,,135,43,256,434
XObject.java,Java,,283,105,364,752
XObjectFactory.java,Java,,107,11,41,159
XRTreeFrag.java,Java,,175,37,172,384
XRTreeFragSelectWrapper.java,Java,,63,16,79,158
XString.java,Java,,403,113,653,1169
XStringForChars.java,Java,,69,23,121,213
XStringForFSB.java,Java,,400,122,466,988
And.java,Java,,23,8,41,72
Bool.java,Java,,19,6,40,65
Div.java,Java,,17,6,41,64
Equals.java,Java,,22,6,43,71
Gt.java,Java,,11,3,32,46
Gte.java,Java,,12,3,32,47
Lt.java,Java,,11,3,32,46
Lte.java,Java,,11,3,32,46
Minus.java,Java,,17,6,42,65
Mod.java,Java,,17,6,41,64
Mult.java,Java,,17,5,41,63
Neg.java,Java,,16,6,40,62
NotEquals.java,Java,,11,3,32,46
Number.java,Java,,19,7,40,66
Operation.java,Java,,91,26,92,209
Or.java,Java,,23,8,41,72
Plus.java,Java,,17,6,41,64
Quo.java,Java,,11,4,34,49
String.java,Java,,10,3,31,44
UnaryOperation.java,Java,,58,21,81,160
Variable.java,Java,,128,48,210,386
VariableSafeAbsRef.java,Java,,23,6,42,71
ContextMatchStepPattern.java,Java,,94,24,59,177
FunctionPattern.java,Java,,111,40,97,248
NodeTest.java,Java,,296,102,291,689
NodeTestFilter.java,Java,,5,2,30,37
StepPattern.java,Java,,600,136,314,1050
UnionPattern.java,Java,,115,29,71,215
XPATHErrorResources.java,Java,,565,349,517,1431
XPATHErrorResources_de.java,Java,,524,317,499,1340
XPATHErrorResources_en.java,Java,,4,2,23,29
XPATHErrorResources_es.java,Java,,524,317,499,1340
XPATHErrorResources_fr.java,Java,,524,317,499,1340
XPATHErrorResources_it.java,Java,,524,317,499,1340
XPATHErrorResources_ja.java,Java,,524,317,499,1340
XPATHErrorResources_ko.java,Java,,524,317,499,1340
XPATHErrorResources_sv.java,Java,,400,522,336,1258
XPATHErrorResources_zh_CN.java,Java,,524,317,499,1340
XPATHErrorResources_zh_HK.java,Java,,4,2,66,72
XPATHErrorResources_zh_TW.java,Java,,524,317,499,1340
XPATHMessages.java,Java,,70,19,60,149
SourceTree.java,Java,,11,5,34,50
SourceTreeManager.java,Java,,191,54,145,390
VariableStack.java,Java,,152,69,256,477
WhitespaceStrippingElementMatcher.java,Java,,9,4,39,52
XPath.java,Java,,262,70,253,585
XPathAPI.java,Java,,73,27,183,283
XPathContext.java,Java,,527,147,585,1259
XPathException.java,Java,,152,54,104,310
XPathFactory.java,Java,,8,4,36,48
XPathProcessorException.java,Java,,12,4,35,51
XPathVisitable.java,Java,,5,2,33,40
XPathVisitor.java,Java,,63,17,121,201
DialogCallbackHandler.java,Java,,195,43,59,297
TextCallbackHandler.java,Java,,175,29,35,239
ConfigFile.java,Java,,407,69,106,582
Crypt.java,Java,,263,55,68,386
JndiLoginModule.java,Java,,380,75,296,751
KeyStoreLoginModule.java,Java,,607,86,203,896
Krb5LoginModule.java,Java,defUsername,608,75,459,1142
NTLoginModule.java,Java,,229,32,119,380
NTSystem.java,Java,,43,15,69,127
SolarisLoginModule.java,Java,,151,25,122,298
SolarisSystem.java,Java,,26,10,44,80
UnixLoginModule.java,Java,,148,25,117,290
UnixSystem.java,Java,,26,10,44,80
NTDomainPrincipal.java,Java,,43,13,75,131
NTNumericCredential.java,Java,,33,12,57,102
NTSid.java,Java,,50,13,78,141
NTSidDomainPrincipal.java,Java,,24,9,58,91
NTSidGroupPrincipal.java,Java,,24,10,53,87
NTSidPrimaryGroupPrincipal.java,Java,,24,10,56,90
NTSidUserPrincipal.java,Java,,24,9,52,85
NTUserPrincipal.java,Java,,43,13,69,125
PolicyFile.java,Java,,760,138,555,1453
PolicyParser.java,Java,,611,106,229,946
PrincipalComparator.java,Java,,4,2,41,47
SolarisNumericGroupPrincipal.java,Java,,60,19,120,199
SolarisNumericUserPrincipal.java,Java,,49,18,98,165
SolarisPrincipal.java,Java,,41,16,72,129
SubjectCodeSource.java,Java,,191,44,150,385
UnixNumericGroupPrincipal.java,Java,,67,19,116,202
UnixNumericUserPrincipal.java,Java,,51,15,95,161
UnixPrincipal.java,Java,,43,14,69,126
X500Principal.java,Java,,61,20,86,167
GSSUtil.java,Java,,11,5,38,54
Applet.java,Java,,143,38,372,553
AppletContext.java,Java,,21,12,142,175
AppletStub.java,Java,,10,8,76,94
AudioClip.java,Java,,6,4,26,36
ActiveEvent.java,Java,,4,3,35,42
Adjustable.java,Java,,22,23,97,142
AlphaComposite.java,Java,,109,44,592,745
AttributeValue.java,Java,,21,5,8,34
AWTError.java,Java,,7,4,21,32
AWTEvent.java,Java,,268,59,202,529
AWTEventMulticaster.java,Java,,363,87,504,954
AWTException.java,Java,,7,4,23,34
AWTKeyStroke.java,Java,,441,66,337,844
AWTPermission.java,Java,,13,9,163,185
BasicStroke.java,Java,,270,58,256,584
BorderLayout.java,Java,,332,57,469,858
BufferCapabilities.java,Java,,60,21,117,198
Button.java,Java,[PENDING:  WDW -- need to provide a localized string,205,54,393,652
Canvas.java,Java,,60,19,141,220
CardLayout.java,Java,,318,48,225,591
Checkbox.java,Java,,281,70,492,843
CheckboxGroup.java,Java,,34,9,90,133
CheckboxMenuItem.java,Java,,184,50,376,610
Choice.java,Java,,265,65,467,797
CMMException.java,Java,,6,7,29,42
ColorSpace.java,Java,,141,75,330,546
ICC_ColorSpace.java,Java,,200,36,353,589
ICC_Profile.java,Java,,878,358,821,2057
ICC_ProfileGray.java,Java,,25,18,88,131
ICC_ProfileRGB.java,Java,,73,34,156,263
ProfileDataException.java,Java,,6,4,14,24
Color.java,Java,,467,81,664,1212
ColorPaintContext.java,Java,,31,11,6,48
Component.java,Java,,3697,618,4278,8593
ComponentOrientation.java,Java,,53,15,111,179
Composite.java,Java,,7,5,57,69
CompositeContext.java,Java,,9,8,35,52
Conditional.java,Java,,4,2,14,20
Container.java,Java,,2224,305,1749,4278
ContainerOrderFocusTraversalPolicy.java,Java,,294,36,153,483
Cursor.java,Java,,224,68,142,434
Clipboard.java,Java,,116,33,192,341
ClipboardOwner.java,Java,,4,5,30,39
DataFlavor.java,Java,,501,124,702,1327
FlavorEvent.java,Java,,7,3,22,32
FlavorListener.java,Java,,5,3,30,38
FlavorMap.java,Java,,6,6,46,58
FlavorTable.java,Java,,6,6,53,65
MimeType.java,Java,,171,40,164,375
MimeTypeParameterList.java,Java,,244,56,89,389
MimeTypeParseException.java,Java,,10,6,20,36
StringSelection.java,Java,,38,11,73,122
SystemFlavorMap.java,Java,,689,110,442,1241
Transferable.java,Java,,7,8,41,56
UnsupportedFlavorException.java,Java,,7,4,22,33
DefaultFocusTraversalPolicy.java,Java,,32,7,68,107
DefaultKeyboardFocusManager.java,Java,,826,121,330,1277
Dialog.java,Java,,333,69,427,829
Dimension.java,Java,,58,20,139,217
DisplayMode.java,Java,,45,12,62,119
Autoscroll.java,Java,,7,9,47,63
DnDConstants.java,Java,,10,14,44,68
DnDEventMulticaster.java,Java,,82,19,116,217
DragGestureEvent.java,Java,,88,55,197,340
DragGestureListener.java,Java,,5,8,28,41
DragGestureRecognizer.java,Java,,94,57,295,446
DragSource.java,Java,,264,75,560,899
DragSourceAdapter.java,Java,,10,8,107,125
DragSourceContext.java,Java,,214,81,301,596
DragSourceDragEvent.java,Java,,97,26,188,311
DragSourceDropEvent.java,Java,,23,19,109,151
DragSourceEvent.java,Java,,37,18,113,168
DragSourceListener.java,Java,,9,15,91,115
DragSourceMotionListener.java,Java,,5,5,34,44
DropTarget.java,Java,,299,140,399,838
DropTargetAdapter.java,Java,,7,6,79,92
DropTargetContext.java,Java,,131,65,207,403
DropTargetDragEvent.java,Java,,47,31,148,226
DropTargetDropEvent.java,Java,,59,43,181,283
DropTargetEvent.java,Java,,18,14,36,68
DropTargetListener.java,Java,,12,22,109,143
InvalidDnDOperationException.java,Java,,6,12,23,41
MouseDragGestureRecognizer.java,Java,,35,35,123,193
DragSourceContextPeer.java,Java,,19,15,29,63
DropTargetContextPeer.java,Java,,23,30,49,102
DropTargetPeer.java,Java,,6,8,28,42
SerializationTester.java,Java,,33,6,17,56
ActionEvent.java,Java,,50,22,173,245
ActionListener.java,Java,,5,5,26,36
AdjustmentEvent.java,Java,,75,26,138,239
AdjustmentListener.java,Java,,5,5,16,26
AWTEventListener.java,Java,,6,5,34,45
AWTEventListenerProxy.java,Java,,19,7,36,62
ComponentAdapter.java,Java,,7,5,44,56
ComponentEvent.java,Java,,45,14,84,143
ComponentListener.java,Java,,8,6,44,58
ContainerAdapter.java,Java,,5,3,38,46
ContainerEvent.java,Java,,36,13,87,136
ContainerListener.java,Java,,6,5,39,50
FocusAdapter.java,Java,,5,3,38,46
FocusEvent.java,Java,,53,19,146,218
FocusListener.java,Java,,6,5,34,45
HierarchyBoundsAdapter.java,Java,,6,3,35,44
HierarchyBoundsListener.java,Java,,6,4,35,45
HierarchyEvent.java,Java,,85,19,183,287
HierarchyListener.java,Java,,5,3,32,40
InputEvent.java,Java,,126,43,210,379
InputMethodEvent.java,Java,,129,32,239,400
InputMethodListener.java,Java,,6,7,26,39
InvocationEvent.java,Java,,72,22,177,271
ItemEvent.java,Java,,51,18,102,171
ItemListener.java,Java,,5,5,30,40
KeyAdapter.java,Java,,6,4,43,53
KeyEvent.java,Java,,685,162,725,1572
KeyListener.java,Java,,7,6,44,57
MouseAdapter.java,Java,,8,6,53,67
MouseEvent.java,Java,,271,47,403,721
MouseListener.java,Java,,9,8,51,68
MouseMotionAdapter.java,Java,,5,3,47,55
MouseMotionListener.java,Java,,6,6,47,59
MouseWheelEvent.java,Java,,49,23,218,290
MouseWheelListener.java,Java,,5,4,32,41
NativeLibLoader.java,Java,,7,3,31,41
PaintEvent.java,Java,,36,13,66,115
TextEvent.java,Java,,23,13,58,94
TextListener.java,Java,,5,5,30,40
WindowAdapter.java,Java,,15,11,75,101
WindowEvent.java,Java,,99,32,256,387
WindowFocusListener.java,Java,,6,5,42,53
WindowListener.java,Java,,11,9,66,86
WindowStateListener.java,Java,,5,3,29,37
Event.java,Java,,230,106,526,862
EventDispatchThread.java,Java,,211,39,119,369
EventQueue.java,Java,,464,73,360,897
FileDialog.java,Java,,123,33,293,449
FlowLayout.java,Java,,189,40,330,559
FocusTraversalPolicy.java,Java,,17,7,131,155
CharArrayIterator.java,Java,,84,26,58,168
FontRenderContext.java,Java,,56,15,98,169
GlyphJustificationInfo.java,Java,,60,23,111,194
GlyphMetrics.java,Java,,69,30,205,304
GlyphVector.java,Java,,82,41,469,592
GraphicAttribute.java,Java,,43,21,111,175
ImageGraphicAttribute.java,Java,,68,36,108,212
LineBreakMeasurer.java,Java,,113,36,367,516
LineMetrics.java,Java,,14,16,98,128
MultipleMaster.java,Java,,15,10,64,89
NumericShaper.java,Java,,643,79,202,924
OpenType.java,Java,,61,64,291,416
ShapeGraphicAttribute.java,Java,,82,35,108,225
StyledParagraph.java,Java,,275,61,131,467
TextAttribute.java,Java,,79,65,760,904
TextHitInfo.java,Java,,54,18,157,229
TextJustifier.java,Java,,146,26,50,222
TextLayout.java,Java,,1328,348,1079,2755
TextLine.java,Java,,826,258,126,1210
TextMeasurer.java,Java,,405,118,223,746
TransformAttribute.java,Java,,31,12,48,91
Font.java,Java,,1016,191,1198,2405
FontFormatException.java,Java,,7,2,20,29
FontMetrics.java,Java,,145,37,411,593
Frame.java,Java,,431,100,668,1199
AffineTransform.java,Java,,1769,136,1211,3116
Arc2D.java,Java,,488,89,701,1278
ArcIterator.java,Java,,143,10,142,295
Area.java,Java,,307,37,250,594
CubicCurve2D.java,Java,,674,112,855,1641
CubicIterator.java,Java,,66,9,64,139
Dimension2D.java,Java,,18,7,65,90
Ellipse2D.java,Java,,136,33,238,407
EllipseIterator.java,Java,,91,11,70,172
FlatteningPathIterator.java,Java,,184,36,158,378
GeneralPath.java,Java,,285,40,312,637
GeneralPathIterator.java,Java,,51,10,80,141
IllegalPathStateException.java,Java,,8,4,27,39
Line2D.java,Java,,297,72,635,1004
LineIterator.java,Java,,58,9,64,131
NoninvertibleTransformException.java,Java,,6,3,20,29
PathIterator.java,Java,,15,13,170,198
Point2D.java,Java,,112,32,226,370
QuadCurve2D.java,Java,,493,103,747,1343
QuadIterator.java,Java,,62,9,64,135
Rectangle2D.java,Java,,314,65,624,1003
RectangularShape.java,Java,,101,28,230,359
RectIterator.java,Java,,66,9,64,139
RoundRectangle2D.java,Java,,213,49,353,615
RoundRectIterator.java,Java,,92,11,69,172
GradientPaint.java,Java,,85,19,141,245
GradientPaintContext.java,Java,,209,23,44,276
Graphics.java,Java,,164,57,1001,1222
Graphics2D.java,Java,,99,47,1074,1220
GraphicsCallback.java,Java,,109,13,6,128
GraphicsConfigTemplate.java,Java,,14,11,67,92
GraphicsConfiguration.java,Java,,51,24,288,363
GraphicsDevice.java,Java,,62,22,232,316
GraphicsEnvironment.java,Java,,107,28,238,373
GridBagConstraints.java,Java,,83,42,381,506
GridBagLayout.java,Java,,646,138,789,1573
GridLayout.java,Java,,154,23,273,450
HeadlessException.java,Java,,19,3,17,39
IllegalComponentStateException.java,Java,,10,4,26,40
InputContext.java,Java,,39,18,263,320
InputMethodHighlight.java,Java,,48,21,109,178
InputMethodRequests.java,Java,,15,11,165,191
InputSubset.java,Java,,24,15,58,97
InputMethod.java,Java,,23,22,320,365
InputMethodContext.java,Java,,15,8,100,123
InputMethodDescriptor.java,Java,,11,10,85,106
AffineTransformOp.java,Java,,275,39,231,545
AreaAveragingScaleFilter.java,Java,,164,11,89,264
BandCombineOp.java,Java,,124,15,120,259
BandedSampleModel.java,Java,,387,92,328,807
BufferedImage.java,Java,,724,132,757,1613
BufferedImageFilter.java,Java,,263,15,122,400
BufferedImageOp.java,Java,,12,7,100,119
BufferStrategy.java,Java,,11,9,136,156
ByteLookupTable.java,Java,,79,13,101,193
ColorConvertOp.java,Java,,712,80,270,1062
ColorModel.java,Java,,702,89,1144,1935
ComponentColorModel.java,Java,,1824,80,1028,2932
ComponentSampleModel.java,Java,,596,112,460,1168
ConvolveOp.java,Java,,134,31,149,314
CropImageFilter.java,Java,,86,11,79,176
DataBuffer.java,Java,,127,40,240,407
DataBufferByte.java,Java,,63,18,130,211
DataBufferDouble.java,Java,,86,26,210,322
DataBufferFloat.java,Java,,86,26,213,325
DataBufferInt.java,Java,,63,19,128,210
DataBufferShort.java,Java,,63,19,127,209
DataBufferUShort.java,Java,,94,21,129,244
DirectColorModel.java,Java,,715,56,629,1400
FilteredImageSource.java,Java,,60,10,122,192
ImageConsumer.java,Java,,22,18,165,205
ImageFilter.java,Java,,52,13,176,241
ImageObserver.java,Java,,14,11,128,153
ImageProducer.java,Java,,8,6,81,95
ImagingOpException.java,Java,,6,4,18,28
IndexColorModel.java,Java,,650,72,690,1412
Kernel.java,Java,,59,19,64,142
LookupOp.java,Java,,331,52,169,552
LookupTable.java,Java,,25,10,57,92
MemoryImageSource.java,Java,,220,24,310,554
MultiPixelPackedSampleModel.java,Java,,291,60,323,674
PackedColorModel.java,Java,,208,35,221,464
PixelGrabber.java,Java,,308,28,315,651
PixelInterleavedSampleModel.java,Java,,67,6,80,153
Raster.java,Java,,649,138,968,1755
RasterFormatException.java,Java,,6,4,17,27
RasterOp.java,Java,,11,7,72,90
ContextualRenderedImageFactory.java,Java,,15,9,101,125
ParameterBlock.java,Java,,191,50,466,707
RenderableImage.java,Java,,18,15,147,180
RenderableImageOp.java,Java,,121,29,182,332
RenderableImageProducer.java,Java,,93,19,89,201
RenderContext.java,Java,,63,22,167,252
RenderedImageFactory.java,Java,,7,4,49,60
RenderedImage.java,Java,,27,25,147,199
ReplicateScaleFilter.java,Java,,115,16,107,238
RescaleOp.java,Java,,348,63,238,649
RGBImageFilter.java,Java,,101,13,158,272
SampleModel.java,Java,,464,152,750,1366
ShortLookupTable.java,Java,,79,13,95,187
SinglePixelPackedSampleModel.java,Java,,380,75,331,786
TileObserver.java,Java,,6,4,27,37
VolatileImage.java,Java,,35,24,275,334
WritableRaster.java,Java,,223,37,466,726
WritableRenderedImage.java,Java,,13,13,107,133
Image.java,Java,,48,20,220,288
ImageCapabilities.java,Java,,20,8,35,63
Insets.java,Java,,53,15,103,171
ItemSelectable.java,Java,,7,7,34,48
JobAttributes.java,Java,,443,68,531,1042
KeyboardFocusManager.java,Java,,1465,252,1314,3031
KeyEventDispatcher.java,Java,,5,4,64,73
KeyEventPostProcessor.java,Java,,5,4,67,76
Label.java,Java,,123,33,185,341
LayoutManager.java,Java,,8,5,46,59
LayoutManager2.java,Java,,8,7,55,70
List.java,Java,[FIXME,623,154,1139,1916
MediaTracker.java,Java,,390,56,487,933
Menu.java,Java,,244,59,300,603
MenuBar.java,Java,,206,42,232,480
MenuComponent.java,Java,,315,96,592,1003
MenuContainer.java,Java,,7,3,16,26
MenuItem.java,Java,[PENDING:  WDW -- need to provide a localized string,287,71,510,868
MenuShortcut.java,Java,,52,13,112,177
MouseInfo.java,Java,,53,12,53,118
PageAttributes.java,Java,,521,52,782,1355
Paint.java,Java,,12,6,59,77
PaintContext.java,Java,,12,7,46,65
Panel.java,Java,,38,14,63,115
ButtonPeer.java,Java,,5,3,13,21
CanvasPeer.java,Java,,4,2,13,19
CheckboxMenuItemPeer.java,Java,,4,1,13,18
CheckboxPeer.java,Java,,7,2,13,22
ChoicePeer.java,Java,,9,3,16,28
ComponentPeer.java,Java,,67,16,50,133
ContainerPeer.java,Java,,14,6,32,52
DialogPeer.java,Java,,6,5,13,24
FileDialogPeer.java,Java,,8,3,13,24
FontPeer.java,Java,,3,2,13,18
FramePeer.java,Java,,12,3,13,28
KeyboardFocusManagerPeer.java,Java,,10,5,6,21
LabelPeer.java,Java,,7,2,13,22
LightweightPeer.java,Java,,3,3,21,27
ListPeer.java,Java,,19,7,28,54
MenuBarPeer.java,Java,,7,2,13,22
MenuComponentPeer.java,Java,,6,2,13,21
MenuItemPeer.java,Java,,7,4,19,30
MenuPeer.java,Java,,7,2,13,22
MouseInfoPeer.java,Java,,7,6,35,48
PanelPeer.java,Java,,4,2,13,19
PopupMenuPeer.java,Java,,5,2,13,20
RobotPeer.java,Java,,13,6,17,36
ScrollbarPeer.java,Java,,6,1,13,20
ScrollPanePeer.java,Java,,11,2,13,26
TextAreaPeer.java,Java,,12,6,25,43
TextComponentPeer.java,Java,,18,2,13,33
TextFieldPeer.java,Java,,10,5,22,37
WindowPeer.java,Java,,10,4,13,27
Point.java,Java,,54,18,140,212
PointerInfo.java,Java,,15,8,44,67
Polygon.java,Java,,263,52,363,678
PopupMenu.java,Java,,78,18,97,193
Book.java,Java,,66,27,110,203
Pageable.java,Java,,9,7,50,66
PageFormat.java,Java,,141,58,146,345
Paper.java,Java,,53,25,111,189
Printable.java,Java,,8,7,107,122
PrinterAbortException.java,Java,,9,6,22,37
PrinterException.java,Java,,8,6,21,35
PrinterGraphics.java,Java,,4,5,20,29
PrinterIOException.java,Java,,16,6,48,70
PrinterJob.java,Java,,91,37,361,489
PrintGraphics.java,Java,,4,4,16,24
PrintJob.java,Java,,11,9,43,63
Rectangle.java,Java,,291,54,558,903
RenderingHints.java,Java,,210,71,428,709
Robot.java,Java,,188,42,216,446
Scrollbar.java,Java,,355,91,864,1310
ScrollPane.java,Java,,351,79,388,818
ScrollPaneAdjustable.java,Java,,140,44,240,424
SentEvent.java,Java,,50,6,15,71
SequencedEvent.java,Java,,111,17,62,190
Shape.java,Java,,17,12,288,317
Stroke.java,Java,,4,6,45,55
SystemColor.java,Java,,111,65,296,472
TextArea.java,Java,,245,60,390,695
TextComponent.java,Java,,486,94,613,1193
TextField.java,Java,,227,55,438,720
TexturePaint.java,Java,,47,13,63,123
TexturePaintContext.java,Java,,702,47,57,806
Toolkit.java,Java,,740,147,1342,2229
Transparency.java,Java,,7,6,29,42
Window.java,Java,,961,167,1268,2396
AppletInitializer.java,Java,,7,10,57,74
BeanContext.java,Java,,16,13,87,116
BeanContextChild.java,Java,,13,12,96,121
BeanContextChildComponentProxy.java,Java,,5,6,26,37
BeanContextChildSupport.java,Java,,100,57,199,356
BeanContextContainerProxy.java,Java,,5,5,25,35
BeanContextEvent.java,Java,,19,19,55,93
BeanContextMembershipEvent.java,Java,,28,24,66,118
BeanContextMembershipListener.java,Java,,7,7,30,44
BeanContextProxy.java,Java,,4,4,60,68
BeanContextServiceAvailableEvent.java,Java,,19,17,35,71
BeanContextServiceProvider.java,Java,,7,9,72,88
BeanContextServiceProviderBeanInfo.java,Java,,5,5,19,29
BeanContextServiceRevokedEvent.java,Java,,20,18,48,86
BeanContextServiceRevokedListener.java,Java,,6,7,18,31
BeanContextServices.java,Java,,17,17,107,141
BeanContextServicesListener.java,Java,,7,4,17,28
BeanContextServicesSupport.java,Java,,623,314,282,1219
BeanContextSupport.java,Java,,590,258,528,1376
BeanDescriptor.java,Java,,29,11,42,82
BeanInfo.java,Java,,15,15,123,153
Beans.java,Java,,310,92,248,650
Customizer.java,Java,,6,8,34,48
DefaultPersistenceDelegate.java,Java,,177,26,195,398
DesignMode.java,Java,,6,9,57,72
Encoder.java,Java,,108,65,152,325
EventHandler.java,Java,,150,23,369,542
EventSetDescriptor.java,Java,,256,44,200,500
ExceptionListener.java,Java,,4,48,21,73
Expression.java,Java,,27,10,90,127
FeatureDescriptor.java,Java,,143,33,138,314
IndexedPropertyChangeEvent.java,Java,,13,6,39,58
IndexedPropertyDescriptor.java,Java,,267,51,161,479
IntrospectionException.java,Java,,7,4,20,31
Introspector.java,Java,,1011,161,403,1575
MetaData.java,Java,,676,119,188,983
MethodDescriptor.java,Java,,119,31,68,218
NameGenerator.java,Java,,52,11,36,99
ParameterDescriptor.java,Java,,8,6,21,35
PersistenceDelegate.java,Java,,26,6,160,192
PropertyChangeEvent.java,Java,,29,13,82,124
PropertyChangeListener.java,Java,,4,6,16,26
PropertyChangeListenerProxy.java,Java,,16,6,39,61
PropertyChangeSupport.java,Java,,223,42,234,499
PropertyDescriptor.java,Java,,368,69,232,669
PropertyEditor.java,Java,,15,25,166,206
PropertyEditorManager.java,Java,,91,18,81,190
PropertyEditorSupport.java,Java,,87,32,152,271
PropertyVetoException.java,Java,,12,8,26,46
ReflectionUtils.java,Java,,261,33,122,416
SimpleBeanInfo.java,Java,,54,14,60,128
Statement.java,Java,,142,20,113,275
VetoableChangeListener.java,Java,,5,2,19,26
VetoableChangeListenerProxy.java,Java,,18,7,39,64
VetoableChangeSupport.java,Java,,229,43,179,451
Visibility.java,Java,,7,8,34,49
XMLDecoder.java,Java,,91,19,132,242
XMLEncoder.java,Java,,316,50,267,633
Bits.java,Java,,93,18,18,129
BufferedInputStream.java,Java,,157,27,262,446
BufferedOutputStream.java,Java,,44,9,73,126
BufferedReader.java,Java,,263,37,208,508
BufferedWriter.java,Java,,105,24,127,256
ByteArrayInputStream.java,Java,,66,17,178,261
ByteArrayOutputStream.java,Java,,67,19,128,214
CharArrayReader.java,Java,,96,17,100,213
CharArrayWriter.java,Java,,97,19,153,269
CharConversionException.java,Java,,10,1,21,32
Closeable.java,Java,,5,6,21,32
DataInput.java,Java,,19,16,595,630
DataInputStream.java,Java,,212,35,372,619
DataOutput.java,Java,,18,15,304,337
DataOutputStream.java,Java,,145,29,225,399
EOFException.java,Java,,10,3,33,46
ExpiringCache.java,Java,,84,15,9,108
Externalizable.java,Java,,7,4,69,80
File.java,Java,,431,85,1058,1574
FileDescriptor.java,Java,,30,16,82,128
FileFilter.java,Java,,4,5,23,32
FileInputStream.java,Java,,73,23,213,309
FilenameFilter.java,Java,,5,2,29,36
FileNotFoundException.java,Java,,14,8,42,64
FileOutputStream.java,Java,,90,25,233,348
FilePermission.java,Java,,341,98,373,812
FileReader.java,Java,,12,8,49,69
FileSystem.java,Java,,51,46,130,227
FileWriter.java,Java,,18,10,74,102
FilterInputStream.java,Java,,35,12,176,223
FilterOutputStream.java,Java,,31,9,105,145
FilterReader.java,Java,,32,15,65,112
FilterWriter.java,Java,,23,12,60,95
Flushable.java,Java,,5,5,20,30
InputStream.java,Java,,68,20,262,350
InputStreamReader.java,Java,,50,16,124,190
InterruptedIOException.java,Java,,11,4,40,55
InvalidClassException.java,Java,,17,5,39,61
InvalidObjectException.java,Java,,6,2,23,31
IOException.java,Java,,10,3,29,42
LineNumberInputStream.java,Java,,97,19,159,275
LineNumberReader.java,Java,,100,23,117,240
NotActiveException.java,Java,,9,3,21,33
NotSerializableException.java,Java,,9,3,23,35
ObjectInput.java,Java,,11,8,71,90
ObjectInputStream.java,Java,,1875,298,1275,3448
ObjectInputValidation.java,Java,,4,2,22,28
ObjectOutput.java,Java,,10,7,56,73
ObjectOutputStream.java,Java,,1135,175,925,2235
ObjectStreamClass.java,Java,,1485,191,582,2258
ObjectStreamConstants.java,Java,,34,36,146,216
ObjectStreamException.java,Java,,9,3,21,33
ObjectStreamField.java,Java,,97,21,139,257
OptionalDataException.java,Java,,13,4,46,63
OutputStream.java,Java,,24,7,106,137
OutputStreamWriter.java,Java,,56,20,149,225
PipedInputStream.java,Java,,166,21,169,356
PipedOutputStream.java,Java,,53,11,95,159
PipedReader.java,Java,,144,23,138,305
PipedWriter.java,Java,,53,14,92,159
PrintStream.java,Java,,331,62,665,1058
PrintWriter.java,Java,,295,58,640,993
PushbackInputStream.java,Java,,111,21,205,337
PushbackReader.java,Java,,120,21,119,260
RandomAccessFile.java,Java,,269,64,730,1063
Reader.java,Java,,64,20,159,243
SequenceInputStream.java,Java,,79,14,108,201
Serializable.java,Java,,3,2,131,136
SerializablePermission.java,Java,,16,11,82,109
StreamCorruptedException.java,Java,,9,3,22,34
StreamTokenizer.java,Java,,368,52,400,820
StringBufferInputStream.java,Java,,54,11,90,155
StringReader.java,Java,,78,16,88,182
StringWriter.java,Java,,59,19,136,214
SyncFailedException.java,Java,,6,2,21,29
UnsupportedEncodingException.java,Java,,11,2,20,33
UTFDataFormatException.java,Java,,10,3,37,50
Win32FileSystem.java,Java,,413,62,104,579
WinNTFileSystem.java,Java,,26,10,16,52
WriteAbortedException.java,Java,,19,6,51,76
Writer.java,Java,,64,20,197,281
AbstractMethodError.java,Java,,10,3,26,39
AbstractStringBuilder.java,Java,,468,65,893,1426
Annotation.java,Java,,7,5,98,110
AnnotationFormatError.java,Java,,12,5,38,55
AnnotationTypeMismatchException.java,Java,,18,6,43,67
Documented.java,Java,,6,2,18,26
ElementType.java,Java,,11,9,25,45
IncompleteAnnotationException.java,Java,,18,6,28,52
Inherited.java,Java,,6,2,26,34
Retention.java,Java,,7,2,19,28
RetentionPolicy.java,Java,,6,4,29,39
Target.java,Java,,7,2,41,50
Appendable.java,Java,,7,6,91,104
ArithmeticException.java,Java,,10,3,25,38
ArrayIndexOutOfBoundsException.java,Java,,13,4,31,48
ArrayStoreException.java,Java,,10,4,28,42
AssertionError.java,Java,,31,10,92,133
AssertionStatusDirectives.java,Java,,8,6,62,76
Boolean.java,Java,,58,19,170,247
Byte.java,Java,,112,35,295,442
Character.java,Java,,2132,340,2993,5465
CharacterData00.java,Java,,1001,50,94,1145
CharacterData01.java,Java,,379,43,69,491
CharacterData02.java,Java,,285,42,68,395
CharacterData0E.java,Java,,290,41,68,399
CharacterDataLatin1.java,Java,,225,44,52,321
CharacterDataPrivateUse.java,Java,,87,33,13,133
CharacterDataUndefined.java,Java,,72,30,13,115
CharSequence.java,Java,,7,9,78,94
Class.java,Java,,1116,235,1708,3059
ClassCastException.java,Java,,10,3,28,41
ClassCircularityError.java,Java,,9,3,22,34
ClassFormatError.java,Java,,10,3,24,37
ClassLoader.java,Java,,838,141,1045,2024
ClassNotFoundException.java,Java,,21,8,79,108
Cloneable.java,Java,,3,2,32,37
CloneNotSupportedException.java,Java,,10,4,32,46
Comparable.java,Java,,4,3,115,122
Compiler.java,Java,,40,10,67,117
ConditionalSpecialCasing.java,Java,,273,61,115,449
Deprecated.java,Java,,6,3,16,25
Double.java,Java,,121,46,746,913
Enum.java,Java,,63,16,132,211
EnumConstantNotPresentException.java,Java,,13,6,36,55
Error.java,Java,,16,6,64,86
Exception.java,Java,,16,6,57,79
ExceptionInInitializerError.java,Java,,22,8,79,109
Float.java,Java,,105,39,669,813
IllegalAccessError.java,Java,,9,3,27,39
IllegalAccessException.java,Java,,9,3,47,59
IllegalArgumentException.java,Java,,17,6,55,78
IllegalMonitorStateException.java,Java,,10,3,30,43
IllegalStateException.java,Java,,17,6,57,80
IllegalThreadStateException.java,Java,,9,3,28,40
IncompatibleClassChangeError.java,Java,,10,3,25,38
IndexOutOfBoundsException.java,Java,,10,3,26,39
InheritableThreadLocal.java,Java,,13,5,49,67
InstantiationError.java,Java,,10,5,27,42
InstantiationException.java,Java,,10,3,26,39
ClassDefinition.java,Java,,22,7,40,69
ClassFileTransformer.java,Java,,11,6,78,95
IllegalClassFormatException.java,Java,,11,4,28,43
Instrumentation.java,Java,,20,10,148,178
UnmodifiableClassException.java,Java,,11,3,23,37
Integer.java,Java,,372,76,715,1163
InternalError.java,Java,,10,3,23,36
InterruptedException.java,Java,,10,3,30,43
Iterable.java,Java,,5,4,14,23
LinkageError.java,Java,,10,3,25,38
Long.java,Java,,356,66,723,1145
ClassLoadingMXBean.java,Java,,8,9,77,94
CompilationMXBean.java,Java,,6,5,70,81
GarbageCollectorMXBean.java,Java,,5,6,63,74
ManagementFactory.java,Java,,135,30,500,665
ManagementPermission.java,Java,,19,5,76,100
MemoryManagerMXBean.java,Java,,6,5,57,68
MemoryMXBean.java,Java,,10,9,264,283
MemoryNotificationInfo.java,Java,,50,13,176,239
MemoryPoolMXBean.java,Java,,21,19,582,622
MemoryType.java,Java,,13,8,35,56
MemoryUsage.java,Java,,80,15,191,286
OperatingSystemMXBean.java,Java,,7,6,87,100
RuntimeMXBean.java,Java,,19,19,281,319
ThreadInfo.java,Java,,125,26,371,522
ThreadMXBean.java,Java,,25,24,518,567
Math.java,Java,,167,55,998,1220
NegativeArraySizeException.java,Java,,10,3,23,36
NoClassDefFoundError.java,Java,,10,3,29,42
NoSuchFieldError.java,Java,,10,3,27,40
NoSuchFieldException.java,Java,,9,3,21,33
NoSuchMethodError.java,Java,,10,3,28,41
NoSuchMethodException.java,Java,,10,3,21,34
NullPointerException.java,Java,,10,3,35,48
Number.java,Java,,14,8,73,95
NumberFormatException.java,Java,,14,5,31,50
Object.java,Java,,36,17,472,525
OutOfMemoryError.java,Java,,10,3,24,37
Override.java,Java,,6,3,15,24
Package.java,Java,,308,41,232,581
Process.java,Java,,11,8,112,131
ProcessBuilder.java,Java,,93,25,338,456
ProcessEnvironment.java,Java,,199,36,66,301
ProcessImpl.java,Java,,92,17,17,126
Readable.java,Java,,5,6,27,38
Finalizer.java,Java,,129,19,31,179
FinalReference.java,Java,,6,6,7,19
PhantomReference.java,Java,,9,7,50,66
Reference.java,Java,,71,33,111,215
ReferenceQueue.java,Java,,74,13,52,139
SoftReference.java,Java,,18,10,70,98
WeakReference.java,Java,,9,7,39,55
AccessibleObject.java,Java,,55,15,101,171
AnnotatedElement.java,Java,,8,6,75,89
Array.java,Java,,56,29,382,467
Constructor.java,Java,,289,45,302,636
Field.java,Java,,296,55,664,1015
GenericArrayType.java,Java,,4,3,28,35
GenericDeclaration.java,Java,,4,2,25,31
GenericSignatureFormatError.java,Java,,2,3,13,18
InvocationHandler.java,Java,,5,3,70,78
InvocationTargetException.java,Java,,22,8,63,93
MalformedParameterizedTypeException.java,Java,,2,3,14,19
Member.java,Java,,10,8,57,75
Method.java,Java,,327,46,378,751
Modifier.java,Java,,89,34,216,339
ParameterizedType.java,Java,,6,6,66,78
Proxy.java,Java,,176,38,432,646
ReflectAccess.java,Java,,98,17,13,128
ReflectPermission.java,Java,,11,6,72,89
Type.java,Java,,3,3,13,19
TypeVariable.java,Java,,6,5,61,72
UndeclaredThrowableException.java,Java,,21,7,74,102
WildcardType.java,Java,,5,4,57,66
Runnable.java,Java,,5,2,44,51
Runtime.java,Java,,126,35,718,879
RuntimeException.java,Java,,16,6,57,79
RuntimePermission.java,Java,,16,9,312,337
SecurityException.java,Java,,16,6,45,67
SecurityManager.java,Java,,374,66,1278,1718
Short.java,Java,,121,35,301,457
Shutdown.java,Java,,142,34,68,244
StackOverflowError.java,Java,,10,3,23,36
StackTraceElement.java,Java,,59,14,139,212
StrictMath.java,Java,,130,57,931,1118
String.java,Java,,910,127,1754,2791
StringBuffer.java,Java,,240,63,327,630
StringBuilder.java,Java,,190,47,226,463
StringCoding.java,Java,,304,50,49,403
StringIndexOutOfBoundsException.java,Java,,13,4,35,52
SuppressWarnings.java,Java,,9,3,35,47
System.java,Java,,212,56,829,1097
Terminator.java,Java,,22,10,23,55
Thread.java,Java,,472,124,1200,1796
ThreadDeath.java,Java,,2,3,30,35
ThreadGroup.java,Java,,465,45,510,1020
ThreadLocal.java,Java,,287,66,322,675
Throwable.java,Java,,138,36,477,651
TypeNotPresentException.java,Java,,9,4,33,46
UnknownError.java,Java,,10,3,23,36
UnsatisfiedLinkError.java,Java,,10,3,24,37
UnsupportedClassVersionError.java,Java,,10,3,23,36
UnsupportedOperationException.java,Java,,15,6,56,77
VerifyError.java,Java,,10,3,23,36
VirtualMachineError.java,Java,,10,3,24,37
Void.java,Java,,6,4,21,31
BigDecimal.java,Java,,1203,206,2118,3527
BigInteger.java,Java,,1602,387,1181,3170
BitSieve.java,Java,,86,21,92,199
MathContext.java,Java,,102,31,205,338
MutableBigInteger.java,Java,,838,183,336,1357
RoundingMode.java,Java,,37,22,279,338
SignedMutableBigInteger.java,Java,,44,19,59,122
Authenticator.java,Java,,152,34,228,414
BindException.java,Java,,7,5,23,35
CacheRequest.java,Java,,7,5,34,46
CacheResponse.java,Java,,9,5,33,47
ConnectException.java,Java,,7,3,24,34
ContentHandler.java,Java,,14,6,72,92
ContentHandlerFactory.java,Java,,4,2,31,37
CookieHandler.java,Java,,28,7,88,123
DatagramPacket.java,Java,,103,26,238,367
DatagramSocket.java,Java,,441,59,673,1173
DatagramSocketImpl.java,Java,,37,24,163,224
DatagramSocketImplFactory.java,Java,,5,2,22,29
FileNameMap.java,Java,,4,3,20,27
HttpRetryException.java,Java,,25,9,47,81
HttpURLConnection.java,Java,,182,82,429,693
Inet4Address.java,Java,,110,29,216,355
Inet4AddressImpl.java,Java,,38,5,14,57
Inet6Address.java,Java,,309,60,375,744
Inet6AddressImpl.java,Java,,60,7,24,91
InetAddress.java,Java,,587,127,715,1429
InetAddressImpl.java,Java,,12,4,15,31
InetSocketAddress.java,Java,,119,19,165,303
JarURLConnection.java,Java,,57,25,219,301
MalformedURLException.java,Java,,9,4,24,37
MulticastSocket.java,Java,,213,47,395,655
NetPermission.java,Java,,16,8,145,169
NetworkInterface.java,Java,,174,34,124,332
NoRouteToHostException.java,Java,,7,3,24,34
PasswordAuthentication.java,Java,,15,9,41,65
PlainDatagramSocketImpl.java,Java,,198,45,119,362
PlainSocketImpl.java,Java,,435,59,187,681
PortUnreachableException.java,Java,,7,5,21,33
ProtocolException.java,Java,,10,4,23,37
Proxy.java,Java,,49,12,92,153
ProxySelector.java,Java,,33,9,104,146
ResponseCache.java,Java,,26,8,112,146
SecureCacheResponse.java,Java,,14,7,69,90
ServerSocket.java,Java,,269,39,506,814
Socket.java,Java,,537,80,926,1543
SocketAddress.java,Java,,3,2,19,24
SocketException.java,Java,,10,4,23,37
SocketImpl.java,Java,,73,33,233,339
SocketImplFactory.java,Java,,5,2,24,31
SocketInputStream.java,Java,,129,25,97,251
SocketOptions.java,Java,,20,34,264,318
SocketOutputStream.java,Java,,72,17,77,166
SocketPermission.java,Java,,701,175,503,1379
SocketTimeoutException.java,Java,,7,5,19,31
SocksConsts.java,Java,,25,6,9,40
SocksSocketImpl.java,Java,,817,35,194,1046
UnknownHostException.java,Java,,10,4,23,37
UnknownServiceException.java,Java,,9,4,26,39
URI.java,Java,,1522,283,1708,3513
URISyntaxException.java,Java,,39,11,65,115
URL.java,Java,,440,105,738,1283
URLClassLoader.java,Java,,333,36,212,581
URLConnection.java,Java,,538,135,1010,1683
URLDecoder.java,Java,,65,20,103,188
URLEncoder.java,Java,,110,19,147,276
URLStreamHandler.java,Java,,299,42,221,562
URLStreamHandlerFactory.java,Java,,4,2,28,34
Bits.java,Java,,519,138,33,690
Buffer.java,Java,,120,31,306,457
BufferOverflowException.java,Java,,6,7,19,32
BufferUnderflowException.java,Java,,6,7,19,32
ByteBuffer.java,Java,,196,490,1309,1995
ByteBufferAsCharBufferB.java,Java,,121,68,9,198
ByteBufferAsCharBufferL.java,Java,,121,68,9,198
ByteBufferAsCharBufferRB.java,Java,,81,109,8,198
ByteBufferAsCharBufferRL.java,Java,,81,109,8,198
ByteBufferAsDoubleBufferB.java,Java,,92,98,8,198
ByteBufferAsDoubleBufferL.java,Java,,92,98,8,198
ByteBufferAsDoubleBufferRB.java,Java,,52,139,7,198
ByteBufferAsDoubleBufferRL.java,Java,,52,139,7,198
ByteBufferAsFloatBufferB.java,Java,,92,98,8,198
ByteBufferAsFloatBufferL.java,Java,,92,98,8,198
ByteBufferAsFloatBufferRB.java,Java,,52,139,7,198
ByteBufferAsFloatBufferRL.java,Java,,52,139,7,198
ByteBufferAsIntBufferB.java,Java,,92,98,8,198
ByteBufferAsIntBufferL.java,Java,,92,98,8,198
ByteBufferAsIntBufferRB.java,Java,,52,139,7,198
ByteBufferAsIntBufferRL.java,Java,,52,139,7,198
ByteBufferAsLongBufferB.java,Java,,92,98,8,198
ByteBufferAsLongBufferL.java,Java,,92,98,8,198
ByteBufferAsLongBufferRB.java,Java,,52,139,7,198
ByteBufferAsLongBufferRL.java,Java,,52,139,7,198
ByteBufferAsShortBufferB.java,Java,,92,98,8,198
ByteBufferAsShortBufferL.java,Java,,92,98,8,198
ByteBufferAsShortBufferRB.java,Java,,52,139,7,198
ByteBufferAsShortBufferRL.java,Java,,52,139,7,198
ByteOrder.java,Java,,17,11,44,72
AlreadyConnectedException.java,Java,,6,7,19,32
AsynchronousCloseException.java,Java,,6,7,20,33
ByteChannel.java,Java,,6,6,16,28
CancelledKeyException.java,Java,,6,7,19,32
Channel.java,Java,,7,8,52,67
Channels.java,Java,,208,40,195,443
ClosedByInterruptException.java,Java,,6,7,21,34
ClosedChannelException.java,Java,,6,7,22,35
ClosedSelectorException.java,Java,,6,7,19,32
ConnectionPendingException.java,Java,,6,7,20,33
DatagramChannel.java,Java,,41,25,355,421
FileChannel.java,Java,,64,43,863,970
FileLock.java,Java,,51,16,177,244
FileLockInterruptionException.java,Java,,6,7,20,33
GatheringByteChannel.java,Java,,10,9,130,149
IllegalBlockingModeException.java,Java,,6,7,19,32
IllegalSelectorException.java,Java,,6,7,20,33
InterruptibleChannel.java,Java,,7,8,49,64
NoConnectionPendingException.java,Java,,6,7,20,33
NonReadableChannelException.java,Java,,6,7,19,32
NonWritableChannelException.java,Java,,6,7,19,32
NotYetBoundException.java,Java,,6,7,19,32
NotYetConnectedException.java,Java,,6,7,19,32
OverlappingFileLockException.java,Java,,6,7,21,34
Pipe.java,Java,,33,16,87,136
ReadableByteChannel.java,Java,,6,7,78,91
ScatteringByteChannel.java,Java,,10,8,127,145
SelectableChannel.java,Java,,25,17,277,319
SelectionKey.java,Java,,37,33,310,380
Selector.java,Java,,20,17,341,378
ServerSocketChannel.java,Java,,20,13,121,154
SocketChannel.java,Java,,46,25,292,363
AbstractInterruptibleChannel.java,Java,,63,18,113,194
AbstractSelectableChannel.java,Java,,139,34,105,278
AbstractSelectionKey.java,Java,,22,10,28,60
AbstractSelector.java,Java,,59,23,131,213
SelectorProvider.java,Java,,87,17,162,266
UnresolvedAddressException.java,Java,,6,7,19,32
UnsupportedAddressTypeException.java,Java,,6,7,19,32
WritableByteChannel.java,Java,,8,7,73,88
CharBuffer.java,Java,,198,179,1031,1408
CharacterCodingException.java,Java,,6,7,19,32
Charset.java,Java,,303,60,515,878
CharsetDecoder.java,Java,,214,186,545,945
CharsetEncoder.java,Java,,259,138,548,945
CoderMalfunctionError.java,Java,,8,6,21,35
CoderResult.java,Java,,97,29,141,267
CodingErrorAction.java,Java,,16,11,40,67
IllegalCharsetNameException.java,Java,,13,9,27,49
MalformedInputException.java,Java,,15,9,13,37
CharsetProvider.java,Java,,12,9,72,93
UnmappableCharacterException.java,Java,,15,9,13,37
UnsupportedCharsetException.java,Java,,13,9,27,49
DirectByteBuffer.java,Java,,614,334,24,972
DirectByteBufferR.java,Java,,339,620,13,972
DirectCharBufferRS.java,Java,,90,333,10,433
DirectCharBufferRU.java,Java,,90,333,10,433
DirectCharBufferS.java,Java,,193,223,17,433
DirectCharBufferU.java,Java,,193,223,17,433
DirectDoubleBufferRS.java,Java,,61,363,9,433
DirectDoubleBufferRU.java,Java,,61,363,9,433
DirectDoubleBufferS.java,Java,,164,253,16,433
DirectDoubleBufferU.java,Java,,164,253,16,433
DirectFloatBufferRS.java,Java,,61,363,9,433
DirectFloatBufferRU.java,Java,,61,363,9,433
DirectFloatBufferS.java,Java,,164,253,16,433
DirectFloatBufferU.java,Java,,164,253,16,433
DirectIntBufferRS.java,Java,,61,363,9,433
DirectIntBufferRU.java,Java,,61,363,9,433
DirectIntBufferS.java,Java,,164,253,16,433
DirectIntBufferU.java,Java,,164,253,16,433
DirectLongBufferRS.java,Java,,61,363,9,433
DirectLongBufferRU.java,Java,,61,363,9,433
DirectLongBufferS.java,Java,,164,253,16,433
DirectLongBufferU.java,Java,,164,253,16,433
DirectShortBufferRS.java,Java,,61,363,9,433
DirectShortBufferRU.java,Java,,61,363,9,433
DirectShortBufferS.java,Java,,164,253,16,433
DirectShortBufferU.java,Java,,164,253,16,433
DoubleBuffer.java,Java,,149,503,756,1408
FloatBuffer.java,Java,,149,503,756,1408
HeapByteBuffer.java,Java,,301,229,43,573
HeapByteBufferR.java,Java,,201,341,31,573
HeapCharBuffer.java,Java,,129,406,38,573
HeapCharBufferR.java,Java,,77,470,26,573
HeapDoubleBuffer.java,Java,,112,424,37,573
HeapDoubleBufferR.java,Java,,60,488,25,573
HeapFloatBuffer.java,Java,,112,424,37,573
HeapFloatBufferR.java,Java,,60,488,25,573
HeapIntBuffer.java,Java,,112,424,37,573
HeapIntBufferR.java,Java,,60,488,25,573
HeapLongBuffer.java,Java,,112,424,37,573
HeapLongBufferR.java,Java,,60,488,25,573
HeapShortBuffer.java,Java,,112,424,37,573
HeapShortBufferR.java,Java,,60,488,25,573
IntBuffer.java,Java,,149,503,756,1408
InvalidMarkException.java,Java,,6,7,19,32
LongBuffer.java,Java,,149,503,756,1408
MappedByteBuffer.java,Java,,43,14,95,152
ReadOnlyBufferException.java,Java,,6,7,19,32
ShortBuffer.java,Java,,149,503,756,1408
StringCharBuffer.java,Java,,66,22,8,96
AccessException.java,Java,,10,5,38,53
Activatable.java,Java,,129,22,315,466
ActivateFailedException.java,Java,,10,5,30,45
ActivationDesc.java,Java,,99,22,202,323
ActivationException.java,Java,,28,9,64,101
ActivationGroup.java,Java,,181,37,316,534
ActivationGroupDesc.java,Java,,122,33,189,344
ActivationGroupID.java,Java,,26,9,63,98
ActivationID.java,Java,,91,16,163,270
ActivationInstantiator.java,Java,,8,5,46,59
ActivationMonitor.java,Java,,15,9,68,92
ActivationSystem.java,Java,,32,14,166,212
Activator.java,Java,,9,4,83,96
UnknownGroupException.java,Java,,7,4,32,43
UnknownObjectException.java,Java,,7,4,34,45
AlreadyBoundException.java,Java,,10,4,31,45
ConnectException.java,Java,,10,5,30,45
ConnectIOException.java,Java,,10,6,31,47
DGC.java,Java,,9,4,84,97
Lease.java,Java,,19,6,34,59
VMID.java,Java,,84,18,58,160
MarshalException.java,Java,,10,5,39,54
MarshalledObject.java,Java,,107,28,157,292
Naming.java,Java,,129,22,137,288
NoSuchObjectException.java,Java,,7,4,34,45
NotBoundException.java,Java,,10,4,33,47
LocateRegistry.java,Java,,68,15,141,224
Registry.java,Java,,18,8,149,175
RegistryHandler.java,Java,,11,5,40,56
Remote.java,Java,,2,2,29,33
RemoteException.java,Java,,28,9,68,105
RMISecurityException.java,Java,,13,4,33,50
RMISecurityManager.java,Java,,6,4,37,47
ExportException.java,Java,,10,6,35,51
LoaderHandler.java,Java,,15,7,56,78
LogStream.java,Java,,118,25,105,248
ObjID.java,Java,,77,23,152,252
Operation.java,Java,,17,5,34,56
RemoteCall.java,Java,,24,10,81,115
RemoteObject.java,Java,,89,15,337,441
RemoteObjectInvocationHandler.java,Java,,131,17,122,270
RemoteRef.java,Java,,22,14,142,178
RemoteServer.java,Java,,27,8,63,98
RemoteStub.java,Java,,14,5,38,57
RMIClassLoader.java,Java,,129,27,546,702
RMIClassLoaderSpi.java,Java,,15,7,153,175
RMIClientSocketFactory.java,Java,,7,4,46,57
RMIFailureHandler.java,Java,,4,5,35,44
RMIServerSocketFactory.java,Java,,7,4,46,57
RMISocketFactory.java,Java,,52,12,107,171
ServerCloneException.java,Java,,25,8,62,95
ServerNotActiveException.java,Java,,9,5,30,44
ServerRef.java,Java,,8,6,35,49
Skeleton.java,Java,,10,3,40,53
SkeletonMismatchException.java,Java,,10,6,29,45
SkeletonNotFoundException.java,Java,,12,6,33,51
SocketSecurityException.java,Java,,10,6,29,45
UID.java,Java,,87,17,145,249
UnicastRemoteObject.java,Java,,83,18,194,295
Unreferenced.java,Java,,4,2,22,28
ServerError.java,Java,,7,4,28,39
ServerException.java,Java,,10,5,35,50
ServerRuntimeException.java,Java,,9,4,35,48
StubNotFoundException.java,Java,,10,5,35,50
UnexpectedException.java,Java,,10,5,32,47
UnknownHostException.java,Java,,10,5,30,45
UnmarshalException.java,Java,,10,5,44,59
AccessControlContext.java,Java,,237,67,191,495
AccessControlException.java,Java,,15,9,42,66
AccessController.java,Java,,45,23,362,430
Acl.java,Java,,16,28,196,240
AclEntry.java,Java,,15,15,108,138
AclNotFoundException.java,Java,,6,5,15,26
Group.java,Java,,9,9,51,69
LastOwnerException.java,Java,,6,4,17,27
NotOwnerException.java,Java,,6,4,16,26
Owner.java,Java,,9,7,61,77
Permission.java,Java,,5,6,25,36
AlgorithmParameterGenerator.java,Java,,78,18,184,280
AlgorithmParameterGeneratorSpi.java,Java,,9,7,53,69
AlgorithmParameters.java,Java,,108,21,229,358
AlgorithmParametersSpi.java,Java,,20,11,103,134
AllPermission.java,Java,,69,32,121,222
AuthProvider.java,Java,,13,7,89,109
BasicPermission.java,Java,,198,75,263,536
Certificate.java,Java,,90,24,141,255
CertificateEncodingException.java,Java,,16,7,48,71
CertificateException.java,Java,,17,8,46,71
CertificateExpiredException.java,Java,,10,5,27,42
CertificateFactory.java,Java,,101,22,345,468
CertificateFactorySpi.java,Java,,38,12,248,298
CertificateNotYetValidException.java,Java,,10,5,27,42
CertificateParsingException.java,Java,,16,7,49,72
CertPath.java,Java,,91,25,195,311
CertPathBuilder.java,Java,,69,13,148,230
CertPathBuilderException.java,Java,,17,9,61,87
CertPathBuilderResult.java,Java,,5,4,42,51
CertPathBuilderSpi.java,Java,,7,5,46,58
CertPathHelperImpl.java,Java,,39,18,20,77
CertPathParameters.java,Java,,4,3,25,32
CertPathValidator.java,Java,,71,13,158,242
CertPathValidatorException.java,Java,,38,14,108,160
CertPathValidatorResult.java,Java,,4,3,26,33
CertPathValidatorSpi.java,Java,,8,5,55,68
CertSelector.java,Java,,5,4,41,50
CertStore.java,Java,,100,15,232,347
CertStoreException.java,Java,,17,9,60,86
CertStoreParameters.java,Java,,4,3,56,63
CertStoreSpi.java,Java,,11,6,91,108
CollectionCertStoreParameters.java,Java,,33,9,82,124
CRL.java,Java,,12,8,51,71
CRLException.java,Java,,17,8,46,71
CRLSelector.java,Java,,5,4,40,49
LDAPCertStoreParameters.java,Java,,39,13,80,132
PKIXBuilderParameters.java,Java,,40,9,133,182
PKIXCertPathBuilderResult.java,Java,,28,7,67,102
PKIXCertPathChecker.java,Java,,20,9,135,164
PKIXCertPathValidatorResult.java,Java,,43,10,89,142
PKIXParameters.java,Java,,246,40,424,710
PolicyNode.java,Java,,12,10,94,116
PolicyQualifierInfo.java,Java,,46,12,98,156
TrustAnchor.java,Java,,101,17,201,319
X509Certificate.java,Java,,60,30,536,626
X509CertSelector.java,Java,,1264,106,1251,2621
X509CRL.java,Java,,82,27,309,418
X509CRLEntry.java,Java,,44,15,99,158
X509CRLSelector.java,Java,,258,37,382,677
X509Extension.java,Java,,8,8,153,169
Certificate.java,Java,,15,11,113,139
CodeSigner.java,Java,,63,15,71,149
CodeSource.java,Java,,284,63,274,621
DigestException.java,Java,,16,7,46,69
DigestInputStream.java,Java,,41,18,116,175
DigestOutputStream.java,Java,,39,16,103,158
DomainCombiner.java,Java,,5,3,86,94
GeneralSecurityException.java,Java,,16,8,47,71
Guard.java,Java,,4,4,31,39
GuardedObject.java,Java,,25,11,49,85
Identity.java,Java,,179,41,259,479
IdentityScope.java,Java,,67,26,146,239
DSAKey.java,Java,,4,3,26,33
DSAKeyPairGenerator.java,Java,,8,5,79,92
DSAParams.java,Java,,7,6,34,47
DSAPrivateKey.java,Java,,6,8,29,43
DSAPublicKey.java,Java,,6,8,29,43
ECKey.java,Java,,5,2,21,28
ECPrivateKey.java,Java,,7,3,26,36
ECPublicKey.java,Java,,7,4,27,38
RSAKey.java,Java,,5,5,22,32
RSAMultiPrimePrivateCrtKey.java,Java,,13,12,58,83
RSAPrivateCrtKey.java,Java,,11,11,46,68
RSAPrivateKey.java,Java,,7,6,20,33
RSAPublicKey.java,Java,,7,5,18,30
InvalidAlgorithmParameterException.java,Java,,17,8,55,80
InvalidKeyException.java,Java,,16,9,47,72
InvalidParameterException.java,Java,,10,6,26,42
Key.java,Java,,7,8,121,136
KeyException.java,Java,,16,8,49,73
KeyFactory.java,Java,,188,25,211,424
KeyFactorySpi.java,Java,,14,9,100,123
KeyManagementException.java,Java,,16,8,58,82
KeyPair.java,Java,,17,9,38,64
KeyPairGenerator.java,Java,,235,41,375,651
KeyPairGeneratorSpi.java,Java,,11,7,71,89
KeyRep.java,Java,,60,21,97,178
KeyStore.java,Java,,589,103,953,1645
KeyStoreException.java,Java,,16,8,49,73
KeyStoreSpi.java,Java,,189,39,345,573
MessageDigest.java,Java,,217,42,285,544
MessageDigestSpi.java,Java,,59,15,117,191
NoSuchAlgorithmException.java,Java,,16,8,48,72
NoSuchProviderException.java,Java,,10,6,25,41
Permission.java,Java,,31,23,161,215
PermissionCollection.java,Java,,30,12,134,176
Permissions.java,Java,,238,80,261,579
Policy.java,Java,,178,42,200,420
Principal.java,Java,,7,6,42,55
PrivateKey.java,Java,,4,3,32,39
PrivilegedAction.java,Java,,4,4,30,38
PrivilegedActionException.java,Java,,19,7,61,87
PrivilegedExceptionAction.java,Java,,4,5,35,44
ProtectionDomain.java,Java,,173,36,157,366
Provider.java,Java,,792,103,542,1437
ProviderException.java,Java,,16,7,49,72
PublicKey.java,Java,,4,3,29,36
SecureClassLoader.java,Java,,73,15,127,215
SecureRandom.java,Java,,139,36,367,542
SecureRandomSpi.java,Java,,7,7,38,52
Security.java,Java,,494,96,478,1068
SecurityPermission.java,Java,,16,9,260,285
Signature.java,Java,,626,96,543,1265
SignatureException.java,Java,,16,8,46,70
SignatureSpi.java,Java,,92,30,257,379
SignedObject.java,Java,,58,16,168,242
Signer.java,Java,,60,18,88,166
AlgorithmParameterSpec.java,Java,,2,3,22,27
DSAParameterSpec.java,Java,,22,9,41,72
DSAPrivateKeySpec.java,Java,,27,10,52,89
DSAPublicKeySpec.java,Java,,27,10,52,89
ECField.java,Java,,6,2,24,32
ECFieldF2m.java,Java,,91,12,121,224
ECFieldFp.java,Java,,28,8,45,81
ECGenParameterSpec.java,Java,,13,4,34,51
ECParameterSpec.java,Java,,42,8,46,96
ECPoint.java,Java,,37,10,50,97
ECPrivateKeySpec.java,Java,,22,6,36,64
ECPublicKeySpec.java,Java,,24,5,39,68
EllipticCurve.java,Java,,83,13,82,178
EncodedKeySpec.java,Java,,11,7,48,66
InvalidKeySpecException.java,Java,,17,9,51,77
InvalidParameterSpecException.java,Java,,11,7,31,49
KeySpec.java,Java,,2,3,40,45
MGF1ParameterSpec.java,Java,,22,7,61,90
PKCS8EncodedKeySpec.java,Java,,12,6,59,77
PSSParameterSpec.java,Java,,59,14,120,193
RSAKeyGenParameterSpec.java,Java,,19,10,40,69
RSAMultiPrimePrivateCrtKeySpec.java,Java,,90,13,92,195
RSAOtherPrimeInfo.java,Java,,35,10,58,103
RSAPrivateCrtKeySpec.java,Java,,44,14,68,126
RSAPrivateKeySpec.java,Java,,16,8,36,60
RSAPublicKeySpec.java,Java,,16,8,36,60
X509EncodedKeySpec.java,Java,,12,6,49,67
Timestamp.java,Java,,49,15,68,132
UnrecoverableEntryException.java,Java,,10,6,23,39
UnrecoverableKeyException.java,Java,,10,6,23,39
UnresolvedPermission.java,Java,,296,47,246,589
UnresolvedPermissionCollection.java,Java,,90,29,82,201
Array.java,Java,,16,16,257,289
BatchUpdateException.java,Java,,29,10,114,153
Blob.java,Java,,12,16,160,188
CallableStatement.java,Java,,114,97,1208,1419
Clob.java,Java,,14,17,184,215
Connection.java,Java,,57,51,768,876
DatabaseMetaData.java,Java,,247,227,2571,3045
DataTruncation.java,Java,,38,15,75,128
Date.java,Java,,71,22,137,230
Driver.java,Java,,11,12,113,136
DriverManager.java,Java,,256,73,256,585
DriverPropertyInfo.java,Java,,12,9,43,64
ParameterMetaData.java,Java,,19,20,123,162
PreparedStatement.java,Java,,57,45,545,647
Ref.java,Java,,7,10,83,100
ResultSet.java,Java,,180,177,2022,2379
ResultSetMetaData.java,Java,,27,28,195,250
Savepoint.java,Java,,5,7,32,44
SQLData.java,Java,,6,6,101,113
SQLException.java,Java,,65,14,89,168
SQLInput.java,Java,,26,31,219,276
SQLOutput.java,Java,,26,31,229,286
SQLPermission.java,Java,,11,11,83,105
SQLWarning.java,Java,,32,11,67,110
Statement.java,Java,,47,53,703,803
Struct.java,Java,,7,8,62,77
Time.java,Java,,86,23,124,233
Timestamp.java,Java,,235,37,214,486
Types.java,Java,,34,40,174,248
Annotation.java,Java,,13,8,45,66
AttributedCharacterIterator.java,Java,,54,29,139,222
AttributedString.java,Java,,716,132,237,1085
Bidi.java,Java,,370,69,200,639
BreakDictionary.java,Java,,142,37,146,325
BreakIterator.java,Java,,193,46,359,598
CharacterIterator.java,Java,,15,17,143,175
CharacterIteratorFieldDelegate.java,Java,,60,11,36,107
ChoiceFormat.java,Java,,263,40,300,603
CollationElementIterator.java,Java,,410,56,285,751
CollationKey.java,Java,,42,16,115,173
CollationRules.java,Java,,204,11,42,257
Collator.java,Java,,117,30,344,491
DateFormat.java,Java,,262,68,579,909
DateFormatSymbols.java,Java,,225,49,288,562
DecimalFormat.java,Java,,1500,232,1451,3183
DecimalFormatSymbols.java,Java,,251,72,340,663
DictionaryBasedBreakIterator.java,Java,,216,49,232,497
DigitList.java,Java,,324,61,239,624
DontCareFieldPosition.java,Java,,18,5,12,35
EntryPair.java,Java,,15,4,23,42
FieldPosition.java,Java,,96,27,163,286
Format.java,Java,,66,27,289,382
MergeCollation.java,Java,,187,32,107,326
MessageFormat.java,Java,,621,70,801,1492
NumberFormat.java,Java,,280,86,668,1034
ParseException.java,Java,,12,6,43,61
ParsePosition.java,Java,,38,12,72,122
PatternEntry.java,Java,,206,29,54,289
RBCollationTables.java,Java,,129,31,125,285
RBTableBuilder.java,Java,,339,55,207,601
RuleBasedBreakIterator.java,Java,,479,118,513,1110
RuleBasedCollator.java,Java,,260,43,469,772
SimpleDateFormat.java,Java,,1028,138,824,1990
StringCharacterIterator.java,Java,,129,26,106,261
AbstractCollection.java,Java,,125,27,312,464
AbstractList.java,Java,,335,75,457,867
AbstractMap.java,Java,,262,55,356,673
AbstractQueue.java,Java,,44,11,94,149
AbstractSequentialList.java,Java,,52,14,197,263
AbstractSet.java,Java,,46,11,99,156
ArrayList.java,Java,,224,50,319,593
Arrays.java,Java,...,1363,293,1523,3179
BitSet.java,Java,,486,121,439,1046
Calendar.java,Java,,785,190,1510,2485
Collection.java,Java,,18,23,388,429
Collections.java,Java,,1742,364,1412,3518
Comparator.java,Java,,5,4,130,139
AbstractExecutorService.java,Java,,170,21,33,224
ArrayBlockingQueue.java,Java,,443,51,200,694
AtomicBoolean.java,Java,,45,13,62,120
AtomicInteger.java,Java,,101,30,91,222
AtomicIntegerArray.java,Java,,108,20,116,244
AtomicIntegerFieldUpdater.java,Java,,141,31,120,292
AtomicLong.java,Java,,103,30,100,233
AtomicLongArray.java,Java,,108,21,112,241
AtomicLongFieldUpdater.java,Java,,222,42,118,382
AtomicMarkableReference.java,Java,,62,12,90,164
AtomicReference.java,Java,,41,14,58,113
AtomicReferenceArray.java,Java,,61,14,75,150
AtomicReferenceFieldUpdater.java,Java,,101,23,105,229
AtomicStampedReference.java,Java,,65,13,90,168
BlockingQueue.java,Java,,16,12,206,234
BrokenBarrierException.java,Java,,8,4,27,39
Callable.java,Java,,4,2,31,37
CancellationException.java,Java,,8,4,23,35
CompletionService.java,Java,,8,8,77,93
ConcurrentHashMap.java,Java,,736,137,542,1415
ConcurrentLinkedQueue.java,Java,,277,54,152,483
ConcurrentMap.java,Java,,8,7,110,125
CopyOnWriteArrayList.java,Java,,582,132,455,1169
CopyOnWriteArraySet.java,Java,,27,8,64,99
CountDownLatch.java,Java,,47,12,222,281
CyclicBarrier.java,Java,,131,22,295,448
Delayed.java,Java,,5,4,25,34
DelayQueue.java,Java,,253,31,128,412
Exchanger.java,Java,,192,29,426,647
ExecutionException.java,Java,,14,6,46,66
Executor.java,Java,,4,3,101,108
ExecutorCompletionService.java,Java,,44,14,91,149
Executors.java,Java,,311,43,306,660
ExecutorService.java,Java,,26,18,248,292
Future.java,Java,,9,10,115,134
FutureTask.java,Java,,152,30,107,289
LinkedBlockingQueue.java,Java,,478,57,206,741
AbstractQueuedSynchronizer.java,Java,,805,121,1194,2120
Condition.java,Java,,12,17,411,440
Lock.java,Java,,10,22,298,330
LockSupport.java,Java,,21,12,146,179
ReadWriteLock.java,Java,,5,3,90,98
ReentrantLock.java,Java,,174,40,517,731
ReentrantReadWriteLock.java,Java,,292,69,763,1124
PriorityBlockingQueue.java,Java,,257,38,166,461
RejectedExecutionException.java,Java,,14,6,43,63
RejectedExecutionHandler.java,Java,,4,3,27,34
ScheduledExecutorService.java,Java,,9,7,130,146
ScheduledFuture.java,Java,,3,2,15,20
ScheduledThreadPoolExecutor.java,Java,,288,51,232,571
Semaphore.java,Java,,141,34,492,667
SynchronousQueue.java,Java,,341,73,273,687
ThreadFactory.java,Java,,4,3,34,41
ThreadPoolExecutor.java,Java,,577,102,848,1527
TimeoutException.java,Java,,8,4,27,39
TimeUnit.java,Java,,76,18,138,232
ConcurrentModificationException.java,Java,,8,3,58,69
Currency.java,Java,,167,31,167,365
CurrencyData.java,Java,,36,11,0,47
Date.java,Java,,531,59,719,1309
Dictionary.java,Java,,13,9,116,138
DuplicateFormatFlagsException.java,Java,,16,7,28,51
EmptyStackException.java,Java,,6,2,19,27
Enumeration.java,Java,,5,3,56,64
EnumMap.java,Java,,380,73,247,700
EnumSet.java,Java,,134,29,246,409
EventListener.java,Java,,3,2,10,15
EventListenerProxy.java,Java,,10,4,39,53
EventObject.java,Java,,16,9,35,60
FormatFlagsConversionMismatchException.java,Java,,23,8,36,67
Formattable.java,Java,,5,4,138,147
FormattableFlags.java,Java,,7,6,45,58
Formatter.java,Java,,1702,248,2413,4363
FormatterClosedException.java,Java,,5,4,19,28
GregorianCalendar.java,Java,,1522,185,1192,2899
HashMap.java,Java,,547,108,420,1075
HashSet.java,Java,,78,26,178,282
Hashtable.java,Java,,548,113,439,1100
IdentityHashMap.java,Java,,585,100,522,1207
IllegalFormatCodePointException.java,Java,,14,8,31,53
IllegalFormatConversionException.java,Java,,21,8,38,67
IllegalFormatException.java,Java,,5,4,16,25
IllegalFormatFlagsException.java,Java,,16,7,27,50
IllegalFormatPrecisionException.java,Java,,14,7,25,46
IllegalFormatWidthException.java,Java,,14,7,24,45
InputMismatchException.java,Java,,10,3,27,40
InvalidPropertiesFormatException.java,Java,,22,8,43,73
Iterator.java,Java,,6,4,58,68
Attributes.java,Java,,257,62,320,639
JarEntry.java,Java,,32,9,69,110
JarException.java,Java,,9,3,21,33
JarFile.java,Java,,305,39,176,520
JarInputStream.java,Java,,88,16,93,197
JarOutputStream.java,Java,,58,10,62,130
JarVerifier.java,Java,,269,64,92,425
JavaUtilJarAccessImpl.java,Java,,8,3,6,17
Manifest.java,Java,,261,34,118,413
Pack200.java,Java,,91,55,579,725
JumboEnumSet.java,Java,,181,47,123,351
LinkedHashMap.java,Java,,152,38,276,466
LinkedHashSet.java,Java,,19,8,124,151
LinkedList.java,Java,,347,75,356,778
List.java,Java,,28,41,495,564
ListIterator.java,Java,,12,13,159,184
ListResourceBundle.java,Java,,39,11,106,156
Locale.java,Java,,482,112,544,1138
ConsoleHandler.java,Java,,33,10,58,101
ErrorManager.java,Java,,24,7,50,81
FileHandler.java,Java,,323,37,249,609
Filter.java,Java,,4,6,23,33
Formatter.java,Java,,36,15,91,142
Handler.java,Java,,87,22,172,281
Level.java,Java,,106,31,222,359
Logger.java,Java,,518,105,810,1433
Logging.java,Java,,59,17,27,103
LoggingMXBean.java,Java,,7,6,101,114
LoggingPermission.java,Java,,14,7,37,58
LogManager.java,Java,,585,87,395,1067
LogRecord.java,Java,,187,46,275,508
MemoryHandler.java,Java,,101,16,135,252
SimpleFormatter.java,Java,,50,9,21,80
SocketHandler.java,Java,,74,15,85,174
StreamHandler.java,Java,,123,18,130,271
XMLFormatter.java,Java,,166,27,53,246
Map.java,Java,,24,27,399,450
MissingFormatArgumentException.java,Java,,16,7,30,53
MissingFormatWidthException.java,Java,,16,7,28,51
MissingResourceException.java,Java,,17,9,54,80
NoSuchElementException.java,Java,,10,3,28,41
Observable.java,Java,,47,15,134,196
Observer.java,Java,,4,1,25,30
AbstractPreferences.java,Java,,530,106,957,1593
BackingStoreException.java,Java,,11,5,25,41
Base64.java,Java,,145,20,79,244
InvalidPreferencesFormatException.java,Java,,14,6,40,60
NodeChangeEvent.java,Java,,24,11,53,88
NodeChangeListener.java,Java,,5,4,28,37
PreferenceChangeEvent.java,Java,,30,12,66,108
PreferenceChangeListener.java,Java,,4,2,23,29
Preferences.java,Java,,162,57,1019,1238
PreferencesFactory.java,Java,,6,3,31,40
WindowsPreferences.java,Java,,700,67,327,1094
WindowsPreferencesFactory.java,Java,,9,3,22,34
XmlSupport.java,Java,,239,33,121,393
PriorityQueue.java,Java,,277,62,310,649
Properties.java,Java,,379,35,472,886
PropertyPermission.java,Java,,268,94,285,647
PropertyResourceBundle.java,Java,,22,8,90,120
Queue.java,Java,,8,7,122,137
Random.java,Java,,114,33,354,501
RandomAccess.java,Java,,3,2,44,49
ASCII.java,Java,,205,40,11,256
Matcher.java,Java,,316,69,765,1150
MatchResult.java,Java,,10,10,151,171
Pattern.java,Java,,3769,302,1593,5664
PatternSyntaxException.java,Java,,45,14,51,110
RegularEnumSet.java,Java,,132,38,113,283
ResourceBundle.java,Java,,437,64,622,1123
ResourceBundleEnumeration.java,Java,,36,7,16,59
Scanner.java,Java,,1041,159,1310,2510
Set.java,Java,,18,26,288,332
SimpleTimeZone.java,Java,,629,109,940,1678
SortedMap.java,Java,,9,8,207,224
SortedSet.java,Java,,9,8,206,223
Stack.java,Java,,34,13,71,118
StringTokenizer.java,Java,,153,27,234,414
Timer.java,Java,,231,48,401,680
TimerTask.java,Java,,27,14,100,141
TimeZone.java,Java,,332,59,396,787
TooManyListenersException.java,Java,,9,8,37,54
TreeMap.java,Java,,862,166,619,1647
TreeSet.java,Java,,115,36,345,496
UnknownFormatConversionException.java,Java,,14,7,28,49
UnknownFormatFlagsException.java,Java,,16,7,28,51
UUID.java,Java,,177,41,269,487
Vector.java,Java,,326,71,623,1020
WeakHashMap.java,Java,,496,103,355,954
XMLUtils.java,Java,,153,17,20,190
Adler32.java,Java,,31,10,35,76
CheckedInputStream.java,Java,,42,8,44,94
CheckedOutputStream.java,Java,,23,7,37,67
Checksum.java,Java,,8,5,30,43
CRC32.java,Java,,30,10,33,73
DataFormatException.java,Java,,10,3,20,33
Deflater.java,Java,,151,35,217,403
DeflaterOutputStream.java,Java,,76,15,73,164
GZIPInputStream.java,Java,,116,20,87,223
GZIPOutputStream.java,Java,,70,15,67,152
Inflater.java,Java,,121,25,193,339
InflaterInputStream.java,Java,,119,23,122,264
ZipConstants.java,Java,,43,7,31,81
ZipEntry.java,Java,,147,33,151,331
ZipException.java,Java,,11,6,24,41
ZipFile.java,Java,,471,75,182,728
ZipInputStream.java,Java,,284,22,112,418
ZipOutputStream.java,Java,,348,25,125,498
Accessible.java,Java,,4,3,26,33
AccessibleAction.java,Java,,12,9,62,83
AccessibleAttributeSequence.java,Java,,7,5,22,34
AccessibleBundle.java,Java,,56,19,63,138
AccessibleComponent.java,Java,,32,30,236,298
AccessibleContext.java,Java,,130,55,543,728
AccessibleEditableText.java,Java,,15,14,86,115
AccessibleExtendedComponent.java,Java,,6,5,45,56
AccessibleExtendedTable.java,Java,,6,5,46,57
AccessibleExtendedText.java,Java,,13,13,97,123
AccessibleHyperlink.java,Java,,14,13,96,123
AccessibleHypertext.java,Java,,9,8,46,63
AccessibleIcon.java,Java,,7,7,50,64
AccessibleKeyBinding.java,Java,,5,4,55,64
AccessibleRelation.java,Java,,65,35,251,351
AccessibleRelationSet.java,Java,,115,16,94,225
AccessibleResourceBundle.java,Java,,89,4,41,134
AccessibleRole.java,Java,,133,84,412,629
AccessibleSelection.java,Java,,10,9,78,97
AccessibleState.java,Java,,68,35,255,358
AccessibleStateSet.java,Java,,86,14,82,182
AccessibleStreamable.java,Java,,7,4,37,48
AccessibleTable.java,Java,,25,26,151,202
AccessibleTableModelChange.java,Java,,11,10,62,83
AccessibleText.java,Java,,20,19,125,164
AccessibleTextSequence.java,Java,,6,4,22,32
AccessibleValue.java,Java,,7,7,61,75
IIOReadProgressListener.java,Java,,16,12,126,154
IIOReadUpdateListener.java,Java,,34,9,189,232
IIOReadWarningListener.java,Java,,6,4,31,41
IIOWriteProgressListener.java,Java,,14,10,99,123
IIOWriteWarningListener.java,Java,,8,4,33,45
IIOException.java,Java,,11,5,40,56
IIOImage.java,Java,,88,20,197,305
IIOParam.java,Java,,152,38,469,659
IIOParamController.java,Java,,4,3,94,101
ImageIO.java,Java,,788,137,603,1528
ImageReader.java,Java,,850,147,1884,2881
ImageReadParam.java,Java,,98,24,369,491
ImageTranscoder.java,Java,,9,5,121,135
ImageTypeSpecifier.java,Java,,710,99,402,1211
ImageWriteParam.java,Java,,398,59,996,1453
ImageWriter.java,Java,,441,92,1485,2018
IIOInvalidTreeException.java,Java,,18,7,55,80
IIOMetadata.java,Java,,222,44,617,883
IIOMetadataController.java,Java,,4,3,62,69
IIOMetadataFormat.java,Java,,59,57,702,818
IIOMetadataFormatImpl.java,Java,,621,118,514,1253
IIOMetadataNode.java,Java,,545,158,307,1010
BMPImageWriteParam.java,Java,,23,11,64,98
JPEGHuffmanTable.java,Java,,156,27,102,285
JPEGImageReadParam.java,Java,,48,11,123,182
JPEGImageWriteParam.java,Java,,104,17,181,302
JPEGQTable.java,Java,,81,19,105,205
DigraphNode.java,Java,,62,20,62,144
IIORegistry.java,Java,,109,14,109,232
IIOServiceProvider.java,Java,,32,12,111,155
ImageInputStreamSpi.java,Java,,32,11,141,184
ImageOutputStreamSpi.java,Java,,33,11,139,183
ImageReaderSpi.java,Java,,78,18,297,393
ImageReaderWriterSpi.java,Java,,181,35,368,584
ImageTranscoderSpi.java,Java,,13,8,57,78
ImageWriterSpi.java,Java,,86,20,314,420
PartiallyOrderedSet.java,Java,,97,31,69,197
RegisterableService.java,Java,,5,4,38,47
ServiceRegistry.java,Java,,324,59,435,818
FileCacheImageInputStream.java,Java,,104,26,85,215
FileCacheImageOutputStream.java,Java,,112,24,86,222
FileImageInputStream.java,Java,,61,11,52,124
FileImageOutputStream.java,Java,,70,13,48,131
IIOByteBuffer.java,Java,,29,12,85,126
ImageInputStream.java,Java,,53,48,876,977
ImageInputStreamImpl.java,Java,,547,109,200,856
ImageOutputStream.java,Java,,29,26,592,647
ImageOutputStreamImpl.java,Java,,382,53,51,486
MemoryCache.java,Java,,185,37,124,346
MemoryCacheImageInputStream.java,Java,,64,20,61,145
MemoryCacheImageOutputStream.java,Java,,81,24,70,175
AndQueryExp.java,Java,,25,16,49,90
Attribute.java,Java,,35,21,44,100
AttributeChangeNotification.java,Java,,29,22,79,130
AttributeChangeNotificationFilter.java,Java,,35,18,57,110
AttributeList.java,Java,,44,17,89,150
AttributeNotFoundException.java,Java,,10,7,20,37
AttributeValueExp.java,Java,,41,20,69,130
BadAttributeValueExpException.java,Java,,11,10,26,47
BadBinaryOpValueExpException.java,Java,,14,12,31,57
BadStringOperationException.java,Java,,11,9,25,45
BetweenQueryExp.java,Java,,60,20,54,134
BinaryOpValueExp.java,Java,,94,25,54,173
BinaryRelQueryExp.java,Java,,120,27,54,201
BooleanValueExp.java,Java,,21,13,35,69
ClassAttributeValueExp.java,Java,,47,14,55,116
DefaultLoaderRepository.java,Java,,14,6,53,73
Descriptor.java,Java,,19,20,130,169
DescriptorAccess.java,Java,,6,5,54,65
DynamicMBean.java,Java,,12,12,80,104
InQueryExp.java,Java,,53,21,48,122
InstanceAlreadyExistsException.java,Java,,10,7,20,37
InstanceNotFoundException.java,Java,,10,6,20,36
IntrospectionException.java,Java,,10,6,20,36
InvalidApplicationException.java,Java,,8,8,24,40
InvalidAttributeValueException.java,Java,,10,6,20,36
JMException.java,Java,,10,7,21,38
JMRuntimeException.java,Java,,20,8,33,61
ListenerNotFoundException.java,Java,,10,7,20,37
ClassLoaderRepository.java,Java,,12,7,116,135
DefaultLoaderRepository.java,Java,,55,20,61,136
MLet.java,Java,,625,104,578,1307
MLetContent.java,Java,,62,25,180,267
MLetMBean.java,Java,,19,18,123,160
MLetObjectInputStream.java,Java,,60,21,22,103
MLetParser.java,Java,,205,34,71,310
PrivateClassLoader.java,Java,,4,3,16,23
PrivateMLet.java,Java,,18,6,60,84
MalformedObjectNameException.java,Java,,10,10,20,40
MatchQueryExp.java,Java,,85,20,55,160
MBeanAttributeInfo.java,Java,,127,29,110,266
MBeanConstructorInfo.java,Java,,74,20,75,169
MBeanException.java,Java,,19,12,40,71
MBeanFeatureInfo.java,Java,,29,14,56,99
MBeanInfo.java,Java,,202,46,238,486
MBeanNotificationInfo.java,Java,,57,19,81,157
MBeanOperationInfo.java,Java,,93,29,116,238
MBeanParameterInfo.java,Java,,36,15,51,102
MBeanPermission.java,Java,,670,95,385,1150
MBeanRegistration.java,Java,,8,9,57,74
MBeanRegistrationException.java,Java,,10,6,27,43
MBeanServer.java,Java,,115,51,1122,1288
MBeanServerBuilder.java,Java,,15,5,76,96
MBeanServerConnection.java,Java,,97,42,701,840
MBeanServerDelegate.java,Java,,105,24,81,210
MBeanServerDelegateMBean.java,Java,,10,11,49,70
MBeanServerFactory.java,Java,,185,39,331,555
MBeanServerInvocationHandler.java,Java,,120,25,145,290
MBeanServerNotification.java,Java,,14,13,48,75
MBeanServerPermission.java,Java,,165,43,141,349
MBeanTrustPermission.java,Java,,19,7,44,70
DescriptorSupport.java,Java,,761,143,457,1361
InvalidTargetObjectTypeException.java,Java,,88,21,87,196
ModelMBean.java,Java,,14,10,94,118
ModelMBeanAttributeInfo.java,Java,,276,46,218,540
ModelMBeanConstructorInfo.java,Java,,298,44,194,536
ModelMBeanInfo.java,Java,,34,33,272,339
ModelMBeanInfoSupport.java,Java,,717,107,230,1054
ModelMBeanNotificationBroadcaster.java,Java,,21,18,145,184
ModelMBeanNotificationInfo.java,Java,,192,42,204,438
ModelMBeanOperationInfo.java,Java,,311,48,208,567
RequiredModelMBean.java,Java,,1502,322,803,2627
XMLParseException.java,Java,,66,15,75,156
CounterMonitor.java,Java,,562,136,542,1240
CounterMonitorMBean.java,Java,,25,21,159,205
GaugeMonitor.java,Java,,557,119,458,1134
GaugeMonitorMBean.java,Java,,19,17,112,148
Monitor.java,Java,,283,94,377,754
MonitorMBean.java,Java,,19,17,109,145
MonitorNotification.java,Java,,39,34,170,243
MonitorSettingException.java,Java,,10,6,26,42
StringMonitor.java,Java,,335,89,304,728
StringMonitorMBean.java,Java,,16,14,94,124
NotCompliantMBeanException.java,Java,,10,8,20,38
Notification.java,Java,,138,32,207,377
NotificationBroadcaster.java,Java,,10,7,59,76
NotificationBroadcasterSupport.java,Java,,114,29,135,278
NotificationEmitter.java,Java,,7,2,38,47
NotificationFilter.java,Java,,4,4,18,26
NotificationFilterSupport.java,Java,,42,17,89,148
NotificationListener.java,Java,,5,7,23,35
NotQueryExp.java,Java,,20,14,41,75
NumericValueExp.java,Java,,127,17,80,224
ObjectInstance.java,Java,,42,17,69,128
ObjectName.java,Java,,839,170,860,1869
ArrayType.java,Java,,125,54,208,387
CompositeData.java,Java,,15,18,112,145
CompositeDataSupport.java,Java,,156,53,203,412
CompositeType.java,Java,,154,52,198,404
InvalidKeyException.java,Java,,13,12,28,53
InvalidOpenTypeException.java,Java,,13,12,26,51
KeyAlreadyExistsException.java,Java,,13,12,28,53
OpenDataException.java,Java,,14,12,28,54
OpenMBeanAttributeInfo.java,Java,,9,21,93,123
OpenMBeanAttributeInfoSupport.java,Java,,277,85,341,703
OpenMBeanConstructorInfo.java,Java,,10,18,94,122
OpenMBeanConstructorInfoSupport.java,Java,,70,34,109,213
OpenMBeanInfo.java,Java,,16,22,135,173
OpenMBeanInfoSupport.java,Java,,107,46,135,288
OpenMBeanOperationInfo.java,Java,,14,23,129,166
OpenMBeanOperationInfoSupport.java,Java,,97,46,133,276
OpenMBeanParameterInfo.java,Java,,20,29,148,197
OpenMBeanParameterInfoSupport.java,Java,,260,85,316,661
OpenType.java,Java,,93,42,164,299
SimpleType.java,Java,,160,52,177,389
TabularData.java,Java,,23,52,209,284
TabularDataSupport.java,Java,,227,141,449,817
TabularType.java,Java,,128,52,183,363
OperationsException.java,Java,,10,8,21,39
OrQueryExp.java,Java,,26,15,47,88
PersistentMBean.java,Java,,10,9,69,88
QualifiedAttributeValueExp.java,Java,,35,16,47,98
Query.java,Java,,98,45,327,470
QueryEval.java,Java,,13,10,42,65
QueryExp.java,Java,,7,8,37,52
ReflectionException.java,Java,,19,11,39,69
InvalidRelationIdException.java,Java,,10,5,21,36
InvalidRelationServiceException.java,Java,,10,5,20,35
InvalidRelationTypeException.java,Java,,10,5,24,39
InvalidRoleInfoException.java,Java,,10,5,21,36
InvalidRoleValueException.java,Java,,10,5,26,41
MBeanServerNotificationFilter.java,Java,,231,67,193,491
Relation.java,Java,,45,16,186,247
RelationException.java,Java,,11,6,21,38
RelationNotFoundException.java,Java,,10,5,21,36
RelationNotification.java,Java,,295,49,250,594
RelationService.java,Java,,2092,519,1468,4079
RelationServiceMBean.java,Java,,141,41,594,776
RelationServiceNotRegisteredException.java,Java,,10,5,21,36
RelationSupport.java,Java,,827,220,786,1833
RelationSupportMBean.java,Java,,7,4,47,58
RelationType.java,Java,,11,8,38,57
RelationTypeNotFoundException.java,Java,,10,5,21,36
RelationTypeSupport.java,Java,,243,73,206,522
Role.java,Java,,154,35,133,322
RoleInfo.java,Java,,296,52,243,591
RoleInfoNotFoundException.java,Java,,10,5,21,36
RoleList.java,Java,,86,25,109,220
RoleNotFoundException.java,Java,,10,5,21,36
RoleResult.java,Java,,118,25,98,241
RoleStatus.java,Java,,22,5,48,75
RoleUnresolved.java,Java,,163,32,145,340
RoleUnresolvedList.java,Java,,85,25,105,215
JMXAuthenticator.java,Java,,6,4,43,53
JMXConnectionNotification.java,Java,,39,13,128,180
JMXConnector.java,Java,,34,14,237,285
JMXConnectorFactory.java,Java,,221,49,234,504
JMXConnectorProvider.java,Java,,8,4,39,51
JMXConnectorServer.java,Java,,143,38,218,399
JMXConnectorServerFactory.java,Java,,102,20,190,312
JMXConnectorServerMBean.java,Java,,15,12,151,178
JMXConnectorServerProvider.java,Java,,10,4,46,60
JMXPrincipal.java,Java,,31,15,70,116
JMXProviderException.java,Java,,19,10,37,66
JMXServerErrorException.java,Java,,14,9,31,54
JMXServiceURL.java,Java,...,322,65,293,680
MBeanServerForwarder.java,Java,,6,5,37,48
NotificationResult.java,Java,,37,13,80,130
NoCallStackClassLoader.java,Java,,65,13,133,211
RMIConnection.java,Java,,197,35,846,1078
RMIConnectionImpl.java,Java,,1428,235,140,1803
RMIConnectionImpl_Stub.java,Java,,540,33,31,604
RMIConnector.java,Java,,1636,288,532,2456
RMIConnectorServer.java,Java,,427,89,323,839
RMIIIOPServerImpl.java,Java,,66,16,64,146
RMIJRMPServerImpl.java,Java,,74,18,72,164
RMIServer.java,Java,,8,4,62,74
RMIServerImpl.java,Java,,229,56,226,511
RMIServerImpl_Stub.java,Java,,49,8,6,63
SubjectDelegationPermission.java,Java,,13,7,59,79
TargetedNotification.java,Java,,26,12,78,116
RuntimeErrorException.java,Java,,19,10,37,66
RuntimeMBeanException.java,Java,,19,10,40,69
RuntimeOperationsException.java,Java,,19,11,38,68
ServiceNotFoundException.java,Java,,11,8,21,40
StandardMBean.java,Java,,318,58,463,839
StringValueExp.java,Java,,21,13,51,85
Timer.java,Java,,547,185,622,1354
TimerAlarmClockNotification.java,Java,,9,5,27,41
TimerMBean.java,Java,,37,33,290,360
TimerNotification.java,Java,,18,16,66,100
ValueExp.java,Java,,7,5,34,46
AuthenticationException.java,Java,,10,5,43,58
AuthenticationNotSupportedException.java,Java,,10,5,48,63
BinaryRefAddr.java,Java,,50,13,103,166
Binding.java,Java,,40,15,128,183
CannotProceedException.java,Java,,42,21,206,269
CommunicationException.java,Java,,10,4,35,49
CompositeName.java,Java,,125,32,456,613
CompoundName.java,Java,,127,30,451,608
ConfigurationException.java,Java,,10,4,41,55
Context.java,Java,,56,49,982,1087
ContextNotEmptyException.java,Java,,10,4,41,55
Attribute.java,Java,,26,22,275,323
AttributeInUseException.java,Java,,11,5,34,50
AttributeModificationException.java,Java,,26,12,85,123
Attributes.java,Java,,16,15,135,166
BasicAttribute.java,Java,,269,51,219,539
BasicAttributes.java,Java,,169,45,145,359
DirContext.java,Java,,77,35,910,1022
InitialDirContext.java,Java,,181,38,62,281
InvalidAttributeIdentifierException.java,Java,,11,6,32,49
InvalidAttributesException.java,Java,,11,6,38,55
InvalidAttributeValueException.java,Java,,11,6,36,53
InvalidSearchControlsException.java,Java,,11,6,33,50
InvalidSearchFilterException.java,Java,,11,6,33,50
ModificationItem.java,Java,,37,14,66,117
NoSuchAttributeException.java,Java,,11,7,31,49
SchemaViolationException.java,Java,,11,6,43,60
SearchControls.java,Java,,70,26,223,319
SearchResult.java,Java,,34,14,124,172
EventContext.java,Java,,15,12,205,232
EventDirContext.java,Java,,15,6,121,142
NamespaceChangeListener.java,Java,,6,5,63,74
NamingEvent.java,Java,,52,20,211,283
NamingExceptionEvent.java,Java,,19,9,49,77
NamingListener.java,Java,,4,2,42,48
ObjectChangeListener.java,Java,,4,3,49,56
InitialContext.java,Java,,187,48,264,499
InsufficientResourcesException.java,Java,,10,5,40,55
InterruptedNamingException.java,Java,,10,5,44,59
InvalidNameException.java,Java,,10,5,40,55
BasicControl.java,Java,,24,11,65,100
Control.java,Java,,8,7,64,79
ControlFactory.java,Java,,27,13,100,140
ExtendedRequest.java,Java,,8,7,116,131
ExtendedResponse.java,Java,,5,6,71,82
HasControls.java,Java,,5,5,43,53
InitialLdapContext.java,Java,,62,20,110,192
LdapContext.java,Java,,17,11,306,334
LdapName.java,Java,,295,55,424,774
LdapReferralException.java,Java,,22,9,114,145
ManageReferralControl.java,Java,,11,6,32,49
PagedResultsControl.java,Java,,31,14,135,180
PagedResultsResponseControl.java,Java,,28,13,74,115
Rdn.java,Java,,369,71,311,751
Rfc2253Parser.java,Java,,153,33,42,228
SortControl.java,Java,,44,17,143,204
SortKey.java,Java,,24,11,65,100
SortResponseControl.java,Java,,35,16,100,151
StartTlsRequest.java,Java,,74,29,128,231
StartTlsResponse.java,Java,,23,19,146,188
UnsolicitedNotification.java,Java,,6,5,36,47
UnsolicitedNotificationEvent.java,Java,,16,8,43,67
UnsolicitedNotificationListener.java,Java,,5,4,42,51
LimitExceededException.java,Java,,11,7,39,57
LinkException.java,Java,,63,23,201,287
LinkLoopException.java,Java,,10,5,35,50
LinkRef.java,Java,,21,7,71,99
MalformedLinkException.java,Java,,10,6,34,50
Name.java,Java,,22,20,218,260
NameAlreadyBoundException.java,Java,,10,5,41,56
NameClassPair.java,Java,,48,21,212,281
NameImpl.java,Java,,530,81,103,714
NameNotFoundException.java,Java,,10,5,33,48
NameParser.java,Java,,4,3,33,40
NamingEnumeration.java,Java,,7,5,118,130
NamingException.java,Java,,104,24,290,418
NamingSecurityException.java,Java,,10,5,39,54
NoInitialContextException.java,Java,,10,4,44,58
NoPermissionException.java,Java,,10,4,33,47
NotContextException.java,Java,,10,5,41,56
OperationNotSupportedException.java,Java,,10,5,35,50
PartialResultException.java,Java,,10,5,34,49
RefAddr.java,Java,,36,12,86,134
Reference.java,Java,,109,29,240,378
Referenceable.java,Java,,4,2,35,41
ReferralException.java,Java,,18,11,158,187
ServiceUnavailableException.java,Java,,10,5,36,51
SizeLimitExceededException.java,Java,,11,6,35,52
ContinuationContext.java,Java,,181,34,14,229
ContinuationDirContext.java,Java,,244,52,20,316
DirectoryManager.java,Java,,121,30,169,320
DirObjectFactory.java,Java,,10,4,101,115
DirStateFactory.java,Java,,20,10,141,171
InitialContextFactory.java,Java,,7,4,44,55
InitialContextFactoryBuilder.java,Java,,8,3,43,54
NamingManager.java,Java,,302,83,472,857
ObjectFactory.java,Java,,8,5,144,157
ObjectFactoryBuilder.java,Java,,8,3,47,58
Resolver.java,Java,,12,7,60,79
ResolveResult.java,Java,,63,13,108,184
StateFactory.java,Java,,8,2,111,121
StringRefAddr.java,Java,,12,5,52,69
TimeLimitExceededException.java,Java,,11,6,35,52
Attribute.java,Java,,6,6,33,45
AttributeSet.java,Java,,16,19,257,292
AttributeSetUtilities.java,Java,,259,73,228,560
DateTimeSyntax.java,Java,,27,17,84,128
DocAttribute.java,Java,,3,4,23,30
DocAttributeSet.java,Java,,5,6,82,93
EnumSyntax.java,Java,,60,23,180,263
HashAttributeSet.java,Java,,163,37,310,510
HashDocAttributeSet.java,Java,,18,10,56,84
HashPrintJobAttributeSet.java,Java,,18,9,55,82
HashPrintRequestAttributeSet.java,Java,,19,12,55,86
HashPrintServiceAttributeSet.java,Java,,19,10,55,84
IntegerSyntax.java,Java,,30,12,74,116
PrintJobAttribute.java,Java,,3,2,22,27
PrintJobAttributeSet.java,Java,,5,5,81,91
PrintRequestAttribute.java,Java,,3,4,26,33
PrintRequestAttributeSet.java,Java,,5,6,82,93
PrintServiceAttribute.java,Java,,3,2,18,23
PrintServiceAttributeSet.java,Java,,5,7,84,96
ResolutionSyntax.java,Java,,82,29,229,340
SetOfIntegerSyntax.java,Java,,265,41,234,540
Size2DSyntax.java,Java,,85,23,220,328
Chromaticity.java,Java,,31,15,95,141
ColorSupported.java,Java,,29,13,70,112
Compression.java,Java,,34,16,66,116
Copies.java,Java,,21,8,89,118
CopiesSupported.java,Java,,31,10,82,123
DateTimeAtCompleted.java,Java,,22,9,76,107
DateTimeAtCreation.java,Java,,22,8,75,105
DateTimeAtProcessing.java,Java,,22,8,76,106
Destination.java,Java,,23,9,73,105
DocumentName.java,Java,,20,9,74,103
Fidelity.java,Java,,35,13,63,111
Finishings.java,Java,,122,30,307,459
JobHoldUntil.java,Java,,22,10,103,135
JobImpressions.java,Java,,21,9,96,126
JobImpressionsCompleted.java,Java,,21,8,81,110
JobImpressionsSupported.java,Java,,27,10,75,112
JobKOctets.java,Java,,21,8,147,176
JobKOctetsProcessed.java,Java,,21,8,93,122
JobKOctetsSupported.java,Java,,27,8,75,110
JobMediaSheets.java,Java,,21,9,90,120
JobMediaSheetsCompleted.java,Java,,21,8,81,110
JobMediaSheetsSupported.java,Java,,27,8,75,110
JobMessageFromOperator.java,Java,,22,9,80,111
JobName.java,Java,,22,9,76,107
JobOriginatingUserName.java,Java,,22,9,80,111
JobPriority.java,Java,,21,8,80,109
JobPrioritySupported.java,Java,,21,11,74,106
JobSheets.java,Java,,35,14,67,116
JobState.java,Java,,52,22,145,219
JobStateReason.java,Java,,138,41,264,443
JobStateReasons.java,Java,,33,12,117,162
Media.java,Java,,24,8,73,105
MediaName.java,Java,,33,15,47,95
MediaPrintableArea.java,Java,,85,24,208,317
MediaSize.java,Java,,319,35,482,836
MediaSizeName.java,Java,,260,35,252,547
MediaTray.java,Java,,45,20,57,122
MultipleDocumentHandling.java,Java,,44,17,189,250
NumberOfDocuments.java,Java,,21,9,66,96
NumberOfInterveningJobs.java,Java,,21,8,66,95
NumberUp.java,Java,,22,9,143,174
NumberUpSupported.java,Java,,51,11,99,161
OrientationRequested.java,Java,,48,16,106,170
OutputDeviceAssigned.java,Java,,22,11,77,110
PageRanges.java,Java,,60,13,174,247
PagesPerMinute.java,Java,,21,8,67,96
PagesPerMinuteColor.java,Java,,21,8,79,108
PDLOverrideSupported.java,Java,,35,14,61,110
PresentationDirection.java,Java,,60,19,89,168
PrinterInfo.java,Java,,21,9,73,103
PrinterIsAcceptingJobs.java,Java,,35,13,62,110
PrinterLocation.java,Java,,21,9,71,101
PrinterMakeAndModel.java,Java,,22,8,70,100
PrinterMessageFromOperator.java,Java,,22,9,85,116
PrinterMoreInfo.java,Java,,22,9,74,105
PrinterMoreInfoManufacturer.java,Java,,22,9,78,109
PrinterName.java,Java,,21,9,73,103
PrinterResolution.java,Java,,24,8,101,133
PrinterState.java,Java,,43,15,66,124
PrinterStateReason.java,Java,,156,45,225,426
PrinterStateReasons.java,Java,,108,23,159,290
PrinterURI.java,Java,,22,10,66,98
PrintQuality.java,Java,,41,14,62,117
QueuedJobCount.java,Java,,21,8,64,93
ReferenceUriSchemesSupported.java,Java,,51,19,95,165
RequestingUserName.java,Java,,22,9,81,112
Severity.java,Java,,34,15,91,140
SheetCollate.java,Java,,35,13,168,216
Sides.java,Java,,40,17,147,204
SupportedValuesAttribute.java,Java,,3,3,20,26
TextSyntax.java,Java,,42,16,76,134
UnmodifiableSetException.java,Java,,8,3,22,33
URISyntax.java,Java,,31,13,60,104
AttributeException.java,Java,,6,8,34,48
CancelablePrintJob.java,Java,,4,5,50,59
Doc.java,Java,,14,11,165,190
DocFlavor.java,Java,,226,123,1067,1416
DocPrintJob.java,Java,,20,12,127,159
PrintEvent.java,Java,,10,7,19,36
PrintJobAdapter.java,Java,,15,13,59,87
PrintJobAttributeEvent.java,Java,,19,16,29,64
PrintJobAttributeListener.java,Java,,4,4,20,28
PrintJobEvent.java,Java,,22,20,65,107
PrintJobListener.java,Java,,9,15,53,77
PrintServiceAttributeEvent.java,Java,,20,15,32,67
PrintServiceAttributeListener.java,Java,,4,5,21,30
FlavorException.java,Java,,5,5,19,29
MimeType.java,Java,,389,43,197,629
MultiDoc.java,Java,,6,8,104,118
MultiDocPrintJob.java,Java,,6,6,37,49
MultiDocPrintService.java,Java,,7,7,15,29
PrintException.java,Java,,15,8,32,55
PrintService.java,Java,,37,25,407,469
PrintServiceLookup.java,Java,,250,42,174,466
ServiceUI.java,Java,,122,26,154,302
ServiceUIFactory.java,Java,,13,15,96,124
SimpleDoc.java,Java,,76,22,135,233
StreamPrintService.java,Java,,21,12,63,96
StreamPrintServiceFactory.java,Java,,98,26,87,211
URIException.java,Java,,9,10,36,55
ClassDesc.java,Java,,5,4,23,32
GetORBPropertiesFileAction.java,Java,,54,18,18,90
PortableRemoteObjectDelegate.java,Java,,17,9,42,68
Stub.java,Java,,135,44,68,247
StubDelegate.java,Java,,17,10,50,77
Tie.java,Java,,18,9,42,69
Util.java,Java,,171,51,158,380
UtilDelegate.java,Java,,28,20,72,120
ValueHandler.java,Java,,14,9,57,80
ValueHandlerMultiFormat.java,Java,,7,4,40,51
PortableRemoteObject.java,Java,,152,45,85,282
SslRMIClientSocketFactory.java,Java,,67,10,120,197
SslRMIServerSocketFactory.java,Java,,128,23,243,394
AuthPermission.java,Java,,13,5,127,145
Callback.java,Java,,2,3,30,35
CallbackHandler.java,Java,,5,3,127,135
ChoiceCallback.java,Java,,48,15,131,194
ConfirmationCallback.java,Java,,122,37,325,484
LanguageCallback.java,Java,,13,8,41,62
NameCallback.java,Java,,31,11,85,127
PasswordCallback.java,Java,,33,11,83,127
TextInputCallback.java,Java,,31,11,86,128
TextOutputCallback.java,Java,,23,9,58,90
UnsupportedCallbackException.java,Java,,16,7,41,64
Destroyable.java,Java,,5,4,36,45
DestroyFailedException.java,Java,,10,5,28,43
DelegationPermission.java,Java,,133,49,187,369
KerberosKey.java,Java,,70,24,125,219
KerberosPrincipal.java,Java,,103,43,143,289
KerberosTicket.java,Java,,272,72,286,630
KeyImpl.java,Java,,118,31,49,198
ServicePermission.java,Java,,221,93,270,584
AccountException.java,Java,,10,6,25,41
AccountExpiredException.java,Java,,10,5,31,46
AccountLockedException.java,Java,,10,5,29,44
AccountNotFoundException.java,Java,,10,5,28,43
AppConfigurationEntry.java,Java,,50,17,85,152
Configuration.java,Java,,81,14,197,292
CredentialException.java,Java,,10,5,25,40
CredentialExpiredException.java,Java,,10,5,33,48
CredentialNotFoundException.java,Java,,10,5,28,43
FailedLoginException.java,Java,,10,5,28,43
LoginContext.java,Java,,422,88,472,982
LoginException.java,Java,,10,6,25,41
Policy.java,Java,,70,14,213,297
PrivateCredentialPermission.java,Java,,230,80,236,546
Refreshable.java,Java,,5,4,36,45
RefreshFailedException.java,Java,,10,5,28,43
LoginModule.java,Java,,15,8,200,223
Subject.java,Java,,658,133,598,1389
SubjectDomainCombiner.java,Java,,358,69,150,577
X500Principal.java,Java,,115,22,252,389
X500PrivateCredential.java,Java,,41,14,62,117
AuthenticationException.java,Java,,13,5,47,65
AuthorizeCallback.java,Java,,34,14,79,127
RealmCallback.java,Java,,11,6,32,49
RealmChoiceCallback.java,Java,,9,5,30,44
Sasl.java,Java,,178,37,359,574
SaslClient.java,Java,,14,11,182,207
SaslClientFactory.java,Java,,13,4,75,92
SaslException.java,Java,,33,11,67,111
SaslServer.java,Java,,14,11,173,198
SaslServerFactory.java,Java,,12,4,73,89
ControllerEventListener.java,Java,,5,5,37,47
Instrument.java,Java,,12,15,46,73
InvalidMidiDataException.java,Java,,9,8,29,46
MetaEventListener.java,Java,,5,5,23,33
MetaMessage.java,Java,,74,36,106,216
MidiChannel.java,Java,,29,30,461,520
MidiDevice.java,Java,,48,52,262,362
MidiEvent.java,Java,,18,15,46,79
MidiFileFormat.java,Java,,59,35,193,287
MidiMessage.java,Java,,36,20,115,171
MidiSystem.java,Java,,594,158,702,1454
MidiUnavailableException.java,Java,,9,8,29,46
Patch.java,Java,,15,18,62,95
Receiver.java,Java,,5,6,46,57
Sequence.java,Java,,81,51,191,323
Sequencer.java,Java,,68,114,669,851
ShortMessage.java,Java,,129,57,215,401
Soundbank.java,Java,,11,17,88,116
SoundbankResource.java,Java,,21,27,113,161
MidiDeviceProvider.java,Java,,16,11,35,62
MidiFileReader.java,Java,,16,15,94,125
MidiFileWriter.java,Java,,30,18,70,118
SoundbankReader.java,Java,,12,15,40,67
Synthesizer.java,Java,,19,48,298,365
SysexMessage.java,Java,,47,26,113,186
Track.java,Java,,109,30,117,256
Transmitter.java,Java,,6,9,44,59
VoiceStatus.java,Java,,9,16,118,143
AudioFileFormat.java,Java,,106,61,233,400
AudioFormat.java,Java,,183,75,387,645
AudioInputStream.java,Java,,199,81,218,498
AudioPermission.java,Java,,10,11,210,231
AudioSystem.java,Java,,627,203,784,1614
BooleanControl.java,Java,,34,41,101,176
Clip.java,Java,,14,13,179,206
CompoundControl.java,Java,,33,38,53,124
Control.java,Java,,28,29,72,129
DataLine.java,Java,,107,56,317,480
EnumControl.java,Java,,43,51,104,198
FloatControl.java,Java,,87,91,300,478
Line.java,Java,,46,47,250,343
LineEvent.java,Java,,49,44,171,264
LineListener.java,Java,,4,6,42,52
LineUnavailableException.java,Java,,9,9,35,53
Mixer.java,Java,,49,38,249,336
Port.java,Java,,45,45,102,192
ReverbType.java,Java,,48,32,202,282
SourceDataLine.java,Java,,6,10,170,186
AudioFileReader.java,Java,,16,10,94,120
AudioFileWriter.java,Java,,31,22,77,130
FormatConversionProvider.java,Java,,48,34,96,178
MixerProvider.java,Java,,15,11,35,61
TargetDataLine.java,Java,,6,9,160,175
UnsupportedAudioFileException.java,Java,,9,9,33,51
ConnectionEvent.java,Java,,14,15,51,80
ConnectionEventListener.java,Java,,5,11,47,63
ConnectionPoolDataSource.java,Java,,11,17,97,125
DataSource.java,Java,,12,15,127,154
PooledConnection.java,Java,,9,9,96,114
BaseRowSet.java,Java,,551,160,2381,3092
CachedRowSet.java,Java,,52,51,1504,1607
FilteredRowSet.java,Java,,10,7,126,143
JdbcRowSet.java,Java,,17,17,238,272
Joinable.java,Java,,14,13,246,273
JoinRowSet.java,Java,,34,29,457,520
Predicate.java,Java,,8,8,130,146
RowSetMetaDataImpl.java,Java,,315,94,632,1041
RowSetWarning.java,Java,,24,11,93,128
SerialArray.java,Java,,506,183,730,1419
SerialBlob.java,Java,,124,39,243,406
SerialClob.java,Java,,167,50,281,498
SerialDatalink.java,Java,,25,13,53,91
SerialException.java,Java,,10,6,23,39
SerialJavaObject.java,Java,,60,21,74,155
SerialRef.java,Java,,58,22,77,157
SerialStruct.java,Java,,70,28,138,236
SQLInputImpl.java,Java,,267,62,428,757
SQLOutputImpl.java,Java,,154,48,343,545
SyncFactory.java,Java,,342,118,421,881
SyncFactoryException.java,Java,,10,8,25,43
SyncProvider.java,Java,,28,26,358,412
SyncProviderException.java,Java,,40,13,95,148
SyncResolver.java,Java,,16,15,323,354
TransactionalWriter.java,Java,,11,7,47,65
XmlReader.java,Java,,9,6,41,56
XmlWriter.java,Java,,9,8,39,56
WebRowSet.java,Java,,18,12,451,481
RowSet.java,Java,,76,79,786,941
RowSetEvent.java,Java,,6,9,32,47
RowSetInternal.java,Java,,9,15,66,90
RowSetListener.java,Java,,6,6,47,59
RowSetMetaData.java,Java,,21,27,174,222
RowSetReader.java,Java,,5,6,44,55
RowSetWriter.java,Java,,5,6,35,46
XAConnection.java,Java,,5,13,27,45
XADataSource.java,Java,,11,16,88,115
AbstractAction.java,Java,,110,28,131,269
AbstractActionPropertyChangeListener.java,Java,,46,10,27,83
AbstractButton.java,Java,,1330,215,1357,2902
AbstractCellEditor.java,Java,,51,15,84,150
AbstractListModel.java,Java,,60,19,125,204
AbstractSpinnerModel.java,Java,,33,18,73,124
Action.java,Java,,20,9,163,192
ActionMap.java,Java,,107,22,76,205
AncestorNotifier.java,Java,,148,31,43,222
ArrayTable.java,Java,,219,21,78,318
Autoscroller.java,Java,,75,21,58,154
AbstractBorder.java,Java,,36,10,75,121
BevelBorder.java,Java,,123,38,122,283
Border.java,Java,,11,4,58,73
CompoundBorder.java,Java,,66,16,75,157
EmptyBorder.java,Java,,38,10,52,100
EtchedBorder.java,Java,,65,22,103,190
LineBorder.java,Java,,68,17,76,161
MatteBorder.java,Java,,126,26,89,241
SoftBevelBorder.java,Java,,68,20,67,155
TitledBorder.java,Java,,389,66,193,648
BorderFactory.java,Java,,127,30,347,504
BoundedRangeModel.java,Java,,18,30,203,251
Box.java,Java,,94,32,295,421
BoxLayout.java,Java,,183,41,266,490
ButtonGroup.java,Java,,60,15,90,165
ButtonModel.java,Java,,27,25,156,208
CellEditor.java,Java,,12,10,95,117
CellRendererPane.java,Java,,83,32,97,212
AbstractColorChooserPanel.java,Java,,70,22,130,222
CenterLayout.java,Java,,41,9,12,62
ColorChooserComponentFactory.java,Java,,14,10,23,47
ColorSelectionModel.java,Java,,10,6,40,56
DefaultColorSelectionModel.java,Java,,47,16,75,138
DefaultHSBChooserPanel.java,Java,,538,124,101,763
DefaultPreviewPanel.java,Java,,161,45,22,228
DefaultRGBChooserPanel.java,Java,,146,41,79,266
DefaultSwatchChooserPanel.java,Java,,479,67,68,614
SmartGridLayout.java,Java,,108,49,16,173
SyntheticImage.java,Java,,106,10,33,149
ComboBoxEditor.java,Java,,11,8,20,39
ComboBoxModel.java,Java,,5,4,30,39
ComponentInputMap.java,Java,,43,7,50,100
DebugGraphics.java,Java,,1039,178,236,1453
DebugGraphicsFilter.java,Java,,13,5,11,29
DebugGraphicsInfo.java,Java,,35,9,12,56
DebugGraphicsObserver.java,Java,,19,6,11,36
DefaultBoundedRangeModel.java,Java,,142,50,216,408
DefaultButtonModel.java,Java,,195,58,299,552
DefaultCellEditor.java,Java,,152,43,169,364
DefaultComboBoxModel.java,Java,,98,25,51,174
DefaultDesktopManager.java,Java,,456,111,171,738
DefaultFocusManager.java,Java,,99,26,31,156
DefaultListCellRenderer.java,Java,,99,33,150,282
DefaultListModel.java,Java,,144,42,340,526
DefaultListSelectionModel.java,Java,,373,97,312,782
DefaultSingleSelectionModel.java,Java,,52,15,94,161
DelegatingDefaultFocusManager.java,Java,,109,9,26,144
DesktopManager.java,Java,,19,11,72,102
AncestorEvent.java,Java,,25,7,54,86
AncestorListener.java,Java,,10,8,36,54
CaretEvent.java,Java,,9,7,39,55
CaretListener.java,Java,,5,5,18,28
CellEditorListener.java,Java,,7,7,15,29
ChangeEvent.java,Java,,7,4,28,39
ChangeListener.java,Java,,5,5,17,27
DocumentEvent.java,Java,,28,20,118,166
DocumentListener.java,Java,,7,5,49,61
EventListenerList.java,Java,,115,18,140,273
HyperlinkEvent.java,Java,,48,20,103,171
HyperlinkListener.java,Java,,5,5,17,27
InternalFrameAdapter.java,Java,,10,8,45,63
InternalFrameEvent.java,Java,,49,18,108,175
InternalFrameListener.java,Java,,11,9,50,70
ListDataEvent.java,Java,,26,12,68,106
ListDataListener.java,Java,,7,9,37,53
ListSelectionEvent.java,Java,,29,10,59,98
ListSelectionListener.java,Java,,6,8,19,33
MenuDragMouseEvent.java,Java,,24,7,54,85
MenuDragMouseListener.java,Java,,8,5,36,49
MenuEvent.java,Java,,7,4,30,41
MenuKeyEvent.java,Java,,23,7,50,80
MenuKeyListener.java,Java,,7,7,22,36
MenuListener.java,Java,,7,5,27,39
MouseInputAdapter.java,Java,,11,7,24,42
MouseInputListener.java,Java,,5,5,13,23
PopupMenuEvent.java,Java,,7,2,28,37
PopupMenuListener.java,Java,,7,6,22,35
SwingPropertyChangeSupport.java,Java,,8,6,23,37
TableColumnModelEvent.java,Java,,15,10,45,70
TableColumnModelListener.java,Java,,12,9,22,43
TableModelEvent.java,Java,,38,18,105,161
TableModelListener.java,Java,,6,5,18,29
TreeExpansionEvent.java,Java,,12,5,41,58
TreeExpansionListener.java,Java,,7,5,22,34
TreeModelEvent.java,Java,,75,16,206,297
TreeModelListener.java,Java,,8,8,65,81
TreeSelectionEvent.java,Java,,71,14,86,171
TreeSelectionListener.java,Java,,6,3,24,33
TreeWillExpandListener.java,Java,,7,5,22,34
UndoableEditEvent.java,Java,,12,5,33,50
UndoableEditListener.java,Java,,5,5,16,26
FileFilter.java,Java,,6,4,30,40
FileSystemView.java,Java,,413,95,243,751
FileView.java,Java,,20,8,66,94
FocusManager.java,Java,,38,10,87,135
GraphicsWrapper.java,Java,,10,8,12,30
GrayFilter.java,Java,,31,9,37,77
Icon.java,Java,,9,6,26,41
ImageIcon.java,Java,,231,61,320,612
InputMap.java,Java,,116,25,73,214
InputVerifier.java,Java,,8,11,98,117
InternalFrameFocusTraversalPolicy.java,Java,,10,4,37,51
JApplet.java,Java,,132,43,282,457
JButton.java,Java,,88,31,189,308
JCheckBox.java,Java,,124,38,214,376
JCheckBoxMenuItem.java,Java,,80,24,164,268
JColorChooser.java,Java,,304,92,340,736
JComboBox.java,Java,,823,186,1297,2306
JComponent.java,Java,,2364,436,2524,5324
JDesktopPane.java,Java,,155,44,219,418
JDialog.java,Java,,249,62,595,906
JEditorPane.java,Java,,1145,166,1024,2335
JFileChooser.java,Java,,717,173,1035,1925
JFormattedTextField.java,Java,,414,88,661,1163
JFrame.java,Java,,238,58,522,818
JInternalFrame.java,Java,,823,178,1306,2307
JLabel.java,Java,,702,129,763,1594
JLayeredPane.java,Java,,308,68,384,760
JList.java,Java,,1373,294,1474,3141
JMenu.java,Java,,778,150,759,1687
JMenuBar.java,Java,,316,74,344,734
JMenuItem.java,Java,,426,80,435,941
JOptionPane.java,Java,,898,160,1463,2521
JPanel.java,Java,,63,23,141,227
JPasswordField.java,Java,,101,30,223,354
JPopupMenu.java,Java,,726,152,662,1540
JProgressBar.java,Java,,305,91,671,1067
JRadioButton.java,Java,,102,33,192,327
JRadioButtonMenuItem.java,Java,,69,21,152,242
JRootPane.java,Java,,319,79,619,1017
JScrollBar.java,Java,,306,111,481,898
JScrollPane.java,Java,,527,149,836,1512
JSeparator.java,Java,,86,25,161,272
JSlider.java,Java,,466,164,580,1210
JSpinner.java,Java,,773,205,999,1977
JSplitPane.java,Java,,403,166,658,1227
JTabbedPane.java,Java,,879,205,1003,2087
JTable.java,Java,,3488,712,3652,7852
JTextArea.java,Java,,299,53,452,804
JTextField.java,Java,,320,65,523,908
JTextPane.java,Java,,169,34,289,492
JToggleButton.java,Java,,144,48,194,386
JToolBar.java,Java,[WDW - need to add orientation from BoxLayout,392,83,417,892
JToolTip.java,Java,,77,29,151,257
JTree.java,Java,,2349,437,2094,4880
JViewport.java,Java,,843,189,783,1815
JWindow.java,Java,,145,40,371,556
KeyboardManager.java,Java,,202,48,84,334
KeyStroke.java,Java,,61,11,186,258
LayoutComparator.java,Java,,92,24,27,143
LayoutFocusTraversalPolicy.java,Java,,106,12,138,256
LegacyGlueFocusTraversalPolicy.java,Java,,147,15,21,183
ListCellRenderer.java,Java,,11,4,55,70
ListModel.java,Java,,9,7,37,53
ListSelectionModel.java,Java,,28,36,191,255
LookAndFeel.java,Java,,141,45,282,468
MenuElement.java,Java,,10,10,47,67
MenuSelectionManager.java,Java,,301,52,110,463
MultiUIDefaults.java,Java,,152,35,11,198
MutableComboBoxModel.java,Java,,7,8,41,56
OverlayLayout.java,Java,,116,26,117,259
ActionMapUIResource.java,Java,,6,4,13,23
BasicArrowButton.java,Java,,155,32,26,213
BasicBorders.java,Java,,461,86,65,612
BasicButtonListener.java,Java,,224,37,40,301
BasicButtonUI.java,Java,,255,63,71,389
BasicCheckBoxMenuItemUI.java,Java,,32,15,14,61
BasicCheckBoxUI.java,Java,,24,11,24,59
BasicColorChooserUI.java,Java,,238,52,31,321
BasicComboBoxEditor.java,Java,,71,21,42,134
BasicComboBoxRenderer.java,Java,,61,20,43,124
BasicComboBoxUI.java,Java,,1017,219,507,1743
BasicComboPopup.java,Java,,618,141,488,1247
BasicDesktopIconUI.java,Java,,197,48,40,285
BasicDesktopPaneUI.java,Java,,623,61,113,797
BasicDirectoryModel.java,Java,,278,46,42,366
BasicDragGestureRecognizer.java,Java,,72,22,31,125
BasicDropTargetListener.java,Java,,150,38,107,295
BasicEditorPaneUI.java,Java,,245,30,86,361
BasicFileChooserUI.java,Java,,973,188,161,1322
BasicFormattedTextFieldUI.java,Java,,11,3,26,40
BasicGraphicsUtils.java,Java,,184,52,53,289
BasicHTML.java,Java,,197,50,273,520
BasicIconFactory.java,Java,,151,33,22,206
BasicInternalFrameTitlePane.java,Java,,563,103,99,765
BasicInternalFrameUI.java,Java,,1212,207,200,1619
BasicLabelUI.java,Java,,300,49,60,409
BasicListUI.java,Java,,1642,304,666,2612
BasicLookAndFeel.java,Java,,1609,170,278,2057
BasicMenuBarUI.java,Java,,162,39,22,223
BasicMenuItemUI.java,Java,,844,136,201,1181
BasicMenuUI.java,Java,,419,78,119,616
BasicOptionPaneUI.java,Java,,986,167,254,1407
BasicPanelUI.java,Java,,37,10,13,60
BasicPasswordFieldUI.java,Java,,28,14,40,82
BasicPopupMenuSeparatorUI.java,Java,,27,9,13,49
BasicPopupMenuUI.java,Java,,876,132,110,1118
BasicProgressBarUI.java,Java,,652,130,413,1195
BasicRadioButtonMenuItemUI.java,Java,,33,13,13,59
BasicRadioButtonUI.java,Java,,160,39,44,243
BasicRootPaneUI.java,Java,,173,33,24,230
BasicScrollBarUI.java,Java,,1038,203,254,1495
BasicScrollPaneUI.java,Java,,667,124,156,947
BasicSeparatorUI.java,Java,,69,22,14,105
BasicSliderUI.java,Java,,1368,258,169,1795
BasicSpinnerUI.java,Java,,565,113,283,961
BasicSplitPaneDivider.java,Java,,636,146,290,1072
BasicSplitPaneUI.java,Java,,1296,281,652,2229
BasicTabbedPaneUI.java,Java,,2544,366,517,3427
BasicTableHeaderUI.java,Java,,324,75,98,497
BasicTableUI.java,Java,,1566,312,389,2267
BasicTextAreaUI.java,Java,,173,34,122,329
BasicTextFieldUI.java,Java,,196,30,168,394
BasicTextPaneUI.java,Java,,25,8,48,81
BasicTextUI.java,Java,,1277,222,1021,2520
BasicToggleButtonUI.java,Java,,99,31,28,158
BasicToolBarSeparatorUI.java,Java,,47,13,14,74
BasicToolBarUI.java,Java,,971,185,230,1386
BasicToolTipUI.java,Java,,171,31,37,239
BasicTransferable.java,Java,,154,31,80,265
BasicTreeUI.java,Java,,3061,610,876,4547
BasicViewportUI.java,Java,,32,11,13,56
CenterLayout.java,Java,,40,11,12,63
ComboPopup.java,Java,,15,11,58,84
DefaultMenuLayout.java,Java,,19,6,15,40
DragRecognitionSupport.java,Java,,95,25,47,167
LazyActionMap.java,Java,,87,17,44,148
BorderUIResource.java,Java,,152,43,33,228
ButtonUI.java,Java,,8,2,12,22
ColorChooserUI.java,Java,,6,6,13,25
ColorUIResource.java,Java,,18,7,24,49
ComboBoxUI.java,Java,,7,6,22,35
ComponentInputMapUIResource.java,Java,,8,4,13,25
ComponentUI.java,Java,,46,17,223,286
DesktopIconUI.java,Java,,3,4,12,19
DesktopPaneUI.java,Java,,3,4,12,19
DimensionUIResource.java,Java,,9,4,26,39
FileChooserUI.java,Java,,14,7,12,33
FontUIResource.java,Java,,14,5,25,44
IconUIResource.java,Java,,25,8,33,66
InputMapUIResource.java,Java,,6,4,13,23
InsetsUIResource.java,Java,,9,4,25,38
InternalFrameUI.java,Java,,3,3,12,18
LabelUI.java,Java,,3,2,12,17
ListUI.java,Java,,10,9,38,57
MenuBarUI.java,Java,,5,5,13,23
MenuItemUI.java,Java,,5,3,14,22
CachedPainter.java,Java,,169,26,89,284
DefaultMetalTheme.java,Java,,172,36,76,284
MetalBorders.java,Java,,759,167,93,1019
MetalBumps.java,Java,,168,32,29,229
MetalButtonUI.java,Java,,112,23,55,190
MetalCheckBoxIcon.java,Java,,55,14,21,90
MetalCheckBoxUI.java,Java,,37,15,31,83
MetalComboBoxButton.java,Java,,140,30,29,199
MetalComboBoxEditor.java,Java,,67,14,42,123
MetalComboBoxIcon.java,Java,,24,11,22,57
MetalComboBoxUI.java,Java,,198,39,94,331
MetalDesktopIconUI.java,Java,,87,21,19,127
MetalFileChooserUI.java,Java,,921,199,148,1268
MetalFontDesktopProperty.java,Java,,35,8,39,82
MetalHighContrastTheme.java,Java,,121,33,18,172
MetalIconFactory.java,Java,,1965,372,304,2641
MetalInternalFrameTitlePane.java,Java,,404,69,61,534
MetalInternalFrameUI.java,Java,,142,31,17,190
MetalLabelUI.java,Java,,32,12,21,65
MetalLookAndFeel.java,Java,,1276,139,284,1699
MetalMenuBarUI.java,Java,,45,6,48,99
MetalPopupMenuSeparatorUI.java,Java,,29,13,13,55
MetalProgressBarUI.java,Java,,96,25,50,171
MetalRadioButtonUI.java,Java,,135,34,40,209
MetalRootPaneUI.java,Java,,603,94,289,986
MetalScrollBarUI.java,Java,,355,151,35,541
MetalScrollButton.java,Java,,228,57,45,330
MetalScrollPaneUI.java,Java,,88,21,27,136
MetalSeparatorUI.java,Java,,45,15,22,82
MetalSliderUI.java,Java,,390,66,50,506
MetalSplitPaneDivider.java,Java,,269,41,89,399
MetalSplitPaneUI.java,Java,,13,6,27,46
MetalTabbedPaneUI.java,Java,,869,166,180,1215
MetalTextFieldUI.java,Java,,15,7,29,51
MetalTheme.java,Java,,68,21,27,116
MetalTitlePane.java,Java,,645,133,208,986
MetalToggleButtonUI.java,Java,,122,26,60,208
MetalToolBarUI.java,Java,,225,41,88,354
MetalToolTipUI.java,Java,,128,27,34,189
MetalTreeUI.java,Java,,127,40,54,221
MetalUtils.java,Java,,297,51,87,435
OceanTheme.java,Java,,237,52,141,430
MultiButtonUI.java,Java,,88,18,87,193
MultiColorChooserUI.java,Java,,88,18,87,193
MultiComboBoxUI.java,Java,,110,21,102,233
MultiDesktopIconUI.java,Java,,88,18,87,193
MultiDesktopPaneUI.java,Java,,88,18,87,193
MultiFileChooserUI.java,Java,,135,24,117,276
MultiInternalFrameUI.java,Java,,88,18,87,193
MultiLabelUI.java,Java,,88,18,87,193
MultiListUI.java,Java,,115,21,105,241
MultiLookAndFeel.java,Java,,120,16,147,283
MultiMenuBarUI.java,Java,,88,18,87,193
MultiMenuItemUI.java,Java,,89,19,90,198
MultiOptionPaneUI.java,Java,,102,20,96,218
MultiPanelUI.java,Java,,88,18,87,193
MultiPopupMenuUI.java,Java,,107,20,99,226
MultiProgressBarUI.java,Java,,88,18,87,193
MultiRootPaneUI.java,Java,,88,18,87,193
MultiScrollBarUI.java,Java,,88,18,87,193
MultiScrollPaneUI.java,Java,,88,18,87,193
MultiSeparatorUI.java,Java,,88,18,87,193
MultiSliderUI.java,Java,,88,18,87,193
MultiSpinnerUI.java,Java,,88,18,87,193
MultiSplitPaneUI.java,Java,,128,24,114,266
MultiTabbedPaneUI.java,Java,,114,21,105,240
MultiTableHeaderUI.java,Java,,88,18,87,193
MultiTableUI.java,Java,,88,18,87,193
MultiTextUI.java,Java,,173,28,141,342
MultiToolBarUI.java,Java,,88,18,87,193
MultiToolTipUI.java,Java,,88,18,87,193
MultiTreeUI.java,Java,,165,28,141,334
MultiViewportUI.java,Java,,88,18,87,193
OptionPaneUI.java,Java,,7,5,20,32
PanelUI.java,Java,,3,4,12,19
PopupMenuUI.java,Java,,14,7,26,47
ProgressBarUI.java,Java,,3,3,12,18
RootPaneUI.java,Java,,3,2,12,17
ScrollBarUI.java,Java,,3,2,12,17
ScrollPaneUI.java,Java,,3,4,12,19
SeparatorUI.java,Java,,3,4,13,20
SliderUI.java,Java,,3,3,12,18
SpinnerUI.java,Java,,3,4,13,20
SplitPaneUI.java,Java,,12,8,32,52
ColorType.java,Java,,34,12,76,122
DefaultMenuLayout.java,Java,,18,7,17,42
DefaultSynthStyleFactory.java,Java,,106,24,62,192
ImagePainter.java,Java,,722,136,79,937
ParsedSynthStyle.java,Java,,765,147,15,927
Region.java,Java,,157,60,314,531
SynthArrowButton.java,Java,,61,16,12,89
SynthBorder.java,Java,,83,8,31,122
SynthButtonUI.java,Java,,295,53,40,388
SynthCheckBoxMenuItemUI.java,Java,,42,10,15,67
SynthCheckBoxUI.java,Java,,22,8,15,45
SynthColorChooserUI.java,Java,,92,25,13,130
SynthComboBoxUI.java,Java,,242,51,41,334
SynthComboPopup.java,Java,,29,5,19,53
SynthConstants.java,Java,,11,3,40,54
SynthContext.java,Java,,97,27,64,188
SynthDefaultLookup.java,Java,,17,2,12,31
SynthDesktopIconUI.java,Java,,139,25,13,177
SynthDesktopPaneUI.java,Java,,353,54,27,434
SynthEditorPaneUI.java,Java,,91,22,34,147
SynthFormattedTextFieldUI.java,Java,,21,5,25,51
SynthGraphicsUtils.java,Java,,215,39,155,409
SynthInternalFrameTitlePane.java,Java,,267,49,23,339
SynthInternalFrameUI.java,Java,,137,32,16,185
SynthLabelUI.java,Java,,138,30,20,188
SynthListUI.java,Java,,136,33,12,181
SynthLookAndFeel.java,Java,,403,48,231,682
SynthMenuBarUI.java,Java,,95,21,12,128
SynthMenuItemUI.java,Java,,450,89,64,603
SynthMenuUI.java,Java,,160,38,15,213
SynthOptionPaneUI.java,Java,,139,36,23,198
SynthPainter.java,Java,,458,116,1325,1899
SynthPanelUI.java,Java,,84,25,13,122
SynthParser.java,Java,,967,90,114,1171
SynthPasswordFieldUI.java,Java,,34,9,35,78
SynthPopupMenuUI.java,Java,,120,33,42,195
SynthProgressBarUI.java,Java,,182,33,20,235
SynthRadioButtonMenuItemUI.java,Java,,41,7,13,61
SynthRadioButtonUI.java,Java,,26,8,18,52
SynthRootPaneUI.java,Java,,74,19,17,110
SynthScrollBarUI.java,Java,,218,48,31,297
SynthScrollPaneUI.java,Java,,136,40,12,188
SynthSeparatorUI.java,Java,,122,31,14,167
SynthSliderUI.java,Java,,583,119,47,749
SynthSpinnerUI.java,Java,,219,65,132,416
SynthSplitPaneDivider.java,Java,,95,17,21,133
SynthSplitPaneUI.java,Java,,195,50,52,297
SynthStyle.java,Java,,715,54,178,947
SynthStyleFactory.java,Java,,10,3,48,61
SynthTabbedPaneUI.java,Java,,417,80,34,531
SynthTableHeaderUI.java,Java,,119,29,19,167
SynthTableUI.java,Java,,445,74,78,597
SynthTextAreaUI.java,Java,,75,22,40,137
SynthTextFieldUI.java,Java,,134,37,49,220
SynthTextPaneUI.java,Java,,70,17,58,145
SynthToggleButtonUI.java,Java,,23,6,15,44
SynthToolBarUI.java,Java,,246,54,21,321
SynthToolTipUI.java,Java,,123,27,15,165
SynthTreeUI.java,Java,,512,89,26,627
SynthViewportUI.java,Java,,92,25,17,134
TabbedPaneUI.java,Java,,8,3,13,24
TableHeaderUI.java,Java,,3,2,12,17
TableUI.java,Java,,3,2,12,17
TextUI.java,Java,,28,11,107,146
ToolBarUI.java,Java,,5,5,12,22
ToolTipUI.java,Java,,3,2,12,17
TreeUI.java,Java,,18,12,58,88
UIResource.java,Java,,3,4,43,50
ViewportUI.java,Java,,3,4,12,19
Popup.java,Java,,95,28,107,230
PopupFactory.java,Java,,547,117,246,910
ProgressMonitor.java,Java,,462,100,472,1034
ProgressMonitorInputStream.java,Java,,73,25,73,171
Renderer.java,Java,,6,3,25,34
RepaintManager.java,Java,,421,95,239,755
RootPaneContainer.java,Java,,13,18,132,163
Scrollable.java,Java,,11,11,90,112
ScrollPaneConstants.java,Java,,25,8,68,101
ScrollPaneLayout.java,Java,,518,138,412,1068
SingleSelectionModel.java,Java,,10,8,42,60
SizeRequirements.java,Java,,175,27,267,469
SizeSequence.java,Java,,126,22,221,369
SortingFocusTraversalPolicy.java,Java,,315,67,211,593
SpinnerDateModel.java,Java,,110,33,304,447
SpinnerListModel.java,Java,,73,28,130,231
SpinnerModel.java,Java,,12,14,96,122
SpinnerNumberModel.java,Java,,118,39,277,434
Spring.java,Java,,280,84,289,653
SpringLayout.java,Java,,375,74,561,1010
SwingConstants.java,Java,,22,8,91,121
SwingUtilities.java,Java,,1068,161,641,1870
SystemEventQueueUtilities.java,Java,,445,86,275,806
AbstractTableModel.java,Java,,74,24,226,324
DefaultTableCellRenderer.java,Java,,111,37,179,327
DefaultTableColumnModel.java,Java,,287,74,390,751
DefaultTableModel.java,Java,,214,55,411,680
JTableHeader.java,Java,,790,155,510,1455
TableCellEditor.java,Java,,9,7,40,56
TableCellRenderer.java,Java,,8,5,38,51
TableColumn.java,Java,,227,76,479,782
TableColumnModel.java,Java,,27,26,171,224
TableModel.java,Java,,15,13,99,127
TablePrintable.java,Java,,207,93,199,499
AbstractDocument.java,Java,,1301,302,1524,3127
AbstractWriter.java,Java,,329,54,313,696
AsyncBoxView.java,Java,,649,109,642,1400
AttributeSet.java,Java,,23,18,121,162
BadLocationException.java,Java,,12,3,33,48
BoxView.java,Java,,561,84,519,1164
Caret.java,Java,,24,21,140,185
ChangedCharSetException.java,Java,,16,7,13,36
ComponentView.java,Java,,234,37,205,476
CompositeView.java,Java,,321,47,408,776
DateFormatter.java,Java,,64,17,62,143
DefaultCaret.java,Java,,972,146,738,1856
DefaultEditorKit.java,Java,,1078,211,903,2192
DefaultFormatter.java,Java,,371,77,293,741
DefaultFormatterFactory.java,Java,,84,22,190,296
DefaultHighlighter.java,Java,,368,52,194,614
DefaultStyledDocument.java,Java,,1479,202,809,2490
DefaultTextUI.java,Java,,5,5,15,25
Document.java,Java,,23,23,413,459
DocumentFilter.java,Java,,26,8,123,157
EditorKit.java,Java,,34,16,141,191
Element.java,Java,,13,14,96,123
ElementIterator.java,Java,,167,42,155,364
FieldView.java,Java,,149,19,126,294
FlowView.java,Java,,377,64,382,823
GapContent.java,Java,,545,96,298,939
GapVector.java,Java,,120,33,131,284
GlyphPainter1.java,Java,,120,23,90,233
GlyphPainter2.java,Java,,211,26,127,364
GlyphView.java,Java,,665,97,548,1310
Highlighter.java,Java,,22,20,94,136
AccessibleHTML.java,Java,,1551,296,1194,3041
BlockView.java,Java,,206,32,189,427
BRView.java,Java,,14,4,22,40
CommentView.java,Java,,92,13,19,124
CSS.java,Java,,2128,327,787,3242
CSSParser.java,Java,,583,77,177,837
EditableView.java,Java,,66,11,30,107
FormSubmitEvent.java,Java,,21,9,44,74
FormView.java,Java,,594,85,327,1006
FrameSetView.java,Java,,178,32,96,306
FrameView.java,Java,,260,46,117,423
HiddenTagView.java,Java,,254,39,51,344
HRuleView.java,Java,,177,27,96,300
HTML.java,Java,,398,46,214,658
HTMLDocument.java,Java,,2049,295,1377,3721
HTMLEditorKit.java,Java,,1257,158,764,2179
HTMLFrameHyperlinkEvent.java,Java,,30,11,55,96
HTMLWriter.java,Java,,813,103,330,1246
ImageView.java,Java,,652,99,286,1037
InlineView.java,Java,,176,20,132,328
IsindexView.java,Java,,51,15,31,97
LineView.java,Java,,63,11,95,169
ListView.java,Java,,53,8,44,105
Map.java,Java,,348,48,92,488
MinimalHTMLWriter.java,Java,,348,82,279,709
MuxingAttributeSet.java,Java,,148,28,118,294
NoFramesView.java,Java,,57,15,84,156
ObjectView.java,Java,,75,11,80,166
Option.java,Java,,38,12,46,96
OptionComboBoxModel.java,Java,,13,7,26,46
OptionListModel.java,Java,,305,74,177,556
ParagraphView.java,Java,,151,22,113,286
AttributeList.java,Java,,83,19,53,155
ContentModel.java,Java,,144,26,68,238
ContentModelState.java,Java,,173,27,78,278
DocumentParser.java,Java,,152,19,93,264
DTD.java,Java,,254,33,151,438
DTDConstants.java,Java,,39,6,20,65
Element.java,Java,,79,22,57,158
Entity.java,Java,,53,15,55,123
Parser.java,Java,,1489,235,488,2212
ParserDelegator.java,Java,,62,15,28,105
ResourceLoader.java,Java,,16,7,20,43
TagElement.java,Java,,33,15,13,61
TagStack.java,Java,,123,29,53,205
ResourceLoader.java,Java,,16,7,20,43
StyleSheet.java,Java,,2092,225,1012,3329
TableView.java,Java,,1032,167,587,1786
TextAreaDocument.java,Java,,20,12,23,55
IconView.java,Java,,56,12,84,152
InternationalFormatter.java,Java,,567,95,421,1083
JTextComponent.java,Java,,1882,324,1662,3868
Keymap.java,Java,,18,16,94,128
LabelView.java,Java,,96,25,173,294
LayeredHighlighter.java,Java,,14,4,28,46
LayoutQueue.java,Java,,67,14,35,116
MaskFormatter.java,Java,,469,86,443,998
MutableAttributeSet.java,Java,,10,20,51,81
NavigationFilter.java,Java,,22,8,99,129
NumberFormatter.java,Java,,285,45,158,488
ParagraphView.java,Java,,612,73,436,1121
PasswordView.java,Java,,112,12,94,218
PlainDocument.java,Java,,172,16,119,307
PlainView.java,Java,,370,45,268,683
Position.java,Java,,15,8,39,62
AbstractFilter.java,Java,,108,27,78,213
Constants.java,Java,,28,10,22,60
MockAttributeSet.java,Java,,78,22,8,108
RTFAttribute.java,Java,,26,7,16,49
RTFAttributes.java,Java,,324,64,16,404
RTFEditorKit.java,Java,,43,13,82,138
RTFGenerator.java,Java,,764,130,97,991
RTFParser.java,Java,,228,35,53,316
RTFReader.java,Java,,1121,228,282,1631
Segment.java,Java,,96,27,126,249
SegmentCache.java,Java,,39,15,56,110
SimpleAttributeSet.java,Java,,200,35,153,388
StateInvariantError.java,Java,,7,2,19,28
StringContent.java,Java,,264,40,177,481
Style.java,Java,,11,10,37,58
StyleConstants.java,Java,,282,100,453,835
StyleContext.java,Java,,715,147,744,1606
StyledDocument.java,Java,,17,16,127,160
StyledEditorKit.java,Java,,397,76,405,878
TabableView.java,Java,,5,4,44,53
TabExpander.java,Java,,4,4,22,30
TableView.java,Java,,427,75,394,896
TabSet.java,Java,,103,17,75,195
TabStop.java,Java,,76,15,70,161
TextAction.java,Java,,45,6,69,120
TextLayoutStrategy.java,Java,,288,51,183,522
Utilities.java,Java,,667,52,308,1027
View.java,Java,,378,66,914,1358
ViewFactory.java,Java,,5,4,22,31
WrappedPlainView.java,Java,,386,57,315,758
ZoneView.java,Java,,247,49,338,634
Timer.java,Java,,139,65,337,541
TimerQueue.java,Java,,170,60,40,270
ToolTipManager.java,Java,,548,82,224,854
TransferHandler.java,Java,,449,101,330,880
AbstractLayoutCache.java,Java,,140,56,318,514
DefaultMutableTreeNode.java,Java,,646,227,617,1490
DefaultTreeCellEditor.java,Java,,362,88,287,737
DefaultTreeCellRenderer.java,Java,,251,71,253,575
DefaultTreeModel.java,Java,,263,57,341,661
DefaultTreeSelectionModel.java,Java,,702,118,393,1213
ExpandVetoException.java,Java,,12,6,28,46
FixedHeightLayoutCache.java,Java,,964,185,435,1584
MutableTreeNode.java,Java,,10,8,38,56
RowMapper.java,Java,,6,3,20,29
TreeCellEditor.java,Java,,10,4,34,48
TreeCellRenderer.java,Java,,8,4,31,43
TreeModel.java,Java,,13,15,108,136
TreeNode.java,Java,,12,10,46,68
TreePath.java,Java,,138,33,147,318
TreeSelectionModel.java,Java,,36,33,225,294
VariableHeightLayoutCache.java,Java,,1046,191,513,1750
UIDefaults.java,Java,,446,101,619,1166
UIManager.java,Java,,571,134,564,1269
AbstractUndoableEdit.java,Java,,73,24,165,262
CannotRedoException.java,Java,,3,2,21,26
CannotUndoException.java,Java,,3,3,21,27
CompoundEdit.java,Java,,110,21,114,245
StateEdit.java,Java,,59,27,90,176
StateEditable.java,Java,,7,8,21,36
UndoableEdit.java,Java,,15,14,90,119
UndoableEditSupport.java,Java,,70,17,75,162
UndoManager.java,Java,,210,44,209,463
UnsupportedLookAndFeelException.java,Java,,7,1,26,34
ViewportLayout.java,Java,,82,20,84,186
WindowConstants.java,Java,,8,7,52,67
DatatypeConfigurationException.java,Java,,15,11,39,65
DatatypeConstants.java,Java,,55,47,156,258
DatatypeFactory.java,Java,,234,55,636,925
Duration.java,Java,,187,54,724,965
FactoryFinder.java,Java,,199,57,139,395
SecuritySupport.java,Java,,65,10,13,88
XMLGregorianCalendar.java,Java,,104,59,874,1037
NamespaceContext.java,Java,,7,8,229,244
QName.java,Java,,122,28,315,465
DocumentBuilder.java,Java,,84,42,189,315
DocumentBuilderFactory.java,Java,,106,53,391,550
FactoryConfigurationError.java,Java,,30,21,59,110
FactoryFinder.java,Java,,165,35,102,302
ParserConfigurationException.java,Java,,9,9,23,41
SAXParser.java,Java,,158,42,319,519
SAXParserFactory.java,Java,,78,33,310,421
SecuritySupport.java,Java,,65,10,13,88
DOMLocator.java,Java,,6,7,20,33
DOMResult.java,Java,,84,31,226,341
DOMSource.java,Java,,29,14,79,122
ErrorListener.java,Java,,9,5,84,98
FactoryFinder.java,Java,,165,35,102,302
OutputKeys.java,Java,,15,12,153,180
Result.java,Java,,9,7,54,70
SAXResult.java,Java,,34,17,77,128
SAXSource.java,Java,,59,23,113,195
SAXTransformerFactory.java,Java,,22,13,99,134
TemplatesHandler.java,Java,,8,7,37,52
TransformerHandler.java,Java,,13,8,39,60
SecuritySupport.java,Java,,65,10,13,88
Source.java,Java,,5,4,27,36
SourceLocator.java,Java,,7,5,65,77
StreamResult.java,Java,,65,23,119,207
StreamSource.java,Java,,68,26,176,270
Templates.java,Java,,6,7,50,63
Transformer.java,Java,,28,20,263,311
TransformerConfigurationException.java,Java,,24,7,52,83
TransformerException.java,Java,,164,60,129,353
TransformerFactory.java,Java,,37,22,271,330
TransformerFactoryConfigurationError.java,Java,,30,19,54,103
URIResolver.java,Java,,5,2,24,31
Schema.java,Java,,7,6,69,82
SchemaFactory.java,Java,,67,29,539,635
SchemaFactoryFinder.java,Java,,221,46,124,391
SchemaFactoryLoader.java,Java,,6,5,35,46
SecuritySupport.java,Java,,117,13,13,143
TypeInfoProvider.java,Java,,10,9,153,172
Validator.java,Java,,38,19,356,413
ValidatorHandler.java,Java,,37,17,387,441
XMLConstants.java,Java,,21,17,140,178
SecuritySupport.java,Java,,116,13,13,142
XPath.java,Java,,26,16,248,290
XPathConstants.java,Java,,11,11,47,69
XPathException.java,Java,,40,14,36,90
XPathExpression.java,Java,,13,8,155,176
XPathExpressionException.java,Java,,10,6,36,52
XPathFactory.java,Java,,53,24,182,259
XPathFactoryConfigurationException.java,Java,,10,6,36,52
XPathFactoryFinder.java,Java,,222,45,98,365
XPathFunction.java,Java,,6,5,31,42
XPathFunctionException.java,Java,,10,6,36,52
XPathFunctionResolver.java,Java,,5,4,42,51
XPathVariableResolver.java,Java,,5,4,33,42
java.c,C/C++/ObjC,,1223,156,402,1781
java.h,h,,35,16,31,82
java_md.c,C/C++/ObjC,,531,83,259,873
java_md.h,h,,28,8,17,53
ChannelBinding.java,Java,,63,23,109,195
GSSContext.java,Java,,62,45,1223,1330
GSSCredential.java,Java,,21,24,309,354
GSSException.java,Java,,108,60,218,386
GSSManager.java,Java,,38,19,655,712
GSSName.java,Java,,27,19,231,277
MessageProp.java,Java,,67,21,130,218
Oid.java,Java,,83,23,93,199
ACTIVITY_COMPLETED.java,Java,,18,7,44,69
ACTIVITY_REQUIRED.java,Java,,18,7,42,67
Any.java,Java,,81,58,565,704
AnyHolder.java,Java,,21,9,60,90
AnySeqHelper.java,Java,,46,10,27,83
AnySeqHolder.java,Java,,24,9,15,48
ARG_IN.java,Java,,4,4,29,37
ARG_INOUT.java,Java,,4,7,30,41
ARG_OUT.java,Java,,4,6,29,39
BAD_CONTEXT.java,Java,,15,7,47,69
BAD_INV_ORDER.java,Java,,15,8,45,68
BAD_OPERATION.java,Java,,15,7,43,65
BAD_PARAM.java,Java,,15,7,52,74
BAD_POLICY.java,Java,,4,2,16,22
BAD_POLICY_TYPE.java,Java,,4,2,16,22
BAD_POLICY_VALUE.java,Java,,4,2,18,24
BAD_QOS.java,Java,,18,7,41,66
BAD_TYPECODE.java,Java,,15,7,44,66
BooleanHolder.java,Java,,21,9,62,92
BooleanSeqHelper.java,Java,,44,10,27,81
BooleanSeqHolder.java,Java,,24,9,15,48
Bounds.java,Java,,9,5,22,36
ByteHolder.java,Java,,21,10,62,93
CharHolder.java,Java,,21,10,63,94
CharSeqHelper.java,Java,,44,10,27,81
CharSeqHolder.java,Java,,24,9,15,48
CODESET_INCOMPATIBLE.java,Java,,18,7,40,65
COMM_FAILURE.java,Java,,15,7,51,73
CompletionStatus.java,Java,,27,13,85,125
CompletionStatusHelper.java,Java,,37,10,14,61
Context.java,Java,,11,19,198,228
ContextList.java,Java,,7,12,70,89
CTX_RESTRICT_SCOPE.java,Java,,4,4,28,36
Current.java,Java,,4,3,23,30
CurrentHelper.java,Java,,43,11,15,69
CurrentHolder.java,Java,,24,8,15,47
CurrentOperations.java,Java,,4,3,16,23
CustomMarshal.java,Java,,7,3,29,39
DataInputStream.java,Java,,36,34,258,328
DataOutputStream.java,Java,,36,34,196,266
DATA_CONVERSION.java,Java,,15,7,46,68
DefinitionKind.java,Java,,114,113,256,483
DefinitionKindHelper.java,Java,,37,10,15,62
DomainManager.java,Java,,5,4,17,26
DomainManagerOperations.java,Java,,5,4,23,32
DoubleHolder.java,Java,,21,12,59,92
DoubleSeqHelper.java,Java,,44,10,27,81
DoubleSeqHolder.java,Java,,24,9,15,48
DynamicImplementation.java,Java,,12,5,12,29
DynAny.java,Java,,90,66,557,713
Invalid.java,Java,,10,5,18,33
InvalidSeq.java,Java,,10,5,19,34
InvalidValue.java,Java,,10,4,22,36
TypeMismatch.java,Java,,10,5,19,34
DynArray.java,Java,,8,5,25,38
DynEnum.java,Java,,9,6,31,46
DynFixed.java,Java,,8,4,27,39
DynSequence.java,Java,,10,7,38,55
DynStruct.java,Java,,10,6,36,52
DynUnion.java,Java,,13,10,53,76
DynValue.java,Java,,9,6,40,55
Environment.java,Java,,6,10,28,44
ExceptionList.java,Java,,9,11,73,93
FieldNameHelper.java,Java,,40,10,14,64
FixedHolder.java,Java,,21,11,49,81
FloatHolder.java,Java,,21,9,58,88
FloatSeqHelper.java,Java,,44,10,27,81
FloatSeqHolder.java,Java,,24,9,15,48
FREE_MEM.java,Java,,15,6,43,64
IdentifierHelper.java,Java,,40,10,15,65
IDLType.java,Java,,4,6,24,34
IDLTypeHelper.java,Java,,51,11,15,77
IDLTypeOperations.java,Java,,5,4,31,40
IMP_LIMIT.java,Java,,15,7,46,68
INITIALIZE.java,Java,,15,6,49,70
INTERNAL.java,Java,,15,6,49,70
INTF_REPOS.java,Java,,15,6,42,63
IntHolder.java,Java,,21,9,65,95
INVALID_ACTIVITY.java,Java,,18,7,43,68
INVALID_TRANSACTION.java,Java,,15,6,44,65
INV_FLAG.java,Java,,15,6,44,65
INV_IDENT.java,Java,,15,6,45,66
INV_OBJREF.java,Java,,15,6,51,72
INV_POLICY.java,Java,,15,6,42,63
IRObject.java,Java,,5,2,17,24
IRObjectOperations.java,Java,,6,6,53,65
LocalObject.java,Java,,89,39,361,489
LongHolder.java,Java,,21,10,60,91
LongLongSeqHelper.java,Java,,44,10,27,81
LongLongSeqHolder.java,Java,,24,9,15,48
LongSeqHelper.java,Java,,44,10,27,81
LongSeqHolder.java,Java,,24,9,15,48
MARSHAL.java,Java,,15,6,49,70
NamedValue.java,Java,,6,10,92,108
NameValuePair.java,Java,,10,8,27,45
NameValuePairHelper.java,Java,,67,10,14,91
NO_IMPLEMENT.java,Java,,15,6,48,69
NO_MEMORY.java,Java,,15,7,41,63
NO_PERMISSION.java,Java,,15,6,41,62
NO_RESOURCES.java,Java,,15,6,42,63
NO_RESPONSE.java,Java,,15,6,42,63
NVList.java,Java,,9,16,136,161
Object.java,Java,,25,35,204,264
ObjectHelper.java,Java,,37,11,19,67
ObjectHolder.java,Java,,21,9,64,94
OBJECT_NOT_EXIST.java,Java,,15,6,51,72
OBJ_ADAPTER.java,Java,,15,6,46,67
OctetSeqHelper.java,Java,,44,10,27,81
OctetSeqHolder.java,Java,,24,9,15,48
OMGVMCID.java,Java,,4,5,16,25
ORB.java,Java,,302,103,902,1307
InconsistentTypeCode.java,Java,,10,4,20,34
InvalidName.java,Java,,9,4,23,36
ParameterMode.java,Java,,29,8,14,51
ParameterModeHelper.java,Java,,37,11,14,62
ParameterModeHolder.java,Java,,24,9,14,47
PERSIST_STORE.java,Java,,15,6,41,62
Policy.java,Java,,4,3,22,29
PolicyError.java,Java,,15,7,31,53
PolicyErrorCodeHelper.java,Java,,40,11,11,62
PolicyErrorHelper.java,Java,,62,11,12,85
PolicyErrorHolder.java,Java,,24,9,10,43
PolicyHelper.java,Java,,51,11,15,77
PolicyHolder.java,Java,,24,8,15,47
PolicyListHelper.java,Java,,46,10,15,71
PolicyListHolder.java,Java,,24,9,15,48
PolicyOperations.java,Java,,7,6,41,54
PolicyTypeHelper.java,Java,,40,11,16,67
ApplicationException.java,Java,,16,6,24,46
BoxedValueHelper.java,Java,,7,2,14,23
CustomValue.java,Java,,4,5,20,29
Delegate.java,Java,,84,30,277,391
IDLEntity.java,Java,,3,3,13,19
IndirectionException.java,Java,,9,4,39,52
InputStream.java,Java,,68,12,223,303
InvokeHandler.java,Java,,6,4,45,55
ObjectImpl.java,Java,,155,38,324,517
OutputStream.java,Java,,66,11,193,270
RemarshalException.java,Java,,6,2,20,28
ResponseHandler.java,Java,,5,3,28,36
ServantObject.java,Java,,5,4,22,31
Streamable.java,Java,,7,4,32,43
StreamableValue.java,Java,,3,5,17,25
UnknownException.java,Java,,8,1,33,42
ValueBase.java,Java,,4,2,29,35
ValueFactory.java,Java,,5,3,33,41
ValueInputStream.java,Java,,5,5,24,34
ValueOutputStream.java,Java,,5,3,23,31
Principal.java,Java,,12,4,24,40
PrincipalHolder.java,Java,,22,10,44,76
PRIVATE_MEMBER.java,Java,,4,2,23,29
PUBLIC_MEMBER.java,Java,,4,2,24,30
REBIND.java,Java,,18,7,44,69
RepositoryIdHelper.java,Java,,40,10,16,66
Request.java,Java,,25,50,209,284
ServerRequest.java,Java,,39,19,239,297
ServiceDetail.java,Java,,11,5,35,51
ServiceDetailHelper.java,Java,,50,6,11,67
ServiceInformation.java,Java,,13,7,24,44
ServiceInformationHelper.java,Java,,58,7,11,76
ServiceInformationHolder.java,Java,,20,10,63,93
SetOverrideType.java,Java,,25,11,69,105
SetOverrideTypeHelper.java,Java,,37,10,14,61
ShortHolder.java,Java,,21,9,63,93
ShortSeqHelper.java,Java,,44,10,27,81
ShortSeqHolder.java,Java,,24,9,15,48
StringHolder.java,Java,,21,9,62,92
StringSeqHelper.java,Java,,46,11,7,64
StringSeqHolder.java,Java,,24,10,7,41
StringValueHelper.java,Java,,73,14,35,122
StructMember.java,Java,,12,8,51,71
StructMemberHelper.java,Java,,74,10,15,99
SystemException.java,Java,,45,11,45,101
TCKind.java,Java,,149,79,310,538
TIMEOUT.java,Java,,18,7,41,66
TRANSACTION_MODE.java,Java,,15,6,44,65
TRANSACTION_REQUIRED.java,Java,,15,6,41,62
TRANSACTION_ROLLEDBACK.java,Java,,15,6,45,66
TRANSACTION_UNAVAILABLE.java,Java,,16,6,44,66
TRANSIENT.java,Java,,15,6,44,65
TypeCode.java,Java,,29,39,448,516
TypeCodeHolder.java,Java,,21,9,63,93
BadKind.java,Java,,9,4,25,38
Bounds.java,Java,,9,5,24,38
ULongLongSeqHelper.java,Java,,44,10,27,81
ULongLongSeqHolder.java,Java,,24,9,15,48
ULongSeqHelper.java,Java,,44,10,27,81
ULongSeqHolder.java,Java,,24,9,15,48
UnionMember.java,Java,,14,9,54,77
UnionMemberHelper.java,Java,,81,10,15,106
UNKNOWN.java,Java,,15,6,50,71
UnknownUserException.java,Java,,11,7,31,49
UnknownUserExceptionHelper.java,Java,,61,10,17,88
UnknownUserExceptionHolder.java,Java,,24,8,15,47
UNSUPPORTED_POLICY.java,Java,,4,2,17,23
UNSUPPORTED_POLICY_VALUE.java,Java,,4,2,18,24
UserException.java,Java,,9,5,27,41
UShortSeqHelper.java,Java,,44,10,27,81
UShortSeqHolder.java,Java,,24,9,15,48
ValueBaseHelper.java,Java,,37,12,22,71
ValueBaseHolder.java,Java,,21,10,58,89
ValueMember.java,Java,,20,12,71,103
ValueMemberHelper.java,Java,,106,10,15,131
VersionSpecHelper.java,Java,,40,10,15,65
VisibilityHelper.java,Java,,40,11,16,67
VM_ABSTRACT.java,Java,,4,2,16,22
VM_CUSTOM.java,Java,,4,2,16,22
VM_NONE.java,Java,,4,4,19,27
VM_TRUNCATABLE.java,Java,,4,2,18,24
WCharSeqHelper.java,Java,,44,10,27,81
WCharSeqHolder.java,Java,,24,9,15,48
WrongTransaction.java,Java,,9,4,25,38
WrongTransactionHelper.java,Java,,54,9,17,80
WrongTransactionHolder.java,Java,,24,8,15,47
WStringSeqHelper.java,Java,,46,11,7,64
WStringSeqHolder.java,Java,,24,10,7,41
WStringValueHelper.java,Java,,73,16,38,127
_IDLTypeStub.java,Java,,90,13,32,135
_PolicyStub.java,Java,,89,14,43,146
ORB.java,Java,,23,13,37,73
Delegate.java,Java,,6,4,29,39
InputStream.java,Java,,24,11,61,96
ObjectImpl.java,Java,,10,6,28,44
OutputStream.java,Java,,18,9,49,76
Binding.java,Java,,14,7,7,28
BindingHelper.java,Java,,68,10,6,84
BindingHolder.java,Java,,24,8,6,38
BindingIterator.java,Java,,4,4,14,22
BindingIteratorHelper.java,Java,,67,13,14,94
BindingIteratorHolder.java,Java,,24,9,14,47
BindingIteratorOperations.java,Java,,7,7,30,44
BindingIteratorPOA.java,Java,,70,21,32,123
BindingListHelper.java,Java,,46,11,9,66
BindingListHolder.java,Java,,24,10,9,43
BindingType.java,Java,,27,8,10,45
BindingTypeHelper.java,Java,,37,11,10,58
BindingTypeHolder.java,Java,,24,9,10,43
IstringHelper.java,Java,,40,10,6,56
NameComponent.java,Java,,14,6,6,26
NameComponentHelper.java,Java,,68,10,6,84
NameComponentHolder.java,Java,,24,8,6,38
NameHelper.java,Java,,46,11,9,66
NameHolder.java,Java,,24,10,9,43
NamingContext.java,Java,,4,4,15,23
NamingContextExt.java,Java,,4,4,19,27
NamingContextExtHelper.java,Java,,67,13,19,99
NamingContextExtHolder.java,Java,,24,9,19,52
NamingContextExtOperations.java,Java,,8,8,67,83
AddressHelper.java,Java,,40,11,9,60
InvalidAddress.java,Java,,12,7,6,25
InvalidAddressHelper.java,Java,,54,10,8,72
InvalidAddressHolder.java,Java,,24,8,6,38
StringNameHelper.java,Java,,40,11,10,61
URLStringHelper.java,Java,,40,11,10,61
NamingContextExtPOA.java,Java,,294,43,230,567
NamingContextHelper.java,Java,,67,13,15,95
NamingContextHolder.java,Java,,24,9,15,48
NamingContextOperations.java,Java,,14,14,176,204
AlreadyBound.java,Java,,12,7,6,25
AlreadyBoundHelper.java,Java,,54,10,8,72
AlreadyBoundHolder.java,Java,,24,8,6,38
CannotProceed.java,Java,,22,8,6,36
CannotProceedHelper.java,Java,,70,10,8,88
CannotProceedHolder.java,Java,,24,8,6,38
InvalidName.java,Java,,12,7,6,25
InvalidNameHelper.java,Java,,54,10,8,72
InvalidNameHolder.java,Java,,24,8,6,38
NotEmpty.java,Java,,12,7,6,25
NotEmptyHelper.java,Java,,54,10,8,72
NotEmptyHolder.java,Java,,24,8,6,38
NotFound.java,Java,,22,8,6,36
NotFoundHelper.java,Java,,70,10,8,88
NotFoundHolder.java,Java,,24,8,6,38
NotFoundReason.java,Java,,29,8,9,46
NotFoundReasonHelper.java,Java,,37,11,9,57
NotFoundReasonHolder.java,Java,,24,9,9,42
NamingContextPOA.java,Java,,223,35,178,436
_BindingIteratorImplBase.java,Java,,71,3,16,90
_BindingIteratorStub.java,Java,,82,14,31,127
_NamingContextExtStub.java,Java,,367,36,229,632
_NamingContextImplBase.java,Java,,370,3,16,389
_NamingContextStub.java,Java,,271,28,177,476
Parameter.java,Java,,14,6,6,26
AnySeqHelper.java,Java,,46,10,6,62
DynAny.java,Java,,4,4,73,81
DynAnyFactory.java,Java,,4,4,27,35
DynAnyFactoryHelper.java,Java,,67,13,27,107
DynAnyFactoryOperations.java,Java,,6,6,68,80
InconsistentTypeCode.java,Java,,12,7,6,25
InconsistentTypeCodeHelper.java,Java,,54,10,8,72
DynAnyHelper.java,Java,,67,13,73,153
DynAnyOperations.java,Java,,54,54,461,569
InvalidValue.java,Java,,12,7,6,25
InvalidValueHelper.java,Java,,54,10,8,72
TypeMismatch.java,Java,,12,7,6,25
TypeMismatchHelper.java,Java,,54,10,8,72
DynAnySeqHelper.java,Java,,46,10,6,62
DynArray.java,Java,,4,4,11,19
DynArrayHelper.java,Java,,67,13,11,91
DynArrayOperations.java,Java,,8,8,29,45
DynEnum.java,Java,,4,4,10,18
DynEnumHelper.java,Java,,67,13,10,90
DynEnumOperations.java,Java,,8,8,30,46
DynFixed.java,Java,,4,4,11,19
DynFixedHelper.java,Java,,67,13,11,91
DynFixedOperations.java,Java,,6,6,26,38
DynSequence.java,Java,,4,4,9,17
DynSequenceHelper.java,Java,,67,13,9,89
DynSequenceOperations.java,Java,,10,10,57,77
DynStruct.java,Java,,4,4,10,18
DynStructHelper.java,Java,,67,13,10,90
DynStructOperations.java,Java,,10,10,66,86
DynUnion.java,Java,,4,4,16,24
DynUnionHelper.java,Java,,67,13,16,96
DynUnionOperations.java,Java,,13,13,75,101
DynValue.java,Java,,4,4,18,26
DynValueBox.java,Java,,4,4,13,21
DynValueBoxOperations.java,Java,,8,8,37,53
DynValueCommon.java,Java,,4,4,9,17
DynValueCommonOperations.java,Java,,7,7,20,34
DynValueHelper.java,Java,,67,13,18,98
DynValueOperations.java,Java,,10,10,80,100
FieldNameHelper.java,Java,,40,10,6,56
NameDynAnyPair.java,Java,,14,8,12,34
NameDynAnyPairHelper.java,Java,,67,10,6,83
NameDynAnyPairSeqHelper.java,Java,,46,10,6,62
NameValuePair.java,Java,,14,8,12,34
NameValuePairHelper.java,Java,,67,10,6,83
NameValuePairSeqHelper.java,Java,,46,10,6,62
_DynAnyFactoryStub.java,Java,,47,15,69,131
_DynAnyStub.java,Java,,527,159,462,1148
_DynArrayStub.java,Java,,568,171,418,1157
_DynEnumStub.java,Java,,568,171,419,1158
_DynFixedStub.java,Java,,548,165,415,1128
_DynSequenceStub.java,Java,,588,177,446,1211
_DynStructStub.java,Java,,588,177,455,1220
_DynUnionStub.java,Java,,618,186,464,1268
_DynValueStub.java,Java,,619,186,480,1285
Codec.java,Java,,4,4,17,25
CodecFactory.java,Java,,4,4,11,19
CodecFactoryHelper.java,Java,,55,13,11,79
CodecFactoryOperations.java,Java,,5,5,19,29
UnknownEncoding.java,Java,,12,7,6,25
UnknownEncodingHelper.java,Java,,54,10,8,72
CodecOperations.java,Java,,8,8,61,77
FormatMismatch.java,Java,,12,7,6,25
FormatMismatchHelper.java,Java,,54,10,8,72
InvalidTypeForEncoding.java,Java,,12,7,6,25
InvalidTypeForEncodingHelper.java,Java,,54,10,8,72
TypeMismatch.java,Java,,12,7,6,25
TypeMismatchHelper.java,Java,,54,10,8,72
CodeSets.java,Java,,5,4,11,20
ComponentIdHelper.java,Java,,40,11,10,61
Encoding.java,Java,,16,9,15,40
ENCODING_CDR_ENCAPS.java,Java,,5,4,10,19
ExceptionDetailMessage.java,Java,,5,4,26,35
IOR.java,Java,,14,8,11,33
IORHelper.java,Java,,72,10,6,88
IORHolder.java,Java,,24,8,6,38
MultipleComponentProfileHelper.java,Java,,46,11,7,64
MultipleComponentProfileHolder.java,Java,,24,10,7,41
ProfileIdHelper.java,Java,,40,11,7,58
RMICustomMaxStreamFormat.java,Java,,5,4,13,22
ServiceContext.java,Java,,14,8,8,30
ServiceContextHelper.java,Java,,71,10,6,87
ServiceContextHolder.java,Java,,24,8,6,38
ServiceContextListHelper.java,Java,,46,11,7,64
ServiceContextListHolder.java,Java,,24,10,7,41
ServiceIdHelper.java,Java,,40,11,7,58
TaggedComponent.java,Java,,14,8,8,30
TaggedComponentHelper.java,Java,,71,10,6,87
TaggedComponentHolder.java,Java,,24,8,6,38
TaggedProfile.java,Java,,14,8,8,30
TaggedProfileHelper.java,Java,,71,10,6,87
TaggedProfileHolder.java,Java,,24,8,6,38
TAG_ALTERNATE_IIOP_ADDRESS.java,Java,,5,4,32,41
TAG_CODE_SETS.java,Java,,5,4,16,25
TAG_INTERNET_IOP.java,Java,,5,4,31,40
TAG_JAVA_CODEBASE.java,Java,,5,4,19,28
TAG_MULTIPLE_COMPONENTS.java,Java,,5,4,17,26
TAG_ORB_TYPE.java,Java,,5,4,24,33
TAG_POLICIES.java,Java,,5,4,10,19
TAG_RMI_CUSTOM_MAX_STREAM_FORMAT.java,Java,,5,4,15,24
TransactionService.java,Java,,5,4,11,20
SyncScopeHelper.java,Java,,40,11,7,58
SYNC_WITH_TRANSPORT.java,Java,,5,4,10,19
ACTIVE.java,Java,,5,4,8,17
AdapterManagerIdHelper.java,Java,,40,11,12,63
AdapterNameHelper.java,Java,,42,11,9,62
AdapterStateHelper.java,Java,,40,11,9,60
ClientRequestInfo.java,Java,,4,4,220,228
ClientRequestInfoOperations.java,Java,,13,13,319,345
ClientRequestInterceptor.java,Java,,4,4,22,30
ClientRequestInterceptorOperations.java,Java,,9,9,175,193
Current.java,Java,,4,4,23,31
CurrentHelper.java,Java,,55,13,23,91
CurrentOperations.java,Java,,6,6,52,64
DISCARDING.java,Java,,5,4,8,17
ForwardRequest.java,Java,,19,9,9,37
ForwardRequestHelper.java,Java,,61,10,8,79
HOLDING.java,Java,,5,4,9,18
INACTIVE.java,Java,,5,4,9,18
Interceptor.java,Java,,4,4,9,17
InterceptorOperations.java,Java,,6,6,38,50
InvalidSlot.java,Java,,12,7,6,25
InvalidSlotHelper.java,Java,,54,10,8,72
IORInfo.java,Java,,4,4,14,22
IORInfoOperations.java,Java,,12,12,82,106
IORInterceptor.java,Java,,4,4,20,28
IORInterceptorOperations.java,Java,,5,5,40,50
IORInterceptor_3_0.java,Java,,4,3,6,13
IORInterceptor_3_0Helper.java,Java,,55,12,6,73
IORInterceptor_3_0Holder.java,Java,,24,8,6,38
IORInterceptor_3_0Operations.java,Java,,7,6,34,47
LOCATION_FORWARD.java,Java,,5,4,15,24
NON_EXISTENT.java,Java,,5,4,8,17
ObjectIdHelper.java,Java,,42,11,9,62
ObjectReferenceFactory.java,Java,,5,6,13,24
ObjectReferenceFactoryHelper.java,Java,,52,13,9,74
ObjectReferenceFactoryHolder.java,Java,,24,9,9,42
ObjectReferenceTemplate.java,Java,,7,7,13,27
ObjectReferenceTemplateHelper.java,Java,,52,13,13,78
ObjectReferenceTemplateHolder.java,Java,,24,9,13,46
ObjectReferenceTemplateSeqHelper.java,Java,,46,11,9,66
ObjectReferenceTemplateSeqHolder.java,Java,,24,10,9,43
ORBIdHelper.java,Java,,40,11,7,58
ORBInitializer.java,Java,,4,4,116,124
ORBInitializerOperations.java,Java,,6,6,144,156
ORBInitInfo.java,Java,,4,4,19,27
ORBInitInfoOperations.java,Java,,14,14,106,134
DuplicateName.java,Java,,19,9,9,37
DuplicateNameHelper.java,Java,,61,10,8,79
InvalidName.java,Java,,12,7,6,25
InvalidNameHelper.java,Java,,54,10,8,72
ObjectIdHelper.java,Java,,40,11,7,58
PolicyFactory.java,Java,,4,4,19,27
PolicyFactoryOperations.java,Java,,5,5,40,50
RequestInfo.java,Java,,4,4,21,29
RequestInfoOperations.java,Java,,18,18,256,292
ServerIdHelper.java,Java,,40,11,7,58
ServerRequestInfo.java,Java,,4,4,218,226
ServerRequestInfoOperations.java,Java,,15,15,306,336
ServerRequestInterceptor.java,Java,,4,4,22,30
ServerRequestInterceptorOperations.java,Java,,9,9,180,198
SUCCESSFUL.java,Java,,5,4,15,24
SYSTEM_EXCEPTION.java,Java,,5,4,15,24
TRANSPORT_RETRY.java,Java,,5,4,15,24
UNKNOWN.java,Java,,5,4,9,18
USER_EXCEPTION.java,Java,,5,4,15,24
AdapterActivator.java,Java,,4,4,13,21
AdapterActivatorOperations.java,Java,,5,5,26,36
Current.java,Java,,4,4,24,32
CurrentHelper.java,Java,,52,13,30,95
CurrentOperations.java,Java,,6,6,44,56
NoContext.java,Java,,12,7,6,25
NoContextHelper.java,Java,,54,10,8,72
DynamicImplementation.java,Java,,4,2,19,25
ForwardRequest.java,Java,,19,8,6,33
ForwardRequestHelper.java,Java,,61,10,8,79
IdAssignmentPolicy.java,Java,,4,4,11,19
IdAssignmentPolicyOperations.java,Java,,5,5,14,24
IdAssignmentPolicyValue.java,Java,,27,8,15,50
IdUniquenessPolicy.java,Java,,4,4,11,19
IdUniquenessPolicyOperations.java,Java,,5,5,14,24
IdUniquenessPolicyValue.java,Java,,27,8,13,48
ID_ASSIGNMENT_POLICY_ID.java,Java,,5,4,9,18
ID_UNIQUENESS_POLICY_ID.java,Java,,5,4,9,18
ImplicitActivationPolicy.java,Java,,4,4,10,18
ImplicitActivationPolicyOperations.java,Java,,5,5,13,23
ImplicitActivationPolicyValue.java,Java,,27,8,15,50
IMPLICIT_ACTIVATION_POLICY_ID.java,Java,,5,4,9,18
LifespanPolicy.java,Java,,4,4,11,19
LifespanPolicyOperations.java,Java,,5,5,14,24
LifespanPolicyValue.java,Java,,27,8,14,49
LIFESPAN_POLICY_ID.java,Java,,5,4,9,18
POA.java,Java,,4,4,16,24
POAHelper.java,Java,,50,12,22,84
POAManager.java,Java,,4,4,12,20
POAManagerOperations.java,Java,,9,9,60,78
AdapterInactive.java,Java,,12,7,6,25
AdapterInactiveHelper.java,Java,,54,10,8,72
State.java,Java,,31,8,9,48
POAOperations.java,Java,,36,36,395,467
AdapterAlreadyExists.java,Java,,12,7,6,25
AdapterAlreadyExistsHelper.java,Java,,54,10,8,72
AdapterNonExistent.java,Java,,12,7,6,25
AdapterNonExistentHelper.java,Java,,54,10,8,72
InvalidPolicy.java,Java,,19,8,6,33
InvalidPolicyHelper.java,Java,,61,10,8,79
NoServant.java,Java,,12,7,6,25
NoServantHelper.java,Java,,54,10,8,72
ObjectAlreadyActive.java,Java,,12,7,6,25
ObjectAlreadyActiveHelper.java,Java,,54,10,8,72
ObjectNotActive.java,Java,,12,7,6,25
ObjectNotActiveHelper.java,Java,,54,10,8,72
ServantAlreadyActive.java,Java,,12,7,6,25
ServantAlreadyActiveHelper.java,Java,,54,10,8,72
ServantNotActive.java,Java,,12,7,6,25
ServantNotActiveHelper.java,Java,,54,10,8,72
WrongAdapter.java,Java,,12,7,6,25
WrongAdapterHelper.java,Java,,54,10,8,72
WrongPolicy.java,Java,,12,7,6,25
WrongPolicyHelper.java,Java,,54,10,8,72
Delegate.java,Java,,13,11,74,98
RequestProcessingPolicy.java,Java,,4,4,11,19
RequestProcessingPolicyOperations.java,Java,,5,5,14,24
RequestProcessingPolicyValue.java,Java,,29,8,24,61
REQUEST_PROCESSING_POLICY_ID.java,Java,,5,4,9,18
Servant.java,Java,,80,18,150,248
ServantActivator.java,Java,,4,4,10,18
ServantActivatorHelper.java,Java,,67,13,10,90
ServantActivatorOperations.java,Java,,6,6,48,60
ServantActivatorPOA.java,Java,,34,13,12,59
ServantLocator.java,Java,,4,4,24,32
ServantLocatorHelper.java,Java,,67,13,24,104
ServantLocatorOperations.java,Java,,6,6,55,67
CookieHolder.java,Java,,18,8,13,39
ServantLocatorPOA.java,Java,,34,13,26,73
ServantManager.java,Java,,4,4,17,25
ServantManagerOperations.java,Java,,4,4,17,25
ServantRetentionPolicy.java,Java,,4,4,10,18
ServantRetentionPolicyOperations.java,Java,,5,5,13,23
ServantRetentionPolicyValue.java,Java,,27,8,14,49
SERVANT_RETENTION_POLICY_ID.java,Java,,5,4,9,18
ThreadPolicy.java,Java,,4,4,11,19
ThreadPolicyOperations.java,Java,,5,5,14,24
ThreadPolicyValue.java,Java,,27,8,13,48
THREAD_POLICY_ID.java,Java,,5,4,9,18
_ServantActivatorStub.java,Java,,48,15,49,112
_ServantLocatorStub.java,Java,,48,15,56,119
RunTime.java,Java,,4,2,22,28
RunTimeOperations.java,Java,,4,2,22,28
_Remote_Stub.java,Java,,11,6,28,45
Attr.java,Java,,11,8,256,275
DOMImplementationRegistry.java,Java,,198,23,166,387
CDATASection.java,Java,,3,2,49,54
CharacterData.java,Java,,23,9,121,153
Comment.java,Java,,3,2,25,30
Counter.java,Java,,6,5,27,38
CSS2Properties.java,Java,,370,125,916,1411
CSSCharsetRule.java,Java,,7,4,37,48
CSSFontFaceRule.java,Java,,4,3,21,28
CSSImportRule.java,Java,,7,6,31,44
CSSMediaRule.java,Java,,12,7,57,76
CSSPageRule.java,Java,,8,5,28,41
CSSPrimitiveValue.java,Java,,47,12,237,296
CSSRule.java,Java,,17,8,68,93
CSSRuleList.java,Java,,5,4,34,43
CSSStyleDeclaration.java,Java,,19,12,121,152
CSSStyleRule.java,Java,,8,5,29,42
CSSStyleSheet.java,Java,,12,7,66,85
CSSUnknownRule.java,Java,,3,2,17,22
CSSValue.java,Java,,12,6,50,68
CSSValueList.java,Java,,5,4,37,46
DocumentCSS.java,Java,,7,4,39,50
DOMImplementationCSS.java,Java,,8,4,28,40
ElementCSSInlineStyle.java,Java,,4,3,25,32
Rect.java,Java,,7,6,31,44
RGBColor.java,Java,,6,5,36,47
ViewCSS.java,Java,,7,4,32,43
Document.java,Java,,53,29,732,814
DocumentFragment.java,Java,,3,2,48,53
DocumentType.java,Java,,9,8,66,83
DOMConfiguration.java,Java,,11,6,396,413
DOMError.java,Java,,12,9,66,87
DOMErrorHandler.java,Java,,4,3,38,45
DOMException.java,Java,,26,3,104,133
DOMImplementation.java,Java,,15,6,115,136
DOMImplementationList.java,Java,,5,4,34,43
DOMImplementationSource.java,Java,,5,4,49,58
DOMLocator.java,Java,,9,8,41,58
DOMStringList.java,Java,,6,5,39,50
Element.java,Java,,49,22,368,439
Entity.java,Java,,9,8,73,90
EntityReference.java,Java,,3,2,38,43
DocumentEvent.java,Java,,6,4,46,56
Event.java,Java,,18,13,110,141
EventException.java,Java,,9,3,24,36
EventListener.java,Java,,4,3,34,41
EventTarget.java,Java,,11,5,86,102
MouseEvent.java,Java,,29,14,109,152
MutationEvent.java,Java,,20,10,78,108
UIEvent.java,Java,,11,6,41,58
HTMLAnchorElement.java,Java,,29,17,66,112
HTMLAppletElement.java,Java,,25,14,64,103
HTMLAreaElement.java,Java,,19,11,49,79
HTMLBaseElement.java,Java,,7,5,22,34
HTMLBaseFontElement.java,Java,,9,6,28,43
HTMLBodyElement.java,Java,,15,9,45,69
HTMLBRElement.java,Java,,5,4,19,28
HTMLButtonElement.java,Java,,15,10,42,67
HTMLCollection.java,Java,,7,7,43,57
HTMLDirectoryElement.java,Java,,5,4,20,29
HTMLDivElement.java,Java,,5,4,19,28
HTMLDListElement.java,Java,,5,4,19,28
HTMLDocument.java,Java,,24,20,111,155
HTMLDOMImplementation.java,Java,,5,5,26,36
HTMLElement.java,Java,,14,9,43,66
HTMLFieldSetElement.java,Java,,4,4,20,28
HTMLFontElement.java,Java,,9,6,28,43
HTMLFormElement.java,Java,,19,13,55,87
HTMLFrameElement.java,Java,,21,13,52,86
HTMLFrameSetElement.java,Java,,7,5,23,35
HTMLHeadElement.java,Java,,5,4,19,28
HTMLHeadingElement.java,Java,,5,4,20,29
HTMLHRElement.java,Java,,11,7,32,50
HTMLHtmlElement.java,Java,,5,4,20,29
HTMLIFrameElement.java,Java,,25,15,59,99
HTMLImageElement.java,Java,,29,16,65,110
HTMLInputElement.java,Java,,41,25,131,197
HTMLIsIndexElement.java,Java,,6,5,24,35
HTMLLabelElement.java,Java,,8,6,28,42
HTMLLegendElement.java,Java,,8,6,29,43
HTMLLIElement.java,Java,,7,5,24,36
HTMLLinkElement.java,Java,,21,12,51,84
HTMLMapElement.java,Java,,6,5,22,33
HTMLMenuElement.java,Java,,5,4,20,29
HTMLMetaElement.java,Java,,11,7,31,49
HTMLModElement.java,Java,,7,5,24,36
HTMLObjectElement.java,Java,,40,23,97,160
HTMLOListElement.java,Java,,9,6,27,42
HTMLOptGroupElement.java,Java,,7,5,24,36
HTMLOptionElement.java,Java,,16,11,51,78
HTMLParagraphElement.java,Java,,5,4,19,28
HTMLParamElement.java,Java,,11,7,33,51
HTMLPreElement.java,Java,,5,4,19,28
HTMLQuoteElement.java,Java,,5,4,20,29
HTMLScriptElement.java,Java,,17,10,40,67
HTMLSelectElement.java,Java,,28,19,87,134
HTMLStyleElement.java,Java,,9,6,27,42
HTMLTableCaptionElement.java,Java,,5,4,19,28
HTMLTableCellElement.java,Java,,32,18,76,126
HTMLTableColElement.java,Java,,15,9,39,63
HTMLTableElement.java,Java,,40,26,123,189
HTMLTableRowElement.java,Java,,21,14,68,103
HTMLTableSectionElement.java,Java,,17,11,57,85
HTMLTextAreaElement.java,Java,,26,17,71,114
HTMLTitleElement.java,Java,,5,4,18,27
HTMLUListElement.java,Java,,7,5,23,35
DOMImplementationLS.java,Java,,12,8,102,122
LSException.java,Java,,10,3,34,47
LSInput.java,Java,,19,10,189,218
LSLoadEvent.java,Java,,7,5,23,35
LSOutput.java,Java,,11,6,89,106
LSParser.java,Java,,26,12,428,466
LSParserFilter.java,Java,,12,7,153,172
LSProgressEvent.java,Java,,7,6,35,48
LSResourceResolver.java,Java,,8,3,70,81
LSSerializer.java,Java,,19,9,408,436
LSSerializerFilter.java,Java,,5,4,54,63
NamedNodeMap.java,Java,,18,10,155,183
NameList.java,Java,,9,7,52,68
Node.java,Java,,74,38,788,900
NodeList.java,Java,,5,4,32,41
Notation.java,Java,,5,4,31,40
ProcessingInstruction.java,Java,,7,4,40,51
DocumentRange.java,Java,,4,3,26,33
Range.java,Java,,61,28,327,416
RangeException.java,Java,,10,3,26,39
DocumentStyle.java,Java,,4,3,27,34
LinkStyle.java,Java,,4,3,24,31
MediaList.java,Java,,13,8,60,81
StyleSheet.java,Java,,12,10,73,95
StyleSheetList.java,Java,,5,4,33,42
Text.java,Java,,9,6,111,126
DocumentTraversal.java,Java,,15,5,73,93
NodeFilter.java,Java,,21,6,117,144
NodeIterator.java,Java,,14,10,85,109
TreeWalker.java,Java,,19,15,145,179
TypeInfo.java,Java,,12,6,167,185
UserDataHandler.java,Java,,13,4,55,72
AbstractView.java,Java,,4,3,20,27
DocumentView.java,Java,,4,3,23,30
AttributeList.java,Java,,9,21,163,193
Attributes.java,Java,,16,34,207,257
ContentHandler.java,Java,,27,25,367,419
DocumentHandler.java,Java,,18,20,194,232
DTDHandler.java,Java,,12,8,97,117
EntityResolver.java,Java,,7,8,104,119
ErrorHandler.java,Java,,9,11,119,139
Attributes2.java,Java,,11,9,112,132
Attributes2Impl.java,Java,,122,46,133,301
DeclHandler.java,Java,,18,13,115,146
DefaultHandler2.java,Java,,55,24,51,130
EntityResolver2.java,Java,,17,6,174,197
LexicalHandler.java,Java,,20,18,174,212
Locator2.java,Java,,7,5,63,75
Locator2Impl.java,Java,,26,15,60,101
HandlerBase.java,Java,,61,42,266,369
AttributeListImpl.java,Java,,90,43,179,312
AttributesImpl.java,Java,,255,75,288,618
DefaultHandler.java,Java,,86,51,330,467
LocatorImpl.java,Java,,51,36,127,214
NamespaceSupport.java,Java,,277,93,454,824
NewInstance.java,Java,,33,7,39,79
ParserAdapter.java,Java,,451,143,452,1046
ParserFactory.java,Java,,35,13,81,129
XMLFilterImpl.java,Java,,255,106,352,713
XMLReaderAdapter.java,Java,,178,85,275,538
XMLReaderFactory.java,Java,,75,17,111,203
InputSource.java,Java,,65,36,235,336
Locator.java,Java,,7,13,116,136
Parser.java,Java,,16,19,174,209
SAXException.java,Java,,48,24,91,163
SAXNotRecognizedException.java,Java,,13,8,34,55
SAXNotSupportedException.java,Java,,13,7,35,55
SAXParseException.java,Java,,63,34,174,271
XMLFilter.java,Java,,6,8,51,65
XMLReader.java,Java,,25,40,339,404
Serializable.java,Java,,3,3,30,36
EventListener.java,Java,,3,3,30,36
EventObject.java,Java,,7,6,30,43
