/jdk1.2.2/com/sun/image/codec/jpeg/ImageFormatException.java,Java,,10,4,40,54
/jdk1.2.2/com/sun/image/codec/jpeg/JPEGCodec.java,Java,,48,13,90,151
/jdk1.2.2/com/sun/image/codec/jpeg/JPEGDecodeParam.java,Java,,62,45,264,371
/jdk1.2.2/com/sun/image/codec/jpeg/JPEGEncodeParam.java,Java,,27,20,211,258
/jdk1.2.2/com/sun/image/codec/jpeg/JPEGHuffmanTable.java,Java,,139,31,70,240
/jdk1.2.2/com/sun/image/codec/jpeg/JPEGImageDecoder.java,Java,,23,14,105,142
/jdk1.2.2/com/sun/image/codec/jpeg/JPEGImageEncoder.java,Java,,29,23,180,232
/jdk1.2.2/com/sun/image/codec/jpeg/JPEGQTable.java,Java,,62,20,70,152
/jdk1.2.2/com/sun/image/codec/jpeg/TruncatedFileException.java,Java,,19,8,57,84
/jdk1.2.2/com/sun/java/swing/plaf/motif/MotifBorders.java,Java,,427,104,70,601
/jdk1.2.2/com/sun/java/swing/plaf/motif/MotifButtonListener.java,Java,,35,10,17,62
/jdk1.2.2/com/sun/java/swing/plaf/motif/MotifButtonUI.java,Java,,54,21,35,110
/jdk1.2.2/com/sun/java/swing/plaf/motif/MotifCheckBoxMenuItemUI.java,Java,,72,25,14,111
/jdk1.2.2/com/sun/java/swing/plaf/motif/MotifCheckBoxUI.java,Java,,26,13,25,64
/jdk1.2.2/com/sun/java/swing/plaf/motif/MotifComboBoxRenderer.java,Java,,44,17,35,96
/jdk1.2.2/com/sun/java/swing/plaf/motif/MotifComboBoxUI.java,Java,,278,50,40,368
/jdk1.2.2/com/sun/java/swing/plaf/motif/MotifDesktopIconUI.java,Java,,247,52,26,325
/jdk1.2.2/com/sun/java/swing/plaf/motif/MotifDesktopPaneUI.java,Java,,103,19,26,148
/jdk1.2.2/com/sun/java/swing/plaf/motif/MotifEditorPaneUI.java,Java,,13,7,33,53
/jdk1.2.2/com/sun/java/swing/plaf/motif/MotifFileChooserUI.java,Java,,472,114,66,652
/jdk1.2.2/com/sun/java/swing/plaf/motif/MotifGraphicsUtils.java,Java,,296,57,76,429
/jdk1.2.2/com/sun/java/swing/plaf/motif/MotifIconFactory.java,Java,,348,54,36,438
/jdk1.2.2/com/sun/java/swing/plaf/motif/MotifInternalFrameTitlePane.java,Java,,312,50,19,381
/jdk1.2.2/com/sun/java/swing/plaf/motif/MotifInternalFrameUI.java,Java,,123,33,27,183
/jdk1.2.2/com/sun/java/swing/plaf/motif/MotifLabelUI.java,Java,,11,4,20,35
/jdk1.2.2/com/sun/java/swing/plaf/motif/MotifLookAndFeel.java,Java,,660,122,48,830
/jdk1.2.2/com/sun/java/swing/plaf/motif/MotifMenuBarUI.java,Java,,23,8,22,53
/jdk1.2.2/com/sun/java/swing/plaf/motif/MotifMenuItemUI.java,Java,,71,23,13,107
/jdk1.2.2/com/sun/java/swing/plaf/motif/MotifMenuMouseListener.java,Java,,17,2,12,31
/jdk1.2.2/com/sun/java/swing/plaf/motif/MotifMenuMouseMotionListener.java,Java,,11,3,12,26
/jdk1.2.2/com/sun/java/swing/plaf/motif/MotifMenuUI.java,Java,,93,25,27,145
/jdk1.2.2/com/sun/java/swing/plaf/motif/MotifOptionPaneUI.java,Java,,49,13,35,97
/jdk1.2.2/com/sun/java/swing/plaf/motif/MotifPasswordFieldUI.java,Java,,13,10,33,56
/jdk1.2.2/com/sun/java/swing/plaf/motif/MotifPopupMenuSeparatorUI.java,Java,,27,9,13,49
/jdk1.2.2/com/sun/java/swing/plaf/motif/MotifPopupMenuUI.java,Java,,149,37,57,243
/jdk1.2.2/com/sun/java/swing/plaf/motif/MotifProgressBarUI.java,Java,,13,6,22,41
/jdk1.2.2/com/sun/java/swing/plaf/motif/MotifRadioButtonMenuItemUI.java,Java,,75,23,20,118
/jdk1.2.2/com/sun/java/swing/plaf/motif/MotifRadioButtonUI.java,Java,,33,15,31,79
/jdk1.2.2/com/sun/java/swing/plaf/motif/MotifScrollBarButton.java,Java,,154,25,16,195
/jdk1.2.2/com/sun/java/swing/plaf/motif/MotifScrollBarUI.java,Java,,54,18,20,92
/jdk1.2.2/com/sun/java/swing/plaf/motif/MotifScrollPaneUI.java,Java,,45,16,19,80
/jdk1.2.2/com/sun/java/swing/plaf/motif/MotifSeparatorUI.java,Java,,16,9,21,46
/jdk1.2.2/com/sun/java/swing/plaf/motif/MotifSliderUI.java,Java,,103,33,32,168
/jdk1.2.2/com/sun/java/swing/plaf/motif/MotifSplitPaneDivider.java,Java,,84,26,39,149
/jdk1.2.2/com/sun/java/swing/plaf/motif/MotifSplitPaneUI.java,Java,,18,6,25,49
/jdk1.2.2/com/sun/java/swing/plaf/motif/MotifTabbedPaneUI.java,Java,,194,34,24,252
/jdk1.2.2/com/sun/java/swing/plaf/motif/MotifTextAreaUI.java,Java,,13,5,35,53
/jdk1.2.2/com/sun/java/swing/plaf/motif/MotifTextFieldUI.java,Java,,13,5,33,51
/jdk1.2.2/com/sun/java/swing/plaf/motif/MotifTextPaneUI.java,Java,,13,7,33,53
/jdk1.2.2/com/sun/java/swing/plaf/motif/MotifTextUI.java,Java,,69,13,76,158
/jdk1.2.2/com/sun/java/swing/plaf/motif/MotifToggleButtonUI.java,Java,,50,18,32,100
/jdk1.2.2/com/sun/java/swing/plaf/motif/MotifTreeCellRenderer.java,Java,,50,16,29,95
/jdk1.2.2/com/sun/java/swing/plaf/motif/MotifTreeUI.java,Java,,74,24,47,145
/jdk1.2.2/com/sun/java/swing/plaf/windows/WindowsBorders.java,Java,,56,18,11,85
/jdk1.2.2/com/sun/java/swing/plaf/windows/WindowsButtonListener.java,Java,,20,8,21,49
/jdk1.2.2/com/sun/java/swing/plaf/windows/WindowsButtonUI.java,Java,,51,16,33,100
/jdk1.2.2/com/sun/java/swing/plaf/windows/WindowsCheckBoxMenuItemUI.java,Java,,5,6,16,27
/jdk1.2.2/com/sun/java/swing/plaf/windows/WindowsCheckBoxUI.java,Java,,28,14,28,70
/jdk1.2.2/com/sun/java/swing/plaf/windows/WindowsComboBoxUI.java,Java,,127,29,31,187
/jdk1.2.2/com/sun/java/swing/plaf/windows/WindowsDesktopIconUI.java,Java,,5,6,16,27
/jdk1.2.2/com/sun/java/swing/plaf/windows/WindowsDesktopManager.java,Java,,83,18,53,154
/jdk1.2.2/com/sun/java/swing/plaf/windows/WindowsDesktopPaneUI.java,Java,,56,11,20,87
/jdk1.2.2/com/sun/java/swing/plaf/windows/WindowsEditorPaneUI.java,Java,,14,7,30,51
/jdk1.2.2/com/sun/java/swing/plaf/windows/WindowsFileChooserUI.java,Java,,652,153,124,929
/jdk1.2.2/com/sun/java/swing/plaf/windows/WindowsIconFactory.java,Java,,313,62,43,418
/jdk1.2.2/com/sun/java/swing/plaf/windows/WindowsInternalFrameUI.java,Java,,16,8,16,40
/jdk1.2.2/com/sun/java/swing/plaf/windows/WindowsLabelUI.java,Java,,5,6,16,27
/jdk1.2.2/com/sun/java/swing/plaf/windows/WindowsListUI.java,Java,,5,6,6,17
/jdk1.2.2/com/sun/java/swing/plaf/windows/WindowsLookAndFeel.java,Java,,304,67,57,428
/jdk1.2.2/com/sun/java/swing/plaf/windows/WindowsMenuBarUI.java,Java,,5,6,16,27
/jdk1.2.2/com/sun/java/swing/plaf/windows/WindowsMenuItemUI.java,Java,,5,6,16,27
/jdk1.2.2/com/sun/java/swing/plaf/windows/WindowsMenuUI.java,Java,,5,6,16,27
/jdk1.2.2/com/sun/java/swing/plaf/windows/WindowsOptionPaneUI.java,Java,,5,6,16,27
/jdk1.2.2/com/sun/java/swing/plaf/windows/WindowsPasswordFieldUI.java,Java,,13,9,30,52
/jdk1.2.2/com/sun/java/swing/plaf/windows/WindowsPopupMenuUI.java,Java,,5,6,16,27
/jdk1.2.2/com/sun/java/swing/plaf/windows/WindowsProgressBarUI.java,Java,,11,6,19,36
/jdk1.2.2/com/sun/java/swing/plaf/windows/WindowsRadioButtonMenuItemUI.java,Java,,5,6,16,27
/jdk1.2.2/com/sun/java/swing/plaf/windows/WindowsRadioButtonUI.java,Java,,36,14,25,75
/jdk1.2.2/com/sun/java/swing/plaf/windows/WindowsScrollBarUI.java,Java,,5,6,16,27
/jdk1.2.2/com/sun/java/swing/plaf/windows/WindowsScrollPaneUI.java,Java,,5,6,16,27
/jdk1.2.2/com/sun/java/swing/plaf/windows/WindowsSeparatorUI.java,Java,,5,6,6,17
/jdk1.2.2/com/sun/java/swing/plaf/windows/WindowsSliderUI.java,Java,,9,7,16,32
/jdk1.2.2/com/sun/java/swing/plaf/windows/WindowsSpinnerUI.java,Java,,5,6,6,17
/jdk1.2.2/com/sun/java/swing/plaf/windows/WindowsSplitPaneDivider.java,Java,,23,7,25,55
/jdk1.2.2/com/sun/java/swing/plaf/windows/WindowsSplitPaneUI.java,Java,,18,10,22,50
/jdk1.2.2/com/sun/java/swing/plaf/windows/WindowsStandardDialogUI.java,Java,,5,6,6,17
/jdk1.2.2/com/sun/java/swing/plaf/windows/WindowsTabbedPaneUI.java,Java,,5,6,16,27
/jdk1.2.2/com/sun/java/swing/plaf/windows/WindowsTableHeaderUI.java,Java,,5,6,6,17
/jdk1.2.2/com/sun/java/swing/plaf/windows/WindowsTableUI.java,Java,,5,6,6,17
/jdk1.2.2/com/sun/java/swing/plaf/windows/WindowsTextAreaUI.java,Java,,13,8,30,51
/jdk1.2.2/com/sun/java/swing/plaf/windows/WindowsTextFieldUI.java,Java,,67,15,80,162
/jdk1.2.2/com/sun/java/swing/plaf/windows/WindowsTextPaneUI.java,Java,,14,6,30,50
/jdk1.2.2/com/sun/java/swing/plaf/windows/WindowsTextUI.java,Java,,139,15,65,219
/jdk1.2.2/com/sun/java/swing/plaf/windows/WindowsToggleButtonUI.java,Java,,44,18,25,87
/jdk1.2.2/com/sun/java/swing/plaf/windows/WindowsToolBarUI.java,Java,,5,6,6,17
/jdk1.2.2/com/sun/java/swing/plaf/windows/WindowsTreeUI.java,Java,,52,17,39,108
/jdk1.2.2/com/sun/java/swing/plaf/windows/WindowsUtils.java,Java,,9,4,20,33
/jdk1.2.2/java/applet/Applet.java,Java,,104,27,302,433
/jdk1.2.2/java/applet/AppletContext.java,Java,,15,9,99,123
/jdk1.2.2/java/applet/AppletStub.java,Java,,10,7,62,79
/jdk1.2.2/java/applet/AudioClip.java,Java,,6,4,26,36
/jdk1.2.2/java/awt/ActiveEvent.java,Java,,4,3,34,41
/jdk1.2.2/java/awt/Adjustable.java,Java,,21,22,79,122
/jdk1.2.2/java/awt/AlphaComposite.java,Java,,93,36,233,362
/jdk1.2.2/java/awt/AlphaCompositeContext.java,Java,,88,24,33,145
/jdk1.2.2/java/awt/AWTError.java,Java,,7,4,21,32
/jdk1.2.2/java/awt/AWTEvent.java,Java,,198,48,160,406
/jdk1.2.2/java/awt/AWTEventMulticaster.java,Java,,264,66,358,688
/jdk1.2.2/java/awt/AWTException.java,Java,,7,4,23,34
/jdk1.2.2/java/awt/AWTPermission.java,Java,,13,9,112,134
/jdk1.2.2/java/awt/BasicStroke.java,Java,,255,55,162,472
/jdk1.2.2/java/awt/BorderLayout.java,Java,,258,47,394,699
/jdk1.2.2/java/awt/Button.java,Java,,122,37,215,374
/jdk1.2.2/java/awt/Canvas.java,Java,,33,11,64,108
/jdk1.2.2/java/awt/CardLayout.java,Java,,211,31,212,454
/jdk1.2.2/java/awt/Checkbox.java,Java,,181,43,270,494
/jdk1.2.2/java/awt/CheckboxGroup.java,Java,,32,9,89,130
/jdk1.2.2/java/awt/CheckboxMenuItem.java,Java,,117,31,190,338
/jdk1.2.2/java/awt/Choice.java,Java,,225,54,273,552
/jdk1.2.2/java/awt/color/CMMException.java,Java,,6,7,28,41
/jdk1.2.2/java/awt/color/ColorSpace.java,Java,,104,68,214,386
/jdk1.2.2/java/awt/color/ICC_ColorSpace.java,Java,,91,51,93,235
/jdk1.2.2/java/awt/color/ICC_Profile.java,Java,,716,314,582,1612
/jdk1.2.2/java/awt/color/ICC_ProfileGray.java,Java,,25,18,86,129
/jdk1.2.2/java/awt/color/ICC_ProfileRGB.java,Java,,73,34,122,229
/jdk1.2.2/java/awt/color/ProfileDataException.java,Java,,6,4,13,23
/jdk1.2.2/java/awt/Color.java,Java,,452,68,514,1034
/jdk1.2.2/java/awt/ColorPaintContext.java,Java,,35,12,6,53
/jdk1.2.2/java/awt/Component.java,Java,,1764,332,2049,4145
/jdk1.2.2/java/awt/ComponentOrientation.java,Java,,53,16,111,180
/jdk1.2.2/java/awt/Composite.java,Java,,7,5,57,69
/jdk1.2.2/java/awt/CompositeContext.java,Java,,9,8,35,52
/jdk1.2.2/java/awt/Conditional.java,Java,,4,2,14,20
/jdk1.2.2/java/awt/Container.java,Java,,1174,188,836,2198
/jdk1.2.2/java/awt/Cursor.java,Java,,187,62,124,373
/jdk1.2.2/java/awt/datatransfer/Clipboard.java,Java,,22,13,35,70
/jdk1.2.2/java/awt/datatransfer/ClipboardOwner.java,Java,,4,5,19,28
/jdk1.2.2/java/awt/datatransfer/DataFlavor.java,Java,,256,118,286,660
/jdk1.2.2/java/awt/datatransfer/FlavorMap.java,Java,,6,8,59,73
/jdk1.2.2/java/awt/datatransfer/MimeType.java,Java,,149,39,114,302
/jdk1.2.2/java/awt/datatransfer/MimeTypeParameterList.java,Java,,196,52,79,327
/jdk1.2.2/java/awt/datatransfer/MimeTypeParseException.java,Java,,9,6,17,32
/jdk1.2.2/java/awt/datatransfer/StringSelection.java,Java,,29,12,29,70
/jdk1.2.2/java/awt/datatransfer/SystemFlavorMap.java,Java,,166,74,61,301
/jdk1.2.2/java/awt/datatransfer/Transferable.java,Java,,7,8,36,51
/jdk1.2.2/java/awt/datatransfer/UnsupportedFlavorException.java,Java,,7,5,20,32
/jdk1.2.2/java/awt/Dialog.java,Java,,196,44,266,506
/jdk1.2.2/java/awt/Dimension.java,Java,,52,19,124,195
/jdk1.2.2/java/awt/dnd/Autoscroll.java,Java,,7,9,47,63
/jdk1.2.2/java/awt/dnd/DnDConstants.java,Java,,10,14,44,68
/jdk1.2.2/java/awt/dnd/DragGestureEvent.java,Java,,55,49,125,229
/jdk1.2.2/java/awt/dnd/DragGestureListener.java,Java,,5,8,28,41
/jdk1.2.2/java/awt/dnd/DragGestureRecognizer.java,Java,,75,58,268,401
/jdk1.2.2/java/awt/dnd/DragSource.java,Java,,106,76,286,468
/jdk1.2.2/java/awt/dnd/DragSourceContext.java,Java,,144,99,207,450
/jdk1.2.2/java/awt/dnd/DragSourceDragEvent.java,Java,,23,25,71,119
/jdk1.2.2/java/awt/dnd/DragSourceDropEvent.java,Java,,18,23,53,94
/jdk1.2.2/java/awt/dnd/DragSourceEvent.java,Java,,9,10,25,44
/jdk1.2.2/java/awt/dnd/DragSourceListener.java,Java,,11,21,104,136
/jdk1.2.2/java/awt/dnd/DropTarget.java,Java,,258,167,305,730
/jdk1.2.2/java/awt/dnd/DropTargetContext.java,Java,,131,85,189,405
/jdk1.2.2/java/awt/dnd/DropTargetDragEvent.java,Java,,44,37,90,171
/jdk1.2.2/java/awt/dnd/DropTargetDropEvent.java,Java,,60,49,128,237
/jdk1.2.2/java/awt/dnd/DropTargetEvent.java,Java,,17,13,34,64
/jdk1.2.2/java/awt/dnd/DropTargetListener.java,Java,,12,22,75,109
/jdk1.2.2/java/awt/dnd/InvalidDnDOperationException.java,Java,,6,12,23,41
/jdk1.2.2/java/awt/dnd/MouseDragGestureRecognizer.java,Java,,34,34,110,178
/jdk1.2.2/java/awt/dnd/peer/DragSourceContextPeer.java,Java,,19,15,29,63
/jdk1.2.2/java/awt/dnd/peer/DropTargetContextPeer.java,Java,,23,30,49,102
/jdk1.2.2/java/awt/dnd/peer/DropTargetPeer.java,Java,,6,8,28,42
/jdk1.2.2/java/awt/event/ActionEvent.java,Java,,40,19,111,170
/jdk1.2.2/java/awt/event/ActionListener.java,Java,,5,5,25,35
/jdk1.2.2/java/awt/event/AdjustmentEvent.java,Java,,64,20,89,173
/jdk1.2.2/java/awt/event/AdjustmentListener.java,Java,,5,5,15,25
/jdk1.2.2/java/awt/event/AWTEventListener.java,Java,,6,5,33,44
/jdk1.2.2/java/awt/event/ComponentAdapter.java,Java,,7,5,43,55
/jdk1.2.2/java/awt/event/ComponentEvent.java,Java,,45,14,77,136
/jdk1.2.2/java/awt/event/ComponentListener.java,Java,,8,6,43,57
/jdk1.2.2/java/awt/event/ContainerAdapter.java,Java,,5,3,37,45
/jdk1.2.2/java/awt/event/ContainerEvent.java,Java,,36,13,78,127
/jdk1.2.2/java/awt/event/ContainerListener.java,Java,,6,5,38,49
/jdk1.2.2/java/awt/event/FocusAdapter.java,Java,,5,3,37,45
/jdk1.2.2/java/awt/event/FocusEvent.java,Java,,35,14,91,140
/jdk1.2.2/java/awt/event/FocusListener.java,Java,,6,5,33,44
/jdk1.2.2/java/awt/event/InputEvent.java,Java,,53,26,109,188
/jdk1.2.2/java/awt/event/InputMethodEvent.java,Java,,107,27,141,275
/jdk1.2.2/java/awt/event/InputMethodListener.java,Java,,6,7,26,39
/jdk1.2.2/java/awt/event/InvocationEvent.java,Java,,59,17,113,189
/jdk1.2.2/java/awt/event/ItemEvent.java,Java,,51,18,93,162
/jdk1.2.2/java/awt/event/ItemListener.java,Java,,5,5,28,38
/jdk1.2.2/java/awt/event/KeyAdapter.java,Java,,6,4,41,51
/jdk1.2.2/java/awt/event/KeyEvent.java,Java,,516,114,313,943
/jdk1.2.2/java/awt/event/KeyListener.java,Java,,7,6,37,50
/jdk1.2.2/java/awt/event/MouseAdapter.java,Java,,8,6,51,65
/jdk1.2.2/java/awt/event/MouseEvent.java,Java,,88,25,226,339
/jdk1.2.2/java/awt/event/MouseListener.java,Java,,9,8,47,64
/jdk1.2.2/java/awt/event/MouseMotionAdapter.java,Java,,5,3,45,53
/jdk1.2.2/java/awt/event/MouseMotionListener.java,Java,,6,6,41,53
/jdk1.2.2/java/awt/event/NativeLibLoader.java,Java,,7,3,31,41
/jdk1.2.2/java/awt/event/PaintEvent.java,Java,,36,13,59,108
/jdk1.2.2/java/awt/event/TextEvent.java,Java,,23,13,50,86
/jdk1.2.2/java/awt/event/TextListener.java,Java,,5,5,28,38
/jdk1.2.2/java/awt/event/WindowAdapter.java,Java,,10,8,55,73
/jdk1.2.2/java/awt/event/WindowEvent.java,Java,,50,17,90,157
/jdk1.2.2/java/awt/event/WindowListener.java,Java,,11,9,61,81
/jdk1.2.2/java/awt/Event.java,Java,,228,106,463,797
/jdk1.2.2/java/awt/EventDispatchThread.java,Java,,115,28,76,219
/jdk1.2.2/java/awt/EventQueue.java,Java,,284,52,192,528
/jdk1.2.2/java/awt/FileDialog.java,Java,,110,27,189,326
/jdk1.2.2/java/awt/FlowLayout.java,Java,,186,37,265,488
/jdk1.2.2/java/awt/font/FontRenderContext.java,Java,,31,11,70,112
/jdk1.2.2/java/awt/font/GlyphJustificationInfo.java,Java,,36,18,111,165
/jdk1.2.2/java/awt/font/GlyphMetrics.java,Java,,48,25,173,246
/jdk1.2.2/java/awt/font/GlyphVector.java,Java,,35,27,355,417
/jdk1.2.2/java/awt/font/GraphicAttribute.java,Java,,43,21,109,173
/jdk1.2.2/java/awt/font/ImageGraphicAttribute.java,Java,,68,36,107,211
/jdk1.2.2/java/awt/font/LineBreakMeasurer.java,Java,,105,33,332,470
/jdk1.2.2/java/awt/font/LineMetrics.java,Java,,14,16,98,128
/jdk1.2.2/java/awt/font/MultipleMaster.java,Java,,15,10,64,89
/jdk1.2.2/java/awt/font/OpenType.java,Java,,61,64,291,416
/jdk1.2.2/java/awt/font/ShapeGraphicAttribute.java,Java,,82,35,108,225
/jdk1.2.2/java/awt/font/TextAttribute.java,Java,,70,65,676,811
/jdk1.2.2/java/awt/font/TextHitInfo.java,Java,,54,18,157,229
/jdk1.2.2/java/awt/font/TextJustifier.java,Java,,146,26,50,222
/jdk1.2.2/java/awt/font/TextLayout.java,Java,,1161,338,1015,2514
/jdk1.2.2/java/awt/font/TextLine.java,Java,,877,272,139,1288
/jdk1.2.2/java/awt/font/TextMeasurer.java,Java,,292,80,115,487
/jdk1.2.2/java/awt/font/TransformAttribute.java,Java,,15,12,34,61
/jdk1.2.2/java/awt/Font.java,Java,,707,144,770,1621
/jdk1.2.2/java/awt/FontMetrics.java,Java,,133,36,367,536
/jdk1.2.2/java/awt/Frame.java,Java,,282,65,322,669
/jdk1.2.2/java/awt/geom/AffineTransform.java,Java,,1678,133,1167,2978
/jdk1.2.2/java/awt/geom/Arc2D.java,Java,,582,111,675,1368
/jdk1.2.2/java/awt/geom/ArcIterator.java,Java,,154,10,64,228
/jdk1.2.2/java/awt/geom/Area.java,Java,,302,37,230,569
/jdk1.2.2/java/awt/geom/CubicCurve2D.java,Java,,671,112,851,1634
/jdk1.2.2/java/awt/geom/CubicIterator.java,Java,,66,9,64,139
/jdk1.2.2/java/awt/geom/Dimension2D.java,Java,,18,7,65,90
/jdk1.2.2/java/awt/geom/Ellipse2D.java,Java,,136,33,238,407
/jdk1.2.2/java/awt/geom/EllipseIterator.java,Java,,100,12,64,176
/jdk1.2.2/java/awt/geom/FlatteningPathIterator.java,Java,,184,36,158,378
/jdk1.2.2/java/awt/geom/GeneralPath.java,Java,,274,37,309,620
/jdk1.2.2/java/awt/geom/GeneralPathIterator.java,Java,,51,10,80,141
/jdk1.2.2/java/awt/geom/IllegalPathStateException.java,Java,,8,4,27,39
/jdk1.2.2/java/awt/geom/Line2D.java,Java,,289,72,569,930
/jdk1.2.2/java/awt/geom/LineIterator.java,Java,,58,9,64,131
/jdk1.2.2/java/awt/geom/NoninvertibleTransformException.java,Java,,6,3,20,29
/jdk1.2.2/java/awt/geom/PathIterator.java,Java,,15,13,169,197
/jdk1.2.2/java/awt/geom/Point2D.java,Java,,112,32,226,370
/jdk1.2.2/java/awt/geom/QuadCurve2D.java,Java,,499,98,681,1278
/jdk1.2.2/java/awt/geom/QuadIterator.java,Java,,62,9,64,135
/jdk1.2.2/java/awt/geom/Rectangle2D.java,Java,,326,65,609,1000
/jdk1.2.2/java/awt/geom/RectangularShape.java,Java,,101,28,224,353
/jdk1.2.2/java/awt/geom/RectIterator.java,Java,,66,9,64,139
/jdk1.2.2/java/awt/geom/RoundRectangle2D.java,Java,,213,49,353,615
/jdk1.2.2/java/awt/geom/RoundRectIterator.java,Java,,92,11,69,172
/jdk1.2.2/java/awt/GradientPaint.java,Java,,77,17,128,222
/jdk1.2.2/java/awt/GradientPaintContext.java,Java,,153,20,44,217
/jdk1.2.2/java/awt/Graphics.java,Java,,162,57,954,1173
/jdk1.2.2/java/awt/Graphics2D.java,Java,,98,47,1004,1149
/jdk1.2.2/java/awt/GraphicsConfigTemplate.java,Java,,14,11,67,92
/jdk1.2.2/java/awt/GraphicsConfiguration.java,Java,,16,15,135,166
/jdk1.2.2/java/awt/GraphicsDevice.java,Java,,17,12,72,101
/jdk1.2.2/java/awt/GraphicsEnvironment.java,Java,,37,16,116,169
/jdk1.2.2/java/awt/GridBagConstraints.java,Java,,75,34,304,413
/jdk1.2.2/java/awt/GridBagLayout.java,Java,,561,127,647,1335
/jdk1.2.2/java/awt/GridLayout.java,Java,,142,23,251,416
/jdk1.2.2/java/awt/IllegalComponentStateException.java,Java,,10,4,26,40
/jdk1.2.2/java/awt/im/InputContext.java,Java,,30,14,132,176
/jdk1.2.2/java/awt/im/InputMethodHighlight.java,Java,,36,18,73,127
/jdk1.2.2/java/awt/im/InputMethodRequests.java,Java,,15,11,165,191
/jdk1.2.2/java/awt/im/InputSubset.java,Java,,20,13,48,81
/jdk1.2.2/java/awt/image/AffineTransformOp.java,Java,,252,35,188,475
/jdk1.2.2/java/awt/image/AreaAveragingScaleFilter.java,Java,,151,11,61,223
/jdk1.2.2/java/awt/image/BandCombineOp.java,Java,,124,15,120,259
/jdk1.2.2/java/awt/image/BandedSampleModel.java,Java,,246,68,244,558
/jdk1.2.2/java/awt/image/BufferedImage.java,Java,,672,129,629,1430
/jdk1.2.2/java/awt/image/BufferedImageFilter.java,Java,,244,15,86,345
/jdk1.2.2/java/awt/image/BufferedImageOp.java,Java,,12,7,65,84
/jdk1.2.2/java/awt/image/ByteLookupTable.java,Java,,79,13,101,193
/jdk1.2.2/java/awt/image/ColorConvertOp.java,Java,,681,84,267,1032
/jdk1.2.2/java/awt/image/ColorModel.java,Java,,438,62,794,1294
/jdk1.2.2/java/awt/image/ComponentColorModel.java,Java,,802,80,521,1403
/jdk1.2.2/java/awt/image/ComponentSampleModel.java,Java,,407,83,307,797
/jdk1.2.2/java/awt/image/ConvolveOp.java,Java,,130,31,141,302
/jdk1.2.2/java/awt/image/CropImageFilter.java,Java,,77,8,48,133
/jdk1.2.2/java/awt/image/DataBuffer.java,Java,,127,40,162,329
/jdk1.2.2/java/awt/image/DataBufferByte.java,Java,,63,18,122,203
/jdk1.2.2/java/awt/image/DataBufferInt.java,Java,,63,19,120,202
/jdk1.2.2/java/awt/image/DataBufferShort.java,Java,,63,19,119,201
/jdk1.2.2/java/awt/image/DataBufferUShort.java,Java,,63,19,121,203
/jdk1.2.2/java/awt/image/DirectColorModel.java,Java,,563,51,336,950
/jdk1.2.2/java/awt/image/FilteredImageSource.java,Java,,60,10,61,131
/jdk1.2.2/java/awt/image/ImageConsumer.java,Java,,22,18,136,176
/jdk1.2.2/java/awt/image/ImageFilter.java,Java,,52,13,97,162
/jdk1.2.2/java/awt/image/ImageObserver.java,Java,,14,11,114,139
/jdk1.2.2/java/awt/image/ImageProducer.java,Java,,8,6,69,83
/jdk1.2.2/java/awt/image/ImagingOpException.java,Java,,6,4,18,28
/jdk1.2.2/java/awt/image/IndexColorModel.java,Java,,551,64,347,962
/jdk1.2.2/java/awt/image/Kernel.java,Java,,59,19,64,142
/jdk1.2.2/java/awt/image/LookupOp.java,Java,,331,52,124,507
/jdk1.2.2/java/awt/image/LookupTable.java,Java,,25,10,48,83
/jdk1.2.2/java/awt/image/MemoryImageSource.java,Java,,215,24,233,472
/jdk1.2.2/java/awt/image/MultiPixelPackedSampleModel.java,Java,,214,61,300,575
/jdk1.2.2/java/awt/image/PackedColorModel.java,Java,,222,34,140,396
/jdk1.2.2/java/awt/image/PixelGrabber.java,Java,,308,28,266,602
/jdk1.2.2/java/awt/image/PixelInterleavedSampleModel.java,Java,,63,6,62,131
/jdk1.2.2/java/awt/image/Raster.java,Java,,587,137,595,1319
/jdk1.2.2/java/awt/image/RasterFormatException.java,Java,,6,4,17,27
/jdk1.2.2/java/awt/image/RasterOp.java,Java,,11,7,56,74
/jdk1.2.2/java/awt/image/renderable/ContextualRenderedImageFactory.java,Java,,15,9,91,115
/jdk1.2.2/java/awt/image/renderable/ParameterBlock.java,Java,,189,50,239,478
/jdk1.2.2/java/awt/image/renderable/RenderableImage.java,Java,,18,15,137,170
/jdk1.2.2/java/awt/image/renderable/RenderableImageOp.java,Java,,121,29,172,322
/jdk1.2.2/java/awt/image/renderable/RenderableImageProducer.java,Java,,93,19,89,201
/jdk1.2.2/java/awt/image/renderable/RenderContext.java,Java,,55,20,131,206
/jdk1.2.2/java/awt/image/renderable/RenderedImageFactory.java,Java,,7,4,49,60
/jdk1.2.2/java/awt/image/RenderedImage.java,Java,,27,25,118,170
/jdk1.2.2/java/awt/image/ReplicateScaleFilter.java,Java,,115,10,48,173
/jdk1.2.2/java/awt/image/RescaleOp.java,Java,,348,63,195,606
/jdk1.2.2/java/awt/image/RGBImageFilter.java,Java,,101,11,114,226
/jdk1.2.2/java/awt/image/SampleModel.java,Java,,399,132,541,1072
/jdk1.2.2/java/awt/image/ShortLookupTable.java,Java,,79,13,88,180
/jdk1.2.2/java/awt/image/SinglePixelPackedSampleModel.java,Java,,281,78,279,638
/jdk1.2.2/java/awt/image/TileObserver.java,Java,,6,4,27,37
/jdk1.2.2/java/awt/image/WritableRaster.java,Java,,178,34,342,554
/jdk1.2.2/java/awt/image/WritableRenderedImage.java,Java,,13,13,97,123
/jdk1.2.2/java/awt/Image.java,Java,,32,14,144,190
/jdk1.2.2/java/awt/Insets.java,Java,,37,13,89,139
/jdk1.2.2/java/awt/ItemSelectable.java,Java,,7,7,31,45
/jdk1.2.2/java/awt/Label.java,Java,,85,23,130,238
/jdk1.2.2/java/awt/LayoutManager.java,Java,,8,5,42,55
/jdk1.2.2/java/awt/LayoutManager2.java,Java,,8,7,55,70
/jdk1.2.2/java/awt/List.java,Java,,388,85,554,1027
/jdk1.2.2/java/awt/MediaTracker.java,Java,,390,56,465,911
/jdk1.2.2/java/awt/Menu.java,Java,,224,52,248,524
/jdk1.2.2/java/awt/MenuBar.java,Java,,186,34,193,413
/jdk1.2.2/java/awt/MenuComponent.java,Java,,145,32,154,331
/jdk1.2.2/java/awt/MenuContainer.java,Java,,6,3,16,25
/jdk1.2.2/java/awt/MenuItem.java,Java,,197,50,330,577
/jdk1.2.2/java/awt/MenuShortcut.java,Java,,52,12,76,140
/jdk1.2.2/java/awt/Paint.java,Java,,12,6,42,60
/jdk1.2.2/java/awt/PaintContext.java,Java,,12,7,44,63
/jdk1.2.2/java/awt/Panel.java,Java,,25,9,40,74
/jdk1.2.2/java/awt/peer/ButtonPeer.java,Java,,5,3,13,21
/jdk1.2.2/java/awt/peer/CanvasPeer.java,Java,,4,2,13,19
/jdk1.2.2/java/awt/peer/CheckboxMenuItemPeer.java,Java,,4,1,13,18
/jdk1.2.2/java/awt/peer/CheckboxPeer.java,Java,,7,2,13,22
/jdk1.2.2/java/awt/peer/ChoicePeer.java,Java,,8,3,16,27
/jdk1.2.2/java/awt/peer/ComponentPeer.java,Java,,40,13,34,87
/jdk1.2.2/java/awt/peer/ContainerPeer.java,Java,,8,3,16,27
/jdk1.2.2/java/awt/peer/DialogPeer.java,Java,,6,5,13,24
/jdk1.2.2/java/awt/peer/FileDialogPeer.java,Java,,8,3,13,24
/jdk1.2.2/java/awt/peer/FontPeer.java,Java,,3,2,13,18
/jdk1.2.2/java/awt/peer/FramePeer.java,Java,,10,5,13,28
/jdk1.2.2/java/awt/peer/LabelPeer.java,Java,,7,2,13,22
/jdk1.2.2/java/awt/peer/LightweightPeer.java,Java,,3,3,21,27
/jdk1.2.2/java/awt/peer/ListPeer.java,Java,,19,7,28,54
/jdk1.2.2/java/awt/peer/MenuBarPeer.java,Java,,7,2,13,22
/jdk1.2.2/java/awt/peer/MenuComponentPeer.java,Java,,4,1,13,18
/jdk1.2.2/java/awt/peer/MenuItemPeer.java,Java,,7,4,19,30
/jdk1.2.2/java/awt/peer/MenuPeer.java,Java,,7,2,13,22
/jdk1.2.2/java/awt/peer/PanelPeer.java,Java,,4,2,13,19
/jdk1.2.2/java/awt/peer/PopupMenuPeer.java,Java,,5,2,13,20
/jdk1.2.2/java/awt/peer/ScrollbarPeer.java,Java,,6,1,13,20
/jdk1.2.2/java/awt/peer/ScrollPanePeer.java,Java,,11,2,13,26
/jdk1.2.2/java/awt/peer/TextAreaPeer.java,Java,,12,6,25,43
/jdk1.2.2/java/awt/peer/TextComponentPeer.java,Java,,11,1,13,25
/jdk1.2.2/java/awt/peer/TextFieldPeer.java,Java,,10,5,22,37
/jdk1.2.2/java/awt/peer/WindowPeer.java,Java,,12,5,13,30
/jdk1.2.2/java/awt/Point.java,Java,,54,18,129,201
/jdk1.2.2/java/awt/Polygon.java,Java,,244,50,284,578
/jdk1.2.2/java/awt/PopupMenu.java,Java,,64,11,54,129
/jdk1.2.2/java/awt/print/Book.java,Java,,66,27,113,206
/jdk1.2.2/java/awt/print/Pageable.java,Java,,9,7,50,66
/jdk1.2.2/java/awt/print/PageFormat.java,Java,,141,58,133,332
/jdk1.2.2/java/awt/print/Paper.java,Java,,53,25,98,176
/jdk1.2.2/java/awt/print/Printable.java,Java,,8,7,53,68
/jdk1.2.2/java/awt/print/PrinterAbortException.java,Java,,9,6,22,37
/jdk1.2.2/java/awt/print/PrinterException.java,Java,,8,6,21,35
/jdk1.2.2/java/awt/print/PrinterGraphics.java,Java,,4,5,20,29
/jdk1.2.2/java/awt/print/PrinterIOException.java,Java,,12,8,28,48
/jdk1.2.2/java/awt/print/PrinterJob.java,Java,,48,26,147,221
/jdk1.2.2/java/awt/PrintGraphics.java,Java,,4,4,16,24
/jdk1.2.2/java/awt/PrintJob.java,Java,,11,9,43,63
/jdk1.2.2/java/awt/Rectangle.java,Java,,234,54,475,763
/jdk1.2.2/java/awt/RenderingHints.java,Java,,195,68,380,643
/jdk1.2.2/java/awt/Scrollbar.java,Java,,226,58,597,881
/jdk1.2.2/java/awt/ScrollPane.java,Java,,386,85,289,760
/jdk1.2.2/java/awt/Shape.java,Java,,17,12,278,307
/jdk1.2.2/java/awt/Stroke.java,Java,,4,6,45,55
/jdk1.2.2/java/awt/SystemColor.java,Java,,109,64,213,386
/jdk1.2.2/java/awt/TextArea.java,Java,,197,52,305,554
/jdk1.2.2/java/awt/TextComponent.java,Java,,234,48,298,580
/jdk1.2.2/java/awt/TextField.java,Java,,188,48,334,570
/jdk1.2.2/java/awt/TexturePaint.java,Java,,47,13,63,123
/jdk1.2.2/java/awt/TexturePaintContext.java,Java,,405,30,26,461
/jdk1.2.2/java/awt/Toolkit.java,Java,,487,144,794,1425
/jdk1.2.2/java/awt/Transparency.java,Java,,7,6,29,42
/jdk1.2.2/java/awt/Window.java,Java,,605,104,403,1112
/jdk1.2.2/java/beans/AppletInitializer.java,Java,,7,10,56,73
/jdk1.2.2/java/beans/beancontext/BeanContext.java,Java,,16,19,50,85
/jdk1.2.2/java/beans/beancontext/BeanContextChild.java,Java,,13,19,70,102
/jdk1.2.2/java/beans/beancontext/BeanContextChildComponentProxy.java,Java,,5,6,22,33
/jdk1.2.2/java/beans/beancontext/BeanContextChildSupport.java,Java,,100,68,109,277
/jdk1.2.2/java/beans/beancontext/BeanContextContainerProxy.java,Java,,5,6,22,33
/jdk1.2.2/java/beans/beancontext/BeanContextEvent.java,Java,,19,17,37,73
/jdk1.2.2/java/beans/beancontext/BeanContextMembershipEvent.java,Java,,24,22,47,93
/jdk1.2.2/java/beans/beancontext/BeanContextMembershipListener.java,Java,,7,9,23,39
/jdk1.2.2/java/beans/beancontext/BeanContextProxy.java,Java,,4,5,54,63
/jdk1.2.2/java/beans/beancontext/BeanContextServiceAvailableEvent.java,Java,,19,17,27,63
/jdk1.2.2/java/beans/beancontext/BeanContextServiceProvider.java,Java,,7,10,40,57
/jdk1.2.2/java/beans/beancontext/BeanContextServiceProviderBeanInfo.java,Java,,5,6,17,28
/jdk1.2.2/java/beans/beancontext/BeanContextServiceRevokedEvent.java,Java,,20,18,30,68
/jdk1.2.2/java/beans/beancontext/BeanContextServiceRevokedListener.java,Java,,6,6,10,22
/jdk1.2.2/java/beans/beancontext/BeanContextServices.java,Java,,17,27,39,83
/jdk1.2.2/java/beans/beancontext/BeanContextServicesListener.java,Java,,7,6,10,23
/jdk1.2.2/java/beans/beancontext/BeanContextServicesSupport.java,Java,,610,316,253,1179
/jdk1.2.2/java/beans/beancontext/BeanContextSupport.java,Java,,596,302,400,1298
/jdk1.2.2/java/beans/BeanDescriptor.java,Java,,28,10,42,80
/jdk1.2.2/java/beans/BeanInfo.java,Java,,15,15,123,153
/jdk1.2.2/java/beans/Beans.java,Java,,299,89,245,633
/jdk1.2.2/java/beans/Customizer.java,Java,,6,8,34,48
/jdk1.2.2/java/beans/DesignMode.java,Java,,6,9,68,83
/jdk1.2.2/java/beans/EventSetDescriptor.java,Java,,154,37,149,340
/jdk1.2.2/java/beans/FeatureDescriptor.java,Java,,106,24,124,254
/jdk1.2.2/java/beans/IndexedPropertyDescriptor.java,Java,,114,20,112,246
/jdk1.2.2/java/beans/IntrospectionException.java,Java,,7,4,20,31
/jdk1.2.2/java/beans/Introspector.java,Java,,709,137,285,1131
/jdk1.2.2/java/beans/MethodDescriptor.java,Java,,41,14,48,103
/jdk1.2.2/java/beans/ParameterDescriptor.java,Java,,8,6,21,35
/jdk1.2.2/java/beans/PropertyChangeEvent.java,Java,,29,13,82,124
/jdk1.2.2/java/beans/PropertyChangeListener.java,Java,,4,6,16,26
/jdk1.2.2/java/beans/PropertyChangeSupport.java,Java,,162,39,124,325
/jdk1.2.2/java/beans/PropertyDescriptor.java,Java,,163,29,143,335
/jdk1.2.2/java/beans/PropertyEditor.java,Java,,15,25,146,186
/jdk1.2.2/java/beans/PropertyEditorManager.java,Java,,90,19,80,189
/jdk1.2.2/java/beans/PropertyEditorSupport.java,Java,,81,33,131,245
/jdk1.2.2/java/beans/PropertyVetoException.java,Java,,12,8,26,46
/jdk1.2.2/java/beans/SimpleBeanInfo.java,Java,,54,14,60,128
/jdk1.2.2/java/beans/VetoableChangeListener.java,Java,,5,2,19,26
/jdk1.2.2/java/beans/VetoableChangeSupport.java,Java,,162,40,135,337
/jdk1.2.2/java/beans/Visibility.java,Java,,7,8,34,49
/jdk1.2.2/java/io/BufferedInputStream.java,Java,,134,25,244,403
/jdk1.2.2/java/io/BufferedOutputStream.java,Java,,44,9,77,130
/jdk1.2.2/java/io/BufferedReader.java,Java,,215,32,194,441
/jdk1.2.2/java/io/BufferedWriter.java,Java,,105,24,121,250
/jdk1.2.2/java/io/ByteArrayInputStream.java,Java,,76,19,175,270
/jdk1.2.2/java/io/ByteArrayOutputStream.java,Java,,73,21,126,220
/jdk1.2.2/java/io/CharArrayReader.java,Java,,96,17,81,194
/jdk1.2.2/java/io/CharArrayWriter.java,Java,,83,16,69,168
/jdk1.2.2/java/io/CharConversionException.java,Java,,10,1,19,30
/jdk1.2.2/java/io/DataInput.java,Java,,19,16,452,487
/jdk1.2.2/java/io/DataInputStream.java,Java,,180,28,349,557
/jdk1.2.2/java/io/DataOutput.java,Java,,18,15,300,333
/jdk1.2.2/java/io/DataOutputStream.java,Java,,130,22,200,352
/jdk1.2.2/java/io/EOFException.java,Java,,10,3,37,50
/jdk1.2.2/java/io/Externalizable.java,Java,,7,4,65,76
/jdk1.2.2/java/io/File.java,Java,,380,83,945,1408
/jdk1.2.2/java/io/FileDescriptor.java,Java,,21,12,84,117
/jdk1.2.2/java/io/FileFilter.java,Java,,4,5,23,32
/jdk1.2.2/java/io/FileInputStream.java,Java,,54,18,174,246
/jdk1.2.2/java/io/FilenameFilter.java,Java,,5,2,29,36
/jdk1.2.2/java/io/FileNotFoundException.java,Java,,14,8,42,64
/jdk1.2.2/java/io/FileOutputStream.java,Java,,64,19,173,256
/jdk1.2.2/java/io/FilePermission.java,Java,,292,88,333,713
/jdk1.2.2/java/io/FileReader.java,Java,,12,8,19,39
/jdk1.2.2/java/io/FileSystem.java,Java,,33,43,122,198
/jdk1.2.2/java/io/FileWriter.java,Java,,15,9,19,43
/jdk1.2.2/java/io/FilterInputStream.java,Java,,35,12,176,223
/jdk1.2.2/java/io/FilterOutputStream.java,Java,,29,8,105,142
/jdk1.2.2/java/io/FilterReader.java,Java,,32,15,58,105
/jdk1.2.2/java/io/FilterWriter.java,Java,,23,12,52,87
/jdk1.2.2/java/io/InputStream.java,Java,,68,20,258,346
/jdk1.2.2/java/io/InputStreamReader.java,Java,,139,30,97,266
/jdk1.2.2/java/io/InterruptedIOException.java,Java,,11,4,40,55
/jdk1.2.2/java/io/InvalidClassException.java,Java,,17,5,31,53
/jdk1.2.2/java/io/InvalidObjectException.java,Java,,6,2,23,31
/jdk1.2.2/java/io/IOException.java,Java,,10,3,29,42
/jdk1.2.2/java/io/LineNumberInputStream.java,Java,,96,19,157,272
/jdk1.2.2/java/io/LineNumberReader.java,Java,,98,23,94,215
/jdk1.2.2/java/io/NotActiveException.java,Java,,9,3,19,31
/jdk1.2.2/java/io/NotSerializableException.java,Java,,9,3,20,32
/jdk1.2.2/java/io/ObjectInput.java,Java,,11,8,69,88
/jdk1.2.2/java/io/ObjectInputStream.java,Java,,1168,197,892,2257
/jdk1.2.2/java/io/ObjectInputValidation.java,Java,,4,2,21,27
/jdk1.2.2/java/io/ObjectOutput.java,Java,,10,7,55,72
/jdk1.2.2/java/io/ObjectOutputStream.java,Java,,950,191,792,1933
/jdk1.2.2/java/io/ObjectStreamClass.java,Java,,816,162,492,1470
/jdk1.2.2/java/io/ObjectStreamConstants.java,Java,,30,29,128,187
/jdk1.2.2/java/io/ObjectStreamException.java,Java,,9,3,19,31
/jdk1.2.2/java/io/ObjectStreamField.java,Java,,141,30,103,274
/jdk1.2.2/java/io/OptionalDataException.java,Java,,13,4,37,54
/jdk1.2.2/java/io/OutputStream.java,Java,,24,7,100,131
/jdk1.2.2/java/io/OutputStreamWriter.java,Java,,122,20,110,252
/jdk1.2.2/java/io/PipedInputStream.java,Java,,134,20,171,325
/jdk1.2.2/java/io/PipedOutputStream.java,Java,,53,11,95,159
/jdk1.2.2/java/io/PipedReader.java,Java,,144,23,138,305
/jdk1.2.2/java/io/PipedWriter.java,Java,,47,12,88,147
/jdk1.2.2/java/io/PrintStream.java,Java,,236,46,261,543
/jdk1.2.2/java/io/PrintWriter.java,Java,,211,48,236,495
/jdk1.2.2/java/io/PushbackInputStream.java,Java,,106,19,183,308
/jdk1.2.2/java/io/PushbackReader.java,Java,,102,20,108,230
/jdk1.2.2/java/io/RandomAccessFile.java,Java,,254,62,665,981
/jdk1.2.2/java/io/Reader.java,Java,,56,19,138,213
/jdk1.2.2/java/io/SequenceInputStream.java,Java,,79,14,107,200
/jdk1.2.2/java/io/Serializable.java,Java,,3,2,99,104
/jdk1.2.2/java/io/SerializablePermission.java,Java,,16,11,82,109
/jdk1.2.2/java/io/StreamCorruptedException.java,Java,,9,3,20,32
/jdk1.2.2/java/io/StreamTokenizer.java,Java,,362,51,370,783
/jdk1.2.2/java/io/StringBufferInputStream.java,Java,,53,11,90,154
/jdk1.2.2/java/io/StringReader.java,Java,,77,16,74,167
/jdk1.2.2/java/io/StringWriter.java,Java,,52,18,63,133
/jdk1.2.2/java/io/SyncFailedException.java,Java,,6,2,19,27
/jdk1.2.2/java/io/UnsupportedEncodingException.java,Java,,11,1,20,32
/jdk1.2.2/java/io/UTFDataFormatException.java,Java,,10,3,32,45
/jdk1.2.2/java/io/WriteAbortedException.java,Java,,14,4,27,45
/jdk1.2.2/java/io/Writer.java,Java,,48,17,106,171
/jdk1.2.2/java/lang/AbstractMethodError.java,Java,,10,3,26,39
/jdk1.2.2/java/lang/ArithmeticException.java,Java,,10,3,25,38
/jdk1.2.2/java/lang/ArrayIndexOutOfBoundsException.java,Java,,13,4,31,48
/jdk1.2.2/java/lang/ArrayStoreException.java,Java,,10,4,28,42
/jdk1.2.2/java/lang/Boolean.java,Java,,39,15,116,170
/jdk1.2.2/java/lang/Byte.java,Java,,82,28,153,263
/jdk1.2.2/java/lang/Character.java,Java,,971,70,869,1910
/jdk1.2.2/java/lang/Class.java,Java,,248,102,997,1347
/jdk1.2.2/java/lang/ClassCastException.java,Java,,10,3,28,41
/jdk1.2.2/java/lang/ClassCircularityError.java,Java,,9,3,22,34
/jdk1.2.2/java/lang/ClassFormatError.java,Java,,10,3,24,37
/jdk1.2.2/java/lang/ClassLoader.java,Java,,632,81,670,1383
/jdk1.2.2/java/lang/ClassNotFoundException.java,Java,,44,12,82,138
/jdk1.2.2/java/lang/Cloneable.java,Java,,3,3,23,29
/jdk1.2.2/java/lang/CloneNotSupportedException.java,Java,,10,4,32,46
/jdk1.2.2/java/lang/Comparable.java,Java,,4,3,102,109
/jdk1.2.2/java/lang/Compiler.java,Java,,37,10,61,108
/jdk1.2.2/java/lang/Double.java,Java,,87,34,422,543
/jdk1.2.2/java/lang/Error.java,Java,,10,3,32,45
/jdk1.2.2/java/lang/Exception.java,Java,,10,3,24,37
/jdk1.2.2/java/lang/ExceptionInInitializerError.java,Java,,43,13,74,130
/jdk1.2.2/java/lang/Float.java,Java,,88,35,406,529
/jdk1.2.2/java/lang/FloatingDecimal.java,Java,,1426,100,714,2240
/jdk1.2.2/java/lang/IllegalAccessError.java,Java,,9,3,27,39
/jdk1.2.2/java/lang/IllegalAccessException.java,Java,,10,3,43,56
/jdk1.2.2/java/lang/IllegalArgumentException.java,Java,,10,3,25,38
/jdk1.2.2/java/lang/IllegalMonitorStateException.java,Java,,10,3,30,43
/jdk1.2.2/java/lang/IllegalStateException.java,Java,,10,3,27,40
/jdk1.2.2/java/lang/IllegalThreadStateException.java,Java,,9,3,28,40
/jdk1.2.2/java/lang/IncompatibleClassChangeError.java,Java,,10,3,25,38
/jdk1.2.2/java/lang/IndexOutOfBoundsException.java,Java,,10,3,26,39
/jdk1.2.2/java/lang/InheritableThreadLocal.java,Java,,14,7,48,69
/jdk1.2.2/java/lang/InstantiationError.java,Java,,10,5,27,42
/jdk1.2.2/java/lang/InstantiationException.java,Java,,10,3,26,39
/jdk1.2.2/java/lang/Integer.java,Java,,274,57,533,864
/jdk1.2.2/java/lang/InternalError.java,Java,,10,3,23,36
/jdk1.2.2/java/lang/InterruptedException.java,Java,,10,3,30,43
/jdk1.2.2/java/lang/LinkageError.java,Java,,10,3,25,38
/jdk1.2.2/java/lang/Long.java,Java,,218,45,526,789
/jdk1.2.2/java/lang/Math.java,Java,,98,43,378,519
/jdk1.2.2/java/lang/NegativeArraySizeException.java,Java,,10,3,23,36
/jdk1.2.2/java/lang/NoClassDefFoundError.java,Java,,10,3,29,42
/jdk1.2.2/java/lang/NoSuchFieldError.java,Java,,10,3,27,40
/jdk1.2.2/java/lang/NoSuchFieldException.java,Java,,9,3,19,31
/jdk1.2.2/java/lang/NoSuchMethodError.java,Java,,10,3,28,41
/jdk1.2.2/java/lang/NoSuchMethodException.java,Java,,10,3,21,34
/jdk1.2.2/java/lang/NullPointerException.java,Java,,10,3,35,48
/jdk1.2.2/java/lang/Number.java,Java,,14,8,72,94
/jdk1.2.2/java/lang/NumberFormatException.java,Java,,10,3,25,38
/jdk1.2.2/java/lang/Object.java,Java,,36,17,413,466
/jdk1.2.2/java/lang/OutOfMemoryError.java,Java,,10,3,24,37
/jdk1.2.2/java/lang/Package.java,Java,,262,35,217,514
/jdk1.2.2/java/lang/Process.java,Java,,11,8,107,126
/jdk1.2.2/java/lang/ref/Finalizer.java,Java,,134,21,32,187
/jdk1.2.2/java/lang/ref/FinalReference.java,Java,,6,6,7,19
/jdk1.2.2/java/lang/ref/PhantomReference.java,Java,,9,7,44,60
/jdk1.2.2/java/lang/ref/Reference.java,Java,,71,29,107,207
/jdk1.2.2/java/lang/ref/ReferenceQueue.java,Java,,61,14,48,123
/jdk1.2.2/java/lang/ref/SoftReference.java,Java,,18,10,67,95
/jdk1.2.2/java/lang/ref/WeakReference.java,Java,,9,7,37,53
/jdk1.2.2/java/lang/reflect/AccessibleObject.java,Java,,24,9,70,103
/jdk1.2.2/java/lang/reflect/Array.java,Java,,56,29,382,467
/jdk1.2.2/java/lang/reflect/Constructor.java,Java,,78,13,148,239
/jdk1.2.2/java/lang/reflect/Field.java,Java,,96,31,498,625
/jdk1.2.2/java/lang/reflect/InvocationTargetException.java,Java,,45,13,52,110
/jdk1.2.2/java/lang/reflect/Member.java,Java,,9,8,42,59
/jdk1.2.2/java/lang/reflect/Method.java,Java,,94,15,171,280
/jdk1.2.2/java/lang/reflect/Modifier.java,Java,,71,34,126,231
/jdk1.2.2/java/lang/reflect/ReflectPermission.java,Java,,10,5,61,76
/jdk1.2.2/java/lang/Runnable.java,Java,,5,2,44,51
/jdk1.2.2/java/lang/Runtime.java,Java,,119,32,369,520
/jdk1.2.2/java/lang/RuntimeException.java,Java,,10,3,29,42
/jdk1.2.2/java/lang/RuntimePermission.java,Java,,15,8,252,275
/jdk1.2.2/java/lang/SecurityException.java,Java,,9,2,23,34
/jdk1.2.2/java/lang/SecurityManager.java,Java,,336,69,1194,1599
/jdk1.2.2/java/lang/Short.java,Java,,104,30,175,309
/jdk1.2.2/java/lang/StackOverflowError.java,Java,,10,3,23,36
/jdk1.2.2/java/lang/String.java,Java,,698,109,1283,2090
/jdk1.2.2/java/lang/StringBuffer.java,Java,,301,55,720,1076
/jdk1.2.2/java/lang/StringIndexOutOfBoundsException.java,Java,,13,4,35,52
/jdk1.2.2/java/lang/System.java,Java,,148,41,631,820
/jdk1.2.2/java/lang/Thread.java,Java,,282,77,783,1142
/jdk1.2.2/java/lang/ThreadDeath.java,Java,,2,3,30,35
/jdk1.2.2/java/lang/ThreadGroup.java,Java,,439,43,443,925
/jdk1.2.2/java/lang/ThreadLocal.java,Java,,244,64,277,585
/jdk1.2.2/java/lang/Throwable.java,Java,,44,15,169,228
/jdk1.2.2/java/lang/UnknownError.java,Java,,10,3,23,36
/jdk1.2.2/java/lang/UnsatisfiedLinkError.java,Java,,10,3,24,37
/jdk1.2.2/java/lang/UnsupportedClassVersionError.java,Java,,10,3,23,36
/jdk1.2.2/java/lang/UnsupportedOperationException.java,Java,,8,3,20,31
/jdk1.2.2/java/lang/VerifyError.java,Java,,10,3,23,36
/jdk1.2.2/java/lang/VirtualMachineError.java,Java,,10,3,24,37
/jdk1.2.2/java/lang/Void.java,Java,,6,4,21,31
/jdk1.2.2/java/math/BigDecimal.java,Java,,267,78,537,882
/jdk1.2.2/java/math/BigInteger.java,Java,,748,208,780,1736
/jdk1.2.2/java/net/Authenticator.java,Java,,70,18,116,204
/jdk1.2.2/java/net/BindException.java,Java,,7,5,23,35
/jdk1.2.2/java/net/ConnectException.java,Java,,7,3,24,34
/jdk1.2.2/java/net/ContentHandler.java,Java,,5,3,42,50
/jdk1.2.2/java/net/ContentHandlerFactory.java,Java,,4,2,31,37
/jdk1.2.2/java/net/DatagramPacket.java,Java,,81,23,168,272
/jdk1.2.2/java/net/DatagramSocket.java,Java,,214,31,309,554
/jdk1.2.2/java/net/DatagramSocketImpl.java,Java,,26,20,68,114
/jdk1.2.2/java/net/FileNameMap.java,Java,,4,2,16,22
/jdk1.2.2/java/net/HttpURLConnection.java,Java,,110,29,126,265
/jdk1.2.2/java/net/InetAddress.java,Java,,357,76,315,748
/jdk1.2.2/java/net/JarURLConnection.java,Java,,55,24,216,295
/jdk1.2.2/java/net/MalformedURLException.java,Java,,9,4,24,37
/jdk1.2.2/java/net/MulticastSocket.java,Java,,102,17,217,336
/jdk1.2.2/java/net/NetPermission.java,Java,,15,8,93,116
/jdk1.2.2/java/net/NoRouteToHostException.java,Java,,7,3,24,34
/jdk1.2.2/java/net/PasswordAuthentication.java,Java,,15,9,41,65
/jdk1.2.2/java/net/PlainDatagramSocketImpl.java,Java,,95,28,77,200
/jdk1.2.2/java/net/PlainSocketImpl.java,Java,,281,70,116,467
/jdk1.2.2/java/net/ProtocolException.java,Java,,10,4,23,37
/jdk1.2.2/java/net/ServerSocket.java,Java,,104,22,217,343
/jdk1.2.2/java/net/Socket.java,Java,,198,36,354,588
/jdk1.2.2/java/net/SocketException.java,Java,,10,4,23,37
/jdk1.2.2/java/net/SocketImpl.java,Java,,43,22,134,199
/jdk1.2.2/java/net/SocketImplFactory.java,Java,,5,2,24,31
/jdk1.2.2/java/net/SocketInputStream.java,Java,,68,16,70,154
/jdk1.2.2/java/net/SocketOptions.java,Java,,14,27,207,248
/jdk1.2.2/java/net/SocketOutputStream.java,Java,,32,13,55,100
/jdk1.2.2/java/net/SocketPermission.java,Java,,510,156,412,1078
/jdk1.2.2/java/net/UnknownHostException.java,Java,,10,4,23,37
/jdk1.2.2/java/net/UnknownServiceException.java,Java,,9,4,26,39
/jdk1.2.2/java/net/URL.java,Java,,324,72,569,965
/jdk1.2.2/java/net/URLClassLoader.java,Java,,310,35,210,555
/jdk1.2.2/java/net/URLConnection.java,Java,,401,89,803,1293
/jdk1.2.2/java/net/URLDecoder.java,Java,,31,7,30,68
/jdk1.2.2/java/net/URLEncoder.java,Java,,67,9,41,117
/jdk1.2.2/java/net/URLStreamHandler.java,Java,,91,7,93,191
/jdk1.2.2/java/net/URLStreamHandlerFactory.java,Java,,4,2,28,34
/jdk1.2.2/java/rmi/AccessException.java,Java,,10,5,38,53
/jdk1.2.2/java/rmi/activation/Activatable.java,Java,,161,28,308,497
/jdk1.2.2/java/rmi/activation/ActivateFailedException.java,Java,,10,5,30,45
/jdk1.2.2/java/rmi/activation/ActivationDesc.java,Java,,99,22,181,302
/jdk1.2.2/java/rmi/activation/ActivationException.java,Java,,47,11,60,118
/jdk1.2.2/java/rmi/activation/ActivationGroup.java,Java,,174,34,297,505
/jdk1.2.2/java/rmi/activation/ActivationGroupDesc.java,Java,,121,32,180,333
/jdk1.2.2/java/rmi/activation/ActivationGroupID.java,Java,,26,9,63,98
/jdk1.2.2/java/rmi/activation/ActivationID.java,Java,,76,18,104,198
/jdk1.2.2/java/rmi/activation/ActivationInstantiator.java,Java,,8,5,46,59
/jdk1.2.2/java/rmi/activation/ActivationMonitor.java,Java,,15,9,68,92
/jdk1.2.2/java/rmi/activation/ActivationSystem.java,Java,,32,14,157,203
/jdk1.2.2/java/rmi/activation/Activator.java,Java,,9,4,83,96
/jdk1.2.2/java/rmi/activation/UnknownGroupException.java,Java,,7,4,32,43
/jdk1.2.2/java/rmi/activation/UnknownObjectException.java,Java,,7,4,34,45
/jdk1.2.2/java/rmi/AlreadyBoundException.java,Java,,10,4,31,45
/jdk1.2.2/java/rmi/ConnectException.java,Java,,10,5,30,45
/jdk1.2.2/java/rmi/ConnectIOException.java,Java,,10,6,31,47
/jdk1.2.2/java/rmi/dgc/DGC.java,Java,,9,4,72,85
/jdk1.2.2/java/rmi/dgc/Lease.java,Java,,19,6,30,55
/jdk1.2.2/java/rmi/dgc/VMID.java,Java,,83,18,57,158
/jdk1.2.2/java/rmi/MarshalException.java,Java,,10,5,39,54
/jdk1.2.2/java/rmi/MarshalledObject.java,Java,,106,28,157,291
/jdk1.2.2/java/rmi/Naming.java,Java,,97,24,130,251
/jdk1.2.2/java/rmi/NoSuchObjectException.java,Java,,7,4,34,45
/jdk1.2.2/java/rmi/NotBoundException.java,Java,,10,4,33,47
/jdk1.2.2/java/rmi/registry/LocateRegistry.java,Java,,64,15,114,193
/jdk1.2.2/java/rmi/registry/Registry.java,Java,,15,8,99,122
/jdk1.2.2/java/rmi/registry/RegistryHandler.java,Java,,8,5,30,43
/jdk1.2.2/java/rmi/Remote.java,Java,,2,2,29,33
/jdk1.2.2/java/rmi/RemoteException.java,Java,,47,11,65,123
/jdk1.2.2/java/rmi/RMISecurityException.java,Java,,10,4,31,45
/jdk1.2.2/java/rmi/RMISecurityManager.java,Java,,6,4,31,41
/jdk1.2.2/java/rmi/server/ExportException.java,Java,,10,6,35,51
/jdk1.2.2/java/rmi/server/LoaderHandler.java,Java,,11,7,56,74
/jdk1.2.2/java/rmi/server/LogStream.java,Java,,107,25,92,224
/jdk1.2.2/java/rmi/server/ObjID.java,Java,,70,19,88,177
/jdk1.2.2/java/rmi/server/Operation.java,Java,,13,5,32,50
/jdk1.2.2/java/rmi/server/RemoteCall.java,Java,,16,10,78,104
/jdk1.2.2/java/rmi/server/RemoteObject.java,Java,,81,15,111,207
/jdk1.2.2/java/rmi/server/RemoteRef.java,Java,,19,14,141,174
/jdk1.2.2/java/rmi/server/RemoteServer.java,Java,,50,9,49,108
/jdk1.2.2/java/rmi/server/RemoteStub.java,Java,,13,5,38,56
/jdk1.2.2/java/rmi/server/RMIClassLoader.java,Java,,28,8,84,120
/jdk1.2.2/java/rmi/server/RMIClientSocketFactory.java,Java,,7,4,39,50
/jdk1.2.2/java/rmi/server/RMIFailureHandler.java,Java,,4,5,35,44
/jdk1.2.2/java/rmi/server/RMIServerSocketFactory.java,Java,,7,4,39,50
/jdk1.2.2/java/rmi/server/RMISocketFactory.java,Java,,52,12,96,160
/jdk1.2.2/java/rmi/server/ServerCloneException.java,Java,,46,10,58,114
/jdk1.2.2/java/rmi/server/ServerNotActiveException.java,Java,,9,5,30,44
/jdk1.2.2/java/rmi/server/ServerRef.java,Java,,8,6,35,49
/jdk1.2.2/java/rmi/server/Skeleton.java,Java,,7,3,35,45
/jdk1.2.2/java/rmi/server/SkeletonMismatchException.java,Java,,8,6,29,43
/jdk1.2.2/java/rmi/server/SkeletonNotFoundException.java,Java,,11,6,35,52
/jdk1.2.2/java/rmi/server/SocketSecurityException.java,Java,,10,6,37,53
/jdk1.2.2/java/rmi/server/UID.java,Java,,85,17,87,189
/jdk1.2.2/java/rmi/server/UnicastRemoteObject.java,Java,,113,26,133,272
/jdk1.2.2/java/rmi/server/Unreferenced.java,Java,,4,2,22,28
/jdk1.2.2/java/rmi/ServerError.java,Java,,7,4,26,37
/jdk1.2.2/java/rmi/ServerException.java,Java,,10,5,31,46
/jdk1.2.2/java/rmi/ServerRuntimeException.java,Java,,7,4,28,39
/jdk1.2.2/java/rmi/StubNotFoundException.java,Java,,10,5,36,51
/jdk1.2.2/java/rmi/UnexpectedException.java,Java,,10,5,32,47
/jdk1.2.2/java/rmi/UnknownHostException.java,Java,,10,5,30,45
/jdk1.2.2/java/rmi/UnmarshalException.java,Java,,10,5,44,59
/jdk1.2.2/java/security/AccessControlContext.java,Java,,247,73,151,471
/jdk1.2.2/java/security/AccessControlException.java,Java,,14,8,42,64
/jdk1.2.2/java/security/AccessController.java,Java,,43,23,333,399
/jdk1.2.2/java/security/acl/Acl.java,Java,,16,28,192,236
/jdk1.2.2/java/security/acl/AclEntry.java,Java,,15,15,104,134
/jdk1.2.2/java/security/acl/AclNotFoundException.java,Java,,5,4,15,24
/jdk1.2.2/java/security/acl/Group.java,Java,,9,9,51,69
/jdk1.2.2/java/security/acl/LastOwnerException.java,Java,,5,3,17,25
/jdk1.2.2/java/security/acl/NotOwnerException.java,Java,,5,3,16,24
/jdk1.2.2/java/security/acl/Owner.java,Java,,9,7,61,77
/jdk1.2.2/java/security/acl/Permission.java,Java,,5,6,25,36
/jdk1.2.2/java/security/AlgorithmParameterGenerator.java,Java,,65,17,159,241
/jdk1.2.2/java/security/AlgorithmParameterGeneratorSpi.java,Java,,9,7,53,69
/jdk1.2.2/java/security/AlgorithmParameters.java,Java,,95,20,200,315
/jdk1.2.2/java/security/AlgorithmParametersSpi.java,Java,,19,11,103,133
/jdk1.2.2/java/security/AllPermission.java,Java,,64,30,110,204
/jdk1.2.2/java/security/BasicPermission.java,Java,,131,52,187,370
/jdk1.2.2/java/security/cert/Certificate.java,Java,,57,15,109,181
/jdk1.2.2/java/security/cert/CertificateEncodingException.java,Java,,9,4,25,38
/jdk1.2.2/java/security/cert/CertificateException.java,Java,,10,5,24,39
/jdk1.2.2/java/security/cert/CertificateExpiredException.java,Java,,9,4,27,40
/jdk1.2.2/java/security/cert/CertificateFactory.java,Java,,118,19,257,394
/jdk1.2.2/java/security/cert/CertificateFactorySpi.java,Java,,16,8,157,181
/jdk1.2.2/java/security/cert/CertificateNotYetValidException.java,Java,,9,4,27,40
/jdk1.2.2/java/security/cert/CertificateParsingException.java,Java,,9,4,26,39
/jdk1.2.2/java/security/cert/CRL.java,Java,,12,8,51,71
/jdk1.2.2/java/security/cert/CRLException.java,Java,,10,5,24,39
/jdk1.2.2/java/security/cert/X509Certificate.java,Java,,31,22,361,414
/jdk1.2.2/java/security/cert/X509CRL.java,Java,,67,23,273,363
/jdk1.2.2/java/security/cert/X509CRLEntry.java,Java,,40,13,84,137
/jdk1.2.2/java/security/cert/X509Extension.java,Java,,8,8,151,167
/jdk1.2.2/java/security/Certificate.java,Java,,14,11,111,136
/jdk1.2.2/java/security/CodeSource.java,Java,,216,42,217,475
/jdk1.2.2/java/security/DigestException.java,Java,,9,4,24,37
/jdk1.2.2/java/security/DigestInputStream.java,Java,,41,18,114,173
/jdk1.2.2/java/security/DigestOutputStream.java,Java,,39,16,101,156
/jdk1.2.2/java/security/GeneralSecurityException.java,Java,,9,5,29,43
/jdk1.2.2/java/security/Guard.java,Java,,4,4,31,39
/jdk1.2.2/java/security/GuardedObject.java,Java,,24,10,49,83
/jdk1.2.2/java/security/Identity.java,Java,,172,39,256,467
/jdk1.2.2/java/security/IdentityScope.java,Java,,67,26,141,234
/jdk1.2.2/java/security/interfaces/DSAKey.java,Java,,4,3,26,33
/jdk1.2.2/java/security/interfaces/DSAKeyPairGenerator.java,Java,,8,5,79,92
/jdk1.2.2/java/security/interfaces/DSAParams.java,Java,,7,6,34,47
/jdk1.2.2/java/security/interfaces/DSAPrivateKey.java,Java,,6,7,24,37
/jdk1.2.2/java/security/interfaces/DSAPublicKey.java,Java,,6,7,24,37
/jdk1.2.2/java/security/interfaces/RSAPrivateCrtKey.java,Java,,10,10,46,66
/jdk1.2.2/java/security/interfaces/RSAPrivateKey.java,Java,,6,6,25,37
/jdk1.2.2/java/security/interfaces/RSAPublicKey.java,Java,,6,6,23,35
/jdk1.2.2/java/security/InvalidAlgorithmParameterException.java,Java,,10,5,32,47
/jdk1.2.2/java/security/InvalidKeyException.java,Java,,9,6,25,40
/jdk1.2.2/java/security/InvalidParameterException.java,Java,,9,5,25,39
/jdk1.2.2/java/security/Key.java,Java,,7,7,90,104
/jdk1.2.2/java/security/KeyException.java,Java,,9,5,27,41
/jdk1.2.2/java/security/KeyFactory.java,Java,,56,16,163,235
/jdk1.2.2/java/security/KeyFactorySpi.java,Java,,13,9,100,122
/jdk1.2.2/java/security/KeyManagementException.java,Java,,9,5,35,49
/jdk1.2.2/java/security/KeyPair.java,Java,,16,8,38,62
/jdk1.2.2/java/security/KeyPairGenerator.java,Java,,88,26,274,388
/jdk1.2.2/java/security/KeyPairGeneratorSpi.java,Java,,11,7,66,84
/jdk1.2.2/java/security/KeyStore.java,Java,,197,31,410,638
/jdk1.2.2/java/security/KeyStoreException.java,Java,,9,5,27,41
/jdk1.2.2/java/security/KeyStoreSpi.java,Java,,34,20,211,265
/jdk1.2.2/java/security/MessageDigest.java,Java,,187,38,241,466
/jdk1.2.2/java/security/MessageDigestSpi.java,Java,,35,12,107,154
/jdk1.2.2/java/security/NoSuchAlgorithmException.java,Java,,9,5,26,40
/jdk1.2.2/java/security/NoSuchProviderException.java,Java,,9,5,25,39
/jdk1.2.2/java/security/Permission.java,Java,,25,22,161,208
/jdk1.2.2/java/security/PermissionCollection.java,Java,,29,12,123,164
/jdk1.2.2/java/security/Permissions.java,Java,,167,60,182,409
/jdk1.2.2/java/security/Policy.java,Java,,60,18,131,209
/jdk1.2.2/java/security/Principal.java,Java,,7,6,42,55
/jdk1.2.2/java/security/PrivateKey.java,Java,,4,3,28,35
/jdk1.2.2/java/security/PrivilegedAction.java,Java,,4,4,30,38
/jdk1.2.2/java/security/PrivilegedActionException.java,Java,,36,9,54,99
/jdk1.2.2/java/security/PrivilegedExceptionAction.java,Java,,4,5,35,44
/jdk1.2.2/java/security/ProtectionDomain.java,Java,,29,12,56,97
/jdk1.2.2/java/security/Provider.java,Java,,100,33,218,351
/jdk1.2.2/java/security/ProviderException.java,Java,,9,5,25,39
/jdk1.2.2/java/security/PublicKey.java,Java,,4,3,25,32
/jdk1.2.2/java/security/SecureClassLoader.java,Java,,74,17,83,174
/jdk1.2.2/java/security/SecureRandom.java,Java,,126,29,298,453
/jdk1.2.2/java/security/SecureRandomSpi.java,Java,,6,6,38,50
/jdk1.2.2/java/security/Security.java,Java,,390,70,305,765
/jdk1.2.2/java/security/SecurityPermission.java,Java,,15,8,244,267
/jdk1.2.2/java/security/Signature.java,Java,,225,58,386,669
/jdk1.2.2/java/security/SignatureException.java,Java,,9,6,24,39
/jdk1.2.2/java/security/SignatureSpi.java,Java,,53,25,210,288
/jdk1.2.2/java/security/SignedObject.java,Java,,57,15,165,237
/jdk1.2.2/java/security/Signer.java,Java,,58,17,88,163
/jdk1.2.2/java/security/spec/AlgorithmParameterSpec.java,Java,,2,3,22,27
/jdk1.2.2/java/security/spec/DSAParameterSpec.java,Java,,22,9,41,72
/jdk1.2.2/java/security/spec/DSAPrivateKeySpec.java,Java,,27,10,52,89
/jdk1.2.2/java/security/spec/DSAPublicKeySpec.java,Java,,27,10,52,89
/jdk1.2.2/java/security/spec/EncodedKeySpec.java,Java,,11,7,46,64
/jdk1.2.2/java/security/spec/InvalidKeySpecException.java,Java,,10,6,29,45
/jdk1.2.2/java/security/spec/InvalidParameterSpecException.java,Java,,10,6,31,47
/jdk1.2.2/java/security/spec/KeySpec.java,Java,,2,3,40,45
/jdk1.2.2/java/security/spec/PKCS8EncodedKeySpec.java,Java,,12,6,39,57
/jdk1.2.2/java/security/spec/RSAPrivateCrtKeySpec.java,Java,,46,12,52,110
/jdk1.2.2/java/security/spec/RSAPrivateKeySpec.java,Java,,16,8,30,54
/jdk1.2.2/java/security/spec/RSAPublicKeySpec.java,Java,,16,8,30,54
/jdk1.2.2/java/security/spec/X509EncodedKeySpec.java,Java,,12,6,39,57
/jdk1.2.2/java/security/UnrecoverableKeyException.java,Java,,9,5,23,37
/jdk1.2.2/java/security/UnresolvedPermission.java,Java,,217,37,177,431
/jdk1.2.2/java/security/UnresolvedPermissionCollection.java,Java,,49,16,43,108
/jdk1.2.2/java/sql/Array.java,Java,,15,16,192,223
/jdk1.2.2/java/sql/BatchUpdateException.java,Java,,29,10,72,111
/jdk1.2.2/java/sql/Blob.java,Java,,8,10,88,106
/jdk1.2.2/java/sql/CallableStatement.java,Java,,40,39,401,480
/jdk1.2.2/java/sql/Clob.java,Java,,9,9,89,107
/jdk1.2.2/java/sql/Connection.java,Java,,37,41,357,435
/jdk1.2.2/java/sql/DatabaseMetaData.java,Java,,222,201,2028,2451
/jdk1.2.2/java/sql/DataTruncation.java,Java,,38,15,75,128
/jdk1.2.2/java/sql/Date.java,Java,,68,24,103,195
/jdk1.2.2/java/sql/Driver.java,Java,,11,12,107,130
/jdk1.2.2/java/sql/DriverManager.java,Java,,237,65,206,508
/jdk1.2.2/java/sql/DriverPropertyInfo.java,Java,,12,9,43,64
/jdk1.2.2/java/sql/PreparedStatement.java,Java,,54,51,469,574
/jdk1.2.2/java/sql/Ref.java,Java,,4,5,21,30
/jdk1.2.2/java/sql/ResultSet.java,Java,,162,164,1670,1996
/jdk1.2.2/java/sql/ResultSetMetaData.java,Java,,27,28,179,234
/jdk1.2.2/java/sql/SQLData.java,Java,,6,7,64,77
/jdk1.2.2/java/sql/SQLException.java,Java,,65,14,79,158
/jdk1.2.2/java/sql/SQLInput.java,Java,,25,29,182,236
/jdk1.2.2/java/sql/SQLOutput.java,Java,,25,29,184,238
/jdk1.2.2/java/sql/SQLWarning.java,Java,,32,11,57,100
/jdk1.2.2/java/sql/Statement.java,Java,,31,35,339,405
/jdk1.2.2/java/sql/Struct.java,Java,,6,8,62,76
/jdk1.2.2/java/sql/Time.java,Java,,77,22,102,201
/jdk1.2.2/java/sql/Timestamp.java,Java,,207,29,138,374
/jdk1.2.2/java/sql/Types.java,Java,,32,23,55,110
/jdk1.2.2/java/text/Annotation.java,Java,,13,8,44,65
/jdk1.2.2/java/text/AttributedCharacterIterator.java,Java,,53,28,137,218
/jdk1.2.2/java/text/AttributedString.java,Java,,638,115,200,953
/jdk1.2.2/java/text/BreakIterator.java,Java,,82,27,370,479
/jdk1.2.2/java/text/CharacterBreakData.java,Java,,159,20,87,266
/jdk1.2.2/java/text/CharacterIterator.java,Java,,15,17,162,194
/jdk1.2.2/java/text/ChoiceFormat.java,Java,,233,30,283,546
/jdk1.2.2/java/text/CollationElementIterator.java,Java,,217,33,207,457
/jdk1.2.2/java/text/CollationKey.java,Java,,45,17,146,208
/jdk1.2.2/java/text/CollationRules.java,Java,,205,11,56,272
/jdk1.2.2/java/text/Collator.java,Java,,118,31,356,505
/jdk1.2.2/java/text/CompactByteArray.java,Java,,196,18,141,355
/jdk1.2.2/java/text/CompactCharArray.java,Java,,198,23,141,362
/jdk1.2.2/java/text/CompactIntArray.java,Java,,180,27,136,343
/jdk1.2.2/java/text/CompactShortArray.java,Java,,244,36,168,448
/jdk1.2.2/java/text/CompactStringArray.java,Java,,306,13,138,457
/jdk1.2.2/java/text/DateFormat.java,Java,,178,39,436,653
/jdk1.2.2/java/text/DateFormatSymbols.java,Java,,205,49,297,551
/jdk1.2.2/java/text/DecimalFormat.java,Java,,928,164,839,1931
/jdk1.2.2/java/text/DecimalFormatSymbols.java,Java,,200,64,262,526
/jdk1.2.2/java/text/DigitList.java,Java,,265,59,272,596
/jdk1.2.2/java/text/EntryPair.java,Java,,15,4,40,59
/jdk1.2.2/java/text/FieldPosition.java,Java,,43,14,109,166
/jdk1.2.2/java/text/Format.java,Java,,28,7,188,223
/jdk1.2.2/java/text/IntHashtable.java,Java,,166,30,88,284
/jdk1.2.2/java/text/LineBreakData.java,Java,,289,14,115,418
/jdk1.2.2/java/text/MergeCollation.java,Java,,176,30,118,324
/jdk1.2.2/java/text/MessageFormat.java,Java,,493,50,401,944
/jdk1.2.2/java/text/Normalizer.java,Java,,1631,105,286,2022
/jdk1.2.2/java/text/NumberFormat.java,Java,,212,61,516,789
/jdk1.2.2/java/text/ParseException.java,Java,,12,6,61,79
/jdk1.2.2/java/text/ParsePosition.java,Java,,38,12,88,138
/jdk1.2.2/java/text/PatternEntry.java,Java,,202,27,71,300
/jdk1.2.2/java/text/resources/DateFormatZoneData.java,Java,,32,4,65,101
/jdk1.2.2/java/text/resources/DateFormatZoneData_en.java,Java,,72,4,199,275
/jdk1.2.2/java/text/resources/DateFormatZoneData_en_US.java,Java,,108,4,197,309
/jdk1.2.2/java/text/resources/LocaleData.java,Java,,150,17,80,247
/jdk1.2.2/java/text/resources/LocaleElements.java,Java,,489,6,64,559
/jdk1.2.2/java/text/resources/LocaleElements_en.java,Java,,15,6,59,80
/jdk1.2.2/java/text/resources/LocaleElements_en_US.java,Java,,25,6,54,85
/jdk1.2.2/java/text/RuleBasedCollator.java,Java,,542,93,619,1254
/jdk1.2.2/java/text/SentenceBreakData.java,Java,,223,35,111,369
/jdk1.2.2/java/text/SimpleDateFormat.java,Java,,727,88,521,1336
/jdk1.2.2/java/text/SimpleTextBoundary.java,Java,,199,33,128,360
/jdk1.2.2/java/text/SpecialMapping.java,Java,,17,6,63,86
/jdk1.2.2/java/text/StringCharacterIterator.java,Java,,129,26,123,278
/jdk1.2.2/java/text/TextBoundaryData.java,Java,,257,10,46,313
/jdk1.2.2/java/text/UnicodeClassMapping.java,Java,,43,8,60,111
/jdk1.2.2/java/text/Utility.java,Java,,273,30,160,463
/jdk1.2.2/java/text/WordBreakData.java,Java,,286,38,113,437
/jdk1.2.2/java/text/WordBreakTable.java,Java,,31,9,71,111
/jdk1.2.2/java/util/AbstractCollection.java,Java,,122,27,301,450
/jdk1.2.2/java/util/AbstractList.java,Java,,330,76,446,852
/jdk1.2.2/java/util/AbstractMap.java,Java,,200,41,330,571
/jdk1.2.2/java/util/AbstractSequentialList.java,Java,,53,14,189,256
/jdk1.2.2/java/util/AbstractSet.java,Java,,25,8,65,98
/jdk1.2.2/java/util/ArrayList.java,Java,,193,52,280,525
/jdk1.2.2/java/util/Arrays.java,Java,,989,210,1000,2199
/jdk1.2.2/java/util/BitSet.java,Java,,194,56,250,500
/jdk1.2.2/java/util/Calendar.java,Java,,414,105,968,1487
/jdk1.2.2/java/util/Collection.java,Java,,18,24,308,350
/jdk1.2.2/java/util/Collections.java,Java,,815,162,702,1679
/jdk1.2.2/java/util/Comparator.java,Java,,5,4,123,132
/jdk1.2.2/java/util/ConcurrentModificationException.java,Java,,8,3,40,51
/jdk1.2.2/java/util/Date.java,Java,,405,47,732,1184
/jdk1.2.2/java/util/Dictionary.java,Java,,13,9,116,138
/jdk1.2.2/java/util/EmptyStackException.java,Java,,6,2,19,27
/jdk1.2.2/java/util/Enumeration.java,Java,,5,3,56,64
/jdk1.2.2/java/util/EventListener.java,Java,,3,2,9,14
/jdk1.2.2/java/util/EventObject.java,Java,,15,7,33,55
/jdk1.2.2/java/util/GregorianCalendar.java,Java,,777,190,963,1930
/jdk1.2.2/java/util/HashMap.java,Java,,429,88,285,802
/jdk1.2.2/java/util/HashSet.java,Java,,71,24,148,243
/jdk1.2.2/java/util/Hashtable.java,Java,,461,93,373,927
/jdk1.2.2/java/util/Iterator.java,Java,,6,4,52,62
/jdk1.2.2/java/util/jar/Attributes.java,Java,,220,52,266,538
/jdk1.2.2/java/util/jar/JarEntry.java,Java,,26,8,46,80
/jdk1.2.2/java/util/jar/JarException.java,Java,,9,3,21,33
/jdk1.2.2/java/util/jar/JarFile.java,Java,,162,24,93,279
/jdk1.2.2/java/util/jar/JarInputStream.java,Java,,88,16,73,177
/jdk1.2.2/java/util/jar/JarOutputStream.java,Java,,58,10,62,130
/jdk1.2.2/java/util/jar/JarVerifier.java,Java,,250,62,88,400
/jdk1.2.2/java/util/jar/Manifest.java,Java,,240,35,104,379
/jdk1.2.2/java/util/LinkedList.java,Java,,300,66,299,665
/jdk1.2.2/java/util/List.java,Java,,28,41,432,501
/jdk1.2.2/java/util/ListIterator.java,Java,,12,13,131,156
/jdk1.2.2/java/util/ListResourceBundle.java,Java,,59,12,139,210
/jdk1.2.2/java/util/Locale.java,Java,,505,113,606,1224
/jdk1.2.2/java/util/Map.java,Java,,24,27,313,364
/jdk1.2.2/java/util/MissingResourceException.java,Java,,17,9,67,93
/jdk1.2.2/java/util/NoSuchElementException.java,Java,,10,3,28,41
/jdk1.2.2/java/util/Observable.java,Java,,45,15,133,193
/jdk1.2.2/java/util/Observer.java,Java,,4,1,25,30
/jdk1.2.2/java/util/Properties.java,Java,,252,34,263,549
/jdk1.2.2/java/util/PropertyPermission.java,Java,,216,86,239,541
/jdk1.2.2/java/util/PropertyResourceBundle.java,Java,,46,10,106,162
/jdk1.2.2/java/util/Random.java,Java,,81,24,330,435
/jdk1.2.2/java/util/ResourceBundle.java,Java,,259,48,393,700
/jdk1.2.2/java/util/Set.java,Java,,18,26,229,273
/jdk1.2.2/java/util/SimpleTimeZone.java,Java,,493,79,739,1311
/jdk1.2.2/java/util/SortedMap.java,Java,,9,8,192,209
/jdk1.2.2/java/util/SortedSet.java,Java,,9,8,190,207
/jdk1.2.2/java/util/Stack.java,Java,,34,13,71,118
/jdk1.2.2/java/util/StringTokenizer.java,Java,,85,19,160,264
/jdk1.2.2/java/util/TimeZone.java,Java,,765,55,1167,1987
/jdk1.2.2/java/util/TooManyListenersException.java,Java,,9,8,36,53
/jdk1.2.2/java/util/TreeMap.java,Java,,866,164,583,1613
/jdk1.2.2/java/util/TreeSet.java,Java,,99,33,309,441
/jdk1.2.2/java/util/Vector.java,Java,,320,71,588,979
/jdk1.2.2/java/util/WeakHashMap.java,Java,,184,66,180,430
/jdk1.2.2/java/util/zip/Adler32.java,Java,,35,11,36,82
/jdk1.2.2/java/util/zip/CheckedInputStream.java,Java,,42,8,43,93
/jdk1.2.2/java/util/zip/CheckedOutputStream.java,Java,,23,7,36,66
/jdk1.2.2/java/util/zip/Checksum.java,Java,,8,5,24,37
/jdk1.2.2/java/util/zip/CRC32.java,Java,,34,11,34,79
/jdk1.2.2/java/util/zip/DataFormatException.java,Java,,10,3,20,33
/jdk1.2.2/java/util/zip/Deflater.java,Java,,150,32,165,347
/jdk1.2.2/java/util/zip/DeflaterOutputStream.java,Java,,60,12,66,138
/jdk1.2.2/java/util/zip/GZIPInputStream.java,Java,,115,18,84,217
/jdk1.2.2/java/util/zip/GZIPOutputStream.java,Java,,55,13,62,130
/jdk1.2.2/java/util/zip/Inflater.java,Java,,120,22,140,282
/jdk1.2.2/java/util/zip/InflaterInputStream.java,Java,,103,17,87,207
/jdk1.2.2/java/util/zip/ZipConstants.java,Java,,43,7,31,81
/jdk1.2.2/java/util/zip/ZipEntry.java,Java,,146,33,124,303
/jdk1.2.2/java/util/zip/ZipException.java,Java,,11,6,24,41
/jdk1.2.2/java/util/zip/ZipFile.java,Java,,211,32,84,327
/jdk1.2.2/java/util/zip/ZipInputStream.java,Java,,264,21,109,394
/jdk1.2.2/java/util/zip/ZipOutputStream.java,Java,,332,24,122,478
/jdk1.2.2/javax/accessibility/Accessible.java,Java,,4,3,26,33
/jdk1.2.2/javax/accessibility/AccessibleAction.java,Java,,6,5,48,59
/jdk1.2.2/javax/accessibility/AccessibleBundle.java,Java,,37,10,61,108
/jdk1.2.2/javax/accessibility/AccessibleComponent.java,Java,,32,30,236,298
/jdk1.2.2/javax/accessibility/AccessibleContext.java,Java,,85,38,381,504
/jdk1.2.2/javax/accessibility/AccessibleHyperlink.java,Java,,15,13,96,124
/jdk1.2.2/javax/accessibility/AccessibleHypertext.java,Java,,10,8,46,64
/jdk1.2.2/javax/accessibility/AccessibleResourceBundle.java,Java,,82,5,41,128
/jdk1.2.2/javax/accessibility/AccessibleRole.java,Java,,103,70,338,511
/jdk1.2.2/javax/accessibility/AccessibleSelection.java,Java,,10,9,78,97
/jdk1.2.2/javax/accessibility/AccessibleState.java,Java,,62,32,226,320
/jdk1.2.2/javax/accessibility/AccessibleStateSet.java,Java,,86,14,81,181
/jdk1.2.2/javax/accessibility/AccessibleText.java,Java,,21,19,125,165
/jdk1.2.2/javax/accessibility/AccessibleValue.java,Java,,7,7,61,75
/jdk1.2.2/javax/swing/AbstractAction.java,Java,,223,31,155,409
/jdk1.2.2/javax/swing/AbstractButton.java,Java,[PENDING:  WDW -- need to provide a localized string,702,134,600,1436
/jdk1.2.2/javax/swing/AbstractListModel.java,Java,,52,16,69,137
/jdk1.2.2/javax/swing/Action.java,Java,,17,6,138,161
/jdk1.2.2/javax/swing/AncestorNotifier.java,Java,,142,30,43,215
/jdk1.2.2/javax/swing/AppContext.java,Java,,61,16,157,234
/jdk1.2.2/javax/swing/Autoscroller.java,Java,,73,17,10,100
/jdk1.2.2/javax/swing/border/AbstractBorder.java,Java,,33,9,34,76
/jdk1.2.2/javax/swing/border/BevelBorder.java,Java,,106,34,80,220
/jdk1.2.2/javax/swing/border/Border.java,Java,,11,4,54,69
/jdk1.2.2/javax/swing/border/CompoundBorder.java,Java,,66,16,73,155
/jdk1.2.2/javax/swing/border/EmptyBorder.java,Java,,35,9,47,91
/jdk1.2.2/javax/swing/border/EtchedBorder.java,Java,,59,20,83,162
/jdk1.2.2/javax/swing/border/LineBorder.java,Java,,63,16,70,149
/jdk1.2.2/javax/swing/border/MatteBorder.java,Java,,106,20,64,190
/jdk1.2.2/javax/swing/border/SoftBevelBorder.java,Java,,62,19,60,141
/jdk1.2.2/javax/swing/border/TitledBorder.java,Java,,356,62,184,602
/jdk1.2.2/javax/swing/BorderFactory.java,Java,,108,28,255,391
/jdk1.2.2/javax/swing/BoundedRangeModel.java,Java,,18,30,194,242
/jdk1.2.2/javax/swing/Box.java,Java,,345,104,708,1157
/jdk1.2.2/javax/swing/BoxLayout.java,Java,,149,33,201,383
/jdk1.2.2/javax/swing/ButtonGroup.java,Java,,48,12,57,117
/jdk1.2.2/javax/swing/ButtonModel.java,Java,,27,25,156,208
/jdk1.2.2/javax/swing/CellEditor.java,Java,,12,10,105,127
/jdk1.2.2/javax/swing/CellRendererPane.java,Java,,199,70,299,568
/jdk1.2.2/javax/swing/colorchooser/AbstractColorChooserPanel.java,Java,,52,16,41,109
/jdk1.2.2/javax/swing/colorchooser/CenterLayout.java,Java,,41,9,12,62
/jdk1.2.2/javax/swing/colorchooser/ColorChooserComponentFactory.java,Java,,14,10,21,45
/jdk1.2.2/javax/swing/colorchooser/ColorSelectionModel.java,Java,,10,6,32,48
/jdk1.2.2/javax/swing/colorchooser/DefaultColorSelectionModel.java,Java,,43,15,37,95
/jdk1.2.2/javax/swing/colorchooser/DefaultHSBChooserPanel.java,Java,,557,159,26,742
/jdk1.2.2/javax/swing/colorchooser/DefaultPreviewPanel.java,Java,,139,49,20,208
/jdk1.2.2/javax/swing/colorchooser/DefaultRGBChooserPanel.java,Java,,148,48,33,229
/jdk1.2.2/javax/swing/colorchooser/DefaultSwatchChooserPanel.java,Java,,489,66,23,578
/jdk1.2.2/javax/swing/colorchooser/JIntegerTextField.java,Java,,122,38,12,172
/jdk1.2.2/javax/swing/colorchooser/SmartGridLayout.java,Java,,94,48,15,157
/jdk1.2.2/javax/swing/colorchooser/SyntheticImage.java,Java,,98,21,35,154
/jdk1.2.2/javax/swing/ComboBoxEditor.java,Java,,11,8,20,39
/jdk1.2.2/javax/swing/ComboBoxModel.java,Java,,5,4,18,27
/jdk1.2.2/javax/swing/DebugGraphics.java,Java,,1041,191,237,1469
/jdk1.2.2/javax/swing/DebugGraphicsFilter.java,Java,,13,5,11,29
/jdk1.2.2/javax/swing/DebugGraphicsInfo.java,Java,,32,9,12,53
/jdk1.2.2/javax/swing/DebugGraphicsObserver.java,Java,,19,6,11,36
/jdk1.2.2/javax/swing/DefaultBoundedRangeModel.java,Java,,133,51,165,349
/jdk1.2.2/javax/swing/DefaultButtonModel.java,Java,,168,52,214,434
/jdk1.2.2/javax/swing/DefaultCellEditor.java,Java,,166,48,118,332
/jdk1.2.2/javax/swing/DefaultComboBoxModel.java,Java,,96,25,46,167
/jdk1.2.2/javax/swing/DefaultDesktopManager.java,Java,,378,107,99,584
/jdk1.2.2/javax/swing/DefaultFocusManager.java,Java,,260,47,56,363
/jdk1.2.2/javax/swing/DefaultListCellRenderer.java,Java,,49,18,37,104
/jdk1.2.2/javax/swing/DefaultListModel.java,Java,,140,42,337,519
/jdk1.2.2/javax/swing/DefaultListSelectionModel.java,Java,,309,77,192,578
/jdk1.2.2/javax/swing/DefaultSingleSelectionModel.java,Java,,44,19,45,108
/jdk1.2.2/javax/swing/DesktopManager.java,Java,,19,11,69,99
/jdk1.2.2/javax/swing/event/AncestorEvent.java,Java,,25,7,52,84
/jdk1.2.2/javax/swing/event/AncestorListener.java,Java,,10,8,36,54
/jdk1.2.2/javax/swing/event/CaretEvent.java,Java,,9,7,37,53
/jdk1.2.2/javax/swing/event/CaretListener.java,Java,,5,5,18,28
/jdk1.2.2/javax/swing/event/CellEditorListener.java,Java,,7,7,15,29
/jdk1.2.2/javax/swing/event/ChangeEvent.java,Java,,7,4,26,37
/jdk1.2.2/javax/swing/event/ChangeListener.java,Java,,5,5,17,27
/jdk1.2.2/javax/swing/event/DocumentEvent.java,Java,,28,20,118,166
/jdk1.2.2/javax/swing/event/DocumentListener.java,Java,,7,5,49,61
/jdk1.2.2/javax/swing/event/EventListenerList.java,Java,,98,15,130,243
/jdk1.2.2/javax/swing/event/HyperlinkEvent.java,Java,,40,18,68,126
/jdk1.2.2/javax/swing/event/HyperlinkListener.java,Java,,5,5,17,27
/jdk1.2.2/javax/swing/event/InternalFrameAdapter.java,Java,,10,8,45,63
/jdk1.2.2/javax/swing/event/InternalFrameEvent.java,Java,,46,13,72,131
/jdk1.2.2/javax/swing/event/InternalFrameListener.java,Java,,11,9,50,70
/jdk1.2.2/javax/swing/event/ListDataEvent.java,Java,,20,11,54,85
/jdk1.2.2/javax/swing/event/ListDataListener.java,Java,,7,9,33,49
/jdk1.2.2/javax/swing/event/ListSelectionEvent.java,Java,,29,10,56,95
/jdk1.2.2/javax/swing/event/ListSelectionListener.java,Java,,6,8,19,33
/jdk1.2.2/javax/swing/event/MenuDragMouseEvent.java,Java,,24,7,52,83
/jdk1.2.2/javax/swing/event/MenuDragMouseListener.java,Java,,8,5,36,49
/jdk1.2.2/javax/swing/event/MenuEvent.java,Java,,7,4,28,39
/jdk1.2.2/javax/swing/event/MenuKeyEvent.java,Java,,23,7,48,78
/jdk1.2.2/javax/swing/event/MenuKeyListener.java,Java,,7,7,22,36
/jdk1.2.2/javax/swing/event/MenuListener.java,Java,,7,5,27,39
/jdk1.2.2/javax/swing/event/MouseInputAdapter.java,Java,,11,7,24,42
/jdk1.2.2/javax/swing/event/MouseInputListener.java,Java,,5,5,13,23
/jdk1.2.2/javax/swing/event/PopupMenuEvent.java,Java,,7,2,26,35
/jdk1.2.2/javax/swing/event/PopupMenuListener.java,Java,,7,6,22,35
/jdk1.2.2/javax/swing/event/SwingPropertyChangeSupport.java,Java,,147,30,76,253
/jdk1.2.2/javax/swing/event/TableColumnModelEvent.java,Java,,15,10,43,68
/jdk1.2.2/javax/swing/event/TableColumnModelListener.java,Java,,12,9,22,43
/jdk1.2.2/javax/swing/event/TableModelEvent.java,Java,,38,18,102,158
/jdk1.2.2/javax/swing/event/TableModelListener.java,Java,,6,5,18,29
/jdk1.2.2/javax/swing/event/TreeExpansionEvent.java,Java,,12,5,34,51
/jdk1.2.2/javax/swing/event/TreeExpansionListener.java,Java,,7,5,18,30
/jdk1.2.2/javax/swing/event/TreeModelEvent.java,Java,,75,16,193,284
/jdk1.2.2/javax/swing/event/TreeModelListener.java,Java,,8,8,54,70
/jdk1.2.2/javax/swing/event/TreeSelectionEvent.java,Java,,65,13,75,153
/jdk1.2.2/javax/swing/event/TreeSelectionListener.java,Java,,6,3,20,29
/jdk1.2.2/javax/swing/event/TreeWillExpandListener.java,Java,,7,5,19,31
/jdk1.2.2/javax/swing/event/UndoableEditEvent.java,Java,,12,5,31,48
/jdk1.2.2/javax/swing/event/UndoableEditListener.java,Java,,5,5,16,26
/jdk1.2.2/javax/swing/filechooser/FileFilter.java,Java,,6,4,33,43
/jdk1.2.2/javax/swing/filechooser/FileSystemView.java,Java,,297,69,119,485
/jdk1.2.2/javax/swing/filechooser/FileView.java,Java,,10,8,61,79
/jdk1.2.2/javax/swing/FocusManager.java,Java,,59,14,49,122
/jdk1.2.2/javax/swing/GraphicsWrapper.java,Java,,10,8,12,30
/jdk1.2.2/javax/swing/GrayFilter.java,Java,,31,9,37,77
/jdk1.2.2/javax/swing/Icon.java,Java,,9,6,26,41
/jdk1.2.2/javax/swing/ImageIcon.java,Java,,153,37,141,331
/jdk1.2.2/javax/swing/JApplet.java,Java,,254,82,471,807
/jdk1.2.2/javax/swing/JButton.java,Java,,71,30,146,247
/jdk1.2.2/javax/swing/JCheckBox.java,Java,,62,27,141,230
/jdk1.2.2/javax/swing/JCheckBoxMenuItem.java,Java,,72,26,148,246
/jdk1.2.2/javax/swing/JColorChooser.java,Java,,250,89,270,609
/jdk1.2.2/javax/swing/JComboBox.java,Java,[PENDING:  WDW -- need to provide a localized string,460,110,525,1095
/jdk1.2.2/javax/swing/JComponent.java,Java,,1933,463,1673,4069
/jdk1.2.2/javax/swing/JDesktopPane.java,Java,,100,32,141,273
/jdk1.2.2/javax/swing/JDialog.java,Java,,385,112,603,1100
/jdk1.2.2/javax/swing/JEditorPane.java,Java,,843,126,839,1808
/jdk1.2.2/javax/swing/JFileChooser.java,Java,,567,161,697,1425
/jdk1.2.2/javax/swing/JFrame.java,Java,,335,89,576,1000
/jdk1.2.2/javax/swing/JInternalFrame.java,Java,,744,161,889,1794
/jdk1.2.2/javax/swing/JLabel.java,Java,,323,89,549,961
/jdk1.2.2/javax/swing/JLayeredPane.java,Java,,287,66,354,707
/jdk1.2.2/javax/swing/JList.java,Java,,1062,262,1055,2379
/jdk1.2.2/javax/swing/JMenu.java,Java,,754,137,579,1470
/jdk1.2.2/javax/swing/JMenuBar.java,Java,,321,77,310,708
/jdk1.2.2/javax/swing/JMenuItem.java,Java,,276,68,315,659
/jdk1.2.2/javax/swing/JOptionPane.java,Java,,685,141,1122,1948
/jdk1.2.2/javax/swing/JPanel.java,Java,,57,22,111,190
/jdk1.2.2/javax/swing/JPasswordField.java,Java,,84,30,194,308
/jdk1.2.2/javax/swing/JPopupMenu.java,Java,,1224,229,695,2148
/jdk1.2.2/javax/swing/JProgressBar.java,Java,,277,79,458,814
/jdk1.2.2/javax/swing/JRadioButton.java,Java,,60,30,149,239
/jdk1.2.2/javax/swing/JRadioButtonMenuItem.java,Java,,61,23,131,215
/jdk1.2.2/javax/swing/JRootPane.java,Java,,316,64,383,763
/jdk1.2.2/javax/swing/JScrollBar.java,Java,,285,106,432,823
/jdk1.2.2/javax/swing/JScrollPane.java,Java,,428,138,620,1186
/jdk1.2.2/javax/swing/JSeparator.java,Java,,85,28,133,246
/jdk1.2.2/javax/swing/JSlider.java,Java,,455,162,546,1163
/jdk1.2.2/javax/swing/JSplitPane.java,Java,,364,156,524,1044
/jdk1.2.2/javax/swing/JTabbedPane.java,Java,,663,152,580,1395
/jdk1.2.2/javax/swing/JTable.java,Java,,2027,433,2046,4506
/jdk1.2.2/javax/swing/JTextArea.java,Java,,280,54,423,757
/jdk1.2.2/javax/swing/JTextField.java,Java,,201,54,373,628
/jdk1.2.2/javax/swing/JTextPane.java,Java,,156,36,252,444
/jdk1.2.2/javax/swing/JToggleButton.java,Java,,128,46,173,347
/jdk1.2.2/javax/swing/JToolBar.java,Java,[WDW - need to add orientation from BoxLayout,353,71,282,706
/jdk1.2.2/javax/swing/JToolTip.java,Java,,70,28,131,229
/jdk1.2.2/javax/swing/JTree.java,Java,,2070,399,1754,4223
/jdk1.2.2/javax/swing/JViewport.java,Java,,660,153,533,1346
/jdk1.2.2/javax/swing/JWindow.java,Java,,237,78,471,786
/jdk1.2.2/javax/swing/KeyboardManager.java,Java,,217,49,87,353
/jdk1.2.2/javax/swing/KeyStroke.java,Java,,266,46,192,504
/jdk1.2.2/javax/swing/ListCellRenderer.java,Java,,11,4,55,70
/jdk1.2.2/javax/swing/ListModel.java,Java,,9,7,34,50
/jdk1.2.2/javax/swing/ListSelectionModel.java,Java,,28,36,191,255
/jdk1.2.2/javax/swing/LookAndFeel.java,Java,,167,53,182,402
/jdk1.2.2/javax/swing/MenuElement.java,Java,,10,10,43,63
/jdk1.2.2/javax/swing/MenuSelectionManager.java,Java,,284,48,97,429
/jdk1.2.2/javax/swing/MultiUIDefaults.java,Java,,114,30,11,155
/jdk1.2.2/javax/swing/MutableComboBoxModel.java,Java,,7,7,24,38
/jdk1.2.2/javax/swing/OverlayLayout.java,Java,,113,26,118,257
/jdk1.2.2/javax/swing/plaf/basic/BasicArrowButton.java,Java,,141,30,24,195
/jdk1.2.2/javax/swing/plaf/basic/BasicBorders.java,Java,,224,48,24,296
/jdk1.2.2/javax/swing/plaf/basic/BasicButtonListener.java,Java,,180,47,33,260
/jdk1.2.2/javax/swing/plaf/basic/BasicButtonUI.java,Java,,227,64,80,371
/jdk1.2.2/javax/swing/plaf/basic/BasicCheckBoxMenuItemUI.java,Java,,41,16,14,71
/jdk1.2.2/javax/swing/plaf/basic/BasicCheckBoxUI.java,Java,,16,10,22,48
/jdk1.2.2/javax/swing/plaf/basic/BasicColorChooserUI.java,Java,,150,56,18,224
/jdk1.2.2/javax/swing/plaf/basic/BasicComboBoxEditor.java,Java,,46,15,30,91
/jdk1.2.2/javax/swing/plaf/basic/BasicComboBoxRenderer.java,Java,,53,19,39,111
/jdk1.2.2/javax/swing/plaf/basic/BasicComboBoxUI.java,Java,,787,167,316,1270
/jdk1.2.2/javax/swing/plaf/basic/BasicComboPopup.java,Java,,567,116,234,917
/jdk1.2.2/javax/swing/plaf/basic/BasicDesktopIconUI.java,Java,,174,45,26,245
/jdk1.2.2/javax/swing/plaf/basic/BasicDesktopPaneUI.java,Java,,170,33,24,227
/jdk1.2.2/javax/swing/plaf/basic/BasicDirectoryModel.java,Java,,231,52,57,340
/jdk1.2.2/javax/swing/plaf/basic/BasicEditorPaneUI.java,Java,,25,10,42,77
/jdk1.2.2/javax/swing/plaf/basic/BasicFileChooserUI.java,Java,,477,119,57,653
/jdk1.2.2/javax/swing/plaf/basic/BasicGraphicsUtils.java,Java,,190,69,45,304
/jdk1.2.2/javax/swing/plaf/basic/BasicHTML.java,Java,,158,45,238,441
/jdk1.2.2/javax/swing/plaf/basic/BasicIconFactory.java,Java,,151,33,20,204
/jdk1.2.2/javax/swing/plaf/basic/BasicInternalFrameTitlePane.java,Java,,351,82,78,511
/jdk1.2.2/javax/swing/plaf/basic/BasicInternalFrameUI.java,Java,,868,185,156,1209
/jdk1.2.2/javax/swing/plaf/basic/BasicLabelUI.java,Java,,249,58,102,409
/jdk1.2.2/javax/swing/plaf/basic/BasicListUI.java,Java,,800,211,501,1512
/jdk1.2.2/javax/swing/plaf/basic/BasicLookAndFeel.java,Java,,635,133,90,858
/jdk1.2.2/javax/swing/plaf/basic/BasicMenuBarUI.java,Java,,180,36,23,239
/jdk1.2.2/javax/swing/plaf/basic/BasicMenuItemUI.java,Java,,648,107,105,860
/jdk1.2.2/javax/swing/plaf/basic/BasicMenuUI.java,Java,,643,77,17,737
/jdk1.2.2/javax/swing/plaf/basic/BasicOptionPaneUI.java,Java,,684,135,198,1017
/jdk1.2.2/javax/swing/plaf/basic/BasicPanelUI.java,Java,,34,11,13,58
/jdk1.2.2/javax/swing/plaf/basic/BasicPasswordFieldUI.java,Java,,17,12,35,64
/jdk1.2.2/javax/swing/plaf/basic/BasicPopupMenuSeparatorUI.java,Java,,27,9,13,49
/jdk1.2.2/javax/swing/plaf/basic/BasicPopupMenuUI.java,Java,,248,60,41,349
/jdk1.2.2/javax/swing/plaf/basic/BasicProgressBarUI.java,Java,,267,49,111,427
/jdk1.2.2/javax/swing/plaf/basic/BasicRadioButtonMenuItemUI.java,Java,,42,14,13,69
/jdk1.2.2/javax/swing/plaf/basic/BasicRadioButtonUI.java,Java,,153,40,46,239
/jdk1.2.2/javax/swing/plaf/basic/BasicScrollBarUI.java,Java,,619,163,194,976
/jdk1.2.2/javax/swing/plaf/basic/BasicScrollPaneUI.java,Java,,370,88,81,539
/jdk1.2.2/javax/swing/plaf/basic/BasicSeparatorUI.java,Java,,68,22,14,104
/jdk1.2.2/javax/swing/plaf/basic/BasicSliderUI.java,Java,,1131,236,124,1491
/jdk1.2.2/javax/swing/plaf/basic/BasicSplitPaneDivider.java,Java,,517,125,233,875
/jdk1.2.2/javax/swing/plaf/basic/BasicSplitPaneUI.java,Java,,1062,264,475,1801
/jdk1.2.2/javax/swing/plaf/basic/BasicTabbedPaneUI.java,Java,,1526,257,169,1952
/jdk1.2.2/javax/swing/plaf/basic/BasicTableHeaderUI.java,Java,,306,78,93,477
/jdk1.2.2/javax/swing/plaf/basic/BasicTableUI.java,Java,,689,162,172,1023
/jdk1.2.2/javax/swing/plaf/basic/BasicTextAreaUI.java,Java,,39,8,55,102
/jdk1.2.2/javax/swing/plaf/basic/BasicTextFieldUI.java,Java,,32,11,51,94
/jdk1.2.2/javax/swing/plaf/basic/BasicTextPaneUI.java,Java,,55,9,56,120
/jdk1.2.2/javax/swing/plaf/basic/BasicTextUI.java,Java,,586,126,717,1429
/jdk1.2.2/javax/swing/plaf/basic/BasicToggleButtonUI.java,Java,,102,34,28,164
/jdk1.2.2/javax/swing/plaf/basic/BasicToolBarSeparatorUI.java,Java,,49,16,14,79
/jdk1.2.2/javax/swing/plaf/basic/BasicToolBarUI.java,Java,,677,138,54,869
/jdk1.2.2/javax/swing/plaf/basic/BasicToolTipUI.java,Java,,131,26,24,181
/jdk1.2.2/javax/swing/plaf/basic/BasicTreeUI.java,Java,,2221,424,657,3302
/jdk1.2.2/javax/swing/plaf/basic/BasicViewportUI.java,Java,,31,11,13,55
/jdk1.2.2/javax/swing/plaf/basic/CenterLayout.java,Java,,41,9,12,62
/jdk1.2.2/javax/swing/plaf/basic/ComboPopup.java,Java,,15,11,46,72
/jdk1.2.2/javax/swing/plaf/basic/DefaultMenuLayout.java,Java,,9,5,15,29
/jdk1.2.2/javax/swing/plaf/BorderUIResource.java,Java,,152,43,31,226
/jdk1.2.2/javax/swing/plaf/ButtonUI.java,Java,,5,3,12,20
/jdk1.2.2/javax/swing/plaf/ColorChooserUI.java,Java,,6,6,13,25
/jdk1.2.2/javax/swing/plaf/ColorUIResource.java,Java,,18,7,22,47
/jdk1.2.2/javax/swing/plaf/ComboBoxUI.java,Java,,7,6,22,35
/jdk1.2.2/javax/swing/plaf/ComponentUI.java,Java,,45,16,27,88
/jdk1.2.2/javax/swing/plaf/DesktopIconUI.java,Java,,3,4,12,19
/jdk1.2.2/javax/swing/plaf/DesktopPaneUI.java,Java,,3,4,12,19
/jdk1.2.2/javax/swing/plaf/DimensionUIResource.java,Java,,9,4,23,36
/jdk1.2.2/javax/swing/plaf/FileChooserUI.java,Java,,14,7,12,33
/jdk1.2.2/javax/swing/plaf/FontUIResource.java,Java,,12,5,23,40
/jdk1.2.2/javax/swing/plaf/IconUIResource.java,Java,,25,8,31,64
/jdk1.2.2/javax/swing/plaf/InsetsUIResource.java,Java,,9,4,23,36
/jdk1.2.2/javax/swing/plaf/InternalFrameUI.java,Java,,3,3,12,18
/jdk1.2.2/javax/swing/plaf/LabelUI.java,Java,,3,2,12,17
/jdk1.2.2/javax/swing/plaf/ListUI.java,Java,,10,9,37,56
/jdk1.2.2/javax/swing/plaf/MenuBarUI.java,Java,,5,5,13,23
/jdk1.2.2/javax/swing/plaf/MenuItemUI.java,Java,,5,3,14,22
/jdk1.2.2/javax/swing/plaf/metal/DefaultMetalTheme.java,Java,,42,12,26,80
/jdk1.2.2/javax/swing/plaf/metal/MetalBorders.java,Java,,296,97,28,421
/jdk1.2.2/javax/swing/plaf/metal/MetalBumps.java,Java,,154,42,37,233
/jdk1.2.2/javax/swing/plaf/metal/MetalButtonUI.java,Java,,95,30,39,164
/jdk1.2.2/javax/swing/plaf/metal/MetalCheckBoxIcon.java,Java,,43,14,19,76
/jdk1.2.2/javax/swing/plaf/metal/MetalCheckBoxUI.java,Java,,29,14,29,72
/jdk1.2.2/javax/swing/plaf/metal/MetalComboBoxButton.java,Java,,110,26,24,160
/jdk1.2.2/javax/swing/plaf/metal/MetalComboBoxEditor.java,Java,,37,13,34,84
/jdk1.2.2/javax/swing/plaf/metal/MetalComboBoxIcon.java,Java,,24,11,22,57
/jdk1.2.2/javax/swing/plaf/metal/MetalComboBoxUI.java,Java,,337,69,44,450
/jdk1.2.2/javax/swing/plaf/metal/MetalDesktopIconUI.java,Java,,67,19,12,98
/jdk1.2.2/javax/swing/plaf/metal/MetalFileChooserUI.java,Java,,645,152,124,921
/jdk1.2.2/javax/swing/plaf/metal/MetalIconFactory.java,Java,,1379,335,249,1963
/jdk1.2.2/javax/swing/plaf/metal/MetalInternalFrameTitlePane.java,Java,,310,98,25,433
/jdk1.2.2/javax/swing/plaf/metal/MetalInternalFrameUI.java,Java,,104,34,15,153
/jdk1.2.2/javax/swing/plaf/metal/MetalLabelUI.java,Java,,18,11,21,50
/jdk1.2.2/javax/swing/plaf/metal/MetalLookAndFeel.java,Java,,597,102,69,768
/jdk1.2.2/javax/swing/plaf/metal/MetalPopupMenuSeparatorUI.java,Java,,29,13,13,55
/jdk1.2.2/javax/swing/plaf/metal/MetalProgressBarUI.java,Java,,49,11,37,97
/jdk1.2.2/javax/swing/plaf/metal/MetalRadioButtonUI.java,Java,,115,32,38,185
/jdk1.2.2/javax/swing/plaf/metal/MetalScrollBarUI.java,Java,,260,131,35,426
/jdk1.2.2/javax/swing/plaf/metal/MetalScrollButton.java,Java,,211,57,43,311
/jdk1.2.2/javax/swing/plaf/metal/MetalScrollPaneUI.java,Java,,54,19,19,92
/jdk1.2.2/javax/swing/plaf/metal/MetalSeparatorUI.java,Java,,45,15,20,80
/jdk1.2.2/javax/swing/plaf/metal/MetalSliderUI.java,Java,,220,51,38,309
/jdk1.2.2/javax/swing/plaf/metal/MetalSplitPaneDivider.java,Java,,232,36,81,349
/jdk1.2.2/javax/swing/plaf/metal/MetalSplitPaneUI.java,Java,,13,6,25,44
/jdk1.2.2/javax/swing/plaf/metal/MetalTabbedPaneUI.java,Java,,454,135,107,696
/jdk1.2.2/javax/swing/plaf/metal/MetalTextFieldUI.java,Java,,36,9,19,64
/jdk1.2.2/javax/swing/plaf/metal/MetalTheme.java,Java,,57,18,14,89
/jdk1.2.2/javax/swing/plaf/metal/MetalToggleButtonUI.java,Java,,86,24,36,146
/jdk1.2.2/javax/swing/plaf/metal/MetalToolBarUI.java,Java,,297,76,17,390
/jdk1.2.2/javax/swing/plaf/metal/MetalToolTipUI.java,Java,,73,16,19,108
/jdk1.2.2/javax/swing/plaf/metal/MetalTreeUI.java,Java,,127,40,38,205
/jdk1.2.2/javax/swing/plaf/metal/MetalUtils.java,Java,,94,31,37,162
/jdk1.2.2/javax/swing/plaf/multi/MultiButtonUI.java,Java,,88,18,81,187
/jdk1.2.2/javax/swing/plaf/multi/MultiColorChooserUI.java,Java,,88,18,81,187
/jdk1.2.2/javax/swing/plaf/multi/MultiComboBoxUI.java,Java,,110,21,94,225
/jdk1.2.2/javax/swing/plaf/multi/MultiDesktopIconUI.java,Java,,88,18,81,187
/jdk1.2.2/javax/swing/plaf/multi/MultiDesktopPaneUI.java,Java,,88,18,81,187
/jdk1.2.2/javax/swing/plaf/multi/MultiFileChooserUI.java,Java,,135,24,107,266
/jdk1.2.2/javax/swing/plaf/multi/MultiInternalFrameUI.java,Java,,88,18,81,187
/jdk1.2.2/javax/swing/plaf/multi/MultiLabelUI.java,Java,,88,18,81,187
/jdk1.2.2/javax/swing/plaf/multi/MultiListUI.java,Java,,115,21,96,232
/jdk1.2.2/javax/swing/plaf/multi/MultiLookAndFeel.java,Java,,117,16,46,179
/jdk1.2.2/javax/swing/plaf/multi/MultiMenuBarUI.java,Java,,88,18,81,187
/jdk1.2.2/javax/swing/plaf/multi/MultiMenuItemUI.java,Java,,89,19,84,192
/jdk1.2.2/javax/swing/plaf/multi/MultiOptionPaneUI.java,Java,,102,20,89,211
/jdk1.2.2/javax/swing/plaf/multi/MultiPanelUI.java,Java,,88,18,81,187
/jdk1.2.2/javax/swing/plaf/multi/MultiPopupMenuUI.java,Java,,88,18,81,187
/jdk1.2.2/javax/swing/plaf/multi/MultiProgressBarUI.java,Java,,88,18,81,187
/jdk1.2.2/javax/swing/plaf/multi/MultiScrollBarUI.java,Java,,88,18,81,187
/jdk1.2.2/javax/swing/plaf/multi/MultiScrollPaneUI.java,Java,,88,18,81,187
/jdk1.2.2/javax/swing/plaf/multi/MultiSeparatorUI.java,Java,,88,18,81,187
/jdk1.2.2/javax/swing/plaf/multi/MultiSliderUI.java,Java,,88,18,81,187
/jdk1.2.2/javax/swing/plaf/multi/MultiSplitPaneUI.java,Java,,128,24,105,257
/jdk1.2.2/javax/swing/plaf/multi/MultiTabbedPaneUI.java,Java,,114,21,96,231
/jdk1.2.2/javax/swing/plaf/multi/MultiTableHeaderUI.java,Java,,88,18,81,187
/jdk1.2.2/javax/swing/plaf/multi/MultiTableUI.java,Java,,88,18,81,187
/jdk1.2.2/javax/swing/plaf/multi/MultiTextUI.java,Java,,171,26,151,348
/jdk1.2.2/javax/swing/plaf/multi/MultiToolBarUI.java,Java,,88,18,81,187
/jdk1.2.2/javax/swing/plaf/multi/MultiToolTipUI.java,Java,,88,18,81,187
/jdk1.2.2/javax/swing/plaf/multi/MultiTreeUI.java,Java,,165,28,127,320
/jdk1.2.2/javax/swing/plaf/multi/MultiViewportUI.java,Java,,88,18,81,187
/jdk1.2.2/javax/swing/plaf/OptionPaneUI.java,Java,,7,5,20,32
/jdk1.2.2/javax/swing/plaf/PanelUI.java,Java,,3,4,12,19
/jdk1.2.2/javax/swing/plaf/PopupMenuUI.java,Java,,5,5,13,23
/jdk1.2.2/javax/swing/plaf/ProgressBarUI.java,Java,,3,3,12,18
/jdk1.2.2/javax/swing/plaf/ScrollBarUI.java,Java,,3,2,12,17
/jdk1.2.2/javax/swing/plaf/ScrollPaneUI.java,Java,,3,4,12,19
/jdk1.2.2/javax/swing/plaf/SeparatorUI.java,Java,,3,4,13,20
/jdk1.2.2/javax/swing/plaf/SliderUI.java,Java,,3,3,12,18
/jdk1.2.2/javax/swing/plaf/SplitPaneUI.java,Java,,12,8,32,52
/jdk1.2.2/javax/swing/plaf/TabbedPaneUI.java,Java,,8,3,13,24
/jdk1.2.2/javax/swing/plaf/TableHeaderUI.java,Java,,3,2,12,17
/jdk1.2.2/javax/swing/plaf/TableUI.java,Java,,3,2,12,17
/jdk1.2.2/javax/swing/plaf/TextUI.java,Java,,25,12,100,137
/jdk1.2.2/javax/swing/plaf/ToolBarUI.java,Java,,5,5,12,22
/jdk1.2.2/javax/swing/plaf/ToolTipUI.java,Java,,3,2,12,17
/jdk1.2.2/javax/swing/plaf/TreeUI.java,Java,,18,12,58,88
/jdk1.2.2/javax/swing/plaf/UIResource.java,Java,,3,4,43,50
/jdk1.2.2/javax/swing/plaf/ViewportUI.java,Java,,3,4,12,19
/jdk1.2.2/javax/swing/ProgressMonitor.java,Java,,198,51,140,389
/jdk1.2.2/javax/swing/ProgressMonitorInputStream.java,Java,,73,25,66,164
/jdk1.2.2/javax/swing/Renderer.java,Java,,6,3,25,34
/jdk1.2.2/javax/swing/RepaintManager.java,Java,,317,84,161,562
/jdk1.2.2/javax/swing/RootPaneContainer.java,Java,,13,18,108,139
/jdk1.2.2/javax/swing/Scrollable.java,Java,,11,11,86,108
/jdk1.2.2/javax/swing/ScrollPaneConstants.java,Java,,21,7,56,84
/jdk1.2.2/javax/swing/ScrollPaneLayout.java,Java,,415,127,358,900
/jdk1.2.2/javax/swing/SingleSelectionModel.java,Java,,10,8,42,60
/jdk1.2.2/javax/swing/SizeRequirements.java,Java,,131,25,195,351
/jdk1.2.2/javax/swing/SwingConstants.java,Java,,20,7,81,108
/jdk1.2.2/javax/swing/SwingGraphics.java,Java,,454,147,50,651
/jdk1.2.2/javax/swing/SwingUtilities.java,Java,,1015,235,410,1660
/jdk1.2.2/javax/swing/SystemEventQueueUtilities.java,Java,,460,185,275,920
/jdk1.2.2/javax/swing/table/AbstractTableModel.java,Java,,66,24,130,220
/jdk1.2.2/javax/swing/table/DefaultTableCellRenderer.java,Java,,65,23,57,145
/jdk1.2.2/javax/swing/table/DefaultTableColumnModel.java,Java,,258,77,243,578
/jdk1.2.2/javax/swing/table/DefaultTableModel.java,Java,,217,72,354,643
/jdk1.2.2/javax/swing/table/JTableHeader.java,Java,,700,142,347,1189
/jdk1.2.2/javax/swing/table/TableCellEditor.java,Java,,9,7,37,53
/jdk1.2.2/javax/swing/table/TableCellRenderer.java,Java,,8,5,32,45
/jdk1.2.2/javax/swing/table/TableColumn.java,Java,,218,74,373,665
/jdk1.2.2/javax/swing/table/TableColumnModel.java,Java,,27,25,134,186
/jdk1.2.2/javax/swing/table/TableModel.java,Java,,15,13,95,123
/jdk1.2.2/javax/swing/text/AbstractDocument.java,Java,,1039,269,1308,2616
/jdk1.2.2/javax/swing/text/AbstractWriter.java,Java,,140,30,165,335
/jdk1.2.2/javax/swing/text/ArabicLigaturizer.java,Java,,57,14,40,111
/jdk1.2.2/javax/swing/text/AttributeSet.java,Java,,23,18,121,162
/jdk1.2.2/javax/swing/text/BadLocationException.java,Java,,12,3,31,46
/jdk1.2.2/javax/swing/text/Bidi.java,Java,,740,130,197,1067
/jdk1.2.2/javax/swing/text/BigBoxView.java,Java,,238,46,309,593
/jdk1.2.2/javax/swing/text/BoxView.java,Java,,490,55,335,880
/jdk1.2.2/javax/swing/text/Caret.java,Java,,24,21,126,171
/jdk1.2.2/javax/swing/text/ChangedCharSetException.java,Java,,16,7,13,36
/jdk1.2.2/javax/swing/text/CharBasedLigaturizer.java,Java,,166,33,95,294
/jdk1.2.2/javax/swing/text/ComponentView.java,Java,,228,35,183,446
/jdk1.2.2/javax/swing/text/CompositeView.java,Java,,525,58,521,1104
/jdk1.2.2/javax/swing/text/DefaultCaret.java,Java,,557,101,503,1161
/jdk1.2.2/javax/swing/text/DefaultEditorKit.java,Java,,914,186,852,1952
/jdk1.2.2/javax/swing/text/DefaultHighlighter.java,Java,,289,43,155,487
/jdk1.2.2/javax/swing/text/DefaultStyledDocument.java,Java,,1383,190,777,2350
/jdk1.2.2/javax/swing/text/DefaultTextUI.java,Java,,4,5,15,24
/jdk1.2.2/javax/swing/text/Document.java,Java,,23,23,372,418
/jdk1.2.2/javax/swing/text/EditorKit.java,Java,,26,16,154,196
/jdk1.2.2/javax/swing/text/Element.java,Java,,13,14,75,102
/jdk1.2.2/javax/swing/text/ElementIterator.java,Java,,147,42,150,339
/jdk1.2.2/javax/swing/text/ExtendedTextLabel.java,Java,,22,19,58,99
/jdk1.2.2/javax/swing/text/FieldView.java,Java,,119,17,126,262
/jdk1.2.2/javax/swing/text/GapContent.java,Java,,510,93,315,918
/jdk1.2.2/javax/swing/text/GapVector.java,Java,,117,32,144,293
/jdk1.2.2/javax/swing/text/Highlighter.java,Java,,22,20,94,136
/jdk1.2.2/javax/swing/text/html/BlockView.java,Java,,98,14,71,183
/jdk1.2.2/javax/swing/text/html/BRView.java,Java,,17,5,22,44
/jdk1.2.2/javax/swing/text/html/CommentView.java,Java,,85,13,15,113
/jdk1.2.2/javax/swing/text/html/CSS.java,Java,,1090,202,505,1797
/jdk1.2.2/javax/swing/text/html/EditableView.java,Java,,63,11,30,104
/jdk1.2.2/javax/swing/text/html/FormView.java,Java,,300,49,179,528
/jdk1.2.2/javax/swing/text/html/FrameSetView.java,Java,,178,33,106,317
/jdk1.2.2/javax/swing/text/html/FrameView.java,Java,,188,42,110,340
/jdk1.2.2/javax/swing/text/html/HiddenTagView.java,Java,,204,34,27,265
/jdk1.2.2/javax/swing/text/html/HRuleView.java,Java,,121,22,80,223
/jdk1.2.2/javax/swing/text/html/HTML.java,Java,,362,41,116,519
/jdk1.2.2/javax/swing/text/html/HTMLDocument.java,Java,,1866,305,1125,3296
/jdk1.2.2/javax/swing/text/html/HTMLEditorKit.java,Java,,732,99,549,1380
/jdk1.2.2/javax/swing/text/html/HTMLFrameHyperlinkEvent.java,Java,,38,12,60,110
/jdk1.2.2/javax/swing/text/html/HTMLWriter.java,Java,,961,116,408,1485
/jdk1.2.2/javax/swing/text/html/ImageView.java,Java,,481,82,191,754
/jdk1.2.2/javax/swing/text/html/InlineView.java,Java,,73,13,42,128
/jdk1.2.2/javax/swing/text/html/IsindexView.java,Java,,52,15,31,98
/jdk1.2.2/javax/swing/text/html/LineView.java,Java,,62,11,94,167
/jdk1.2.2/javax/swing/text/html/ListView.java,Java,,55,8,44,107
/jdk1.2.2/javax/swing/text/html/Map.java,Java,,341,47,90,478
/jdk1.2.2/javax/swing/text/html/MinimalHTMLWriter.java,Java,,280,76,247,603
/jdk1.2.2/javax/swing/text/html/NoFramesView.java,Java,,57,15,82,154
/jdk1.2.2/javax/swing/text/html/ObjectView.java,Java,,74,11,82,167
/jdk1.2.2/javax/swing/text/html/Option.java,Java,,38,12,46,96
/jdk1.2.2/javax/swing/text/html/OptionComboBoxModel.java,Java,,13,7,26,46
/jdk1.2.2/javax/swing/text/html/OptionListModel.java,Java,,301,73,168,542
/jdk1.2.2/javax/swing/text/html/ParagraphView.java,Java,,132,22,118,272
/jdk1.2.2/javax/swing/text/html/parser/AttributeList.java,Java,,83,19,53,155
/jdk1.2.2/javax/swing/text/html/parser/ContentModel.java,Java,,144,26,57,227
/jdk1.2.2/javax/swing/text/html/parser/ContentModelState.java,Java,,169,27,61,257
/jdk1.2.2/javax/swing/text/html/parser/DocumentParser.java,Java,,137,24,35,196
/jdk1.2.2/javax/swing/text/html/parser/DTD.java,Java,,251,33,87,371
/jdk1.2.2/javax/swing/text/html/parser/DTDConstants.java,Java,,39,6,21,66
/jdk1.2.2/javax/swing/text/html/parser/Element.java,Java,,79,22,57,158
/jdk1.2.2/javax/swing/text/html/parser/Entity.java,Java,,53,15,35,103
/jdk1.2.2/javax/swing/text/html/parser/Parser.java,Java,,1405,229,373,2007
/jdk1.2.2/javax/swing/text/html/parser/ParserDelegator.java,Java,,61,15,28,104
/jdk1.2.2/javax/swing/text/html/parser/ResourceLoader.java,Java,,16,7,20,43
/jdk1.2.2/javax/swing/text/html/parser/TagElement.java,Java,,33,15,13,61
/jdk1.2.2/javax/swing/text/html/parser/TagStack.java,Java,,123,29,53,205
/jdk1.2.2/javax/swing/text/html/ResourceLoader.java,Java,,16,7,20,43
/jdk1.2.2/javax/swing/text/html/StyleSheet.java,Java,,2017,221,937,3175
/jdk1.2.2/javax/swing/text/html/TableView.java,Java,,170,39,214,423
/jdk1.2.2/javax/swing/text/html/TextAreaDocument.java,Java,,20,12,23,55
/jdk1.2.2/javax/swing/text/IconView.java,Java,,58,13,92,163
/jdk1.2.2/javax/swing/text/JTextComponent.java,Java,,1352,246,1574,3172
/jdk1.2.2/javax/swing/text/Keymap.java,Java,,18,16,94,128
/jdk1.2.2/javax/swing/text/LabelView.java,Java,,688,117,592,1397
/jdk1.2.2/javax/swing/text/LayeredHighlighter.java,Java,,14,4,28,46
/jdk1.2.2/javax/swing/text/Ligaturizer.java,Java,,8,5,32,45
/jdk1.2.2/javax/swing/text/MutableAttributeSet.java,Java,,10,20,55,85
/jdk1.2.2/javax/swing/text/NewArabicShaping.java,Java,,91,29,80,200
/jdk1.2.2/javax/swing/text/ParagraphView.java,Java,,732,90,496,1318
/jdk1.2.2/javax/swing/text/PasswordView.java,Java,,78,11,84,173
/jdk1.2.2/javax/swing/text/PlainDocument.java,Java,,150,15,96,261
/jdk1.2.2/javax/swing/text/PlainView.java,Java,,341,44,235,620
/jdk1.2.2/javax/swing/text/Position.java,Java,,15,8,39,62
/jdk1.2.2/javax/swing/text/RLEUtilities.java,Java,,110,25,68,203
/jdk1.2.2/javax/swing/text/rtf/AbstractFilter.java,Java,,108,27,77,212
/jdk1.2.2/javax/swing/text/rtf/Constants.java,Java,,28,10,22,60
/jdk1.2.2/javax/swing/text/rtf/MockAttributeSet.java,Java,,78,22,8,108
/jdk1.2.2/javax/swing/text/rtf/RTFAttribute.java,Java,,26,7,16,49
/jdk1.2.2/javax/swing/text/rtf/RTFAttributes.java,Java,,324,64,16,404
/jdk1.2.2/javax/swing/text/rtf/RTFEditorKit.java,Java,,46,14,89,149
/jdk1.2.2/javax/swing/text/rtf/RTFGenerator.java,Java,,764,130,97,991
/jdk1.2.2/javax/swing/text/rtf/RTFParser.java,Java,,228,35,53,316
/jdk1.2.2/javax/swing/text/rtf/RTFReader.java,Java,,1114,228,286,1628
/jdk1.2.2/javax/swing/text/Segment.java,Java,,22,10,42,74
/jdk1.2.2/javax/swing/text/SimpleAttributeSet.java,Java,,178,33,152,363
/jdk1.2.2/javax/swing/text/StandardExtendedTextLabel.java,Java,,349,81,258,688
/jdk1.2.2/javax/swing/text/StateInvariantError.java,Java,,7,2,19,28
/jdk1.2.2/javax/swing/text/StringContent.java,Java,,264,40,169,473
/jdk1.2.2/javax/swing/text/Style.java,Java,,11,10,36,57
/jdk1.2.2/javax/swing/text/StyleConstants.java,Java,,316,130,550,996
/jdk1.2.2/javax/swing/text/StyleContext.java,Java,,685,140,714,1539
/jdk1.2.2/javax/swing/text/StyledDocument.java,Java,,17,16,127,160
/jdk1.2.2/javax/swing/text/StyledEditorKit.java,Java,,338,64,373,775
/jdk1.2.2/javax/swing/text/TabableView.java,Java,,5,4,45,54
/jdk1.2.2/javax/swing/text/TabExpander.java,Java,,4,4,22,30
/jdk1.2.2/javax/swing/text/TableView.java,Java,,412,74,393,879
/jdk1.2.2/javax/swing/text/TabSet.java,Java,,66,15,52,133
/jdk1.2.2/javax/swing/text/TabStop.java,Java,,76,15,64,155
/jdk1.2.2/javax/swing/text/TextAction.java,Java,,43,7,66,116
/jdk1.2.2/javax/swing/text/TextLabel.java,Java,,26,14,54,94
/jdk1.2.2/javax/swing/text/Utilities.java,Java,,358,77,210,645
/jdk1.2.2/javax/swing/text/View.java,Java,,187,49,624,860
/jdk1.2.2/javax/swing/text/ViewFactory.java,Java,,5,4,22,31
/jdk1.2.2/javax/swing/text/WrappedPlainView.java,Java,,361,57,309,727
/jdk1.2.2/javax/swing/Timer.java,Java,,124,62,137,323
/jdk1.2.2/javax/swing/TimerQueue.java,Java,,167,60,40,267
/jdk1.2.2/javax/swing/ToolTipManager.java,Java,,517,92,160,769
/jdk1.2.2/javax/swing/tree/AbstractLayoutCache.java,Java,,132,56,237,425
/jdk1.2.2/javax/swing/tree/DefaultMutableTreeNode.java,Java,,646,227,605,1478
/jdk1.2.2/javax/swing/tree/DefaultTreeCellEditor.java,Java,,316,85,207,608
/jdk1.2.2/javax/swing/tree/DefaultTreeCellRenderer.java,Java,,187,49,120,356
/jdk1.2.2/javax/swing/tree/DefaultTreeModel.java,Java,,244,54,250,548
/jdk1.2.2/javax/swing/tree/DefaultTreeSelectionModel.java,Java,,680,113,258,1051
/jdk1.2.2/javax/swing/tree/ExpandVetoException.java,Java,,12,6,24,42
/jdk1.2.2/javax/swing/tree/FixedHeightLayoutCache.java,Java,,974,186,430,1590
/jdk1.2.2/javax/swing/tree/MutableTreeNode.java,Java,,10,8,35,53
/jdk1.2.2/javax/swing/tree/RowMapper.java,Java,,6,3,20,29
/jdk1.2.2/javax/swing/tree/TreeCellEditor.java,Java,,10,4,32,46
/jdk1.2.2/javax/swing/tree/TreeCellRenderer.java,Java,,8,4,26,38
/jdk1.2.2/javax/swing/tree/TreeModel.java,Java,,13,15,73,101
/jdk1.2.2/javax/swing/tree/TreeNode.java,Java,,12,10,39,61
/jdk1.2.2/javax/swing/tree/TreePath.java,Java,,138,33,120,291
/jdk1.2.2/javax/swing/tree/TreeSelectionModel.java,Java,,36,33,148,217
/jdk1.2.2/javax/swing/tree/VariableHeightLayoutCache.java,Java,,1061,191,458,1710
/jdk1.2.2/javax/swing/UIDefaults.java,Java,,215,51,246,512
/jdk1.2.2/javax/swing/UIManager.java,Java,,454,115,377,946
/jdk1.2.2/javax/swing/undo/AbstractUndoableEdit.java,Java,,70,24,112,206
/jdk1.2.2/javax/swing/undo/CannotRedoException.java,Java,,3,2,19,24
/jdk1.2.2/javax/swing/undo/CannotUndoException.java,Java,,3,3,19,25
/jdk1.2.2/javax/swing/undo/CompoundEdit.java,Java,,110,21,96,227
/jdk1.2.2/javax/swing/undo/StateEdit.java,Java,,59,27,90,176
/jdk1.2.2/javax/swing/undo/StateEditable.java,Java,,7,8,21,36
/jdk1.2.2/javax/swing/undo/UndoableEdit.java,Java,,15,14,85,114
/jdk1.2.2/javax/swing/undo/UndoableEditSupport.java,Java,,66,16,67,149
/jdk1.2.2/javax/swing/undo/UndoManager.java,Java,,208,44,200,452
/jdk1.2.2/javax/swing/UnsupportedLookAndFeelException.java,Java,,7,1,24,32
/jdk1.2.2/javax/swing/ViewportLayout.java,Java,,71,19,78,168
/jdk1.2.2/javax/swing/WindowConstants.java,Java,,7,6,30,43
/jdk1.2.2/launcher/java.c,C/C++/ObjC,,615,78,120,813
/jdk1.2.2/launcher/java.h,h,,13,6,18,37
/jdk1.2.2/launcher/java_md.c,C/C++/ObjC,,178,30,38,246
/jdk1.2.2/launcher/java_md.h,h,,18,7,14,39
/jdk1.2.2/org/omg/CORBA/Any.java,Java,,76,90,525,691
/jdk1.2.2/org/omg/CORBA/AnyHolder.java,Java,,21,9,57,87
/jdk1.2.2/org/omg/CORBA/ARG_IN.java,Java,,4,5,29,38
/jdk1.2.2/org/omg/CORBA/ARG_INOUT.java,Java,,4,7,26,37
/jdk1.2.2/org/omg/CORBA/ARG_OUT.java,Java,,4,6,26,36
/jdk1.2.2/org/omg/CORBA/BAD_CONTEXT.java,Java,,15,7,47,69
/jdk1.2.2/org/omg/CORBA/BAD_INV_ORDER.java,Java,,15,8,43,66
/jdk1.2.2/org/omg/CORBA/BAD_OPERATION.java,Java,,15,7,43,65
/jdk1.2.2/org/omg/CORBA/BAD_PARAM.java,Java,,15,7,47,69
/jdk1.2.2/org/omg/CORBA/BAD_POLICY.java,Java,,4,2,6,12
/jdk1.2.2/org/omg/CORBA/BAD_POLICY_TYPE.java,Java,,4,2,6,12
/jdk1.2.2/org/omg/CORBA/BAD_POLICY_VALUE.java,Java,,4,2,6,12
/jdk1.2.2/org/omg/CORBA/BAD_TYPECODE.java,Java,,15,7,44,66
/jdk1.2.2/org/omg/CORBA/BooleanHolder.java,Java,,21,9,59,89
/jdk1.2.2/org/omg/CORBA/Bounds.java,Java,,9,5,22,36
/jdk1.2.2/org/omg/CORBA/ByteHolder.java,Java,,21,10,59,90
/jdk1.2.2/org/omg/CORBA/CharHolder.java,Java,,21,10,60,91
/jdk1.2.2/org/omg/CORBA/COMM_FAILURE.java,Java,,15,7,50,72
/jdk1.2.2/org/omg/CORBA/CompletionStatus.java,Java,,27,13,73,113
/jdk1.2.2/org/omg/CORBA/Context.java,Java,,11,19,195,225
/jdk1.2.2/org/omg/CORBA/ContextList.java,Java,,7,12,70,89
/jdk1.2.2/org/omg/CORBA/CTX_RESTRICT_SCOPE.java,Java,,4,3,24,31
/jdk1.2.2/org/omg/CORBA/Current.java,Java,,4,3,34,41
/jdk1.2.2/org/omg/CORBA/DATA_CONVERSION.java,Java,,15,7,43,65
/jdk1.2.2/org/omg/CORBA/DefinitionKind.java,Java,,112,4,30,146
/jdk1.2.2/org/omg/CORBA/DomainManager.java,Java,,5,5,17,27
/jdk1.2.2/org/omg/CORBA/DoubleHolder.java,Java,,21,12,56,89
/jdk1.2.2/org/omg/CORBA/DynamicImplementation.java,Java,,6,6,27,39
/jdk1.2.2/org/omg/CORBA/DynAny.java,Java,,89,69,675,833
/jdk1.2.2/org/omg/CORBA/DynAnyPackage/Invalid.java,Java,,10,4,11,25
/jdk1.2.2/org/omg/CORBA/DynAnyPackage/InvalidSeq.java,Java,,10,4,11,25
/jdk1.2.2/org/omg/CORBA/DynAnyPackage/InvalidValue.java,Java,,10,3,7,20
/jdk1.2.2/org/omg/CORBA/DynAnyPackage/TypeMismatch.java,Java,,10,4,12,26
/jdk1.2.2/org/omg/CORBA/DynArray.java,Java,,7,6,21,34
/jdk1.2.2/org/omg/CORBA/DynEnum.java,Java,,8,7,30,45
/jdk1.2.2/org/omg/CORBA/DynFixed.java,Java,,7,5,21,33
/jdk1.2.2/org/omg/CORBA/DynSequence.java,Java,,9,7,32,48
/jdk1.2.2/org/omg/CORBA/DynStruct.java,Java,,9,7,29,45
/jdk1.2.2/org/omg/CORBA/DynUnion.java,Java,,12,11,52,75
/jdk1.2.2/org/omg/CORBA/DynValue.java,Java,,8,6,30,44
/jdk1.2.2/org/omg/CORBA/Environment.java,Java,,6,10,28,44
/jdk1.2.2/org/omg/CORBA/ExceptionList.java,Java,,9,11,73,93
/jdk1.2.2/org/omg/CORBA/FixedHolder.java,Java,,21,11,46,78
/jdk1.2.2/org/omg/CORBA/FloatHolder.java,Java,,21,9,55,85
/jdk1.2.2/org/omg/CORBA/FREE_MEM.java,Java,,15,6,42,63
/jdk1.2.2/org/omg/CORBA/IDLType.java,Java,,6,2,22,30
/jdk1.2.2/org/omg/CORBA/IMP_LIMIT.java,Java,,15,7,42,64
/jdk1.2.2/org/omg/CORBA/INITIALIZE.java,Java,,15,6,47,68
/jdk1.2.2/org/omg/CORBA/INTERNAL.java,Java,,15,6,48,69
/jdk1.2.2/org/omg/CORBA/INTF_REPOS.java,Java,,15,6,40,61
/jdk1.2.2/org/omg/CORBA/IntHolder.java,Java,,21,9,62,92
/jdk1.2.2/org/omg/CORBA/INVALID_TRANSACTION.java,Java,,15,6,42,63
/jdk1.2.2/org/omg/CORBA/INV_FLAG.java,Java,,15,6,43,64
/jdk1.2.2/org/omg/CORBA/INV_IDENT.java,Java,,15,6,43,64
/jdk1.2.2/org/omg/CORBA/INV_OBJREF.java,Java,,15,6,46,67
/jdk1.2.2/org/omg/CORBA/INV_POLICY.java,Java,,15,6,42,63
/jdk1.2.2/org/omg/CORBA/IRObject.java,Java,,7,1,33,41
/jdk1.2.2/org/omg/CORBA/LongHolder.java,Java,,21,10,57,88
/jdk1.2.2/org/omg/CORBA/MARSHAL.java,Java,,15,6,42,63
/jdk1.2.2/org/omg/CORBA/NamedValue.java,Java,,6,10,92,108
/jdk1.2.2/org/omg/CORBA/NameValuePair.java,Java,,10,8,27,45
/jdk1.2.2/org/omg/CORBA/NO_IMPLEMENT.java,Java,,15,6,43,64
/jdk1.2.2/org/omg/CORBA/NO_MEMORY.java,Java,,15,7,42,64
/jdk1.2.2/org/omg/CORBA/NO_PERMISSION.java,Java,,15,6,41,62
/jdk1.2.2/org/omg/CORBA/NO_RESOURCES.java,Java,,15,6,42,63
/jdk1.2.2/org/omg/CORBA/NO_RESPONSE.java,Java,,15,6,41,62
/jdk1.2.2/org/omg/CORBA/NVList.java,Java,,9,16,137,162
/jdk1.2.2/org/omg/CORBA/Object.java,Java,,25,35,191,251
/jdk1.2.2/org/omg/CORBA/ObjectHolder.java,Java,,21,9,61,91
/jdk1.2.2/org/omg/CORBA/OBJECT_NOT_EXIST.java,Java,,15,6,44,65
/jdk1.2.2/org/omg/CORBA/OBJ_ADAPTER.java,Java,,15,6,44,65
/jdk1.2.2/org/omg/CORBA/ORB.java,Java,,286,114,775,1175
/jdk1.2.2/org/omg/CORBA/ORBPackage/InconsistentTypeCode.java,Java,,10,4,20,34
/jdk1.2.2/org/omg/CORBA/ORBPackage/InvalidName.java,Java,,9,4,23,36
/jdk1.2.2/org/omg/CORBA/PERSIST_STORE.java,Java,,15,6,40,61
/jdk1.2.2/org/omg/CORBA/Policy.java,Java,,7,7,25,39
/jdk1.2.2/org/omg/CORBA/PolicyError.java,Java,,15,7,30,52
/jdk1.2.2/org/omg/CORBA/portable/ApplicationException.java,Java,,16,6,24,46
/jdk1.2.2/org/omg/CORBA/portable/Delegate.java,Java,,86,29,220,335
/jdk1.2.2/org/omg/CORBA/portable/IDLEntity.java,Java,,3,3,13,19
/jdk1.2.2/org/omg/CORBA/portable/InputStream.java,Java,,53,12,49,114
/jdk1.2.2/org/omg/CORBA/portable/InvokeHandler.java,Java,,6,4,44,54
/jdk1.2.2/org/omg/CORBA/portable/ObjectImpl.java,Java,,155,37,85,277
/jdk1.2.2/org/omg/CORBA/portable/OutputStream.java,Java,,63,12,36,111
/jdk1.2.2/org/omg/CORBA/portable/RemarshalException.java,Java,,6,2,20,28
/jdk1.2.2/org/omg/CORBA/portable/ResponseHandler.java,Java,,5,3,28,36
/jdk1.2.2/org/omg/CORBA/portable/ServantObject.java,Java,,5,4,22,31
/jdk1.2.2/org/omg/CORBA/portable/Streamable.java,Java,,7,4,32,43
/jdk1.2.2/org/omg/CORBA/Principal.java,Java,,5,6,24,35
/jdk1.2.2/org/omg/CORBA/PrincipalHolder.java,Java,,21,11,41,73
/jdk1.2.2/org/omg/CORBA/PRIVATE_MEMBER.java,Java,,4,1,12,17
/jdk1.2.2/org/omg/CORBA/PUBLIC_MEMBER.java,Java,,4,1,12,17
/jdk1.2.2/org/omg/CORBA/Request.java,Java,,25,50,209,284
/jdk1.2.2/org/omg/CORBA/ServerRequest.java,Java,,35,19,230,284
/jdk1.2.2/org/omg/CORBA/ServiceDetail.java,Java,,11,4,6,21
/jdk1.2.2/org/omg/CORBA/ServiceDetailHelper.java,Java,,51,6,7,64
/jdk1.2.2/org/omg/CORBA/ServiceInformation.java,Java,,13,7,11,31
/jdk1.2.2/org/omg/CORBA/ServiceInformationHelper.java,Java,,59,7,7,73
/jdk1.2.2/org/omg/CORBA/ServiceInformationHolder.java,Java,,20,10,60,90
/jdk1.2.2/org/omg/CORBA/SetOverrideType.java,Java,,25,9,36,70
/jdk1.2.2/org/omg/CORBA/ShortHolder.java,Java,,21,9,60,90
/jdk1.2.2/org/omg/CORBA/StringHolder.java,Java,,21,9,59,89
/jdk1.2.2/org/omg/CORBA/StructMember.java,Java,,12,8,39,59
/jdk1.2.2/org/omg/CORBA/SystemException.java,Java,,31,11,41,83
/jdk1.2.2/org/omg/CORBA/TCKind.java,Java,,148,79,298,525
/jdk1.2.2/org/omg/CORBA/TRANSACTION_REQUIRED.java,Java,,15,6,43,64
/jdk1.2.2/org/omg/CORBA/TRANSACTION_ROLLEDBACK.java,Java,,15,6,43,64
/jdk1.2.2/org/omg/CORBA/TRANSIENT.java,Java,,15,6,41,62
/jdk1.2.2/org/omg/CORBA/TypeCode.java,Java,,42,39,409,490
/jdk1.2.2/org/omg/CORBA/TypeCodeHolder.java,Java,,21,9,60,90
/jdk1.2.2/org/omg/CORBA/TypeCodePackage/BadKind.java,Java,,9,4,25,38
/jdk1.2.2/org/omg/CORBA/TypeCodePackage/Bounds.java,Java,,9,5,24,38
/jdk1.2.2/org/omg/CORBA/UnionMember.java,Java,,14,9,45,68
/jdk1.2.2/org/omg/CORBA/UNKNOWN.java,Java,,15,6,43,64
/jdk1.2.2/org/omg/CORBA/UnknownUserException.java,Java,,11,7,28,46
/jdk1.2.2/org/omg/CORBA/UNSUPPORTED_POLICY.java,Java,,4,2,6,12
/jdk1.2.2/org/omg/CORBA/UNSUPPORTED_POLICY_VALUE.java,Java,,4,2,6,12
/jdk1.2.2/org/omg/CORBA/UserException.java,Java,,9,5,24,38
/jdk1.2.2/org/omg/CORBA/ValueMember.java,Java,,20,12,60,92
/jdk1.2.2/org/omg/CORBA/VM_ABSTRACT.java,Java,,4,2,6,12
/jdk1.2.2/org/omg/CORBA/VM_CUSTOM.java,Java,,4,2,6,12
/jdk1.2.2/org/omg/CORBA/VM_NONE.java,Java,,4,2,6,12
/jdk1.2.2/org/omg/CORBA/VM_TRUNCATABLE.java,Java,,4,2,6,12
/jdk1.2.2/org/omg/CORBA/WrongTransaction.java,Java,,9,4,25,38
/jdk1.2.2/org/omg/CosNaming/Binding.java,Java,,10,1,14,25
/jdk1.2.2/org/omg/CosNaming/BindingHelper.java,Java,,55,3,13,71
/jdk1.2.2/org/omg/CosNaming/BindingHolder.java,Java,,20,4,14,38
/jdk1.2.2/org/omg/CosNaming/BindingIterator.java,Java,,9,1,32,42
/jdk1.2.2/org/omg/CosNaming/BindingIteratorHelper.java,Java,,41,2,13,56
/jdk1.2.2/org/omg/CosNaming/BindingIteratorHolder.java,Java,,20,4,14,38
/jdk1.2.2/org/omg/CosNaming/BindingListHelper.java,Java,,42,2,13,57
/jdk1.2.2/org/omg/CosNaming/BindingListHolder.java,Java,,21,3,14,38
/jdk1.2.2/org/omg/CosNaming/BindingType.java,Java,,24,1,12,37
/jdk1.2.2/org/omg/CosNaming/BindingTypeHelper.java,Java,,33,2,13,48
/jdk1.2.2/org/omg/CosNaming/BindingTypeHolder.java,Java,,20,4,14,38
/jdk1.2.2/org/omg/CosNaming/IstringHelper.java,Java,,31,2,13,46
/jdk1.2.2/org/omg/CosNaming/NameComponent.java,Java,,10,1,14,25
/jdk1.2.2/org/omg/CosNaming/NameComponentHelper.java,Java,,44,3,13,60
/jdk1.2.2/org/omg/CosNaming/NameComponentHolder.java,Java,,20,4,14,38
/jdk1.2.2/org/omg/CosNaming/NameHelper.java,Java,,42,2,13,57
/jdk1.2.2/org/omg/CosNaming/NameHolder.java,Java,,21,3,14,38
/jdk1.2.2/org/omg/CosNaming/NamingContext.java,Java,,23,1,137,161
/jdk1.2.2/org/omg/CosNaming/NamingContextHelper.java,Java,,41,2,13,56
/jdk1.2.2/org/omg/CosNaming/NamingContextHolder.java,Java,,20,4,14,38
/jdk1.2.2/org/omg/CosNaming/NamingContextPackage/AlreadyBound.java,Java,,7,1,13,21
/jdk1.2.2/org/omg/CosNaming/NamingContextPackage/AlreadyBoundHelper.java,Java,,34,2,14,50
/jdk1.2.2/org/omg/CosNaming/NamingContextPackage/AlreadyBoundHolder.java,Java,,20,4,14,38
/jdk1.2.2/org/omg/CosNaming/NamingContextPackage/CannotProceed.java,Java,,14,1,14,29
/jdk1.2.2/org/omg/CosNaming/NamingContextPackage/CannotProceedHelper.java,Java,,57,5,14,76
/jdk1.2.2/org/omg/CosNaming/NamingContextPackage/CannotProceedHolder.java,Java,,20,4,14,38
/jdk1.2.2/org/omg/CosNaming/NamingContextPackage/InvalidName.java,Java,,7,1,13,21
/jdk1.2.2/org/omg/CosNaming/NamingContextPackage/InvalidNameHelper.java,Java,,34,2,14,50
/jdk1.2.2/org/omg/CosNaming/NamingContextPackage/InvalidNameHolder.java,Java,,20,4,14,38
/jdk1.2.2/org/omg/CosNaming/NamingContextPackage/NotEmpty.java,Java,,7,1,13,21
/jdk1.2.2/org/omg/CosNaming/NamingContextPackage/NotEmptyHelper.java,Java,,34,2,14,50
/jdk1.2.2/org/omg/CosNaming/NamingContextPackage/NotEmptyHolder.java,Java,,20,4,14,38
/jdk1.2.2/org/omg/CosNaming/NamingContextPackage/NotFound.java,Java,,14,1,14,29
/jdk1.2.2/org/omg/CosNaming/NamingContextPackage/NotFoundHelper.java,Java,,57,5,14,76
/jdk1.2.2/org/omg/CosNaming/NamingContextPackage/NotFoundHolder.java,Java,,20,4,14,38
/jdk1.2.2/org/omg/CosNaming/NamingContextPackage/NotFoundReason.java,Java,,28,1,12,41
/jdk1.2.2/org/omg/CosNaming/NamingContextPackage/NotFoundReasonHelper.java,Java,,34,2,13,49
/jdk1.2.2/org/omg/CosNaming/NamingContextPackage/NotFoundReasonHolder.java,Java,,20,4,14,38
/jdk1.2.2/org/omg/CosNaming/_BindingIteratorImplBase.java,Java,,71,3,15,89
/jdk1.2.2/org/omg/CosNaming/_BindingIteratorStub.java,Java,,44,6,16,66
/jdk1.2.2/org/omg/CosNaming/_NamingContextImplBase.java,Java,,370,3,15,388
/jdk1.2.2/org/omg/CosNaming/_NamingContextStub.java,Java,,237,6,23,266
/jdk1.2.2/sun/tools/ttydebug/TTY.java,Java,,1555,154,107,1816
/jdk1.2.2/sunw/io/Serializable.java,Java,,3,3,30,36
/jdk1.2.2/sunw/util/EventListener.java,Java,,3,3,30,36
/jdk1.2.2/sunw/util/EventObject.java,Java,,6,5,30,41
